abat - opat
abazhur - abażur
abdikim - abdykacja
abetare - abecadło, alfabet, ABC, poradnik
abetare morze - alfabet Morse'a
absolutizëm - absolutyzm
absorbim - absorpcja
abstrakt - abstrakcyjny
absurditet - absurd
adhuroj - czcić, wielbić, uwielbiać
adhurueshëm - fascynujący, wciągający, absorbujący, uroczy
administrativ - administracyjny
admirueshëm - godny podziwu, wspaniały
adresë - adres
aeroplan - samolot
aeroport - lotnisko
afër - blisko
afërmënç - na pewno
afërsisht - około
aftësi - umiejętność
agim - brzask, poranek, wschód słońca
ah - buk
ai - on
ajër - powietrze
ajkë - krem, śmietana
ajo - ona
aksident - wypadek
aktivizëm - aktywizm
aktor - aktor
akull - lód
alfabet - alfabet
alkool - alkohol
ambulancë - ambulans, karetka
Amerika - Ameryka
analogji - analogia
anarkizëm - anarchizm
anatomi - anatomia
Andora - Andora
anglisht - po angielsku
anije - statek
Antigua dhe Barbuda - Antigua i Barbuda
antimon - antymon
antonim - antonim
antropologji - antropologia
anullim - anulowanie, unieważnienie
apokalips - apokalipsa
ar - złoto
ardhme - przyszłość
ardhshëm - przyszły
arësye - powód
arëz - trzmiel
argjend - srebro
ari - niedźwiedź
aristokraci - arystokracja
Aristoteli - Arystoteles
arkeologji - archeologia
arkitekt - architekt
arkivol - trumna
Armenia - Armenia
armëpushim - rozejm
armik - wróg
armiqësor - wrogi
arrati - ucieczka
arrestoj - aresztować
arsimoj - edukować
art - sztuka
artikull - artykuł
asgjë - nic
asht - kość
asistent - asystent
asistente - asystent
asnjëherë - nigdy
astrofizikë - astrofizyka
astrologji - astrologia
astronom - astronom
astronomi - astronomia
ata - oni
atdhe - ojczyzna
ateist - ateista
ateizëm - ateizm
atmosferë - atmosfera
atribut - atrybut
atrofi - atrofia
Australi - Australia
Austria - Austria
autizmi - autyzm
autobus - autobus
autograf - autograf
autonom - niezależny
autonomi - autonomia
autor - autor
autore - autorka
autostradë - autostrada
avari - razem
avlëmend - krosno
avokat - adwokat
avull - para
Azia - Azja
azot - azot
baba - ojciec
Baba Dimri - święty mikołaj, Dziadek Mróz
babagjysh - dziadek
bagazh - bagaż
bahçe - ogród
bajgë - gnój, łajno
bajonetë - bagnet
bakelit - bakelit
bakshish - napiwek
bakter - bakteria
bakteriologji - bakteriologia
baldosë - borsuk
balenë - wieloryb
balet - balet
ballkon - balkon
baltë - błoto
bambu - bambus
bamirësi - dobroczynność
banane - banan
bardhë - biały
bari - pasterz
barukë - runo owcze
barut - proch strzelniczy
bashkëndodhi - zbieg okoliczności
bashkëveprim - interakcja
bashkim - unia, związek, połączenie, fuzja, zjednoczenie
Bashkimi Europian - Unia Europejska
bathë - bób
be - przysięga
bëj - robić, przejeżdżać, prowadzić
bëj dashuri - kochać się, uprawiać miłość
Benini - Benin
benzinë - benzyna
beqar - samotny, nieżonaty
bërryl - łokieć
bërshen - jałowiec
bërthamor - jądrowy, nuklearny
besoj - wierzyć
betejë - bitwa, walka
bibliotekë - biblioteka
biçikletë - rower
bijë - córka
bile - penis
biletë - bilet
bimë - roślina
Binjakët - Bliźnięta
biografik - biograficzny
biologji - biologia
biologjik - biologiczny
bir - syn
birrë - piwo
bisedë - rozmowa
biseksualitet - biseksualizm
blehurë - blady
blej - kupować
blemja - kupiony
blerë - zielony
blertë - zielony
blozë - sadza
bor - bor
borë - śnieg
botë - świat
bozhure - piwonia
Brazil - Brazylia
Brazili - Brazylia
bredh - jodła
breshër - grad
breshkë - żółw
bretkosë - żaba
brimë - dziura
brinjë - żebro
brishtë - delikatny
brumë - ciasto
brushtull - wrzos
bubu - niestety
budallaçkë - idiotka, kretynka, głupia dziewczyna
budizëm - buddyzm
buf - sowa
bujk - rolnik, farmer
bujqësi - rolnictwo
bukë - chleb
bukël - łasica
bukur - piękny
bukurshkrim - kaligrafia
Bullgari - Bułgaria
Bullgaria - Bułgaria
burdhë - worek
burg - więzienie
burrë - mężczyzna, mąż
bush - bukszpan
buzëqesh - uśmiechać się
buzëqeshje - uśmiech
çadër - parasol, namiot
çaj - herbata
çakall - szakal
çakalle - szakal
çalë - kulawy
çamçakëz - guma do żucia
çast - chwila, moment
çë - co
çelës - klucz
çelik - stal
cëril - drozd
cerk - uderzyć
çfarë - co
cigare - papieros
cilësi - jakość
cimb - żądło
cirlë - kos
çlirim - wyzwolenie
çmim - cena
çmos - wszystko
çoban - pasterz
çokollatë - czekolada
Colombo - Kolumb (odkrywca)
çorbë - zupa
çukë - szczyt, dziób
cullak - nagi
çupkë - dziewczynka
daltë - dłuto
dangë - brzuch
dardhë - gruszka
darkë - kolacja
Dashi - Baran
dashur - kochany, ukochany, miły
dashuri - miłość
dashuroj - kochać
dasmë - ślub, wesele
dëborë - śnieg
defekt - defekt
dëgjoj - słuchać
dëkoj - uderzyć
dele - owca
delfin - delfin
dem - byk
dembel - leniwy
Demi - Byk, Byk  ♉
demokraci - demokracja
demokratik - demokratyczny
derdhazë - powódź
dërgoj - wysłać, wysyłać
dermatologji - dermatologia
derr - wieprz
derrkuc - prosię
dëshiroj - chcieć, pragnąć
dëshirueshëm - pożądany
det - morze
detal - część maszyny, detal
Deti Adriatik - Morze Adriatyckie
Deti Baltik - Morze Bałtyckie
Deti Mesdhe - Morze Śródziemne
detyrim - obowiązek
deve - wielbłąd
dhallë - maślanka
dhanore - celownik
dhatë - miejsce
dhe - i, ziemia, grunt
dhelpër - lis
dhëmb - ząb
dhembje koke - ból głowy
dhëndërr - zięć, pan młody
dhjetë - dziesięć, 10
dhjetor - grudzień
dhomë - pokój, pomieszczenie
dhunë - przemoc
dhuratë - dar, prezent
di - wiedzieć, znać
dialekt - dialekt
diçka - coś
diell - słońce
diellor - słoneczny
diku - gdzieś
dikush - ktoś
dimër - zima
dinjitet - godność
ditë - dzień
ditëlindje - urodziny
divan - kanapa, sofa, tapczan
djalë - chłopiec, syn
djall - diabeł
djathë - ser
dje - wczoraj
djersë - pot
djersij - pocić się
do - chcieć, lubić, kochać
dobët - słaby
domate - pomidor
dorashkë - rękawiczka
dorë - ręka
dragua - smok
drapër - sierp
dre - jeleń
dredhëz - truskawka
dredhkë - bluszcz
drejtësi - sprawiedliwość
drejtues - administrator
drenjë - przepiórka
dreq - diabeł
dritare - okno
drithë - ziarno, zboże
droe - strach
drokth - miotła
drom - droga
dru - drewno
dryshk - rdza
duhan - tytoń
duhanpirës - palacz
duhet - musieć
dy - dwa, 2
dygjuhësh - dwujęzyczny
dyllë - wosk
dymbëdhjetë - dwanaście
dyqan - sklep
dyzet - czterdzieści, 40
e - i, forma wprowadzająca dopełniacz
e celet - blady
eci - iść
edh - koza
e diel - niedziela
e enjte - czwartek
e hënë - poniedziałek
ehull - sopel
ekologji - ekologia
ekspozitë - wystawa, ekspozycja
elb - jęczmień
elefant - słoń
e martë - wtorek
ëmbël - słodki
ëmbëlsi - słodycz, słodkość
ëmbëlsirë - ciasteczko, słodycz, deser
ëmë - matka
emër - imię
e mërkurë - środa
emëroj - nazywać
emërore - mianownik
emtë - ciotka
enciklopedia - encyklopedia
ëndërr - sen
ëndërroj - śnić
energji - energia
engjëll - anioł
ëngjëll - anioł
enigmatik - enigmatyczny
enigmë - zagadka
epidemi - epidemia
epidemik - epidemiczny
e premte - piątek
epsh - żądza
epshmëri - elastyczność
erë - wiatr
erotik - erotyczny
err - ciemność
errët - ciemny
esh - jeż
është - jam
e shtunë - sobota
Estonia - Estonia
et - pragnienie
ethe - gorączka
eufori - euforia
e vërteta të merr sytë - prawda w oczy kole
faleminderit - dziękuję
fall - przepowiednia
famshëm - sławny, słynny
fantazmë - duch
farë - nasiono, nasienie
farmaci - apteka, farmacja
farmakologji - farmakologia
fashë - bandaż
fe - religia
fëmijë - dziecko
feniks - feniks
ferr - piekło
fier - paproć
fill - nić, nitka
fill dhëmbësh - nitka do zębów
fillim - początek
filloj - zaczynać
filxhan - filiżanka
firmë - podpis
firmos - podpisywać
fitoj - zdobyć, wygrać
fitore - zwycięstwo
fizikë - fizyka
fiziologji - fizjologia
fjala është argjend, heshtja është flori - mowa jest srebrem, a milczenie złotem
fjalë - słowo
fjalor - słownik
fjalorth - glosariusz
flakë - płomień
flamur - flaga
flas - mówić
fle - spać
flojere - flet
flori - złoto
flutur - motyl
fole - gniazdo
forcë - siła, moc
fortë - mocny, silny
fortësi - siła, twardość
foshnjë - niemowlę
fotografi - fotografia, zdjęcie
fqinj - sąsiad
Francë - Francja
freskët - świeży
frikë - strach
frushkull - gwizdek
frutë - owoc
frymë - oddech
frymëmarrje - oddech, oddychanie
fshaj - wzdychać
fshehtë - sekret, tajemnica
ftesë - zaproszenie
ftohtë - zimny
ftoj - zaprosić, zapraszać
fund - spódnica
fundit - ostatni, końcowy
funksion - funkcja
fuqi - siła, moc
fuqishëm - silny, potężny
furçë dhëmbësh - szczoteczka do zębów
fushatë - kampania
fushë - pole
fustan - sukienka
fyej - obrażać
fyell - flet
fyerje - obraza
fyt - gardło
gabim - błąd, pomyłka, wina
Gaforrja - Rak
gajdhur - osioł
Galilea - Galilea (kraina)
gamule - sterta
gatë - czapla
gatuaj - gotować, przygotowywać jedzenie
gavër - dziura
gaz - radość, śmiech
gazetar - dziennikarz
gazetari - dziennikarstwo
gazetë - gazeta
gënjeshtër - kłamstwo
gërhas - chrapać
gërshërë - nożyczki
gështenjë - kasztan
gëzim - radość, szczęście
gëzuar - wesoły
gisht - palec
gisht i madh - kciuk
gjah - polowanie
gjak - krew
gjalpë - masło
gjarpër - wąż
gjashtë - sześć, 6
gjashtëdhjetë - sześćdziesiąt
gjashtëmbëdhjetë - szesnaście, 16
gjatë - wysoki, długi
gjë - rzecz
gjej - znaleźć
gjelbër - zielony
gjellë - danie (potrawa)
gjellëz - sól
gjemb - cierń, kolec
gjendër - gruczoł
gjenealogji - genealogia
gjenetik - genetyczny
gjenocid - ludobójstwo
gjeografi - geografia
gjeolog - geolog
gjeologji - geologia
gjeometri - geometria
gjeometrik - geometryczny
gjepur - nonsens
gjer - popielica
gjerë - szeroki
Gjermani - Niemcy
Gjermania - Niemcy
Gjibraltari - Gibraltar
gjimnastikë - gimnastyka
gjinore - dopełniacz
gjirafë - żyrafa
gjithashtu - także, też, również
gjithçka - wszystko
gjithësi - wszechświat
gjithë thelbi i çështjes - tu leży pies pogrzebany
gjor - nędzny, nieszczęsny
gju - kolano
gjuhë - język
gjuhë amtare - język ojczysty
gjuhë e huaj - język obcy
gjuhësi - lingwistyka, językoznawstwo
gjuhësor - językowy
gjumë - sen, spanie
gjurmë - ślad
gjysh - dziadek
gjyshe - babcia
gjysmë - połowa
gledhë - pieszczota
glep - żądło, pokrzywa
Godzilla - Godzilla
gomar - osioł
gozhdë - gwóźdź
gramatikan - gramatyk
gramatikë - gramatyka
gramatikisht - gramatycznie
gramatikor - gramatyczny
grehull - zarośla, gąszcz
grek - grecki
greqisht - po grecku
grerak - szerszeń
grerë - szerszeń, osa
grih - ostrzyć
grip - grypa
grua - kobieta, żona
grumbull - sterta
gurgull - gardło
gusht - sierpień
ha - jeść
habi - zaskoczenie, zdumienie
hajdut - złodziej
hap - otwierać
hapur - otwarty
hardhi - wino, winorośl
hardhucë - jaszczurka
harraq - zapominalski
harroj - zapomnieć
hartë - mapa
hauz - staw, sadzawka
hë - teraz
hekur - żelazo
helm - trucizna
hënë - księżyc
herët - wcześnie
herr - karzeł
heshtë - włócznia
heteroseksualitet - heteroseksualizm
hidhem - skakać
hidhërohem - posmutnieć
hierarki - hierarchia
hije - cień
hime - otręby
himn - hymn
hirrë - serwatka
histori - historia
hokë - żart
Hollanda - Holandia
hollë - szczupły, chudy
hollësi - detal, szczegół
homonim - homonim
homoseksualitet - homoseksualizm
hordhi - horda
huall - plaster
hudhër - czosnek
hundë - nos
Hungaria - Węgry
hyjnor - boski
idealizëm - idealizm
identifikim - identyfikacja
i hollësishëm - szczegółowy, z detalami
i madh - duży
imagjinatë - wyobraźnia
infeksion - infekcja
infektim - infekcja
institucion - instytucja
institut - instytut
inteligjent - inteligentny
i përditshëm - codzienny
Irak - Irak
iriq - jeż
Irlanda - Irlandia
ironi - ironia
ishull - wyspa
ishulli - wyspa
islam - islamski, islam
Islanda - Islandia
Italia - Włochy
jam - być
janar - styczeń
jap - dawać
jashtëzakonshëm - nietypowy
javë - tydzień
jes - pozostać
jetë - życie
Jezusi - Jezus
jomiqësor - nieprzyjazny
ju - wy
jug - południe
jugor - południowy
jurist - prawnik
kabisht - skorek
kaçel - kulawy
kafe - kawa, brązowy
kafshë - zwierzę
kajsi - morela
kalë - koń
kalem - ołówek
kalimtar - przechodni
kalium - potas
Kalium - potas
kallamboq - kukurydza
kaltër - niebieski
kam - mieć
kamion - ciężarówka
kanape - kanapa, sofa, tapczan
karbë - sęp
karkalec - konik polny
kartolinë - pocztówka
kastravec - ogórek
katër - cztery, 4
katërmbëdhjetë - czternaście
katran - smoła
katund - wioska
Kaukazi - Kaukaz
kek - ciasto
kem - kadzidło
këmish - koszula
këmishë - koszula
kënaqësi - przyjemność, satysfakcja
këndoj - śpiewać
këngë - pieśń, piosenka
keq - kiepsko, zły
keqardhës - współczujący
keqkuptim - nieporozumienie
Kërshëndella - Boże Narodzenie
këshill - rada
kështjellë - zamek
ketër - wiewiórka
këtu - tutaj, tu
këtu është gjithë puna - tu leży pies pogrzebany
kilometër - kilometr
kinema - kino
kinematografi - kinematografia
kirurg - chirurg
kishë - kościół
kmesë - sierp
kockë - kość
kodër - wzgórze
kofshë - udo
kohë - czas, czas trwania, pogoda
kohëpaskohshëm - sporadyczny
kokë - głowa
kokëçarje - ból głowy
kokë turku - kozioł ofiarny
kokosh - kogut
kolibër - koliber
kollë - kaszel
komb - naród
kombësi - narodowość
kombëtar - narodowy
kompjuter - komputer
komshi - sąsiad
komunizëm - komunizm
Konfuci - Konfucjusz
kopësht - ogród
kopsht - ogród
korb - kruk
kordhë - miecz
korrik - lipiec
korrupsion - korupcja
kos - jogurt
kosë - kosa
Kosovë - Kosowo
krah - ramię
krahasim - porównanie
krahasueshëm - porównywalny
kravatë - krawat
krehër - grzebień
krenar - dumny
krenari - duma
krënd - chrust
kreshkë - listowie
krevat - łóżko
krim - zbrodnia, przestępstwo
krimb - robak
Krime - Krym
kripë - sól
kripur - słony
Kroaci - Chorwacja
kryeqytet - stolica
kryesisht - głównie
krypë - sól
kryqëzatë - krucjata
kthetër - pazur
ku - gdzie
kufi - granica
kujtoj - pamiętać
kulë - przepuklina
kullë - wieża
kulturë - kultura
kunadhe - kuna
kungull - dynia
kuptim - zrozumienie
kuptoj - rozumieć
kuq - czerwony
kur - kiedy
Kuran - Koran
Kur'ani - Koran
kurorë - korona
kurrë - nigdy
kurth - pułapka
kurvë - kurwa, dziwka
kushtetutë - konstytucja
kushtueshëm - drogi, kosztowny
kuzhinë - kuchnia
ky - to, ten
laj - myć
lajkë - pochlebstwo
lakuriq - nagi
laps - ołówek
lar - wawrzyn
lartësi - wysokość
lashtë - stary, starożytny
lëbarke - dyzenteria, czerwonka
legjendar - legendarny
legjendë - legenda
lehtë - łatwy, lekki
lejoj - pozwolić
lend - żołądź
lëng seminal - sperma
lepur - królik
lepur i gropave - królik
lepuri i egër - zając
lesh - wełna
letargji - letarg
letër - list, karta
letërsi - literatura
lëviz - ruszać
lexim - czytanie
lexoj - czytać
libër - książka
librari - księgarnia
ligj - prawo
ligjëratë - mowa
ligjërim - legalizacja
ligjërues - wykładowca
lind - urodzić
lindje - urodzenie, narodziny, wschód
lindor - wschodni
linjë ajrore - linie lotnicze (przedsiębiorstwo)
liqen - jezioro
lirë - wolny, swodobny, tani, niedrogi
liri - wolność
lise - strumień
Lituania - Litwa
livadhe - łąka
llahtarshëm - przerażający
lloj - rodzaj, typ, gatunek
llom - błoto
llucë - muł, breja, papka
lluke - ślepy
llum - błoto
lodër - zabawka
lodhur - zmęczony
lojë - gra
lopatë - łopata
lopë - krowa
lorzë - papuga
luan - lew
luftë - wojna, walka
lugatë - ster
lugë - łyżka
luginë - dolina
lule - kwiat
lumë - rzeka
lumtur - szczęśliwy
lupesh - żarłok
mace - kot
madh - wielki, duży
madhësi - rozmiar
magar - osioł
maj - maj
makinë - maszyna
mal - góra
Mal i Zi - Czarnogóra
malor - górzysty
manastir - monastyr, klasztor, opactwo
mangan - mangan
marihuana - marihuana
marr - brać, wziąć
marramendje - zawroty głowy
marrë - szalony
marr frymë - oddychać
mars - marzec
martesë - ślub, wesele
martohem - poślubić
martuar - żonaty
mas - mierzyć
mashkullor - męski
masturboj - masturbować się
matematik - matematyczny
matematikë - matematyka
mbaj - trzymać
mbaroj - kończyć, wypełniać
mbërrij - przybyć
mbi - nad
mbiemri - nazwisko
mbrëmë - wczorajszej nocy
mbrëmje - wieczór
mbret - król
mburojë - tarcza
mëkat - grzech
mel - proso
mëmë - matka
me mirë një vezë sot se një pulë mot - lepszy wróbel w garści niż gołąb na dachu
mençur - inteligentny, mądry, bystry
mëndafsh - jedwab
mëngë - rękaw
mëngjes - rano, ranek, śniadanie
mënyrë - sposób
mëri - gniew
merimangë - pająk
mërzi - nuda, rozgoryczenie
mesazh - wiadomość
mesditë - południe (godzina)
meshin - skóra
mëshqerrë - jałówka
mështjerrë - jałówka
mësim - nauka
mesnatë - północ
mësoj - uczyć, uczyć się
miell - mąka
mijë - tysiąc
mik - przyjaciel
mikologji - mykologia
mikrobiologji - mikrobiologia
milingonë - mrówka
milion - milion, 1.000.000
mill - pochwa
miqësi - przyjaźń
miqësor - przyjazny
mirë - dobry, dobrze
mirëmbrëma - dobry wieczór
mirë u pafshim - do widzenia
misër - kukurydza
mishi të piqet, helli të mos digjet - wilk syty i owca cała
mision - misja
mitologji - mitologia
mjaft - wystarczająco
mjalcë - pszczoła
mjedër - malina
mjel - doić
mjellmë - łabędź
mjerth - do (aż)
modest - skromny
modesti - skromność
molë - ćma
mollë - jabłko
morfologji - morfologia
morr - wesz
mort - śmierć
mortje - śmierć
Moskë - Moskwa
motër - siostra
mrekulli - cud
mrekullueshëm - cudowny
muaj - miesiąc
muf - niedojrzały
mund - móc, być w stanie
murrët - ponury
murrmë - ponury
mushkëri - płuco
mushkonjë - komar
muzg - zmierzch
muzikë - muzyka
myshk - mech
mysliman - muzułmański, muzułmanin
na - my
nani - teraz
nashti - teraz
natë - noc
natën e mirë - dobranoc
natyrshëm - naturalnie, naturalny
ndajfolje - przysłówek
ndërkombëtar - międzynarodowy
ndihmë - pomoc
ndjenjë humori - poczucie humoru
ndodh - zdarzyć się
ndonjëherë - czasami
ndoshta - może
ne - my
në - w (o miejscu), w (o czasie), na (do kraju), o (godzinie), do (dokądś)
nën - pod
nënë - mama
neni - punkt, paragraf
nëntë - dziewięć, 9, dziewiąty
nëntëmbëdhjetë - dziewiętnaście
nëntor - listopad
nesër - jutro
nevojë - potrzeba
nga - z, od
ngjalë - węgorz
ngjashëm - podobny
ngjire - wir
ngjyrë - kolor
ngjyrë gri - szary
ngratë - nędzny, nieszczęsny
ngushtë - wąski
ni - teraz
nisem - wyruszać
një - jeden, 1, jakiś
njëmbëdhjetë - jedenaście
njëmijë - tysiąc, 1000
njëqind - sto, 100
njerk - ojczym
njerkë - macocha
njëzet - dwadzieścia, 20
njoh - wiedzieć
njomë - wilgotny
nuk - nie
numër - liczba
nuselalë - łasica
nxehtë - gorący
nyjë - węzeł, supeł
ombrellë - umbrella
oqean - ocean
Oqeania - Oceania
orë - godzina
organizëm - organizm
orgazmë - orgazm
orgji - orgia
orientim - orientacja
orientim seksual - orientacja seksualna
oriz - ryż
paganizëm - pogaństwo
paharrueshëm - niezapomniany
pakuptueshëm - niezrozumiały
pallë - miecz
pambuk - bawełna
Panama - Panama
panjë - klon
panjohur - nieznany
paqësor - pokojowy
paradoks - paradoks
parazit - pasożyt
pare - pieniądze
parlament - parlament
parlamentar - parlamentarny
partner - partner
pasditë - popołudnie, po południu
pasdrekë - popołudnie
pashpjegueshëm - niewytłumaczalny
pasion - pasja, namiętność
pasqyrë - lustro
patë - gęś
patëllxhan - bakłażan
patologji - patologia
pavarësi - niepodległość
pavarësisht - niezależnie
pavdekshëm - nieśmiertelny
pelë - klucz
pëllumb - gołąb
pemë - drzewo
penxhere - okno
përcëlloj - piec
përditë - codziennie, każdego dnia
përgjegjësi - odpowiedzialność
përgjigje - odpowiedź
përkas - dotykać
përkthej - tłumaczyć
përkthim - tłumaczenie
përkthyes - tłumacz
përkthyese - tłumacz
përrallë - opowieść, bajka
përrua - strumień
përsëri - znowu, znów
për shembull - na przykład
përveç - oprócz
përvojë - doświadczenie
pesë - pięć, 5
pesëdhjetë - pięćdziesiąt
pesëmbëdhjetë - piętnaście
peshk - ryba
peshkaqen - rekin
peshk i kuq - złota rybka
peshkop - biskup
Peshorja - Waga
peshqir - ręcznik
pështymë - ślina
piano - pianino
pirë - por
pis - brudny
pitër - częsty
pjalm - pyłek kwiatowy
pjekë - rzęsa
pjeshkë - brzoskwinia
plagë - rana
planet - planeta
plengë - katapulta
plep - topola
plesht - pchła
plor - lemiesz
plotë - pełny
plug - pług
plumb - ołów, pocisk
Polonia - Polska
popull - naród, narodowość
popullor - narodowy, ludowy
pornografi - pornografia
pornografik - pornograficzny
Portugalia - Portugalia
poshtë - w dół
pothuaj - prawie
pothuajse - prawie
prag - próg
pranverë - wiosna
pre - zdobycz, kamieniołom
pres - czekać
prezervativ - prezerwatywa
prill - kwiecień
prind - rodzic
priqe - artretyzm
prostitutë - prostytutka
pshurr - sikać
psikolog - psycholog
psikologji - psychologia
puçërr - krosta
pulë - kurczak, kura
pulqer - kciuk
punë - praca
punësi - zatrudnienie
punoj - pracować
pupël - pióro
purth - biegunka
pushkë - karabin
putër - łapa
puth - całować
puthje - pocałunek
pyll - las
qelb - ropa
qen - pies
qengj - jagnię
qengjë - ul
qepë - cebula
qershor - czerwiec
qesh - śmiać się
qeveri - rząd
qiell - niebo
qind - sto
qivur - trumna
qumësht - mleko
qysh - jak
qytet - miasto
raft - półka
rangë - praca domowa
ratë - poziomy
re - chmura
reagim - reakcja
reagoj - reagować
reklamë - reklama
rëkuall - oset
relaksohem - odpoczywać, relaksować się
rende - tarka
rëndë - ciężki
rëndësishëm - ważny
repë - pustynia
republikë - republika
rërë - piasek
rezultat - rezultat
ri - młody, nowy
rikëz - prosię
rit - rytuał
rrasë - deska
rrëkuall - oset
rrenë - kłamstwo
rrepë - rzepa, burak
rrëqebull - ryś
rrëshirë - żywica
rrëshqanor - gad
rreth - okręg
rrezik - ryzyko, niebezpieczeństwo
rrezikshëm - niebezpieczny
rrokë - spirala
rrotë - koło
rrua - strumień
rrugë - ulica
rrush - winogrono
Rumani - Rumunia
rus - rosyjski
Rusi - Rosja
rusisht - rosyjski
ryj - wejść
Sao Tome dhe Principe - Wyspy Świętego Tomasza i Książęca
seks - płeć
seksual - seksualny
seksualisht - seksualnie
seksualitet - seksualność
send - rzecz, przedmiot
sëpatë - siekiera, topór
serb - Serb
serbe - Serbka
Serbi - Serbia
shah - szachy
shalë - siodło
shegë - granat
shejtan - diabeł, szatan
shekull - wiek, stulecie
shembull - przykład
shenjtë - święty
sheqer - cukier
shi - deszcz
shigjetar - łucznik
shije - smak
shikoj - widzieć
shilor - jarzmo
shitje - sprzedaż
shitore - sklep
shkak - powód, przyczyna
shkallë krahasore - stopień wyższy
shkallmë - miecz
shkencë - nauka
shkencëtar - naukowiec
shkencor - naukowy
shklube - karabin
shkoj - iść, jechać
shkojëz - por
shkollë - szkoła
shkopis - kastrować
shkorre - krzew
shkrap - skorpion
shkrim - pismo
shkundëllimë - trzęsienie ziemi
shkurt - luty, krótko
shlligë - żmija
shpatë - miecz
shpejtë - szybki
shpejtësi - prędkość
shpellë - jaskinia
shpesh - często
shpirt - dusza, duch
shpjertë - szybki
shportë - kosz
shpresë - nadzieja
shprishë - śniadanie
shqarr - kuna
shqarth - kuna
shqerrë - jagnię
shqezë - brona
shqip - albański
shqipe - orzeł
Shqipëri - Albania
shqiptar - Albańczyk
shqyt - tarcza
shtatë - siedem, 7, siódmy
shtatëmbëdhjetë - siedemnaście
shtator - wrzesień
shtazë - zwierzę
shtëpi - dom
shterrë - jałówka
shtet - kraj
Shtetet e Bashkuara të Amerikës - Stany Zjednoczone Ameryki
shtiak - poronienie
shtrat - łóżko
shtrembërim - deformacja
shtrigë - wiedźma
shturë - szpak
shumë zhurmë për asgjë - burza w szklance wody, wiele hałasu o nic
shurdh - głuchy
shurdhët - głuchy
shurqel - wodospad
sidomos - w szczególności, zwłaszcza
sillë - śniadanie
Singapori - Singapur
sinonim - synonim
sipas - zgodnie (z czymś)
sistem - system
sistematik - systematyczny
skandal - skandal
s'ka tym pa zjarr - nie ma dymu bez ognia
skelet - szkielet
skërfyell - krtań
skile - lis
skllav - niewolnik
skllavëri - niewolnictwo
socialist - socjalista, socjalistyczny
socializëm - socjalizm
sociologji - socjologia
sopatë - siekiera, topór
sorrë - wrona
sot - dziś, dzisiaj
sovjetik - sowiecki
Spanja - Hiszpania
Spanjë - Hiszpania
spikth - dzięcioł
spontan - spontaniczny
sqarim - wyjaśnienie
sqepadruth - dzięcioł
strall - krzemień
strategji - strategia
student - student
studente - studentka
studentor - studencki
studim - studia, nauka
studioj - uczyć się, studiować
stuhishëm - burzliwy
Suedia - Szwecja
sulmim - atak
supë - zupa
taftar - lejek
tambël - mleko
tash - teraz
tatë - ojciec, tata
tatuazh - tatuaż
të - (nie każdy)
tëbutë - dąb
tejzë - ścięgno
teknologji - technika
telefon - telefon
televizion - telewizja
televizor - telewizor
tenjë - ćma
teprim - przesada
tërësisht - całkowicie, kompletnie
tërfil - koniczyna
tërmet - trzęsienie ziemi
tërshërë - owies
teshtimë - kichnięcie
tetë - osiem, 8, ósmy
tetëmbëdhjetë - osiemnaście
tetor - październik
tezgjah - krosno
thatë - suchy
theç - delikatny
thekër - żyto
thellë - głęboki
thëllëzë - kuropatwa
thi - świnia
thirr - sadza
thjerë - soczewica
thnegël - mrówka
ti - ty
tigër - tygrys
tiji - jego
tillë - taki
tingulloj - brzmieć
titull - tytuł
tog - sterta
Toka - Ziemia
Tora - Tora
tradhtar - zdrajca
traditë - tradycja
tre - trzy, 3
treg - rynek
trekëndësh - trójkąt
trembëdhjetë - trzynaście
tren - pociąg
tretë - trzeci
tri - trzy
tridhjetë - trzydzieści
trishtë - smutny
trishtuar - smutny
troftë - pstrąg
tronditje - szok
tru - mózg
truç - tłum
trup - ciało
tryezë shkrimi - biurko
tulipan - tulipan
tullë - cegła
tung - cześć!
tungjatjeta - cześć, hej
turp - wstyd
tus - przestraszyć
tym - dym
udhëtim - wycieczka
ujdhesë - wyspa
ujë - woda
ujk - wilk
Ukraina - Ukraina
ulok - kulawy
unë - ja
ungj - wujek
ungji - całkowicie
ungjill - ewangelia
upeshk - biskup
urë - most
uri - głód
urinë - mocz
urrejtje - nienawiść
ushqim - jedzenie
ushtar - żołnierz
uthull - ocet
uturij - grzmieć
va - bród
vajzë - dziewczyna, córka
valixhe - walizka
vampir - wampir
varem - zależeć
varr - grób
varrezë - cmentarz
vath - kolczyk
Vatikani - Watykan (państwo)
vdekje - śmierć
ve - jajko, wdowa
veçoj - izolować
vegjë - krosno
vëlla - brat
vendim - decyzja
vendlindje - miejsce urodzenia
verbër - ślepy
verbërisht - ślepo
verdhë - żółty
verë - lato, wino (napój alkoholowy)
veri - północ
verior - północny
verr - olcha
verrë - dziura
veshkë - nerka
vështirë - trudny
veshtull - jemioła
vëth - kolczyk
vetull - brew
vetvetishëm - spontaniczny
vezë - jajko
vidh - wiąz
virgjëreshë - dziewica
vit - rok
vito - gołąb
vizatim - rysunek
vizitor - gość
vjedhje - kradzież
vjedull - borsuk
vjehërr - teść
vjehrrë - teściowa
vjej - potrzebować
vjershë - wiersz
vjeshtë - jesień
vjetër - stary
vlerë - wartość
vodkë - wódka
vogë - para
vogël - mały
vonë - późno
vorbë - amfora
vorr - grób
vrajë - rana
vras - zabić
vrasës - zabójca
vrerë - trucizna
vrimë - dziura
Wikipedia - Wikipedia
xham - szkło
xhami - meczet
xheloz - zazdrosny
xhelozi - zazdrość
xixë - iskra
xixëllonjë - świetlik
yjor - gwiezdny, gwiaździsty
ylber - tęcza
yll - gwiazda
yllnajë - gwiazdozbiór
yllth - gwiazdka, gwiazdeczka
zakonisht - zwykle
zambak - lilia
zarf - koperta
zbathur - bosy
zbokth - łupież
zbulim - odkrycie
zdralë - brud
zdrukthëtar - stolarz
ze - dusza
zero - zero, 0
-zet - dwadzieścia
zgavër - dziura
zgjerbe - ćma
zgjuar - inteligentny, mądry
zhabë - ropucha
zhapi - jaszczurka
zhdukje - zniknięcie
zhurmë - hałas
zhurmëmadh - głośny, hałaśliwy
zi - czarny
zjarm - ogień
zjarr - ogień
zog - ptak
zonë - strefa
zonë erogjene - strefa erogenna
zonjë - dama
zoolog - zoolog
zoologji - zoologia
Zot - Bóg
zvarranik - gad
zyrtarisht - oficjalnie
