և - trzydziesta siódma litera alfabetu ormiańskiego
8888 - siedemdziesiąt osiem | 78
աբխազական - abchaski
աբխազերեն - język abchaski
Աբխազիա - Abchazja
աբորտ - aborcja
Աբու Դաբի - Abu Zabi | Abu Dhabi | Abu Dabi
ագահ - chciwy | zachłanny
ագարակ - farma | gospodarstwo
ագեվազ - kangur
ագի - ogon
ագնոստիցիզմ - agnostycyzm
ագռավ - wrona
ագրարային - rolny
ագրեսիա - agresja
ագրեսիվ - agresywny
ադամաթուզ - banan
ադամանդ - diament | brylant
Ադրբեջան - Azerbejdżan
ադրբեջաներեն - język azerski
ազատ - wolny | niepodległy | niezależny
ազատութիւն - wolność | swodoba
ազատություն - wolność | uwolnienie
ազգ - nacja | naród | lud | ludzie
ազգային - narodowy
ազգայնականություն - nacjonalizm
ազգություն - narodowość
ազդր - udo
ազնիվ - przyzwoity | szlachetny | uczciwy
ազնվական - szlachcic
ազոտ - azot
աթեիզմ - ateizm
աթեիստ - ateista
Աթենք - Ateny
աթոռ - krzesło
ալամ - świat
ալբաներեն - język albański
Ալբանիա - Albania
ալբատրոս - albatros
ալբոմ - album
ալգորիթմ - algorytm
ալերգիա - alergia
Ալժիր - Algieria
ալիգատոր - aligator
ալիք - fala
Ալլահ - Allah
ալկոհոլ - alkohol
ալկոհոլային - alkoholowy
ալմանախ - almanach
ալմաստ - diament
ալյումին - glin
ալյումինում - glin
ալյուր - mąka
ալքիմիա - alchemia
ալքիմիկոս - alchemik
ախտաբանություն - patologia
ածական - przymiotnik
ածելի - brzytwa
ածխածին - węgiel
ածուխ - węgiel
ականջ - ucho
ակորդեոն - akordeon
ակտինիում - aktyn
ահ - strach | przerażenie
ահագին - ogromny | wielki | szeroki
աղ - sól | esencja
աղանդեր - deser
աղավնի - gołąb
աղետ - katastrofa
աղյուս - cegła
աղոթել - modlić się
աղոթք - modlitwa
աղջիկ - córka | dziewczyna | młoda kobieta
աղվես - lis
աղցան - sałatka
աղքատ - biedny
ամաչկոտ - nieśmiały
ամառ - lato
ամբար - spichlerz
ամեոբա - ameba
Ամերիկա - Ameryka | Stany Zjednoczone
Ամերիկայի Միացյալ Նահանգներ - Stany Zjednoczone Ameryki
ամերիցիում - ameryk
ամիս - miesiąc
ամոթ - wstyd | nieśmiałość
ամորձիք - jądro
ամուսին - mąż | małżonek
ամուսնալուծություն - rozwód
ամուսնացած - żonaty | po ślubie
ամուսնացնել - brać ślub | poślubiać
ամուսնություն - małżeństwo | ślub
ամպ - chmura
ամպրոպ - burza
այբուբեն - alfabet
այգի - ogród | park | lasek
այծ - koza
այծքաղ - antylopa
այսբերգ - góra lodowa
այսօր - dziś | dzisiaj
այտ - policzek
այցելել - odwiedzić
անագ - cyna
անալիզ - analiza
անախորժ - nieprzyjemny
անանաս - ananas
անապատ - pustynia
անատոմիա - anatomia
անարդարութիւն - niesprawiedliwość
անարխիզմ - anarchizm
անգիր - ustny | oralny | niepisany
անգլերեն - język angielski
Անգլիա - Anglia
անգլիական - angielski
անգղ - sęp
Անգոլա - Angola
Անդալուսիա - Andaluzja
անդամ - członek
Անդորա - Andora | Անդորրա
Անդորրա - Andora
անել - robić
անթացուպ - kula
անիծել - potępiać | przeklinać
անիմաստ - niedorzeczny | bezsensowny
անիվ - koło
Անկախ Պետությունների Համագործակցություն - Wspólnota Niepodległych Państw
անկասկած - na pewno
անկողին - łóżko
անհրաժեշտություն - konieczność
անձամբ - osobiście
անձավ - jaskinia
անձնագիր - paszport
անձրև - deszcz
անձրեւ - deszcz
անձրեւանոց - parasol
անմահ - nieśmiertelny
անմահություն - nieśmiertelność
անութ - pacha
անուն - imię
անուշ - słodki
անուրջ - sen | marzenie senne
անպայման - absolutnie | bezwarunkowo | zdecydowanie | na pewno
անսալ - słuchać
անվադող - opona
անվտանգ - bezpieczny
անվտանգություն - bezpieczeństwo
անտառ - las
անտարակույս - na pewno
անտարբերություն - obojętność
Անտարկտիկա - Antarktyka
անցք - dziura
աշխատել - działać | pracować | funkcjonować
աշխարհ - kraj | ziemia | świat
աշխարհագրություն - geografia
աշորա - żyto
աշուն - jesień
աշտանակ - świecznik
աշտարակ - wieża
աչք - oko
ապագա - przyszły | przyszłość
ապահարզան - rozwód
ապահով - bezpieczny
ապարանջան - bransoletka
ապարանք - pałac
ապերջանիկ - nieszczęśliwy
ԱՊԼ - Արաբական երկրների լիգա (LPA, Liga Państw Arabskich, Liga Arabska)
ապուր - zupa
ապրել - mieszkać | żyć | przebywać
ապրիլ - kwiecień
աջ - prawy (z prawej strony)
առակ - bajka
առանց - bez
առաջին - pierwszy
առասպել - mit | legenda
առավոտ - ranek
առաքելություն - misja
առաքյալ - apostoł
առիթ - okazja
առյուծ - lew
առնանդամ - penis
առնետ - szczur
առողջ - zdrowy
ասել - powiedzieć | mówić
ասեղ - igła
Ասիա - Azja
ասորի - asyryjski | Asyryjczyk
ասպարեզ - arena
ասպետ - rycerz
աստատ - astat
աստղ - gwiazda
աստղագիտություն - astronomia
աստղագնաց - astronauta
աստղագուշակություն - astrologia
աստղադիտարան - obserwatorium
աստղաֆիզիկա - astrofizyka
աստված - bóg
աստվածամերժություն - ateizm
աստվածեղեն - boski
աստվածուհի - bogini
ավազ - piasek
ավազաքար - piaskowiec
ավանակ - osioł
ավանդ - tradycja
Ավստրալիա - Australia
Ավստրիա - Austria
ավտոբուս - autobus
ավտոմեքենա - samochód
ավտոտնակ - garaż
ատամ - ząb
ատամի խոզանակ - szczoteczka do zębów
ատամի մածուկ - pasta do zębów
ատել - nienawidzić
Ատլանտյան օվկիանոս - Ocean Atlantycki
ատոմ - atom
ատոմային - atomowy
ատրճանակ - pistolet | rewolwer
արև - słońce
արաբական - arabski
Արաբական թերակղզի - Półwysep Arabski
Արաբական Միացյալ Էմիրություններ - Zjednoczone Emiraty Arabskie
արաբերեն - język arabski
արագացում - przyspieszenie
արագիլ - bocian
արաղ - wódka
արարած - stworzenie
արբանյակ - satelita
արգանակ - rosół
արգանդային փող - jajowód
արգանդափող - jajowód
արգելան - więzienie
Արգենտինա - Argentyna
արգոն - argon
արդար - słuszny | sprawiedliwy
արդարութիւն - sprawiedliwość
արդեն - już
արդյունաբերություն - przemysł
արեգակնային - słoneczny
արեւ - słońce
արեւածագ - wschód Słońca
արեւային - słoneczny
Արեւելյան Թիմոր - Timor Wschodni
արեւելք - wschód
արեւմուտք - zachód
Արեւմտյան Սահարա - Sahara Zachodnia
արժեք - wartość
Արիստոտել - Arystoteles
արխիվ - archiwum
արծաթ - srebro
արծաթե - srebrny
արծաթյա - srebrny
արծիվ - orzeł
արմունկ - łokieć
արյան - krew
արյուն - krew
արշալույս - świt
արշիպելագ - archipelag
արջ - niedźwiedź
արսեն - arsen
արվարձան - przedmieście
արվեստ - sztuka
արտագաղթ - emigracja
արտասահմանցի - obcokrajowiec
արցունք - łza
արքայադուստր - księżniczka
արքայություն - królestwo
ափիոն - opium
աքաղաղ - kogut
աքիս - łasica
աքլոր - kogut
աքսիոմ - aksjomat
Աֆղանստան - Afganistan
Աֆրիկա - Afryka
աֆրիկանս - afrikaans
բադ - kaczka
բադակտուց - dziobak
բադրիջան - bakłażan
բազկաթոռ - fotel
բազմոց - kanapa | sofa
բալետ - balet
Բահամներ - Bahamy
Բահրեյն - Bahrajn
Բաղդադ - Bagdad
բամբակ - bawełna
բայ - czasownik
բայց - ale
բանակցություն - negocjacje
բանան - banan
բանասիրություն - filologia
բանաստեղծ - poeta
բանավեճ - debata
Բանգլադեշ - Bangladesz
բանջարեղեն - warzywo
բանտ - więzienie
բանտարկել - uwięzić
բանտարկություն - uwięzienie
բառ - słowo
բառարան - słownik
բառնալ - podnieść | unieść
բավիղ - labirynt
բարեկամ - przyjaciel
բարեկամական - przyjazny
բարեւել - pozdrawiać
բարիում - bar
բարիք - życzliwość | uprzejmość
բարձ - poduszka
բարյավ - dobrze
բարութ - proch strzelniczy
բացակա - nieobecny
բացականչել - wykrzyknąć
բացատրել - wyjaśniać
բացատրություն - wyjaśnienie
բացել - otwierać
բացում - odkrycie
Բելառուս - Białoruś
Բելգիա - Belgia
Բելիզ - Belize
բեղ - wąsy
Բենին - Benin
բևեռային - polarny
Բեռլին - Berlin
բերան - buzia | usta
բերիլիում - beryl
բերկլիում - berkel
բզեզ - żuk
բժիշկ - lekarz
բժշկություն - medycyna
բիբար - pieprz
բիսմութ - bizmut
Բիրմա - Birma
բլղուր - bulgur
բլոգ - blog
բլուր - pagórek
բյուջե - budżet
բնազանցություն - metafizyka
բնական - naturalny
բնակարան - mieszkanie
բնապահպանություն - ekologia
բնավորություն - kompozycja
բնություն - natura
բնույթ - charakter | natura
Բոթսվանա - Botswana
Բոլիվիա - Boliwia
բողկ - rzodkiewka
բոյկոտ - bojkot
Բոսնիա եւ Հերցոգովինա - Bośnia i Hercegowina
Բոսնիա և Հերցոգովինա - Bośnia i Hercegowina
բոսնիերեն - język bośniacki
Բոտսվանա - Botswana
բոր - bor
բորբոս - pleśń
բորենի - hiena
բորիում - bohr
բու - sowa
բուդդայականություն - buddyzm
բուդդիզմ - buddyzm
Բութան - Bhutan
բութ մատ - kciuk
բուլղարերեն - język bułgarski
Բուլղարիա - Bułgaria
Բուխարեստ - Bukareszt
բումերանգ - bumerang
բուսաբանություն - botanika
բուսնել - rosnąć
բուրդ - wełna
Բուրկինա Ֆասո - Burkina Faso
Բուրունդի - Burundi
բռնաբարել - gwałcić
Բրազիլիա - Brazylia
Բրետան - Bretania
բրինձ - ryż
բրիտանական - brytyjski
Բրիտանիա - Brytania
Բրյուսել - Bruksela
բրոմ - brom
Բրունեյ - Brunei
բրուտ - garncarz
Գաբոն - Gabon
գադոլինիում - gadolin
գազար - marchew
գալակտիկական - galaktyczny
գալիում - gal
գահ - tron
գաղափար - koncepcja | idea | pomysł
գաղութ - kolonia
գաղտնիք - tajemnica
Գամբիա - Gambia
Գայանա - Gujana
գայլ - wilk
Գանա - Ghana
գառ - jagnię
գարեջուր - piwo
գարի - jęczmień
գարնանային - południowy
գարշ - odrażający | wstrętny
գարուն - wiosna
գդալ - łyżka
գելարան - Madejowe łoże | łoże tortur
գելոց - Madejowe łoże | łoże tortur
գեղեցիկ - piękny | przystojny
գետ - rzeka
գետաձի - hipopotam
գետնանուշ - orzech ziemny
գերան - belka | kloc
գերանդի - kosa
գերեզման - grób
գերեզմանոց - cmentarz
գերմանական - niemiecki
գերմանացի - Niemiec
գերմաներեն - język niemiecki
Գերմանիա - Niemcy
գերմանիում - german
գինի - wino
գիշեր - noc
գիշերահավասար - równonoc
գիտական - naukowy
գիտակցություն - świadomość
գիտնական - naukowiec
գիտություն - wiedza | nauka
գիրություն - otyłość
գիրք - książka
գլուխ - głowa | góra | górna część | rozdział (książki)
գյուղ - wieś | wioska
գյուղատնտեսություն - rolnictwo
գյուտարար - wynalazca
գնոստիկություն - gnostycyzm
գնոստիցիզմ - gnostycyzm
գոյական - rzeczownik
գոյություն ունենալ - istnieć
գոռ - gwałtowny
գովազդ - reklama
գովել - chwalić
գովք - pochwała
գորգ - dywan
գործազրկություն - bezrobocie
գործիք - narzędzie | instrument
գորշուկ - borsuk
գորտ - żaba
գութան - pług
գույն - kolor | pąk | pączek | kwiat
Գվատեմալա - Gwatemala
Գվինեա - Gwinea
գրադարան - biblioteka
գրախանութ - księgarnia
գրականություն - literatura
գրամ - gram
գրամեքենա - maszyna do pisania
գրանիտ - granit
գրեթե - prawie
գրել - pisać
Գրենադա - Grenada
Գրենլանդիա - Grenlandia
գրկում - uścisk | objęcie
գրող - pisarz
գրպան - kieszeń
դագաղ - trumna
դադար - przerwa | pauza | odpoczynek
դահուկ - narta
Դամասկոս - Damaszek
դանակ - nóż
Դանիա - Dania
դանիական - duński
դանիերեն - język duński
դաշնություն - federacja
դաշտ - pole
դավադրություն - konspiracja
դավաճանում - zdrada
դատավոր - sędzia
դատարկ - pusty
դարբին - kowal
դարձված - idiom
դարմշտադիում - darmsztadt
դարչին - cynamon
դարչնագույն - brązowy
դափնի - wawrzyn
դդում - dynia
դելֆին - delfin
դեկտեմբեր - grudzień
դեղագործ - farmaceuta
դեղագործական - farmaceutyczny
դեղին - żółty | żółć
դեղձ - brzoskwinia
դեղնավուն - żółtawy
դեղնուց - żółtko
դեմոկրատիա - demokracja
դեմք - twarz
դեր - rola
դերանուն - zaimek
դերասան - aktor
դերձակ - krawiec
դինաստիա - dynastia
դիպլոմ - dyplom
դիսպրոզիում - dysproz
դիտորդ - obserwator
դիտում - obserwacja
դիցաբանություն - mitologia
դյուժին - tuzin
դոգմա - dogmat
դոդոշ - ropucha
Դոմինիկա - Dominika
Դոմինիկյան Հանրապետության - Dominikana
դու - ty
դուբնիում - dubn
դույլ - wiadro
դուռ - drzwi
դուստր - córka
դուր - dłuto
դուք - ty | wy
դպրոց - szkoła
դրակոն - smok
դրացի - sąsiad
դրոշ - flaga
եգիպտացորեն - kukurydza
Եգիպտոս - Egipt
եգուց - jutro
եզակի - pojedynczy | unikatowy | liczba pojedyncza
եզերք - krawędź
Եզովպոս - Ezop
եթե - jeśli
Եթովպիա - Etiopia
ելակ - truskawka
ելուզակ - rabuś
եկեղեցի - kościół
եղանակ - pogoda
եղբայր - brat
եղբայրական - braterski
եղբոր աղջիկ - bratanica
եղերական - tragiczny
եղեւնի - świerk
եղինջ - pokrzywa
Եմեն - Jemen
ենթակառույց - infrastruktura
ենթակառուցվածք - infrastruktura
եռանկյուն - trójkąt
եռանկյունաչափություն - trygonometria
եռանկյունի - trójkąt
ես - ja | mnie | mi
Եվրասիա - Eurazja
Եվրոպա - Europa
եվրոպիում - europ
երաժիշտ - muzyk
երաժշտություն - muzyka
երաժտություն - muzyka
երակ - żyła
Երևան - Erywań
երաշխավորում - rekomendacja
երբեք - nigdy
երգ - piosenka
երգահան - kompozytor
երգել - śpiewać
երգիծանք - satyra
երգիչ - śpiewak | piosenkarz
երեկ - wczoraj
երեկո - wieczór
երեսուն - trzydzieści | 30
երեսուներեք - trzydzieści trzy | 33
երեսուներկու - trzydzieści dwa | 32
երեսունինը - trzydzieści dziewięć | 39
երեսունհինգ - trzydzieści pięć | 35
երեսունմեկ - trzydzieści jeden | 31
երեսունյոթ - trzydzieści siedem | 37
երեսունութ - trzydzieści osiem | 38
երեսունչորս - trzydzieści cztery | 34
երեսունվեց - trzydzieści sześć | 36
երեւակայություն - wyobraźnia
երեք - trzy | 3
երեքհարիւր - trzysta | 300
երեքշաբթի - wtorek
երիկամ - nerka
երիցուկ - rumianek
երկաթ - żelazo
երկաթգիծ - kolej
երկայն - długi
երկայնք - długość
երկանաքար - kamień młyński
երկարավուն - podłużny
երկերիւր - dwieście | 200
երկինք - niebo
երկիր - kraj | ziemia | ląd
երկու - dwa | 2
երկուշաբթի - poniedziałek
երկվորյակ - bliźniak
երկրաբան - geolog
երկրաբանություն - geologia
երկրաշարժ - trzęsienie ziemi
երկրաչափություն - geometria
Երուսաղեմ - Jerozolima
երջանկություն - radość
Երվազ - Ervaz
Եփրատ - Eufrat
եօթանասուն - siedemdziesiąt | 70
Զամբիա - Zambia
զամբյուղ - kosz
Զամոստիա - Zamość
զանգ - dzwon | dzwonek
զառանցանք - delirium
Զատիկ - Wielkanoc | Pascha
զարմացնել - zaskoczyć | zaskakiwać | zdumić | zdumiewać
զարնվել - uderzyć
զբոսանավ - jacht
զգուշացում - ostrzeżenie
զեբր - zebra
զեյթուն - oliwka (owoc)
զենիթ - zenit
զեփյուռ - zefir
զիբիլ - śmieć
Զիմբաբվե - Zimbabwe
զմրուխտ - szmaragd
զննել - egzaminować | przeprowadzać inspekcję | badać
զոմբի - zombie
զորավոր - potężny
զուգարան - toaleta
զույգ - para (2)
զվարթ - radosny
էժան - tani | niedrogi
էլեկտրական - elektryczny
էլեկտրական լամպ - żarówka
էլեկտրականություն - elektryczność
Էկվադոր - Ekwador
էկրան - ekran
էյնշտեյնիում - einstein
էներգիա - energia
Էսթետիկա - estetyka
էսպերանտո - esperanto
էստոներեն - język estoński
Էստոնիա - Estonia
էտրուսկյան - etruski
էրբիում - erb
Էրիտրեա - Erytrea
ըմբիշ - zapaśnik
ըմբշամարտություն - zapasy
ըմպելիք - napój
ընդմիշտ - na zawsze
ընդունակություն - zdolność
ընթացակարգ - procedura
ընթրիք - kolacja
ընկերուհի - dziewczyna (partnerka)
ընկույզ - orzech
ընձառյուծ - lampart
ընձուղտ - żyrafa
ընտանիք - rodzina
ընտրել - wybrać | wybierać
թաթպան - rękawiczka
Թաիլանդ - Tajlandia
թալիում - tal
թամբ - siodło
Թայվան - Tajwan
թայֆուն - tajfun
թանաքաձուկ - kalmar
թանգարան - muzeum
թարգմանել - tłumaczyć
թարգմանիչ - tłumacz
թարթիչ - rzęsa
թարմ - świeży
թացություն - wilgoć
թե - że | lub
թեկնածու - kandydat
Թեհրան - Teheran
թեղի - wiąz
թեյ - herbata
թենիս - tenis
թերակղզի - półwysep
թերասնում - niedożywienie
Թերմոպիլե - Termopile
թեւ - skrzydło
թեւք - rękaw
թեփ - łupież | trociny
թթվածին - tlen
թթվուտ - kwas
թիթեռ - motyl
թիկնապահ - ochroniarz
թիվ - liczba
թլփատել - obrzezać
թլփատություն - obrzezanie
թխկի - klon
թշնամի - wróg
թոռնիկ - wnuk / wnuczka
թոռնուհի - wnuczka
թորիում - tor
թութ - morwa
թութակ - papuga
թուլիում - tul
թույլ - słaby
թունել - tunel
Թունիս - Tunezja | Tunis
թուր - miecz
Թուրքիա - Turcja
Թուրքմենստան - Turkmenistan
թռչուն - ptak
թվաբանություն - arytmetyka
ժամ - godzina
ժամանակ - czas
ժանգ - rdza
ժանր - gatunek | rodzaj
ժողովրդագրություն - demografia
ժողովրդավարական - demokratyczny
ժողովրդավարություն - demokracja
ժպիտ - uśmiech
ժպտալ - uśmiechać się
իգական - kobiecy | żeński | damski
իմաստություն - mądrość
իմպերիալիզմ - imperializm
իմպրեսիոնիզմի - impresjonizm
ինդիում - ind
Ինդոնեզիա - Indonezja
ինը - dziewięć | 9
իննսուն - dziewięćdziesiąt | 90
իննսուներեք - dziewięćdziesiąt trzy | 93
իննսուներկու - dziewięćdziesiąt dwa | 92
իննսունինը - dziewięćdziesiąt dziewięć | 99
իննսունհինգ - dziewięćdziesiąt pięć | 95
իննսունմեկ - dziewięćdziesiąt jeden | 91
իննսունյոթ - dziewięćdziesiąt siedem | 97
իննսունութ - dziewięćdziesiąt osiem | 98
իննսունչորս - dziewięćdziesiąt cztery | 94
իննսունվեց - dziewięćdziesiąt sześć | 96
ինքնաթիռ - samolot
ինքնաշարժ - automatyczny
ինքնասպանություն - samobójstwo
ինքնավար - niezależny
իշամեղու - trzmiel
իշղար - borsuk
իռացիոնալ - irracjonalny
իռլանդացի - Irlandczyk
Իռլանդիա - Irlandia
իսլամ - islam
Իսլամ - islam
իսլամական - islamski
Իսլանդիա - Islandia
իսպանական - hiszpański
իսպաներեն - język hiszpański
Իսպանիա - Hiszpania
Իսրայել - Izrael
իտալերեն - język włoski
Իտալիա - Włochy
իտերբիում - iterb
իտրիում - itr
իրական - prawdziwy
իրականություն - rzeczywistość
Իրան - Iran
իրատեսություն - realizm
Իրաք - Irak
իրիդիում - iryd
լահմաջո - lahmacun
լամա - lama
լամպ - lampa
լայն - szeroki
լանթան - lantan
Լաոս - Laos
լավ - dobry
լատինական - łaciński
Լատվիա - Łotwa
լեզու - język
լեզվաբան - językoznawca | lingwista
լեզվաբանական - językowy
լեզվաբանություն - językoznawstwo
լեհական - polski
Լեհաստան - Polska
լեհաստանցի - polski
լեհերեն - język polski
լեհուհի - Polak | polski
լեղի - żółć
Լեսոթո - Lesotho
լերկ - bezwłosy | gładki
Լիբանան - Liban
լիբանանցի - libański
Լիբերիա - Liberia
Լիբիա - Libia
լիբրետո - libretto
լիթիում - lit
Լիխտենշտեյն - Liechtenstein
լիճ - jezioro
լիմոն - cytryna
լիմոնադ - lemoniada
Լիտվա - Litwa
լյարդ - wątroba
Լյուքսեմբուրգ - Luksemburg
լոգարան - łazienka
լոլիկ - pomidor
լող - pływanie
լողավազան - basen
լողափ - plaża
Լոնդոն - Londyn
լոուրենսիում - lorens
լոսդի - łosoś
լոտոս - lotos
լոր - przepiórka
լորիկ - przepiórka
լու - pchła
լույծ - wodnisty
լույս - światło
լուսամուտ - okno
լուսան - ryś
լուսատտիկ - świetlik
լուսին - księżyc
լուտեցիում - lutet
լպստել - lizać
լռություն - cisza
լրջություն - powaga
լրտես - szpieg
խաբար - wieść | wiadomość
խաբեբայություն - oszustwo | podstęp | oszustwo (finansowe) | defraudacja
խալիֆայություն - kalifat
խաղալ - bawić się
խաղաղ - pokojowy | cichy
խաղաղություն - pokój | spokój
Խաղաղ օվկիանոս - Ocean Spokojny
խաղամոլ - hazardzista
խաղատուն - kasyno
խանութ - sklep
խավար - ciemność | mrok
խավարասեր - karaluch
խարիսխ - kotwica
խարխլել - zrujnować | zniszczyć | poluzować
խխունջ - ślimak
խճուղի - autostrada
խմել - pić
խմիչք - napój
խմոր - ciasto
խնձոր - jabłko
խնձորենի - jabłoń
խնջույք - uczta
խոլորձ - orchidea
խոսել - mówić | rozmawiać
խոստանալ - obiecać | obiecywać
խորթ աղջիկ - pasierbica
խորթ հայր - ojczym
խորթ մայր - macocha
խորթ տղա - pasierb
խորովել - piec | grillować
խորվաթական - chorwacki
Խորվաթերեն - język chorwacki
Խորվաթիա - Chorwacja
խուճապ - panika
խումար - kac
խումբ - grupa
խոփ - lemiesz
խցանահան - korkociąg
ծածան - karp
ծաղիկ - kwiat
ծաղկակաղամբ - kalafior
ծաղկաման - wazon
ծամոն - guma do żucia
ծառ - drzewo
ծարավ - spragniony
ծարավություն - pragnienie
ծարիր - antymon
ծեր կին - staruszka
ծերություն - starość
ծերուկ - starzec
ծիծաղ - śmiech
ծիծաղալ - śmiać się
ծիծաղել - śmiać się
ծիծեռնակ - jaskółka
ծիրան - morela
ծխախոտ - tytoń | papieros
ծխնելույզ - komin
ծծումբ - siarka
ծնծղա - talerz | czynel
ծնող - rodzic
ծնոտ - szczęka
ծնունդ - narodziny
ծով - morze
ծովահեն - pirat
ծովատառեխ - śledź
ծովացուլ - mors
ծովափիղ - mors
ծուղակ - pułapka
ծույլ - leniwy
Կաբո-Վերդե - Republika Zielonego Przylądka
կադմիում - kadm
կազինո - kasyno
կազմակերպություն - organizacja
կաթ - mleko
կաթնասուն - ssak
կաթնասուններ - ssak
կաթնուկ - sałata
կալ - klepisko
կալանք - areszt
կալիում - potas
Կալիֆոռնիա - Kalifornia
կալիֆոռնիում - kaliforn
կալցիում - wapń
կախաղան - szubienica
կախարդ - magik
կակաչ - mak | tulipan
կակտուս - kaktus
Կահիրե - Kair
կաղ - kulawy
կաղամար - kalmar
կաղամբ - kapusta
կաղնի - dąb (drzewo)
Կամբոջա - Kambodża
Կամերուն - Kamerun
կամուրջ - most
կայան - stacja
կայարան - stacja
կայծոռիկ - świetlik
կայմ - maszt
կայսր - cesarz
կայսրություն - imperium
կայֆ - kef | odurzenie narkotyczne | euforia
Կանադա - Kanada
կանաչ - zielony | zieleń
կանաչավուն - zielonkawy
կանկառ - karczoch
կաշառել - przekupić
կաշառք - łapówka
կաչաղակ - sroka
կապար - ołów
կապիտալիզմ - kapitalizm
կապույտ - niebieski | kolor niebieski
կապտավուն - niebieskawy
կառավարություն - rząd
կառուցել - budować
կասկած - wątpliwość
կաստա - kasta
կավագործ - garncarz
կատակ - żart
կատակերգություն - komedia
կատեգորիա - kategoria
կատու - kot
կարագ - masło
կարանտին - kwarantanna
կարապ - łabędź
կարդալ - czytać
կարել - szyć
կարենալ - móc
կարծիք - opinia
կարկուտ - grad
կարմիր - czerwony
կարմրավուն - czerwonawy
կարտոֆիլ - ziemniak | kartofel
կացին - topór
կեղծամ - peruka
կեղտ - brud | plama
կենգուրու - kangur
կենդանաբան - zoolog
կենդանաբանական - zoologiczny
կենդանաբանություն - zoologia
կենդանակերպ - zodiak
կենդանի - zwierzę
կենսաբան - biolog
կենսաբանական - biologiczny
կենսաբանություն - biologia
կենսագրություն - biografia
կենտրոնական - centralny
կեչի - brzoza
կեռնեխ - drozd
կեսգիշեր - północ
կեսօր - południe
կետչուպ - keczup
կզաքիս - kuna
կիբեռնետիկա - cybernetyka
կիթառ - gitara
կիլոգրամ - kilogram
կիլոմետր - kilometr
կին - kobieta | dama | małżonka | żona
կիպարիս - cyprys
Կիպրոս - Cypr
կիվի - kiwi
կիրակի - niedziela
կլոր - okrągły
կղզի - wyspa
կղզիախումբ - archipelag
կյանք - życie
կյուրիում - kiur
կնձնի - wiąz
կոալա - koala
կոբալտ - kobalt
կոլիբրի - koliber
Կոլումբիա - Kolumbia
կոկաին - kokaina
կոկոս - kokos
կոկորդ - gardło | krtań
կոկորդիլոս - krokodyl
կոկտեյլ - koktail
կոմունիզմ - komunizm
կոնյակ - brandy | winiak
կոշիկ - but
կոպ - powieka
Կոսովո - Kosowo
Կոստա Ռիկա - Kostaryka
կով - krowa
կովբոյ - kowboj
կոտորած - masakra
Կորեա - Korea
կորեկ - proso
Կորսիկա - Korsyka
Կուբա - Kuba
կուղբ - bóbr
կռիվ - bitwa | walka | starcie
կռճիկ - chrząstka
կվարց - kwarc
կվենի - modrzew
կտակ - wola | testament
կտուր - dach
կտուց - dziób
կրետ - osa
կրիպտոն - krypton
կրծքանշան - odznaka | medal
կրծքապտուկ - sutek
կրկես - cyrk
կրճատում - skrót
կրոն - religia
կրոնական - religijny
հագուստ - ubrania | ubiór
հազալ - kaszleć
հազար - tysiąc | 1000
հազարամյակ - tysiąclecie | millenium
հազվադեպ - rzadko | nieczęsto
Հաիթի - Haiti
հականիշ - antonim
հաղթանակ - zwycięstwo | wygrana | triumf | sukces
հաղթու - zwycięski
հաճախ - często
հաճարենի - buk
հաճույք - przyjemność
համալսարան - uniwersytet
համակարգ - system
համակարգիչ - komputer
համաճարակ - epidemia
համառ - uparty
համասեռահակություն - homoseksualizm
համասեռամոլություն - homoseksualizm
համաստեղություն - gwiazdozbiór
համարյա - prawie
համբավ - reputacja
համբերություն - cierpliwość
համբույր - pocałunek
համբուրել - całować
համեստություն - skromność
հայ - Ormianin
Հայաստան - Armenia
հայելի - lustro
հայերեն - język ormiański
Հայիթի - Haiti
հայր - ojciec
հայրենի - ojcowski | ojczysty
հանդբոլ - piłka ręczna
հանրապետություն - republika
հանցագործ - przestępca
հանք - minerał
հանքաբան - mineralog
հանքաբանություն - mineralogia
հանքային ջուր - woda mineralna
հաշվապահ - księgowy
հապավում - skrót
հասարակ - zwykły | pospolity
հասարակագիտություն - socjologia
հասիում - has
հասցե - adres
հավալուսն - pelikan
հավատալ - wierzyć | ufać | polegać (na) | być przekonanym
հավք - ptak
հատապտուղ - jagoda
հարավ - południe
Հարավային Ամերիկա - Ameryka Południowa
Հարավային Կորեա - Korea Południowa
Հարավային Օսիա - Osetia Południowa
Հարավաֆրիկյան Հանրապետություն - Republika Południowej Afryki
Հարավսլավիա - Jugosławia
հարբել - upić się
հարիւր - sto | 100
հարյուր - sto
հարսանեկան - ślubny | weselny
հարսանիք - ślub
հարվածել - uderzyć
հարց - pytanie | kwestia
հարցմունք - pytanie
հաց - chleb
հացի - jesion
հաֆնիում - hafn
հեգնական - ironiczny
հեդոնիզմ - hedonizm
հելիում - hel
հեծան - belka | kloc
հեծանիվ - rower
հեծելազոր - kawaleria | konnica
հեկտար - hektar
հեղաշրջում - rewolucja
հեղափոխություն - rewolucja
հեղինակ - kompozytor
հեշտոց - pochwa | wagina
հեռախոս - telefon
հեռավորություն - dystans
հեռացնել - usunąć
հեռուստատեսություն - telewizja
հետաքրքիր - interesujący
հերյուն - szydło
հերոին - heroina
հերոս - bohater
հերոսություն - bohaterstwo
հիասթափություն - rozczarowanie
հինգ - pięć | 5
հինգշաբթի - czwartek
հիպնոս - hipnoza
հիսուն - pięćdziesiąt | 50
հիսուներեք - pięćdziesiąt trzy | 53
հիսուներկու - pięćdziesiąt dwa | 52
հիսունինը - pięćdziesiąt dziewięć | 59
հիսունհինգ - pięćdziesiąt pięć | 55
հիսունմեկ - pięćdziesiąt jeden | 51
հիսունյոթ - pięćdziesiąt siedem | 57
հիսունութ - pięćdziesiąt osiem | 58
հիսունչորս - pięćdziesiąt cztery | 54
հիսունվեց - pięćdziesiąt sześć | 56
Հիսուս - Jezus
Հիսուսը - Jezus
հիվանդանոց - szpital
հիւանդանոց - szpital
հղի կին - w ciąży | brzemienna
հղիություն - ciąża
հյութ - sok
հյուսիս - północ
Հյուսիսային Ամերիկա - Ameryka Północna
հյուսիսային եղջերու - renifer
Հյուսիսային Կորեա - Korea Północna
հյուր - gość
հյուրանոց - hotel
հնագիտություն - archeologia
հնազանդություն - posłuszeństwo
հնարավոր - możliwy
Հնդկական օվկիանոս - Ocean Indyjski
հնդկահավ - indyk
Հնդկաստան - Indie
հնդկացորեն - gryka
հնոց - piec
հնչյունաբանական - fonetyczny
հնչյունաբանություն - fonetyka
հնչույթ - fonem
հոգեբան - psycholog
հոգեբանություն - psychologia
հոգի - dusza
հոգնա - lewatywa
հոլանդական - holenderski
հոլանդերեն - język holenderski
հոլմիում - holm
հոլովում - deklinacja
հոկեյ - hokej
հոկտեմբեր - październik
հոմանիշ - synonim
հոմոսեքսուալիզմ - homoseksualizm
Հոնդուրաս - Honduras
Հոնկոնգ - Hongkong
հոնք - brew
հովիտ - dolina
հոտ գալ - czuć (za pomocą zmysłu węchu) | wąchać
հորանջ - ziewnięcie
հորանջել - ziewać
հորաքույր - ciocia | ciotka (ze strony ojca)
Հորդանան - Jordania
հորեղբայր - wuj | wujek ze strony ojca
հորիզոն - horyzont
հորիզոնական - horyzontalny | poziomy
հուդայականություն - judaizm
հուժկու - mocny
հուլիս - lipiec
հումանիզմ - humanizm
հույն - Grek
հույս - nadzieja
հունական - grecki
Հունաստան - Grecja
հունարեն - język grecki
Հունգարիա - Węgry
հունիս - czerwiec
հունվար - styczeń
հուշարձան - pomnik
հուր - ogień
հպարտ - dumny
հպարտություն - duma
հռետորաբանություն - retoryka
Հռոմ - Rzym
հռոմեական - rzymski
հռչակ - sława
հրաբուխ - wulkan
հրաշք - cud
հրեշտակ - anioł
ձագ - młode (zwierzę)
ձագար - lejek
ձախ - lewy
ձայն - dźwięk | odgłos | brzmienie
ձեթ - olej
ձեռնոց - rękawiczka
ձեռք - ramię | ręka
ձեւաբանություն - morfologia
ձեւանմուշ - model | wzór
ձի - koń
ձիթենի - drzewo oliwne
ձկնաբան - ichtiolog
ձկնկուլ - czapla
ձկնորս - rybak
ձմեռ - zima
ձմերուկ - arbuz
ձյուն - śnieg
ձյունակույտ - lawina
ձյուն գալ - śnieżyć
ձնագնդիկ - kula śnieżna
ձնծաղիկ - przebiśnieg
ձու - jajko
ձուկ - ryba
ձվաձեւ - owal
Ղազախստան - Kazachstan
ղալաթ - pomyłka
ղեկավարություն - kierownictwo | szefostwo
Ղուրան - Koran
ղպտիական - koptyjski
Ղրղզստան - Kirgistan
ճագար - królik
ճակատագիր - los | przeznaczenie
ճակնդեղ - burak
ճամբար - obóz
ճանաչել - znać | rozpoznawać | poznawać
ճանապարհորդ - podróżnik
ճաշ - kolacja
ճաշացուցակ - menu
ճապոներեն - język japoński
Ճապոնիա - Japonia
ճարպ - tłuszcz
ճարտարապետ - architekt
ճարտարապետություն - architektura
ճգնաժամ - kryzys
ճկուն - elastyczny
ճկունություն - elastyczność
ճնճղուկ - wróbel
ճշմարտություն - prawda
ճշտմարտություն - prawda
ճոճ - hamak
մագնեզիում - magnez
մագնիս - magnes
մագնիսականություն - magnetyzm
Մադագասկար - Madagaskar
մազ - włos
մաթեմատիկա - matematyka
Մալայզիա - Malezja
Մալավի - Malawi
Մալդիվներ - Malediwy
Մալթա - Malta
Մալի - Mali
մականախաղ - hokej
մականուն - przydomek
մակարոն - makaron
մակդիր - epitet
Մակեդոնիա - Macedonia
մահ - śmierć
մահանալ - umrzeć
մահկանացու - śmiertelny
մահմեդական - muzułmanin
մաղ - sito
մաղադանոս - pietruszka
մամոնտ - mamut
մամուռ - mech
մայիս - maj
մայոնեզ - majonez
մայտներիում - meitner
մայր - matka
մայրցամաք - kontynent
մանգան - mangan
մանգո - mango
մանկապարտեզ - przedszkole
մանուկ - dziecko
մանրադիտակ - mikroskop
մաչետե - maczeta
մառախուղ - mgła
մաստակ - guma do żucia
մաստուրբացիա - masturbacja
Մավրիտանիա - Mauretania
Մավրիտիուս - Mauritius
մատ - palec
մատիտ - ołówek
մատուռ - kaplica
մատուցող - kelner
մատուցողուհի - kelnerka
մարգագետին - łąka
մարգարե - prorok
մարգարեություն - przepowiednia
մարգարեուհի - prorokini
մարգարիտ - perła
մարգարտածաղիկ - stokrotka
մարդ - człowiek | istota ludzka
մարդաբան - antropolog
մարդաբանություն - antropologia
մարդկային - ludzki
մարիխուանա - marihuana
մարմին - ciało
Մարշալյան Կղզիներ - Wyspy Marshalla
Մարոկկո - Maroko
մարսողություն - trawienie
մարտ - marzec
մարտակառք - rydwan
մարտիրոս - męczennik
մաքրել - czyścić | oczyszczać | usuwać
մեգ - mgła
մեդալ - medal
մեթոդ - metoda | sposób
մեխ - gwóźdź
մեխանիզմ - mechanizm
մեծամասնություն - większość
Մեծ Բրիտանիա - Wielka Brytania
մեկ - jeden | 1
մեղեդի - melodia
մեղու - pszczoła
մեղր - miód
մեղրամիս - miodowy miesiąc
մեղրամոմ - wosk pszczeli
մեղք - grzech
մեյդան - plac
մենդելեեւիում - mendelew
մենդելեւիում - mendelew
մեռած - martwy
մեռնել - umrzeć
մետաղ - metal
մետաղագործություն - metalurgia
մետաղադրամ - moneta
մետաքս - jedwab
մետաֆիզիկա - metafizyka
Մերձդնեստր - Naddniestrze
մեքենա - maszyna | samochód
Մեքսիկա - Meksyk
մզկիթ - meczet
մթնոլորտ - atmosfera
մթություն - ciemność | mrok
միակ - jedyny | sam
միապետություն - monarchia
միասեռություն - homoseksualizm
միասին - razem
Միավորված ազգերի կազմակերպություն - Organizacja Narodów Zjednoczonych
Միացյալ Թագավորություն - Zjednoczone Królestwo
Միացյալ Նահանգներ - Stany Zjednoczone
միեղջյուր - jednorożec
միզուկ - cewka moczowa
Միկրոնեզիա - Mikronezja
մինարեթ - minaret
միշտ - zawsze
միջազգային - międzynarodowy
միջատ - owad
միջատաբանություն - entomologia
Միջերկրական ծով - Morze Śródziemne
միջոց - metoda
միրգ - owoc
մլուկ - pluskwa
մկան - mięsień
մկրատ - nożyczki
մկրտել - chrzcić
մկրտություն - chrzest
մկրտում - chrzest
մղձավանջ - koszmar
մնացյալ - pozostały
մշակույթ - kultura
մշուշ - mgła
Մոզամբիկ - Mozambik
Մոլդովա - Mołdawia
մոլիբդեն - molibden
մոլորակ - planeta
մոխրաման - popielniczka
մոծակ - komar
մողես - jaszczurka
մոմ - wosk | świeca
Մոնղոլիա - Mongolia
Մոնտենեգրո - Czarnogóra
մոռանալ - zapomnieć
Մոսկվա - Moskwa
մոտիկ - bliski | niedaleki
մորաքույր - ciocia | ciotka
մորեխ - konik polny
մուժ - mgła
մուխ - dym
մուկ - mysz
մուշ - persymona
մուշտարի - klient
մսագործ - rzeźnik
մտածող - myśliciel
մրջյուն - mrówka
մրջնակեր - mrówkojad
մրցակից - oponent
մրցանակ - nagroda
մրցել - rywalizować
մրցորդ - konkurent
յագուար - jaguar
յակ - jak
յոգուրտ - jogurt
յոդ - jod
յոթ - siedem | 7
յոթանասուն - siedemdziesiąt
յոթանասուներեք - siedemdziesiąt trzy | 73
յոթանասուներկու - siedemdziesiąt dwa | 72
յոթանասունինը - siedemdziesiąt dziewięć | 79
յոթանասունհինգ - siedemdziesiąt pięć | 75
յոթանասունմեկ - siedemdziesiąt jeden | 71
յոթանասունյոթ - siedemdziesiąt siedem | 77
յոթանասունչորս - siedemdziesiąt cztery | 74
յոթանասունվեց - siedemdziesiąt sześć | 76
Յուլյա - Julia
նախաճաշ - śniadanie
նախապատմություն - prehistoria
նախնի - przodek
նահանգապետ - gubernator
նահատակ - męczennik
նամակ - list
Նամիբիա - Namibia
Նաուրու - Nauru
նապաստակ - zając
նավ - statek
նավատորմ - flota
նավթ - ropa naftowa
նատրիում - sód
նարինջ - pomarańcza (owoc)
նարնջագույն - pomarańcz | pomarańczowy
նեոդիմ - neodym
նեոն - neon
Նեպալ - Nepal
նեպտունիում - neptun
ներարկիչ - strzykawka
ներգաղթ - imigracja
ներքին - wewnętrzny
ներքինի - eunuch
ներքնազգեստ - bielizna
ներքնակ - materac
Նիգեր - Niger
Նիգերիա - Nigeria
նիդերլանդական - holenderski
Նիդերլանդներ - Holandia
նիզակ - włócznia
Նիկարագուա - Nikaragua
նիկել - nikiel
նիհիլիզմ - nihilizm
նիոբիում - niob
նկարագրել - opisać
նյարդ - nerw
Նյու Դելի - Nowe Delhi
նյութ - materiał
ննջել - spać
նշանաբան - motto
նշանակալից - znaczący
նոբելիում - nobel
նոխազ - kozioł
նոճի - cyprys
նոյեմբեր - listopad
Նոր Զելանդիա - Nowa Zelandia
նորից - znowu | znów
նորվեգական - norweski
Նորվեգիա - Norwegia
նուշ - migdał
նուռ - granat
նվագախումբ - orkiestra
նվեր - prezent
շաբաթ - sobota | tydzień
շագանակ - kasztan
շագանակագույն - brązowy
շախմատ - szachy
շաղգամ - rzepa
շատրվան - fontanna
շարադրություն - kompozycja
շարահյուսություն - składnia
շարժ - ruch
շարունակել - kontynuować
շարքային - zwykły
շափյուղա - szafir
շաքար - cukier
շերեփուկ - kijanka
շիմպանզե - szympans
շիշ - butelka
շնագայլ - szakal
շնաձուկ - rekin
շնորհ - łaska | względy
շնորհավորում - gratulacje
շոկոլադ - czekolada
շողալ - błyszczeć
Շոտլանդիա - Szkocja
շուկա - rynek | bazar
շուն - pies
շպրից - strzykawka
շպրտել - rzucać
շվեդական - szwedzki
շվեդերեն - język szwedzki
Շվեդիա - Szwecja
Շվեյցարիա - Szwajcaria
շրթներկ - szminka
շրթունք - warga (ust)
Շրի Լանկա - Sri Lanka
շրջակայք - sąsiedztwo | okolica
ոզնի - jeż
ոչինչ - nic
ոչխար - owca
ոջիլ - wesz
ոսկե - złoty
ոսկեծաղիկ - chryzantema
ոսկի - złoto
ոսկյա - złoty
ոսկոր - kość
ոսոխ - wróg
ոսպ - soczewica
ոստիկան - policja
ոստիկանություն - policja
ոստրե - ostryga
ով - kto
ոտնակ - pedał
ոտք - noga | stopa
որթ - winorośl
որովայն - brzuch
որովհետեւ - ponieważ
որտեղ - gdzie
Ուգանդա - Uganda
Ուզբեկստան - Uzbekistan
ուզենալ - chcieć | życzyć sobie
ութ - osiem | 8
ութոտնուկ - ośmiornica
ութսուն - osiemdziesiąt | 80
ութսուներեք - osiemdziesiąt trzy | 83
ութսուներկու - osiemdziesiąt dwa | 82
ութսունինը - osiemdziesiąt dziewięć | 89
ութսունհինգ - osiemdziesiąt pięć | 85
ութսունմեկ - osiemdziesiąt jeden | 81
ութսունյոթ - osiemdziesiąt siedem | 87
ութսունութ - osiemdziesiąt osiem | 88
ութսունչորս - osiemdziesiąt cztery | 84
ութսունվեց - osiemdziesiąt sześć | 86
Ուկրաինա - Ukraina
ուկրաինական - ukraiński
ուղարկել - wysyłać
ուղղաթիռ - helikopter | śmigłowiec
ուղտ - wielbłąd
ունք - brew
ուշ - późno
ուռենի - wierzba
ուսանող - student
ուսուցանել - uczyć
ուսուցիչ - nauczyciel
ուտելիք - jedzenie
ուր - gdzie
ուրագ - topór ciesielski
ուրախ - szczęśliwy
ուրան - uran
ուրանալ - wypierać się | zaprzeczać
ուրբաթ - piątek
Ուրուգվայ - Urugwaj
Չադ - Czad
չամիչ - rodzynka
չար - złośliwy | zły
չափանիշ - kryterium
չեզոքություն - neutralność
չեխական - czeski
Չեխիայի Հանրապետություն - Czechy
Չեչնիա - Czeczenia
Չեռնոգորիա - Czarnogóra
Չիլի - Chile
Չինաստան - Chiny
չինարեն - język chiński
չորեքշաբթի - środa
չորս - cztery | 4
պալադիում - pallad
պալարախտ - gruźlica
Պակիստան - Pakistan
պահանջել - domagać się
Պաղեստին - Palestyna
պաղպաղակ - lody
պայման - warunek
պայուսակ - torba
պայտ - podkowa
Պանամա - Panama
պանիր - ser
պաշտամունք - kult
պաշտոն - funkcja | stanowisko
պաշտոնակից - kolega
պաշտպանել - bronić | chronić
պաչ - pocałunek
պաչիկ - dziobnięcie
պապ - dziadek
Պապուա Նոր Գվինեա - Papua-Nowa Gwinea
պառավ - staruszka | starsza osoba
պատառաքաղ - widelec
պատասխանատվություն - odpowiedzialność
պատասխանել - odpowiedzieć
պատերազմ - wojna
պատիժ - kara
պատկեր - obrazek | ilustracja | obraz | portret
պատկերացնել - wyobrazić sobie
պատճեն - kopia
պատմություն - historia
պատշգամբ - balkon
պատուհան - okno
պատվաստում - szczepienie
պար - taniec
Պարագվայ - Paragwaj
պարան - sznurek | sznur | lina
պարանոց - szyja | kark
պարաշյուտ - spadochron
պարել - tańczyć
պարկավոր արջ - koala
պարսկական - perski
Պարսկաստան - Persja
պարսկերեն - język perski
պարտեզ - ogród
պարտություն - porażka
պեդալ - pedał
Պեկին - Pekin
պետ - szef
պետություն - państwo
Պերու - Peru
պզուկ - krosta
Պէյրութ - Bejrut
պինգվին - pingwin
պիրոլ - wilga
պիցցա - pizza
պլաստիկ - plastik | tworzywo sztuczne
պլատին - platyna
պլուտոնիում - pluton
պղինձ - miedź
պղպեղ - pieprz
պնակ - danie | talerz
պնդուկ - orzech laskowy
պոլոնիում - polon
պողպատ - stal
պոչ - ogon
պոպոք - orzech włoski
պոռնոգրաֆիա - pornografia
պորտ - pępek
պորտուգալերեն - język portugalski
Պորտուգալիա - Portugalia
Պուերտո Ռիկո - Portoryko
պրազեոդիմ - prazeodym
պրոմեթիում - promet
պրոտակտինիում - protaktyn
պրոտոն - proton
ջայլամ - struś
ջարդ - masakra
ջերմ - ciepły | gorący
ջերմաստիճան - temperatura
Ջիբութի - Dżibuti
Ջիբրալթար - Gibraltar
ջիղ - nerw
ջին - gin | dżin
ջութակ - skrzypce
ջունգլի - dżungla
ջուր - woda
ջրածին - wodór
ջրահարս - syrena
ջրաղացաքար - kamień młyński
ջրասամույր - wydra
ջրարջ - szop
ջրվեժ - wodospad
Ռաբաթ - Rabat
ռադիո - radio
ռադիոընդունիչ - radioodbiornik
ռադիում - rad
ռադոն - radon
ռասիզմ - rasizm
ռեակցիա - reakcja
ռեզերֆորդիում - roentgen
ռենիում - ren
ռենտգենիում - rutherford
ռեստորան - restauracja
ռնգեղջյուր - nosorożec
ռոբոտ - robot
ռոդիում - rod
ռոմ - rum
Ռուանդա - Rwanda
ռուբիդիում - rubid
ռութենիում - ruten
ռումբ - bomba
ռումիներեն - język rumuński
Ռումինիա - Rumunia
Ռուսաստան - Rosja
ռուսերեն - język rosyjski
սև - czarny | czerń
սա - ten | to
սագ - gęś
սալաթ - sałata | sałatka
սալամանդր - salamandra
Սալվադոր - Salwador
սաղմոն - łosoś
սամարիում - samar
սանդ - moździerz
Սան Մարինո - San Marino
սանտիմետր - centymetr
Սան Տոմե և Պրինսիպի - Wyspy Świętego Tomasza i Książęca
սանր - grzebień
Սաուդյան Արաբիա - Arabia Saudyjska
սաունա - sauna
սառույց - lód
սառցալեզվակ - sopel
սար - góra
սարդ - pająk
սարդենի - wawrzyn
սարյակ - szpak
սելեն - selen
սեխ - melon
սեղան - stół | jedzenie | menu | czworobok | trapez | ołtarz
սեղանատուն - jadalnia
Սենեգալ - Senegal
սեպտեմբեր - wrzesień
սեռ - płeć | rodzaj
սեռական - seksualny | płciowy
սեռական հոլով - dopełniacz
սեր - miłość
սերբերեն - język serbski
Սերբիա - Serbia
սերմ - nasiono | nasienie | sperma
սեւ - czarny
սեքսիզմ - seksizm
սիբորգիում - seaborg
սիգար - cygaro
սիլիցիում - krzem
Սինգապուր - Singapur
սիսեռ - groch
Սիսիփոս - Syzyf
սիրամարգ - paw
սիրել - kochać
Սիրիա - Syria
սիրտ - serce
Սիցիլիա - Sycylia
Սլովակիա - Słowacja
Սլովենիա - Słowenia
սխտոր - czosnek
Սև ծով - Morze Czarne
սկանդիում - skand
սև կեռնեխ - kos
սկզբունք - zasada | reguła
սկյուռ - wiewiórka
սկումբրիա - makrela
սնահավատ - przesądny
սնուցում - odżywianie
Սոլոն - Solon
սոխ - cebula
սողուն - gad
Սոմալի - Somalia
սոուս - sos
սոսինձ - klej
սոսկ - jedyny
Սովետական Միություն - Związek Radziecki
սոցիալիզմ - socjalizm
սոցիոլոգիա - socjologia
սուգ - smutek | żal | żałoba
Սուդան - Sudan
սուզանավ - łódź podwodna | okręt podwodny
սուպ - zupa
սուպերմարկետ - supermarket
սուտակ - rubin
սուրահ - sura
Սուրբ Ծնունդ - Boże Narodzenie
Սուրբ Հեղինեի կղզի - Meksyk
Սուրինամ - Surinam
սուրճ - kawa
սպա - oficer
սպանություն - morderstwo
սպառնալիք - groźba
սպասել - czekać
սպի - blizna
սպիտակ - biały
սպիտակավուն - białawy
սպիտակ արջ - niedźwiedź polarny
սպիրտ - alkohol
սպունգ - gąbka
սվին - bagnet
Ստամբուլ - Stambuł
ստամոքս - żołądek
ստել - kłamać
ստեղծագործություն - kompozycja
ստեղնաշար - klawiatura
ստորակետ - przecinek
ստուգում - weryfikacja
ստվեր - cień
ստրոնցիում - stront
ստրուկ - niewolnik
ստրուկություն - niewolnictwo
սրբիչ - ręcznik
սրճահատիկ - ziarenko kawy
սրճարան - kawiarnia
սփռոց - obrus
վագր - tygrys
վագրակատու - gepard
վաթսուն - sześćdziesiąt | 60
վաթսուներեք - sześćdziesiąt trzy | 63
վաթսուներկու - sześćdziesiąt fwa | 62
վաթսունինը - sześćdziesiąt dziewięć | 69
վաթսունհինգ - sześćdziesiąt pięć | 65
վաթսունմեկ - sześćdziesiąt jeden | 61
վաթսունյոթ - sześćdziesiąt siedem | 67
վաթսունութ - sześćdziesiąt osiem | 68
վաթսունչորս - sześćdziesiąt cztery | 64
վաթսունվեց - sześćdziesiąt sześć | 66
վախկոտ - tchórz
վակուում - próżnia
վահան - tarcza
վաղ - wczesny | wcześnie
վաճառել - sprzedawać
վայրի - dziki
վայրի գազար - pasternak
վայրի խոզ - dzik
վանադիում - wanad
վանկ - sylaba
Վանուատու - Vanuatu
վանք - klasztor
վառոդ - proch strzelniczy
Վատիկան - Państwo Watykańskie
վարազ - dzik
վարդագույն - różowy | róż
վարդակակաչ - tulipan
վարժություն - ćwiczenie
Վարշավա - Warszawa
վարունգ - ogórek
վարչապետ - premier
վարսակ - owies
Վենեսուելա - Wenezuela
Վենետիկ - Wenecja
վերարտադրություն - reprodukcja
վերլուծել - analizować
վերմուտ - wermut
վերնաշապիկ - koszula
վերք - rana
վեց - sześć | 6
Վիետնամ - Wietnam
վիզ - kark | szyja
վիզա - wiza
վիթ - gazela
վիճակախաղ - loteria
Վիսլա - Wisła
Վիքիփեդիա - Wikipedia
վճիռ - werdykt
վճռում - decyzja
վոլֆրամ - wolfram
վտանգավոր - niebezpieczny
Վրաստան - Gruzja
վրացերեն - język gruziński
տանել - nieść
Տանզանիա - Tanzania
տանտալ - tantal
Տաջիկստան - Tadżykistan
տասը - dziesięć | 10
տասներեք - trzynaście | 13
տասներկու - dwanaście | 12
տասնինը - dziewiętnaście | 19
տասնհինգ - piętnaście | 15
տասնմեկ - jedenaście | 11
տասնյոթ - siedemnaście | 17
տասնութ - osiemnaście | 18
տասնչորս - czternaście | 14
տասնվեց - szesnaście | 16
տավիղ - harfa
տատ - babka | staruszka
տատիկ - babcia
տարածք - terytorium
տարի - rok
տափաստան - step
տաքդեղ - pieprz
տաքսի - taksówka
տգեղ - brzydki
տելուր - tellur
տեխնեցիում - technet
տեղ - lokalizacja | pozycja | miejsce
տեղեկատվություն - informacja
տեղեկացնել - informować | ogłaszać | obwieszczać
տենդախտ - malaria
տեռորիզմ - terroryzm
տեռորիստական - terrorystyczny
տեսնել - widzieć
տեսություն - teoria
տերբիում - terb
տեւողություն - czas trwania
տխրություն - smutek | żal
տղա - chłopiec | syn
տղամարդ - mężczyzna
տնային աշխատանք - praca domowa
տնտեսագիտություն - ekonomia
Տոգո - Togo
տևողություն - czas trwania
տորմիղ - flota
տուկան - tukan
տուն - dom
տուրիզմ - turystyka
տրական հոլով - celownik
տրամաբան - logik
տրամաբանություն - logika
տրամագիծ - średnica
տրամադրություն - nastrój | humor
Տրինիդադ եւ Տոբագո - Trynidad i Tobago
ցածր - niski
ցածրահասակ - niski
ցանկություն - pragnienie | życzenie
ցեզիում - cez
ցեղասպանություն - ludobójstwo
ցերիում - cer
ցեց - ćma
ցինկ - cynk
ցիրկոնիում - cyrkon
ցուլ - byk
ցունամի - tsunami
փախլավա - bakława
փախուստ - ucieczka
փականագործ - ślusarz
փայտածուխ - węgiel drzewny
փայտյա - drewniany
փայտփորիկ - dzięcioł
փասիան - bażant
փաստաթուղթ - dokument
Փարիզ - Paryż
փարոս - latarnia morska
փեշ - spódnica
փետուր - pióro
փետրվար - luty
փիլիսոփա - filozof
փիլիսոփայություն - filozofia
փիղ - słoń
Փյունիկիա - Fenicja
փոխել - zmieniać
փողոց - ulica
փոշեկուլ - odkurzacz
փորձառություն - doświadczenie
փորսուղ - borsuk
փուռ - piekarnia
փոքր - mały
փռշտալ - kichnąć
փռշտոց - kichnięcie
Քաթար - Katar
քած - suka | samica psa
քահանա - ksiądz
քաղաք - miasto
քաղաքական - polityczny
քաղաքականություն - cywilizacja | polityka
քաղաքապետ - major
քաղաքավար - uprzejmy
քաղաքացի - obywatel
քաղց - głód | głodowanie
քաղցկեղ - rak | nowotwór
քաղցր - słodki (także przenośnie)
քամի - wiatr | powiew
քայլ - krok
քայլել - iść | chodzić
քան - niż | od
քանակ - suma | ilość
քաոս - chaos
քաոսային - chaotyczny
քաջ - odważny | dzielny
քաջվարդ - piwonia
քառասուն - czterdzieści | 40
քառասուներեք - czterdzieści trzy | 43
քառասուներկու - czterdzieści dwa | 42
քառասունինը - czterdzieści dziewięć | 49
քառասունհինգ - czterdzieści pięć | 45
քառասունմեկ - czterdzieści jeden | 41
քառասունյոթ - czterdzieści siedem | 47
քառասունութ - czterdzieści osiem | 48
քառասունչորս - czterdzieści cztery | 44
քառասունվեց - czterdzieści sześć | 46
քար - kamień
քարտեզ - mapa
քացախ - ocet
քեն - zemsta
Քենիա - Kenia
քեռի - wujek
քերականագետ - gramatyk
քերականական - gramatyczny
քերականորեն - gramatycznie
քերականություն - gramatyka
քթածակ - nozdrze
քթանցք - nozdrze
քիմիա - chemia
քիմիական - chemiczny
քլոր - chlor
քյաբաբ - kebab
քնամուկ - popielica
քնել - spać | zasypiać
քննադատ - krytyk
քննադատություն - krytyka
քննարկում - dyskusja
քույր - siostra
քուն - sen | drzemka
Քուվեյթ - Kuwejt
քսան - dwadzieścia | 20
քսաներեք - dwadzieścia trzy | 23
քսաներկու - dwadzieścia dwa | 22
քսաներորդ - dwudziesty
քսանինը - dwadzieścia dziewięć | 29
քսանհինգ - dwadzieścia pięć | 25
քսանմեկ - dwadzieścia jeden | 21
քսանյոթ - dwadzieścia siedem | 27
քսանութ - dwadzieścia osiem | 28
քսանչորս - dwadzieścia cztery | 24
քսանվեց - dwadzieścia sześć | 26
քսենոն - ksenon
քվեարկող - wyborca
քրիստոնեություն - chrześcijaństwo
Քրիստոնեություն - chrześcijaństwo
քրիստոնյա - chrześcijanin
Քրիստոս - Chrystus
քրոմ - chrom
քրտինք - pot
քրքում - szafran | krokus | szafranowy (kolor)
օբյեկտ - obiekt
օգնել - asystować | pomagać
օգնություն - pomoc | serwis
օգոստոս - sierpień
օգուտ - korzyść | zysk | użytek
օգտագործում - użytek | użyteczność
օդ - powietrze
օդակայան - lotnisko
օդանավ - samolot
օդանավակայան - lotnisko
օդաչու - pilot (lotnik)
օդապարիկ - balon
Օդեսա - Odessa
օդերեւութաբան - meteorolog | zapowiadający pogodę
օդերեւութաբանություն - meteorologia
օլիգարխիա - oligarchia
օձ - wąż
օձաձուկ - węgorz
օղի - wódka
օճառ - mydło
Օման - Oman
օմար - homar
օպերա - opera
օջախ - serce | dom
օսական - osetyjski
օսեթական - osetyjski
օսմիում - osm
Օվկիանիա - Oceania
օվկիանոս - ocean
օտար - zagraniczny | obcy
օտարական - obcokrajowiec
օր - dzień
օրանգուտան - orangutan
օրգազմ - orgazm
օրգան - organ
օրգանական - organiczny
օրգանիզմ - organizm
օրենք - prawo
օրինակ - przykład
օրիորդ - dziewczyna | młoda kobieta
ֆալոպյան խողովակ - jajowód
ֆալոպյան փող - jajowód
ֆաշիստական - faszystowski
ֆարերյան - farerski
ֆերմիում - ferm
ֆիզիկա - fizyka
ֆիզիկական - fizyczny
ֆիզիկապես - fizycznie
ֆիզիկոս - fizyk
ֆիզիկորեն - fizycznie
ֆիզիոլոգիա - fizjologia
Ֆիլիպիններ - Filipiny
ֆիլմ - film
Ֆինլանդիա - Finlandia
ֆինն - Fin
ֆիննական - fiński
ֆիններեն - język fiński
Ֆիջի - Fidżi
ֆիջիական - fidżyjski
ֆոսֆոր - fosfor
ֆտոր - fluor
ֆրանսերեն - język francuski
Ֆրանսիա - Francja
ֆրանսիական - francuski
ֆրանսիում - frans
ֆրանսուհի - Francuzka
