агрэсіўнасьць - agresywność
Адам - Adam
Азія - Azja
айнштайн - einstein
актын - aktyn
Альбанія - Albania
альгебра - algebra
альгебраічны - algebraiczny
альфабэт - alfabet
алюмін - aluminium | glin
Аляксандар - Aleksander (imię męskie)
ампэр - amper
Амэрыка - Ameryka
амэрыканец - Amerykanin (mieszkaniec USA) | Amerykanin (mieszkaniec kontynentu amerykańskiego)
амэрыканка - Amerykanka (mieszkanka lub obywatelka USA) | Amerykanka (mieszkanka kontynentu amerykańskiego)
амэрыканскі - amerykański
амэрыц - ameryk
аналёгія - analogia
аналягічны - analogiczny
ананімнасьць - anonimowość
антрапалёгія - antropologia
антрапалягічны - antropologiczny
антраполяг - antropolog
антыманіт - antymonit
антымон - antymon
антысэміт - antysemita
антысэмітка - antysemitka
антысэмітызм - antysemityzm
антысэміцкі - antysemicki
антысэптык - antyseptyk | środek antyseptyczny
антысэптыка - antyseptyka
антысэптычны - antyseptyczny
апазыцыя - opozycja
апіялёгія - apiologia
арабскі - arabski
Аргентына - Argentyna
археалёгія - archeologia
археалягічны - archeologiczny
Архімэд - Archimedes
аршэньнік - arsen
Арыстотэль - Arystoteles
астралёгія - astrologia
астралягічны - astrologiczny
Атлянтычны акіян - Ocean Atlantycki
атмасфэра - atmosfera | atmosfera (jednostka miary ciśnienia)
атмасфэрны - atmosferyczny
Аўстрыя - Austria
аўтабіяграфія - autobiografia
Бабілён - Babilon
баўгарскі - bułgarski
баўгарын - Bułgar
Баўгарыя - Bułgaria
беларускі - białoruski
Беларусь - Białoruś
бізнэс - biznes
бізнэс-вумэн - businesswoman | bizneswoman | biznesmenka
бізнэс-кляс - klasa biznes
бізнэсмэн - biznesmen
бізнэсовы - biznesowy
бізнэс-плян - biznesplan
бісмут - bizmut
біяграфія - biografia
біялёгія - biologia
біялягічны - biologiczny
біясфэра - biosfera
біясынтэз - biosynteza
Блізкі Ўсход - Bliski Wschód
борыюм - bohr (unnilseptium)
Босьнія і Герцагавіна - Bośnia i Hercegowina
Бразылія - Brazylia
Браніслаў - Bronisław
быць - być
бэкерэль - bekerel
Бэліз - Belize (państwo środkowoamerykańskie)
бэльгіец - Belg
бэльгійскі - belgijski
Бэльгія - Belgia
Бэрлін - Berlin
бэрлінскі - berliński
бэрыль - beryl
ванад - wanad
вапень - wapń
Ватыкан - Watykan
верасень - wrzesień
Вікіпэдыя - Wikipedia
Вільня - Wilno
волава - ołów
востраў - wyspa
вугорец - Węgier
Вугоршчына - Węgry
вэбэр - weber
вэгетарыянства - wegetarianizm
вэнгерац - Węgier
Вэнгрыя - Węgry
Вэнэсуэла - Wenezuela
вэнэсуэлец - Wenezuelczyk
вэнэсуэлька - Wenezuelka
вэнэсуэльскі - wenezuelski
Вэнэцыя - Wenecja
Вэста - Westa (bogini ogniska domowego) | Westa (planetoida)
гадалін - gadolin
галь - gal
гартаваць - hartować
гас - has
гафн - hafn
геалёгія - geologia
геалягічны - geologiczny
геамэтрычны - geometryczny | geometryczny (składający się z linii i figur geometrycznych)
геамэтрыя - geometria
гель - hel
генэтыка - genetyka
генэтычны - genetyczny
генэтычны код - kod genetyczny
геоляг - geolog
герман - german
герпэталёгія - herpetologia
Гібральтарскі праліў - Cieśnina Gibraltarska
гінэкалёгія - ginekologia
гіпэртанія - hipertensja | nadciśnienie
гісторыя - historia
глябалізацыя - globalizacja
год - rok
гольм - holm
гомасэксуалізм - homoseksualizm
гомасэксуаліст - homoseksualista
гомасэксуальнасьць - homoseksualność
гомасэксуальны - homoseksualny
грэгарыянскі - gregoriański (odnoszący się do papieża Grzegorza XIII) | gregoriański (odnoszący się do papieża Grzegorza I)
Грэнляндыя - Grenlandia
гуляць - grać (w grę)
гэрц - herc
даляр - dolar
Данія - Dania
дармштат - darmsztadt
дзясяты - dziesiąty | 10.
другая сусьветная вайна - druga wojna światowa
дубн - dubn
дыплямат - dyplomata
дыпляматычны - dyplomatyczny
дыпляматыя - dyplomacja
дыспроз - dysproz
дэмэнцыя - demencja
жнівень - sierpień
жыцьцяпіс - życiorys | biografia
заалёгія - zoologia
заалягічны - zoologiczny | radykalny | fanatyczny
заалягічны парк - ogród zoologiczny
залева - ulewa
затрымаць - zatrzymać
Заходні Бэрлін - Berlin Zachodni
знак - znak
ідэалёгія - ideologia
ідэалягічны - ideologiczny
імавернасьць - prawdopodobieństwo
імпэрыя - imperium
імпэрыялізм - imperializm
імпэрыяліст - imperialista
імпэрыялістычны - imperialistyczny
інд - ind
Інданэзія - Indonezja
індаэўрапейскі - indoeuropejski
Ірляндыя - Irlandia
ірыд - iryd
Ісляндыя - Islandia
Ісьляндыя - Islandia
Італія - Włochy
ітар - itr
ітэрб - iterb
кадм - kadm
калёнізатар - kolonizator
калёнізацыя - kolonizacja
калёнія - kolonia | kolonia (jednostka osadnicza) | kolonia (forma wypoczynku letniego dzieci)
калёрыя - kaloria
каліфорн - kaliforn
каль - potas
кальц - wapń
калюмбійскі - kolumbijski
Калюмбія - Kolumbia (państwo południowoamerykańskie)
каляндар - kalendarz
калянізаваць - kolonizować
каляніялізм - kolonializm
каляніяльны - kolonialny
камэта - kometa
Канада - Kanada
кантынэнт - kontynent
кантынэнтальны - kontynentalny
канфэдэрацыя - konfederacja
канфэсія - konfesja | wyznanie
капэрніц - kopernik
кастрычнік - październik
Касьцюшка - Kościuszko (nazwisko polskie i białoruskie)
Каталёнія - Katalonia
каталёнскі - kataloński
каталянскі - kataloński
квас - kwas chlebowy
кіляграм - kilogram
кінэтычная энэргія - energia kinetyczna
клясыцызм - klasycyzm
клясычны правапіс - klasyczna ortografia (określenie taraszkiewicy)
колькасьць - ilość
Корсыка - Korsyka
красавік - kwiecień
крэмн - krzem
ксёндз - ksiądz katolicki
ксэнафобія - ksenofobia
Куба - Kuba
кулён - kulomb
кюр - kiur
лаўрэнс - lorens
лацінаамэрыканец - Latynoamerykanin
лацінаамэрыканка - Latynoamerykanka
лацінаамэрыканскі - latynoamerykański
Лацінская Амэрыка - Ameryka Łacińska
лексыкаграфія - leksykografia
лексыкалёгія - leksykologia
лесьбійскі - lesbijski
лесьбіянка - lesbijka
Летува - Litwa
лёгіка - logika
лівэрморыюм - liwermor
Лізавета - Elżbieta (imię żeńskie)
ліпень - lipiec
лістапад - listopad
літ - lit
Ліхтэнштайн - Liechtenstein
Люксэмбург - Luksemburg (państwo) | Luksemburg (miasto)
люмэн - lumen
люты - luty | mroźny | ostry | bezlitosny
лютэц - lutet
лягічны - logiczny (odnoszący się do logiki) | logiczny (zgodny z logiką)
лянтан - lantan
магн - magnez
магнэз - magnez
Мадагаскар - Madagaskar
май - maj
майтнэр - meitner
маладушнасьць - małoduszność (brak odwagi, hartu ducha, wiary i zdecydowania)
Манака - Monako
манган - mangan
марфалёгія - morfologia
марфалягічны - morfologiczny
Менск - Mińsk
месяц - miesiąc
метадалёгія - metodologia
мікрабіялёгія - mikrobiologia
мікрабіялягічны - mikrobiologiczny
мірмекалёгія - myrmekologia
міталёгія - mitologia
міталягічны - mitologiczny
множаньне - mnożenie
мова - język | mowa
музэй - muzeum
мысьленьне - myślenie
мэдыцына - medycyna
мэксіканскі - meksykański
Мэксыка - Meksyk
Мэсапатамія - Mezopotamia
мэтал - metal | metal (gatunek muzyki rockowej)
мэталюрг - metalurg
мэталюргічны - metalurgiczny
мэталюргія - metalurgia
мэтар - metr (jednostka miary długości)
мэтафізыка - metafizyka
мэтафізычны - metafizyczny
мядзьведзь - niedźwiedź
мяжа - granica
натар - sód
недатыкальнасьць - nietykalność
незалежнасьць - niezależność | niepodległość
ніоб - niob
Новая Зэляндыя - Nowa Zelandia
норма - norma
нэадым - neodym
нэптун - neptun
Нэптун - Neptun
няўдзячнасьць - niewdzięczność
осм - osm
пабудаваць - wybudować
палён - polon
паляд - pallad
парлямэнт - parlament
парлямэнцкі - parlamentarny
парніковы эфэкт - efekt cieplarniany
патэнцыйная энэргія - energia potencjalna
паўднёваамэрыканскі - południowoamerykański
Паўднёвая Амэрыка - Ameryka Południowa
паўночнаамэрыканскі - północnoamerykański
Паўночная Амэрыка - Ameryka Północna
перакладчык - tłumacz
першая сусьветная вайна - pierwsza wojna światowa
плютон - pluton
плянэта - planeta
плянэтарны - planetarny
Плятон - Platon
плятына - platyna
плятынавы - platynowy
плятынавы мэтал - platynowiec
пнэўмалёгія - pneumonologia
правансальскай - język prowansalski
правесьці - przeprowadzić | spędzić | poprowadzić | wyznaczyć | wykonać | odprowadzić | pogładzić | przesunąć
праект - projekt
празэадым - prazeodym
прамысловасьць - przemysł
прамэт - promet
пратактын - protaktyn
прафэсар - profesor
прэзыдэнт - prezydent | prezes
псыхалёгія - psychologia
псыхалягічны - psychologiczny
псыхапат - psychopata
псыхапаталёгія - psychopatologia
псыхапаталягічны - psychopatologiczny
псыхапатычны - psychopatyczny
псыхапатыя - psychopatia
псыхатычны - psychotyczny
псыхатэрапеўт - psychoterapeuta
псыхатэрапія - psychoterapia
псыхіка - psychika
псыхічны - psychiczny
псыхіятр - psychiatra
псыхіятрычны - psychiatryczny
псыхіятрыя - psychiatria
псыхоз - psychoza
псыхоляг - psycholog
псэўданавуковы - pseudonaukowy
публіцыст - publicysta
пульманалёгія - pulmonologia
пульманоляг - pulmonolog
пустэльнік - pustelnik | samotnik
пустэльня - pustynia | pustelnia | samotnia
пэніцылін - penicylina
Пэрсыдзкая затока - Zatoka Perska
рад - rad
радыяактыўнасьць - radioaktywność
радыяактыўны - radioaktywny
Расейская Фэдэрацыя - Federacja Rosyjska
расейскі - rosyjski
Расея - Rosja
расьліна - roślina
расьліннасьць - roślinność
расьлінны - roślinny
раўнаньне - równanie
рашэньне - decyzja
род - rod
роўнасьць - równość
рубід - rubid
рутэн - ruten
Рыбы - Ryby | ♓
Рым - Rzym
рэзэрфорд - rutherford
рэн - ren
рэнтген - roentgen
сакавік - marzec
самар - samar
Сан-Тамэ і Прынсыпі - Wyspy Świętego Tomasza i Książęca
Сардынія - Sardynia
сацыёляг - socjolog
сацыялёгія - socjologia
серка - siarka
сканд - skand
Славаччына - Słowacja
Славенія - Słowenia
Сонечная сыстэма - Układ Słoneczny
срэбра - srebro
стронц - stront
студзень - styczeń
сувэрэнітэт - suwerenność
сукупны ўнутраны прадукт - produkt krajowy brutto
сусьветны - światowy
сыборг - seaborg
сымбалізм - symbolizm
сымбаліст - symbolista (przedstawiciel symbolizmu)
сымбалічны - symboliczny
сымбаль - symbol
сымэнс - simens
сынтэз - synteza
сынтэзатар - syntezator
сынтэтычны - syntetyczny | sztuczny
сыстэма - system | układ
сьветапогляд - światopogląd
сьветлавы год - rok świetlny
сьнежань - grudzień
сьпеў - śpiew
сэкс - seks
сэксалёгія - seksuologia
сэксалягічны - seksuologiczny
сэксуальнасць - seksualność
сэксуальная арыентацыя - orientacja seksualna
сэксуальны - seksualny
сэкунда - sekunda
сэлен - selen
сэмантыка - semantyka
сэмантычны - semantyczny
сэпаратызм - separatyzm
сэрб - Serb
Сэрбія - Serbia
сэрбка - Serbka
табліца - tablica
таль - tal
тарашкевіца - taraszkiewica | białoruski taraszkiewica
тарпэда - torpeda
творчасьць - twórczość
тор - tor
травень - maj
туль - tul
Турэччына - Turcja
тыпалёгія - typologia
тыпалягічны - typologiczny
тэалёгія - teologia
тэалягічны - teologiczny
тэлюр - tellur
тэмпэратура - temperatura
тэорыя імавернасьцяў - teoria prawdopodobieństwa | rachunek prawdopodobieństwa
тэрб - terb
тэрміналёгія - terminologia
тэрміналягічны - terminologiczny
тэхнэц - technet
унівэрсытэт - uniwersytet
унунгекс - ununhexium
унунокт - ununoctium
унунпэнт - ununpentium
унунсэпт - ununseptium
унунтар - ununtrium
ў - w | po | do
ўдзячнасьць - wdzięczność
фартэцыя - forteca | twierdza
ф’ёрд - fiord
фізыялёгія - fizjologia
фізыялягічны - fizjologiczny
філёзаф - filozof
Філіпіны - Filipiny
філязофія - filozofia
філязофскі - filozoficzny
флеровіюм - flerow
флёра - flora
фотасынтэз - fotosynteza
фразэалёгія - frazeologia
фразэалягічны - frazeologiczny
франц - frans
Францыя - Francja
фэдэратыўны - federacyjny | federalny | zjednoczony | sfederowany
фэдэрацыя - federacja (państwo federalne) | federacja (związek)
фэмінізацыя - feminizacja
фэмінізм - feminizm
фэмініст - feminista
фэміністка - feministka
фэміністычны - feministyczny
фэрм - ferm
фэстываль - festiwal
хада - chodzenie
Харватыя - Chorwacja
хімічны элемэнт - pierwiastek chemiczny
хлёр - chlor
хлярафіл - chlorofil
хрысьціянін - chrześcijanin
хрысьціянінка - chrześcijanka
хрысьціянскі - chrześcijański
хрысьціянства - chrześcijaństwo
цына - cyna
цыркон - cyrkon
цэз - cez
цэр - cer
частасьць - częstotliwość
чацьвер - czwartek
Чылі - Chile
чэрвень - czerwiec
Чэхаславаччына - Czechosłowacja
швайцарац - Szwajcar
швайцарка - Szwajcarka
швайцарскі - szwajcarski
Швайцарыя - Szwajcaria
Швэцыя - Szwecja
шчыльнасьць - gęstość
экалёгія - ekologia
экалягічны - ekologiczny
экспэрымэнт - eksperyment
экспэрымэнтальны - eksperymentalny
энтамалёгія - entomologia
энэргія - energia
эпістэмалёгія - epistemologia
эпістэмалягічны - epistemologiczny
эрб - erb
этналёгія - etnologia
этналягічны - etnologiczny
Этыёпія - Etiopia
этыёпскі - etiopski
этымалёгія - etymologia | źródłosłów
этымалягічны - etymologiczny
этыялёгія - etiologia
Эўразія - Eurazja
Эўразьвяз - Unia Europejska
эўрапеец - Europejczyk
эўрапейка - Europejka
эўрапейскі - europejski
Эўрапейскі Зьвяз - Unia Europejska
Эўрасаюз - Unia Europejska
эўраскептыцызм - eurosceptycyzm
эўраскептычны - eurosceptyczny
эўроп - europ
Эўропа - Europa
эфэкт - efekt | wrażenie
эфэктыўнасьць - efektywność | skuteczność | wydajność
эфэктыўны - efektywny | skuteczny | wydajny
Японія - Japonia
