аазіс - oaza
аалагічны - oologiczny
ааліт - oolit
аалогія - oologia
ААН - ONZ
аартальны - aortalny
абавязак - obowiązek
Абакан - Abakan
абапал - po obydwu stronach
абарот - obrót
абат - opat
абацтва - opactwo
абед - obiad
абедаць - jeść obiad
Абіджан - Abidżan
абменіць - wymienić
або - albo | lub
абое - obaj
аборт - aborcja
Абруца - Abruzja
абсалютны - absolutny
абсалютызм - absolutyzm
АБСЕ - OBWE (Арганізацыя па бяспецы і супрацоўніцтву ў Еўропе)
абсурд - absurd
абсурдны - absurdalny
Абу-Дабі - Abu Zabi | Abu Dhabi | Abu Dabi
Абуджа - Abudża
Абхазія - Abchazja
абхазская мова - język abchaski
абцяжарваць - utrudniać | obciążać
Аб'яднаныя Арабскія Эміраты - Zjednoczone Emiraty Arabskie
авангардны - awangardowy
Авен - Baran
авечы - owczy
авіяцыя - lotnictwo | awiacja
авуляцыя - owulacja | jajeczkowanie
агарод - ogród
агнастыцызм - agnostycyzm
агнастычны - agnostyczny
агностык - agnostyk
агнястрэльная зброя - broń palna
агнястрэльны - palny | postrzałowy
агонь - ogień | światło
аграрны - agrarny
агрэсар - agresor
агрэсарка - agresorka
агрэсіўнасць - agresywność
агрэсіўны - agresywny
агрэсія - agresja
агульны - ogólny
агурок - ogórek
ад - od | z
адамаў яблык - jabłko Adama
Адана - Adana
адбывацца - адбыцца
адбыцца - odbyć się
адвага - odwaga
адважны - odważny
адвакат - adwokat
аддаваць перавагу - woleć
аддаленасць - oddalenie
аддаць перавагу - woleć
Аджарыя - Adżaria
адзін - jeden | sam | (jeden) | pewien | jakiś | samotny
адзінаццаты - jedenasty
адзінаццаць - jedenaście | 11
адзінокі - samotny
адзначаць - адзначыць
адказ - odpowiedź | reakcja | odpowiedzialność
адказаць - odpowiedzieć | być odpowiedzialnym | odpowiedzieć tym samym | zapisać komuś w testamencie
адказваць - адказаць
адказнасць - odpowiedzialność
адкрывалка для бутэлек - otwieracz (do butelek)
адкрыты - otwarty | nieograniczony | otwarty (dla wszystkich) | jawny | szczery
адміністрацыя - administracja | kierownictwo
аднагорбы вярблюд - wielbłąd jednogarbny | dromader
аднаму богу вядома - Bóg jeden wie
аднаразовы - jednorazowy | jednokrotny
аднародны - jednorodny
адпачываць - odpoczywać
адрас - adres
адрасант - nadawca
адрасат - adresat
адрасны - adresowy
адрэс - adres
адсутны - nieobecny
ад усяго сэрца - z całego serca
адчуваць - адчуць
адшукаць - шукаць
Адыгея - Adygeja
Адыс-Абеба - Addis Abeba
адысці - odejść | odstąpić | odstawać | wrócić do normalnego stanu | przejść (na kogoś) | odjechać (o pociągu)
адыходзіць на задні план - schodzić na drugi plan | ustępować na dalszy plan
Адэлаіда - Adelajda (miasto w Australii)
Азербейджан - Azerbejdżan
Азія - Azja
азіят - Azjata
азіятка - Azjatka
азіяцкі - azjatycki
азонавы - ozonowy
азот - azot
азотны - azotowy
Азэрбайджан - Azerbejdżan
айкідо - aikido
айчына - ojczyzna
айчынны - ojczyźniany
акведук - akwedukt
Аквітанія - Akwitania
акіян - ocean
акіяналогія - oceanologia
Акіянія - Oceania
акіянскі - oceaniczny
акно - ulica
акорд - akord
акр - akr
Акра - Akra
акронім - skrótowiec | akronim
Аксана - Ksenia
актор - aktor
акторка - aktorka
актыній - aktyn
актыноід - aktynowiec
актыўнасьць - aktywność
акультызм - okultyzm
акуляры - okulary
акупіраваць - okupować
акуратны - akuratny
акцыянернае таварыства - spółka akcyjna
Алабама - Alabama
алатропія - alotropia
Алах - Allah
албанец - Albańczyk
Албанія - Albania
албанка - Albanka
албанскі - albański
алгарытм - algorytm
алгебра - algebra
алгебраічны - algebraiczny
але - ale
Алег - Oleg
алергія - alergia
Алжыр - Algieria | Algier
Алжырская Народная Дэмакратычная Рэспубліка - Algierska Republika Ludowo-Demokratyczna
алжырскі - algierski
алігарх - oligarcha
алігархія - oligarchia
алімпійскія гульні - igrzyska olimpijskie | olimpiada
Аліна - Alina
алкагалізм - alkoholizm
алкагалік - alkoholik
алкагалічка - alkoholiczka
алкаголь - alkohol
алкагольны - alkoholowy
алкагольны напой - napój alkoholowy
алмаз - diament
алфавіт - alfabet
алхімія - alchemia
Альберта - Alberta
альбінізм - albinizm
альбінос - albinos
альбо - lub
альгарытм - algorytm
альпійскі - alpejski
альпініст - alpinista
альпіністка - alpinistka
Альпы - Alpy
алюмініевы - aluminiowy
алюміній - aluminium | glin
Аляксандр - Aleksander
Аляксандра - Aleksandra
Аляска - Alaska
Амазонка - Amazonka
амаль - prawie | omal
Аман - Oman | Amman
АМАП - OMON = ддзел іліцыі собага рызначэння
Амерыка - Ameryka
амерыканец - Amerykanin (mieszkaniec USA) | Amerykanin (mieszkaniec kontynentu amerykańskiego)
амерыканка - Amerykanka (mieszkanka USA) | Amerykanka (mieszkanka kontynentu amerykańskiego)
амерыканскі - amerykański
амерыцый - ameryk
ампіцылін - ampicylina
Амстэрдам - Amsterdam
Анадыр - Anadyr
аналіз - analiza
аналізаваць - analizować
аналізатар - analizator
аналітычны - analityczny
анальгетык - analgetyk | środek przeciwbólowy
анамастыка - onomastyka
ананас - ananas
анархізм - anarchizm
анархія - anarchia
анатам - anatom
анатамічны - anatomiczny
анатомія - anatomia
анафілаксія - anafilaksja
анафілактычны шок - anafilaksja
анахранізм - anachronizm
анахранічны - anachroniczny
ангар - hangar
Ангілья - Anguilla
англійскі - angielski
англіканец - anglikanin
англіканка - anglikanka
англіканскі - anglikański
англіканства - anglikanizm
англічанін - Anglik
англічанка - Angielka
Англія - Anglia
Англсі - Anglesey
Ангола - Angola
Андалусія - Andaluzja
Андора - Andora
Андора-ла-Велья - Andorra La Vella | Andora
андралогія - andrologia
Андрэй - Andrzej
Анды - Andy
анестэзія - znieczulenie
анестэзіялогія - anestezjologia
анёл - anioł
аніён - anion
анімізм - animizm
анімэ - anime
анкалогія - onkologia
Анкара - Ankara
анталогія - antologia | ontologia
Антананарыва - Antananarywa
Антарктыда - Antarktyda
антрапалагічны - antropologiczny
антрапалогія - antropologia
антрапамарфізм - antropomorfizm
антрапамарфічны - antropomorficzny
антраполаг - antropolog
антыбіётык - antybiotyk
Антыгуа і Барбуда - Antigua i Barbuda
антыкамунізм - antykomunizm
антыкамуніст - antykomunista
антыкамуністка - antykomunistka
антыкамуністычны - antykomunistyczny
антысеміт - antysemita
антысемітка - antysemitka
антысемітызм - antysemityzm
антысеміцкі - antysemicki
антыцыклон - wyż atmosferyczny
Аньхой - Anhui
апавяданне - opowiadanie
ападкі - opady ( deszczu, śniegu)
апазіцыйны - opozycyjny
апазіцыя - opozycja
апазіцыянер - opozycjonista
апазіцыянерка - opozycjonistka
апартунізм - oportunizm
апартуніст - oportunista
апартуністка - oportunistka
апартуністычны - oportunistyczny
апельсін - pomarańcza
апельсінавы - pomarańczowy (z pomarańczy)
аперацыйная сістэма - system operacyjny
аперацыйны - operacyjny
аперацыя - operacja | operacja (działania skierowane na wykonanie określonego zadania)
апіялогія - apiologia
апошні - ostatni
аптовы - hurtowy
аранжавы - pomarańczowy
Арарат - Ararat (masyw)
аргазм - orgazm
арганізаваць - organizować
арганізатар - organizator
арганізатарка - organizatorka
арганізатарскі - organizatorski
арганізацыйны - organizacyjny
арганізацыя - organizacja
Арганізацыя Аб'яднаных Нацый - Organizacja Narodów Zjednoczonych | ONZ
арганіст - organista
Аргентына - Argentyna
аргентынскі - argentyński
Аргенціна - Argentyna
аргон - argon
Арменія - Armenia
армія - armia
армянін - Ormianin
армянка - Ormianka
армянскі - ormiański | armeński
арол - orzeł
артыкул - artykuł | typ towaru
артэрыя - tętnica
арфаграфічная памылка - błąd ortograficzny
арфіст - harfista | harfiarz
археалагічны - archeologiczny
архезаалогія - archeozoologia
архітэктура - architektura
архіў - archiwum
арыстакратыя - arystokracja
Арыстоцель - Arystoteles
асабліва - szczególnie
асексуальнасць - aseksualizm | aseksualność
асманскі - osmański
асноўны - podstawowy | zasadniczy
асоба - osoba
аспірын - aspiryna
астат - astat
астатні - pozostały
астма - astma
астматык - astmatyk
астматычка - astmatyczka
астматычны - astmatyczny
астракізм - ostracyzm (bojkot jakiejś osoby lub grupy osób) | ostracyzm (sąd skorupkowy)
астраномія - astronomia
-асць - -ość
Атава - Ottawa
атакаваць - atakować
атаманскі - ottomański
Атлантычны акіян - Ocean Atlantycki
атмасферны - atmosferyczny
атмасферны ціск - ciśnienie atmosferyczne
атрад - oddział
атрымацца - udać się (osiągnąć coś) | zdarzyć się | wydarzyć się
атрымаць - otrzymać | dostać | zostać pobitym | zachorować
атрымлівацца - атрымацца
атрымліваць - атрымаць
атрымоўвацца - атрымацца
атэізм - ateizm
Аўганістан - Afganistan
аўстраліец - Australijczyk
аўстралійка - Australijka
аўстралійскі - australijski
Аўстралія - Australia (kontynent) | Australia (państwo)
аўстрыец - Austriak
аўстрыйка - Austriaczka
аўстрыйскі - austriacki
Аўстрыя - Austria
аўтар - autor
аўтарскі - autorski
аўтарызаваць - autoryzować
аўтобус - autobus
аўторак - wtorek
афганец - Afgańczyk
Афганістан - Afganistan
Афіны - Ateny
Афрыка - Afryka
Афрыканская Рэспубліка - Republika Środkowoafrykańska
афрыканскі - afrykański
ахаваць - ахоўваць
Ахен - Akwizgran
ахова - ochrona
ахоўваць - ochraniać | chronić
ахоўны - ochronny
ацяпленне - ogrzewanie
ачысціць - ачышчаць
ачышчаць - oczyszczać | sprzątać | obierać
Ашхабад - Aszchabad
аэрапорт - lotnisko
бабіна лета - babie lato (wczesnojesienne ciepłe dni)
бабка надвае варажыла - na dwoje babka wróżyła
бабка надвае гадала - na dwoje babka wróżyła
бабуля - babcia
Баварыя - Bawaria
багаж - bagaż
багаты - bogaty | zamożny
багіня - bogini
балада - ballada
балгарка - Bułgarka
балгарскі - bułgarski
балгарын - Bułgar
Балгарыя - Bułgaria
балівійскі - boliwijski
Балівія - Boliwia
балканскі - bałkański
Балканы - Bałkany
балкон - balkon
Балтыйскае мора - Morze Bałtyckie
балтыйскі - bałtycki
Балтыка - Bałtyk
бальніца - szpital
бамбардзіроўшчык - bombowiec
бамбасховішча - schron przeciwlotniczy
банан - banan
Бангкок - Bangkok
Бангладэш - Bangladesz
банк - bank
барада - broda | o człowieku | który nosi brodę
барадаты - brodaty
Баранавічы - Baranowicze
Баранцава мора - Morze Barentsa
барацьба - walka
Барбадас - Barbados
Барбара - Barbara
бардовы - bordowy | bordo
барый - bar
басейн - basen | zlewisko | dorzecze | zagłębie
батаніка - botanika
батанічны - botaniczny
батанічны сад - ogród botaniczny
Батсвана - Botswana
бацька - ojciec | założyciel
бацькаў - ojcowski
бацькі - rodzice
бацян - bocian
бачыць - widzieć | spotykać
баязлівасць - bojaźliwość | tchórzliwość
баязлівец - tchórz (bojaźliwy człowiek)
баязлівы - bojaźliwy | tchórzliwy
баяцца як агню - bać się jak ognia
баяцца як чорт крыжа - bać się jak diabeł święconej wody | bać się jak czart krzyża
баяцца як чорт пасвячонай вады - bać się jak diabeł święconej wody
бегемот - hipopotam
бедны - biedny | niezamożny | nieszczęśliwy
безалкагольны - bezalkoholowy
без нажа зарэзаць - dziury nie zrobić, a krew wyssać
беларус - Białorusin
беларусістыка - białorutenistyka
беларуская мова - język białoruski
беларускі - białoruski
Беларусь - Białoruś
Беласток - Białystok
беластоцкі - białostocki
Беласточчына - Białostocczyzna
Белград - Belgrad
белградскі - belgradzki
Беліз - Belize
белы - biały
белы чай - biała herbata
бельгіец - Belg
бельгійка - Belgijka
бельгійскі - belgijski
Бельгія - Belgia
бенгальскі - bengalski
Бенін - Benin
бераг - brzeg | brzeg (tkaniny) | brzeg (naczynia)
берагчы як зрэнку вока - strzec jak źrenicy oka
берклій - berkel
Берлін - Berlin
берлінскі - berliński
Бермудскія астравы - Bermudy
Берн - Berno
берылій - beryl
бесперапынны - ciągły | nieprzerwany
беспрацоўе - bezrobocie
бессаромны - bezwstydny | bezczelny | niegodziwy
бібліятэка - biblioteka
бізнес - biznes
бізнес-клас - klasa biznes
бізнес-лэдзі - businesswoman | bizneswoman | biznesmenka
бізнес-план - biznesplan
бізнес-школа - szkoła biznesu
біклага - menażka
біржа - giełda
біржавы - giełdowy
Бірма - Birma
бірузовы - turkusowy
біскуп - biskup
біскупства - biskupstwo
бітва - bitwa
біялагічная хімія - chemia biologiczna | biochemia
біялагічны - biologiczny
біялогія - biologia
біяпсія - biopsja
біясінтэз - biosynteza
біясфера - biosfera
біятэхналагічны - biotechnologiczny
біятэхналогія - biotechnologia
біяхімік - biochemik
біяхімічны - biochemiczny
біяхімія - biochemia
блакіт - błękit (kolor) | błękit (czyste niebo)
блакітны - błękitny
бледнасць - bladość
бледны - blady (pozbawiony rumieńca, opalenizny, mający jasną karnację) | blady (o mało intensywnej barwie) | blady (mało intensywny)
бледны як смерць - blady jak śmierć
блізарукасць - krótkowzroczność
блізка - blisko
блізкі - bliski | pobliski | bliski (pod względem pokrewieństwa) | drogi | podobny
Блізкі Усход - Bliski Wschód
Блізняты - Bliźnięta
блудны сын - syn marnotrawny
блыха - pchła
БНР - Białoruska Republika Ludowa
бог - bóg
Бог - Bóg
боепрыпас - amunicja
бомба - bomba
бомбавы - bombowy
Бон - Bonn
бор - bór (stary las iglasty) | bor | wiertło
борны - borowy (dotyczący pierwiastka bor, zawierający bor)
борый - bohr (unnilseptium)
Боснія і Герцагавіна - Bośnia i Hercegowina
Боснія і Гэрцагавіна - Bośnia i Hercegowina
бочка - beczka
бразілец - Brazylijczyk
Бразілія - Brazylia
бразільскі - brazylijski
бразільянка - Brazylijka
Бразылія - Brazylia
Браніслаў - Bronisław
бранхіт - bronchit
бранхіяльная астма - astma oskrzelowa
бранхіяльны - oskrzelowy
браняносец - pancernik
брат - brat
Браціслава - Bratysława
браць - узяць
бром - brom
бронетранспарцёр - transporter opancerzony
брудны - brudny
Брусель - Bruksela
брыво - brew
брыгада - brygada | ekipa
брыгадзір - brygadzista
брыдкі - brzydki (subiektywnie pozbawiony piękna, wartości estetycznych) | brzydki (moralnie naganny, niezgodny z przyjętymi normami)
брытанскі - brytyjski
Брэст - Brześć
Брэстчына - Ziemia brzeska
брэсцкі - brzeski
будаванне - budowanie
будаваць - budować
Будапешт - Budapeszt
будзьце здаровы - na zdrowie
будучы - przyszły | przyszłość | los
будызм - buddyzm
будынак - budynek
буйны - ogromny | bardzo duży | ważny | znaczący | mocny | porwisty | niespokojny | żywy | bujny
булгур - bulgur
бульба - ziemniak | ziemniaki
бура ў шклянцы вады - burza w szklance wody
Бургундыя - Burgundia
Буркіна-Фасо - Burkina Faso
Бурунды - Burundi
бусел - bocian | wysoka butelka wódki
бутан - butan
Бутан - Bhutan
бутэлька - butelka
Бухарэст - Bukareszt
бывай - cześć (na pożegnanie)
бываць - bywać | zdarzać się | żegnaj | żegnajcie
быць - być
быць на нажах - być na noże
быць на сёмым небе - być w siódmym niebie
быць у цэнтры ўвагі - być w centrum uwagi
бэжавы - beżowy
бюракратыя - biurokracja
бядро - biodro
бяздзетнасць - bezdzietność
бяздзетны - bezdzietny
бяззубы - bezzębny | bezzębny (słaby, bezradny i niegroźny)
бязлюдны - bezludny
Бялград - Belgrad
бяроза - brzoza
Бяскіды - Beskidy
бяспечны - bezpieczny
вавёрка - wiewiórka
вада - woda
вадабоязь - wścieklizna
вадалаз - nurek
Вадалей - Wodnik
вадарод - wodór
вадародны - wodorowy
вадаспад - wodospad
вадзіцель - kierowca
вадзіцельскае пасведчанне - prawo jazdy
вадзіць за нос - wodzić za nos
ваенны - wojenny
ваенны злачынец - zbrodniarz wojenny
важны - ważny | znaczący
вазелін - wazelina
вазэктамія - wazektomia
вайна - wojna
вайсковы - wojskowy
вакзал - dworzec
валодаць - posiadać | władać | posługiwać się
вальфрам - wolfram
вальфраміт - wolframit
ванадый - wanad
вандал - wandal | Wandal
вандалізм - wandalizm
варожасць - wrogość
варожы - wrogi
варта - warto | warta | straż
Варшава - Warszawa
варшаўскі - warszawski
васемнаццаты - osiemnasty
васемнаццаць - osiemnaście 18
васемсот - osiemset
Ватыкан - Watykan
ватыканскі - watykański
Ваўкавыск - Wołkowysk
Вашынгтон - Waszyngton
ведаць - wiedzieć | znać | znać (kogoś) | znać (coś) | zaznawać | doświadczać
везір - wezyr
вейка - rzęsa
велікадушны - wielkoduszny | hojny
велікодны - wielkanocny
велічыня - wielkość | wysokość
вельмі - bardzo
вена - żyła
Вена - Wiedeń
венгерац - Węgier
венгерка - Węgierka
венгерскі - węgierski
Венгрыя - Węgry
Венесуэла - Wenezuela
венесуэлец - Wenezuelczyk
венесуэлка - Wenezuelka
Венецыя - Wenecja
венецыянец - wenecjanin
венецыянка - wenecjanka
венецыянскі - wenecki | język/dialekt wenecki
верасень - wrzesień
В'етнам - Wietnam
в'етнамец - Wietnamczyk
в'етнамка - Wietnamka
в'етнамкі - japonki
в'етнамскі - wietnamski
ветраны - wietrzny
вецер - wiatr | pędziwiatr (ktoś ruchliwy i niespokojny)
вечар - wieczór
вёска - wieś
віза - wiza
візантыец - Bizantyjczyk
Візантый - Bizancjum (miasto nad Bosforem)
візантыйскі - bizantyjski
Візантыя - Bizancjum | cesarstwo bizantyjskie
візір - wezyr
візіт - wizyta
Вікіпедыя - Wikipedia
Вікіцытатнік - Wikicytaty
вільгаць - wilgoć
вільготнасць - wilgotność
вільготны - wilgotny
Вільнюс - Wilno
Вільня - Wilno
віно - wino
віскі - whisky
Вісла - Wisła (rzeka)
вісмут - bizmut
Віцебск - Witebsk
Вічэнца - Vicenza (miasto)
вішня - czereśnia
віяланчэліст - wiolonczelista
віяланчэлістка - wiolonczelistka
віяланчэль - wiolonczela
Віялета - Wioleta
воданепранікальны - wodoszczelny
воддаль - w oddali
водка - wódka
водны - wodny
вожык - jeż
возера - jezioro
воін - wojownik
войска - wojsko
вока - oko
вокавы яблык - gałka oczna
вол - wół
волава - cyna
волас - włos
Вольга - Olga
вольны - wolny
вопратка - ubranie
вораг - wróg
восем - osiem | 8
восемдзесят - osiemdziesiąt 80
восень - jesień
воск - wosk
востраў - wyspa
вось - tu
восьмы - ósmy
воўк - wilk
воўкам глядзець - patrzeć wilkiem
воўк у авечай шкуры - wilk w owczej skórze
воўна - wełna
Вроцлаў - Wrocław
вугаль - węgiel
вуглярод - węgiel
вулачка - uliczka
вуліца - ulica
вулкан - wulkan
вусны - usta | ustny
вусце - ujście
вуха - ucho
вучыцца - uczyć się
вучыць - uczyć
вы - wy | Pan | Pani
выбаршчык - wyborca
выбары - wybory (parlamentarne, prezydenckie)
выбачайце - przepraszam
выбраць - wybierać
вывад - wniosek
выдра - wydra
выехаць - ехаць
вызалаціць - залаціць
вызваліць - wyzwolić | wyswobodzić
выйсці - wyjść | pojawić się | stracić | wejść | zostać wydanym | wdrukowanym | przypaść | wyjść za mąż | okazać się | wyjść (jako kto) | pochodzić
выкідаць грошы на вецер - wyrzucać pieniądze w błoto | wyrzucać pieniądze przez okno
вынік - wynik
выпрабавнне - próba
выпрацаваць - wypracować | opracować
выпрацоўваць - выпрацаваць
вырабы - wyrób | produkt
вырасці - расці
вырашыць - postanowić
выслухаць - слухаць
высокі - wysoki
выстаўка - wystawa
вядро - wiadro
вяз - wiąz
Вялікабрытанія - Wielka Brytania
вялікадзяржаўны - wielkomocarstwowy
Вялікае Княства Літоўскае - Wielkie Księstwo Litewskie
вялікарасейскі - wielkorosyjski | wielkoruski
вялікарускі - wielkoruski | wielkorosyjski
вялікі - wielki | duży
вялікі палец - kciuk
вярба - wierzba
вярблюд - wielbłąd
вярнуцца - wrócić
вясёлы - wesoły
вясна - wiosna
вясновы - wiosenny
вяснушка - pieg
вячэра - kolacja
вячэрні - wieczorny
г. - rok = r.
Гаага - Haga
Габон - Gabon
гадаліній - gadolin
гадзіна - godzina
гадзіннік - zegar | zegarek
гады ў рады - bardzo rzadko
газ - gaz | pedał gazu
газаваны - gazowany
газавы - gazowy
газета - gazeta
газэта - gazeta
Гаіці - Haiti
галава - głowa | rozum | początek | czoło
галава закруцілася - przewrócić się w głowie
галава сям'і - głowa rodziny
галактыка - galaktyka
галандзец - Holender
галандка - Holenderka
галандскі - holenderski
Галандыя - Holandia
галаўны мозг - mózgowie
галёнка - goleń
галій - gal
Галілея - Galilea (kraina) | Galilea (miasto w Hiszpanii)
галодны - głodny
Гамбія - Gambia
гамеапатыя - homeopatia
Гана - Ghana
гандаль - handel
гандляваць - handlować
Гандурас - Honduras
Ганконг - Hongkong
Ганна - Anna | Hanna
гара - góra | strych | sterta | góra (miejsce umieszczone wysoko)
гарадскі - miejski
гараж - garaż
гарачка - gorączka
гарачы - gorący | namiętny
гарачыня - upał
гарбата - herbata
Гарганцюа - Gargantua
гармата - armata
гарнастай - gronostaj
гарышча - strych
гарэлка - wódka
гарэць - palić się
гасцінец - gościniec (droga, trakt) | gościniec (podarunek od gościa lub powracającego z podróży)
гасцініца - hotel
гасціннасць - gościnność
гасцінны - gościnny (cecha człowieka) | gościnny (przeznaczony dla gości)
гафній - hafn
Гаяна - Gujana
Гватэмала - Gwatemala
Гвінея-Бісау - Gwinea Bissau
геаграфічны - geograficzny
геаграфія - geografia
геалогія - geologia
геаметрычны - geometryczny | geometryczny (składający się z linii i figur geometrycznych)
геаметрыя - geometria
геданізм - hedonizm
гелій - hel
гематалогія - hematologia
гематурыя - hematuria | krwiomocz
генерал - generał
гентаміцін - gentamycyna
германій - german
Германія - Niemcy
германскі - niemiecki
герпеталогія - herpetologia
герцаг - książę
герцагіня - księżna
герцагскі - książęcy
герцагства - księstwo
Гімалаі - Himalaje
гінекалогія - ginekologia
гінеколаг - ginekolog
гінуць - ginąć
гістамін - histamina
гістарычны - historyczny | znaczący
гісторыя - historia
гітара - gitara
глаголіца - głagolica
глеба - ziemia | gleba | grunt
глухі - głuchy
глыбіня - głębokość
глюкоза - glukoza
глядзець - oglądać | patrzeć | pilnować | doglądać
глядзець праз пальцы - patrzeć przez palce
глядзець праз ружовыя акуляры - patrzeć przez różowe okulary
глядзець смерці ў вочы - patrzeć śmierci w oczy | spoglądać śmierci w oczy
глянуць - глядзець
гляцыялогія - glacjologia
гміна - gmina
гном - gnom | krasnal
год - rok
голуб - gołąb
гольмій - holm
гольф - golf
гомасексуалізм - homoseksualizm
гомасексуаліст - homoseksualista
гомасексуальнасць - homoseksualność
гомасексуальны - homoseksualny
Гомель - Homel
горад - miasto
горац - góral
горача - gorąco
горды - dumny
горла - gardło
горны - górski
госць - gość
градус - stopień
грамадзянін - obywatel | pan (zwracając się bezpośrednio do kogoś)
грамадзянка - obywatelka
грамадзянская вайна - wojna domowa
грамадзянскі - obywatelski | cywilny | świecki
грамадзянства - obywatelstwo
граматыка - gramatyka
граматычны - gramatyczny
граната - granat
гранатамёт - granatnik
грачанка - Greczynka
грашовы - pieniężny
гродзенскі - grodzieński
Гродзеншчына - Grodzieńszczyzna
Гродна - Grodno
гром - grzmot | piorun | huk
грошы - pieniądze
грошы не пахнуць - pieniądze nie śmierdzą
грудзі - piersi
грудзіна - mostek
грудная клетка - klatka piersiowa
грузін - Gruzin
грузінка - Gruzinka
грузінскі - gruziński
Грузія - Gruzja
група - grupa
грыб - grzyb
грыва - grzywa
грыгарыянскі - gregoriański (odnoszący się do papieża Grzegorza XIII) | gregoriański (odnoszący się do papieża Grzegorza I)
грэйпфрутавы - grejpfrutowy
грэк - Grek
Грэнада - Grenada
грэх - grzech
Грэцыя - Grecja
грэчаскі - grecki
гук - dźwięk | brzmienie
гулец - gracz | zawodnik
гульня - zabawa | igraszka | mecz | spotkanie | gra | rozgrywka | gra planszowa (настольная гульня)
гульня слоў - gra słów
гуляць - grać (w grę)
гуляць з агнём - igrać z ogniem
гуманізм - humanizm
гусь - gęś
гучны - głośny
гэты - гэты - ten | гэтая (гэта) - ta | гэта (гэтае) - to | гэтыя - ci,te
дабрабыт - dobrobyt
дабранач - dobranoc
дабро - dobro
даваенны - przedwojenny
даваць - даць
давер'е - zaufanie
даверлівасць - ufność | łatwowierność | poufność
даверлівы - ufny | łatwowierny | poufny
даверху - po brzegi
Давід - Dawid
даволі - dosyć | wystarczająco | starczy
дадому - do domu
Дака - Dhaka
даксіцыклін - doksycyklina
дактрынёр - doktryner
дактрынёрскі - doktrynerski
дактрынёрства - doktrynerstwo
дакумент - dokument | papiery | dowód tożsamości
дакументаваць - dokumentować
дакументацыя - dokumentacja
далай-лама - dalajlama
даліна - dolina
далонь - dłoń
дамен - domena
Дамініка - Dominika
Дамініканская Рэспубліка - Dominikana
дамоў - do domu | дом
Данецк - Donieck
Даніл - Daniel
Данія - Dania
дантыст - dentysta
да пабачэння - do widzenia
дармштатый - darmsztadt
дарога - droga
дарослы - dorosły
датчанін - Duńczyk
датчанка - Dunka
Даўгаўпілс - Dyneburg
даўжыня - długość
даўна - dawno
даўні - dawny | stary
дах - dach
дацкі - duński
даць - dać
дачка - córka
два - dwa | 2
двайны - podwójny
дванаццаты - dwunasty
дванаццаць - dwanaście 12
дваццаты - dwudziesty
дваццаць - dwadzieścia 20
двор - podwórko | dwór (majątek) | dwór (monarcha i jego otoczenie)
двудушнасць - dwulicowość
двудушнік - dwulicowiec | obłudnik | hipokryta
двудушны - dwulicowy
джала - żądło
Джыбуты - Dżibuti
дзверы - drzwi
дзвесце - dwieście 200
Дзвіна - Dźwina
дзе - gdzie | gdzieś
Дзева - Panna
дзеватнаццаты - dziewiętnasty
дзевяноста - dziewięćdziesiąt 90
дзевяносты - dziewięćdziesiąty | 90.
дзевятнаццаць - dziewiętnaście 19
дзевяты - dziewiąty
дзевяць - dziewięć 9
дзевяцьсот - dziewięćset 900
дзеепрыметнік - imiesłów przymiotnikowy
дзеепрыслоўе - imiesłów przysłówkowy
дзеля - dla | ze względu (na co) | w imię
дзень - dzień
дзесяцігоддзе - dziesięciolecie (okres dziesięciu lat) | dziesięciolecie (dziesiąta rocznica)
дзесяць - dziesięć
дзеяслоў - czasownik
дзівіць - dziwić | zadziwiać | zaskakiwać
дзірка - dziura
дзірка азонавая - dziura ozonowa
дзіўны - dziwny
дзіцё - dziecko
дзіця - dziecko
дзіцячы сад - przedszkole
дзюна - wydma
дзявяты - dziewiąty
дзядзька - wujek
дзядуля - dziadek
дзякуй - dziękuję
дзяліць шкуру забітага мядзведзя - dzielić skórę na niedźwiedziu
дзяржава - państwo | mocarstwo
дзяржаўны - państwowy
дзясна - dziąsło
дзясяты - dziesiąty | 10.
дзяўчына - dziewczyna
дно - dno
Дняпро - Dniepr
добра - dobrze
добрай раніцы - dzień dobry (używane rano)
добрасумленнасць - sumienność | rzetelność
добрасумленны - sumienny | rzetelny
добры - dobry | działający | miły | przyjacielski | pozytywny
добры вечар - dobry wieczór
добры дзень - dzień dobry
дождж - deszcz | ogrom | mnóstwo
долата - dłuto
дом - dom (budynek mieszkalny) | dom (siedziba placówki o charakterze publicznym)
Дораці - Dorota
досвітак - świt
доўгі - długi
Доха - Ad-Dauha
другая сусветная вайна - druga wojna światowa
другі - drugi | inny
дрыжаць за сваю шкуру - drżeć o swoją skórę | bać się o swoją skórę
дрэва - drzewo
дрэнна - źle | marnie | kiepsko
дрэнны - zły | marny | kiepski
дрэўца - drzewko
дуб - dąb | dębina (materiał)
дубній - dubn
дужы - silny
думаць - myśleć
думка - myśl
Дунай - Dunaj
дурань - dureń | dureń (gra w karty)
душ - prysznic
дуэль - pojedynek (sposób rozwiązania sporu honorowego poprzez walkę na broń białą lub pistolety) | pojedynek (walka, spór toczone między dwoma antagonistami)
дыван - dywan
дыктатура - dyktatura
дым - dym
дымарфізм - dymofrizm
дыпламатычны - dyplomatyczny | rozsądny | nastawiony na osiągnięcie celu
дыскатэка - dyskoteka
дыспрозій - dysproz
дысцыпліна - dyscyplina
дыхаць - oddychać
дыяфрагма - przepona
дэванагары - dewanagari
дэвіз - dewiza | motto
дэзадарант - dezodorant
дэзерцір - dezerter
дэмагагічны - demagogiczny
дэмагог - demagog
дэмагогія - demagogia
дэмаграфічны - demograficzny
дэмаграфія - demografia
дэмакрат - demokrata (zwolennik demokracji) | demokrata (członek lub sympatyk partii noszącej przymiotnik „demokratyczny” w nazwie)
дэмакратызацыя - demokratyzacja
Дэмакратычная Рэспубліка Конга - Demokratyczna Republika Konga
дэмакратычны - demokratyczny
дэмакратыя - demokracja
Дэмакртычая Рэспубліка Конга - Demokratyczna Republika Konga | Zair
дэманстраваць - demonstrować | pokazywać | demonstrować (urządzać demonstrację)
дэманстрацыя - pokaz | demonstracja (czynność pokazywania czegoś) | demonstracja (zbiorowe wystąpienie mające na celu wyrażenie protestu lub poparcia, zwykle głośne lub gwałtowne)
дэменцыя - demencja
дэндралогія - dendrologia
дэрматолаг - dermatolog
Егіпет - Egipt
егіпецкая кара - plaga egipska
егіпецкі - egipski
егіпцянін - Egipcjanin
егіпцянка - Egipcjanka
ездзіць - ехаць
езуіт - jezuita | jezuita (obłudnik)
езуітка - jezuitka (kobieta przebiegła, przewrotna i obłudna)
езуіцкі - jezuicki | jezuicki (przebiegły, przewrotny, obłudny)
Елізавета - Elżbieta (imię żeńskie)
есці - jeść
есьці - jeść
еўра - euro | Euro (impreza sportowa)
еўрапеец - Europejczyk
еўрапейка - Europejka
еўрапейскі - europejski
Еўрапейскі Саюз - Unia Europejska
Еўрасаюз - Unia Europejska
Еўропа - Europa
еўропій - europ
ехаць - jechać | wykorzystywać
ёга - joga | jog
ёд - jod
ёлка - świerk | choinka
ёлуп - jełop
ёмістасць - pojemność | objętość
ёмісты - pojemny | bogaty w treść
ён - on
ёсць - tak jest! | быць   i
жаба - żaba
жалеза - żelazo
жалезны - żelazny (wykonany z żelaza lub zawierający żelazo) | żelazny (dotyczący żelaza) | żelazny (odporny, twardy, niezłomny) | żelazny (ściśle przestrzegany)
Жамойць - Żmudź
жаночы - żeński
жанчына - kobieta
жарт - żart
жнівень - sierpień
жонка - żona
жоўты - żółty
журналістыка - dziennikarstwo
жывёла - zwierzę
жывое серабро - żywe srebro (rtęć)
жывот - brzuch
Жыгімонт - Zygmunt
жыхар - mieszkaniec
жыццё - życie
жыць - żyć | mieszkać
жыць як кошка з сабакам - żyć jak pies z kotem
з - z
заалагічны - zoologiczny
заалагічны парк - ogród zoologiczny
заалогія - zoologia
заапарк - zoo | ogród zoologiczny
заатакаваць - атакаваць
забіць - zabić | uśmiercić | strzelić | wbić | zacząć bić
забяспечваць - забяспечыць
забяспечыць - zapewnić | zaopatrzyć
завод - zakład | fabryka | mechanizm sprężynowy | sprężyna
загадзя - wcześniej
Заграб - Zagrzeb
ЗАГС - urząd stanu cywilnego
задаваленне - szczęście | radość | zadowolenie
задаць - задаваць
задзівіць - дзівіць
задні - tylny | zadni | dalszy
Заір - Demokratyczna Republika Konga | Zair
займацца - zajmować się | uprawiać | robić
займеннік - zaimek
зайсці - zejść | wejść | zajść (od strony) | zajść | zejść (w kartach) | oddać kartę
закапаць сякеру вайны - zakopać topór wojenny
закон - prawo
зал - sala
залаты - złoty
залаціць - pozłacać | oświetlać nadając złoty kolor
заліў - zatoka
заложнік - zakładnik
залп - salwa
замазваць вочы - mydlić oczy
замак - zamek
Замасьць - Zamość
замах - zamach (atak) | zamach (ręką)
Замбія - Zambia
замкавы - zamkowy
запаленне - zapalenie
запісаць - пісаць
запрацаваць - zarobić | zacząć pracować (działać)
запрацоўваць - запрацаваць
запясце - nadgarstek | przegub
зараз - obecnie | teraz
зарплата - wypłata
заснавальнік - założyciel
засцежка - suwak | zamek
засяленне - zaludnienie | zaludnianie
заўжды - zawsze
заўсёды - zawsze
заўтра - jutro
захад - zachód (kierunek) | zachód (zjawisko)
захапленне - zachwyt | zauroczenie | zapał | pobudzenie | zainteresowanie
Захары - Zachariasz
захварэць - хварэць
заходні - zachodni
Заходні Берлін - Berlin Zachodni
зашпіліць - zapiąć
зашпіляць - зашпіліць
збегчы - pobiec | polecieć | zbiec (na dół) | zbiec | uciec | spłynąć | ściec | zniknąć
зборная - drużyna narodowa | reprezentacja
зброя - broń
збягаць - збегчы
зваліцца як снег на галаву - spaść jak grom z jasnego nieba
звер - zwierzę (dzikie) | zwierzę (o człowieku)
звесці канцы з канцамі - wiązać koniec z końcem
звязда - gwiazda
здаровы - zdrowy | korzystny | silny | mocny | część | witaj (, )
здароўе - zdrowie
здарыцца - zdarzyć się | odbyć się
здарэнне - zdarzenie | wydarzenie
здаць - zdać | przekazać | oddać | wynająć (komuś) | poddać | zmniejszyć | osłabić
здзівіць - дзівіць
здзіўляць - дзівіць
здольны - zdolny
здрада - zdrada
здраджваць - zdradzać
здрадзіць - zdradzić
здраднік - zdrajca
здрадніцкі - zdradziecki
землетрасенне - trzęsienie ziemi
земляробства - rolnictwo
земскі - ziemski
з-за - z powodu | przez (kogo, co)
зіма - zima
Зімбабвэ - Zimbabwe
зімні - zimowy
злапамятлівасць - pamiętliwość
злапамятлівы - pamiętliwy
злапамятнасць - pamiętliwość
злапамятны - pamiętliwy
злапомны - pamiętliwy
злачынец - przestępca | złoczyńca
злачыннасць - przestępczość
злачынны - przestępczy
злачынства - przestępstwo
злодзей - złodziej
Злучанае Каралеўства - Zjednoczone Królestwo | Wielka Brytania
Злучаныя Штаты Амерыкі - Stany Zjednoczone Ameryki
змрок - zmrok
змыць галаву - zmyć głowę (skarcić kogoś)
змяненне - zmiana
змярканне - zmierzch
знаёмы - znajomy
знайсці - znaleźć | zastać
знайсці агульную мову - znaleźć wspólny język
знаходзіцца - znajdować się | odszukiwać się | mieścić się
знікаць - znikać | niknąć
знішчальнік - myśliwiec
знішчыць - zepsuć | zniszczyć
зноў - znów
знянацку - niespodziewanie | znienacka | nagle
золак - świt
золата - złoto | wyroby ze złota | złoty medal | o człowieku
зорка - gwiazda | osoba popularna | gwiazda (kształt, symbol)
зрабіць - рабіць
зразумелы - zrozumiały
зразумець - zrozumieć | pojąć
зрэнка - źrenica
з торбай ісці - iść z torbami
зуб - ząb
зусім - całkiem | zupełnie | absolutnie
ЗША - USA
з'ява - zjawisko | odsłona | scena
з'явіцца - з'яўляцца
зялёны - zielony
зялёны чай - zielona herbata
зямля - ziemia | ląd | ziemia (terytorium)
зямны шар - kula ziemska
з'яўляцца - być | pojawiać się
і - i (oraz) | dziesiąta litera białoruskiego alfabetu
іарданец - Jordańczyk
Іарданія - Jordania
іарданка - Jordanka
іарданскі - jordański
ідэалізаваць - idealizować
ідэалізм - idealizm
ідэаліст - idealista (zwolennik idealizmu) | idealista
ідэалістычны - idealistyczny
ідэальны - idealny
ідэйны - ideowy
ідэя - idea | pomysł | myśl | koncept
іерарх - hierarcha
Іерусалім - Jerozolima
Ізраіль - Izrael
ізраільскі - izraelski
ізраільцянін - Izraelczyk
ізраільцянка - Izraelka
імпарт - import | przywóz | wwóz
імпартаваць - importować
імпартны - importowy
імпатэнт - impotent
імпатэнтны - impotentny
імпатэнцыя - impotencja
імператар - imperator | cesarz
імперыя - imperium
імперыялізм - imperializm
імперыяліст - imperialista
імперыялістычны - imperialistyczny
імплікацыйны - implikacyjny
імплікацыя - implikacja
імправізаваць - improwizować
імправізатар - improwizator
імправізатарскі - improwizatorski
імправізацыйны - improwizacyjny
імправізацыя - improwizacja
імпрэсарыё - impresario
імпрэсія - impresja
імпрэсіянізм - impresjonizm
імпрэсіяніст - impresjonista
імпульс - impuls
імпульсіўнасць - impulsywność
імпульсіўны - impulsywny | popędliwy | porywczy | gwałtowny | odruchowy
імуналагічны - immunologiczny
імуналогія - immunologia
імунітэт - odporność | immunitet
імя - imię | nazwa
імяніны - imieniny
імянны - imienny
індаеўрапейскі - indoeuropejski
Індакітай - Indochiny
індакітайскі - indochiński
інданезіец - Indonezyjczyk
інданезійка - Indonezyjka
інданезійскі - indonezyjski
Інданезія - Indonezja
індзеец - Indianin
індзейскі - indiański
індуізм - hinduizm
індуктыўнасць - indukcyjność
індуктыўны - indukcyjny
індукцыя - indukcja
індустрыя - przemysł
індустрыялізаваць - industrializować | uprzemysławiać | zindustrializować | uprzemysłowić
індустрыялізацыя - industrializacja
індустрыяльны - industrialny | przemysłowy
індывідуалізаваць - indywidualizować | zindywidualizować
індывідуалізм - indywidualizm
індывідуаліст - indywidualista
індывідуалістка - indywidualistka
індывідуалістычны - indywidualistyczny
індывідуальнасць - indywidualność | jaźń
індывідуальны - indywidualny (właściwy jednostce, typowy dla konkretnej osoby, swoisty) | indywidualny (przeznaczony do osobistego użytku, znajdujący się w osobistym posiadaniu) | jednostkowy
індывідуум - indywiduum | jednostka | osoba
індый - ind
індыйскі - indyjski
Індыйскі акіян - Ocean Indyjski
індыферэнтнасць - indyferentność
індыферэнтны - indyferentny
індыферэнтызм - indyferentyzm
Індыя - Indie
індыянка - Indianka
інжынер - inżynier
інжынерыя - inżynieria
інстанцыя - instancja
інструктаваць - instruować | poinstruować
інструктаж - instruktaż
інструктар - instruktor
інструктарка - instruktorka
інструктарскі - instruktorski
інструкцыйны - instrukcyjny
інструкцыя - instrukcja
інстытут - instytut
інтрыга - intryga
інтрыгаваць - intrygować
інтрыган - intrygant
інтрыганка - intrygantka
інтрыганскі - intrygancki
інтрыганства - intryganctwo
інтэрнацыяналізм - internacjonalizm
інфаркт - atak serca
інфекцыя - zakażenie | infekcja
інцыдэнт - incydent
інцэст - kazirodztwo
іншаземец - cudzoziemiec
іншы - inny
Ірак - Irak
іракец - Irakijczyk
іракскі - iracki
Іран - Iran
іранец - Irańczyk
іранізаваць - ironizować
іранічны - ironiczny
іранка - Iranka
іранскі - irański
ірачка - Irakijka
ірландзец - Irlandczyk
ірландка - Irlandka
ірландскі - irlandzki
Ірландыя - Irlandia
іронія - ironia
ірыдый - iryd
іслам - islam
ісламізм - islamizm
ісламіст - islamista
ісламістка - islamistka
ісландзец - Islandczyk
ісландка - Islandka
ісландскі - islandzki
Ісландыя - Islandia
існаваць - istnieć
існавенне - istnienie
іспанец - Hiszpan
Іспанія - Hiszpania
іспанка - Hiszpanka | hiszpanka
іспанскі - hiszpański
істота - istota
Ісус - Jezus
Ісус Хрыстос - Jezus Chrystus
ісці - iść | wychodzić za mąż | pasować | jechać | mijać | przemijać | odbywać się | być granym | transmitowanym | wychodzić | padać | być zużytym | toczyć się | ciągnąć się
ісці круглым выдатнікам - uczyć się na samych piątkach
ісці на дно - iść na dno
ісці пад вянок - stanąć na ślubnym kobiercu
ісці поўным ходам - iść pełną parą
ісці ўгару - iść w górę | piąć się w górę
ісці як па масле - iść jak po maśle
Італія - Włochy
італьянец - Włoch
італьянка - Włoszka
італьянскі - włoski
ітрый - itr
ітэрбій - iterb
іўдаізм - judaizm
іхтыялогія - ichtiologia
ішак - osioł
Йемен - Jemen
йеменскі - jemeński
кааліцыя - koalicja
каб - żeby | oby
кава - kawa
каганат - kaganat
кадмій - kadm
каза - koza
казах - Kazach
казахскі - kazachski
Казахстан - Kazachstan
казачны - bajkowy
казашка - Kazaszka
Казярог - Koziorożec
какаін - kokaina
каланізаваць - kolonizować
каланізатар - kolonizator
каланізацыя - kolonizacja
каланіст - kolonista
каланіялізм - kolonializm
каланіяльны - kolonialny
каларыйны - kaloryczny
калектывізаваць - kolektywizować
калектывізацыя - kolektywizacja
калектывізм - kolektywizm
калектывіст - kolektywista
калектывістка - kolektywistka
калектывісцкі - kolektywistyczny
калектыў - kolektyw | zespół | ekipa
калектыўна - kolektywnie
калектыўнасць - kolektywność
калектыўны - kolektywny | zbiorowy
калена - kolano | pokolenie
калі - gdy | jeśli
калідор - korytarz
калій - potas
калійны - potasowy
калі ласка - proszę
калісьці - kiedyś (w przeszłości)
калі трывога, тады да Бога - kiedy trwoga, to do Boga | jak trwoga, to do Boga
каліфарнійскі - kalifornijski
каліфорній - kaliforn
Каліфорнія - Kalifornia
калонія - kolonia | osada
калос на гліняных нагах - kolos na glinianych nogach
калоць - kłuć | bóść | żgać | bić | zabijać (zwierzę) | łupać
Калумб - Kolumb (odkrywca)
калумбійец - Kolumbijczyk
калумбійка - Kolumbijka
калумбійскі - kolumbijski
Калумбія - Kolumbia
кальвінізм - kalwinizm
кальвініст - kalwinista | kalwin
кальвіністка - kalwinistka
кальвінскі - kalwiński | kalwinistyczny
кальцый - wapń
кальцыт - kalcyt
каля - około | obok
каляндар - kalendarz
каляровы - kolorowy
каманда - drużyna
камандзір - dowódca
Камбоджа - Kambodża
каменны - kamienny | z kamienia | skamieniały | zastygły | zdrętwiały | niezłomny
камень - kamień
Камерун - Kamerun
камерунскі - kameruński
камісія - komisja
Каморскія астравы - Komory
кампакт-дыск - płyta CD
камп’ютэр - komputer
камунізм - komunizm
камуніст - komunista
камуністка - komunistka
камуністычны - komunistyczny
камуфляжны - kamuflujący
камфартабельны - komfortowy
камфортны - komfortowy
канавал - konował (człowiek bez przygotowania weterynaryjnego zajmujący się kastrowaniem lub leczeniem koni) | konował (kiepski lekarz)
Канада - Kanada
канадскі - kanadyjski
канал - kanał
кананізаваць - kanonizować
кананізацыя - kanonizacja
канапа - kanapa
кандыцыянер - klimatyzacja
канец - koniec | zakończenie | śmierć | odległość
канікулы - wakacje
каноплі - konopie
кансервавы нож - otwieracz (do puszek)
канстытуцыя - konstytucja
кантрабанда - kontrabanda
кантрабандыст - kontrabandzista | przemytnik
кантрабандыстка - kontrabandzistka | przemytniczka
кантрабас - kontrabas
кантрабасіст - kontrabasista
кантрабасістка - kontrabasistka
кантроль - kontrola
кантынент - kontynent
кантынентальны - kontynentalny
канфармізм - konformizm
канфарміст - konformista
канфармістка - konformistka
канфармісцкі - konformistyczny
канфедэрацыя - konfederacja
канферэнцыя - konferencja
канфлікт - konflikt
канфліктны - konfliktowy (związany z konfliktem) | konfliktowy (mający skłonność do popadania w konflikty)
канцлагер - obóz koncentracyjny
канцэнтрацыйны лагер - obóz koncentracyjny
канцэрт - koncert
канцэртаваць - koncertować
Капенгаген - Kopenhaga
каперніцый - kopernik
капрал - kapral
карабель - statek | okręt
карак - kark
каралева - królowa
каралевіч - królewicz
каралеўна - królewna
каралеўскі - królewski
каралеўства - królestwo
Каран - Koran
Карл - Karol
карова - krowa
каровін - krowi (należący do krowy)
кароль - król
карона - korona
карона з галавы не зваліцца - korona z głowy nie spadnie
кароткі - krótki
Карпаты - Karpaty
карціна - obraz | malunek | widok | film | odsłona
карычневы - brązowy
карэйскі - koreański
Карэя - Korea
касмапаліт - kosmopolita
касмапалітка - kosmopolitka
касмапалітызм - kosmopolityzm
касмапалітычны - kosmopolityczny
кастрычнік - październik
касцёл - kościół
касцюм - garnitur | kostium (dla kobiet) | kostium | strój
Касцюшка - Kościuszko (nazwisko polskie i białoruskie)
каталік - katolik
каталіцкі - katolicki
каталіцызм - katolicyzm
каталічка - katoliczka
Каталонія - Katalonia
каталонскі - kataloński
Катар - Katar
Катманду - Katmandu
катэгорыя - kategoria
каханне - miłość | kochanie
кахаць - kochać
Кацярына - Katarzyna
качацца са смеху - tarzać się ze śmiechu | pokładać się ze śmiechu
качка - kaczka
качканос - dziobak
каша - kasza
кашаль - kaszel
кашляць - kaszleć
кашмар - koszmar
кашуля - koszula
квас - kwas chlebowy
кватэра - mieszkanie
кветка - kwiat
КДБ - KGB (Камітэт Дзяржаўнай Бяспекі)
кенійскі - kenijski
Кенія - Kenia
Кёльн - Kolonia
ківі - kiwi
ківун - palec wskazujący
кідаць словы на вецер - rzucać słowa na wiatr
Кіеў - Kijów
кіеўскі - kijowski
кіламетр - kilometr
кіно - kino
кіношны - kinowy
Кіпр - Cypr
кіраванне - kierowanie
кіраваць - kierować | zarządzać | administrować
кіраўнік - kierownik
кіргізскі - kirgiski
кіроўца - kierowca
кісларод - tlen
кіслародны - tlenowy
кіслы - kwaśny
кітаец - Chińczyk
Кітай - Chiny
кітайка - kitajka (cienka, jedwabna tkanina pochodzenia wschodniego) | Chinka
кітайская мова - język chiński
кітайскі - chiński
кітаянка - Chinka
кішка - jelito
Кішынёў - Kiszyniów
клавіш - klawisz
клавіша - klawisz
клавіятура - klawiatura
клаксан - klakson
кларнет - klarnet
класіфікаваць - klasyfikować
класіфікацыя - klasyfikacja
класіцызм - klasycyzm
класічны - klasyczny
клей - klej
клейкасць - lepkość
клейкі - kleisty | lepki
клептаман - kleptoman
клептаманія - kleptomania
клептаманка - kleptomanka
клерыкал - klerykał
клерыкалізм - klerykalizm
клерыкальны - klerykalny
клетка - komórka | kratka | klatka
клеткавыя мембраны - błona komórkowa
кліент - klient
кліентка - klientka
кліка - klika
клімат - klimat | atmosfera
кліматычны - klimatyczny
клініка - klinika
клінічны - kliniczny
клоун - klaun | klown
клуб - klub
клубніца - truskawka
ключнік - klucznik
ключніца - klucznica
ключык - kluczyk
ключыца - obojczyk
клятвапарушальнік - krzywoprzysięzca
клятвапарушэнне - krzywoprzysięstwo
кляштар - klasztor
кляштарны - klasztorny
км - km = kilometr
кніга - książka
кнігарня - księgarnia
кніжка - książka
кніжны - książkowy
кніжны магазін - księgarnia
княгіня - kniahini | księżna
княжацкі - kniaziowski | książęcy
княжыч - kniaziewicz | syn kniazia
князёўна - kniaziówna | córka kniazia
князь - książę | wysoki tytuł szlachecki
княства - księstwo
кобальт - kobalt
кодэкс - kodeks
кожны - każdy
козыр - atut
колер - kolor
комік - komik
Конга - Kongo | Republika Konga
конская сіла - koń mechaniczny
конскі - koński
конь - koń
Косава - Kosowo
космас - kosmos
Коста-Рыка - Kostaryka
косць - kość
кот - kot
Кот-д'Івуар - Wybrzeże Kości Słoniowej
кошка - kotka
кошт - koszt
краіна - państwo
Краіна Баскаў - Kraj Basków
крама - sklep
красавацца - kwitnąć | być w widocznym miejscu
красаваць - kwitnąć
красавік - kwiecień
краска - kwiat
красці - kraść
кровазварот - krwiobieg
кровазліццё - wylew
кроватачыць - krwawić
кроў - krew
круг - kółko
круглы - okrągły | całkowity | cały | zupełny | kompletny
крывадушнасць - hipokryzja | obłuda
крывадушнік - obłudnik | hipokryta
крывадушны - obłudny
крыважэрны - żądny krwi
крывацёк - krwotok
крывяносная сістэма - układ krwionośny
крывяносны - krwionośny
крыжовы паход - wyprawa krzyżowa | krucjata
крызіс - kryzys
крыптон - krypton
Крыстафер - Krzysztof
Крыт - Kreta
крэдытная картка - karta kredytowa
крэмній - krzem
крэпасць - twierdza | cytadela
крэсла - fotel
ксенафілія - ksenofilia
ксенафоб - ksenofob
ксенафобія - ksenofobia
ксенафобскі - ksenofobiczny
ксёндз - ksiądz katolicki
Куба - Kuba
кубізм - kubizm
Кувейт - Kuwejt
кудысьці - dokądś | gdzieś
кулак - pięść
культура - kultura
культурны - kulturalny | kulturowy
куля - kula
кулямёт - karabin
куніца - kuna
купальны - kąpielowy
купіць - kupić
купляць - купіць
курва - prostytutka | kurwa
курсіраваць - kursować
кусок - kawałek
кухня - kuchnia
Кыргызстан - Kirgistan
кюрый - kiur
лабавы - czołowy
лабараторны - laboratoryjny
лабараторыя - laboratorium
Лабрадор - Labrador
лаванда - lawenda
лагер - obóz
лагічны - logiczny
Ла-Манш - La Manche (kanał)
ламаць галаву - łamać sobie głowę
ландшафт - krajobraz
лантан - lantan
лантаноід - lantanowiec
Лаос - Laos
лапата - łopata
Лапландыя - Laponia
ластаўка - jaskółka
Латвія - Łotwa
латыш - Łotysz
латышка - Łotyszka
латышскі - łotewski
лаўрэнсій - lorens
лацінаамерыканец - Latynoamerykanin
лацінаамерыканка - Latynoamerykanka
лацінаамерыканскі - latynoamerykański
Лацінская Амерыка - Ameryka Łacińska
Лацыё - Lacjum
лебедзь - łabędź
левы - lewy
легалізацыя - legalizacja
легальнасць - legalność
легальны - legalny
легенда - legenda
легендарны - legendarny
легкадумнасць - lekkomyślność
легкадумны - lekkomyślny
лекар - lekarz
лексікаграфічны - leksykograficzny
лексікаграфія - leksykografia
лексікалогія - leksykologia
лепш з разумным згубіць, чым з дурнем знайсці - lepiej z mądrym zgubić, niż z głupim znaleźć
лепш сініца ў руках, чым журавель у небе - lepszy wróbel w garści niż gołąb na dachu | lepsza sikorka w rękach | niż żuraw na niebie
лес - las
лесаруб - drwal
лесбіянка - lesbijka
Лесота - Lesotho
лета - lato
летапіс - latopis | staroruski rocznik dziejopisarski
летась - w zeszłym roku
Леў - Lew
лёгкае - płuco
лёгкі - lekki | łatwy
Ліберыя - Liberia
Ліван - Liban
ліверморый - liwermor
Лівія - Libia
ліга - liga
Ліда - Lida
лідэр - lider | przywódca
лік - wynik | liczba | ilość
ліманад - limoniada
лімналогія - limnologia
лімон - cytryna
лінгвіст - lingwista
лінгвістка - lingwistka
лінгвістыка - lingwistyka
лінгвістычны - lingwistyczny
лінія - linia
ліпень - lipiec
Лісабон - Lizbona
ліст - list | liść
лістапа́д - listopad
літаратура - literatura
літаратурны - literacki
літаратурны парабак - murzyn | ghostwriter (człowiek, który za pieniądze, anonimowo pisze jakieś utwory literackie)
Літва - Litwa
літвін - Litwin (mieszkaniec Wielkiego Księstwa Litewskiego)
літовец - Litwin
літоўскі - litewski
літый - lit
Ліхтэнштэйн - Lichtenstein
ліцвін - літвін
ліць - lać | wlewać | mocno ciec | padać | odlewać
ліцэнзія - licencja
лічба - liczba
лічэбнік - liczebnik
логіка - logika
ложак - łóżko
локаць - łokieć
Лондан - Londyn
Луара - Loara
Луізіана - Luizjana
Лхаса - Lhasa
лыжка - łyżka
лытка - łydka
Львоў - Lwów
любімы - ulubiony | kochany
любіць - kochać | lubić | mieć potrzebę
любоў - miłość
людзі - ludzie
людны - ludny
Люксембург - Luksemburg
люты - luty | mroźny | ostry | bezlitosny
лютэранства - luteranizm
лютэцый - lutet
ляжаць - leżeć | znajdować się | być
лякарства - lekarstwo
лянівы - leniwy
мааізм - maoizm
мааіст - maoista
мааісцкі - maoistowski
мабільнік - komórka | telefon komórkowy
магазін - sklep | magazynek
магіла - grób | mogiła
Магілёў - Mohylew
магічны - magiczny
магній - magnez
магчы - móc
магчымасць - możliwość
Мадагаскар - Madagaskar
Мадрыд - Madryt
маёмасны - majątkowy
Мазамбік - Mozambik (państwo)
Мазовія - Mazowsze
май - maj
Македонія - Macedonia
македонскі - macedoński
макіявелеўскі - makiaweliczny | machiaweliczny | makiawelski
макіявелізм - makiawelizm (polityka zgodna z zasadą, że „cel uświęca środki”) | makiawelizm (postępowanie przewrotne i perfidne)
макіявеліст - makiawelista
малаважны - błahy
Малаві - Malawi
маладзёжная турбаза - schronisko młodzieżowe
маладушнасць - małoduszność (brak odwagi, hartu ducha, wiary i zdecydowania)
маладушны - małoduszny (pozbawiony odwagi, hartu ducha, wiary i zdecydowania)
малады - młody | państwo młodzi
Малайзія - Malezja
малако - mleko
Малдова - Mołdawia
маленькі - mały
Малі - Mali
малібдэн - molibden
малібдэніт - molibdenit
малітва - modlitwa
малы - mały | niewielki
Мальдывы - Malediwy
Мальта - Malta
Манака - Monako
манарх - monarcha
манархізм - monarchizm
манархіст - monarchista
манархістка - monarchistka
манархія - monarchia
манастыр - monastyr | klasztor
манастырскі - klasztorny
манатэізм - monoteizm
Манблан - Mont Blanc
манга - mango
Манголія - Mongolia
мангольскі - mongolski
манета - moneta
манія - mania
мантра - mantra
мара - marzenie
марганец - mangan
Маргарыта - Małgorzata
мароз - mróz
Марока - Maroko
марскі - morski
марскі воўк - wilk morski
Марта - Marta | imię żeńskie
марфалагічны - morfologiczny
марфалогія - morfologia
Марцін - Marcin
Марыя - Maria | imię żeńskie
Масква - Moskwa
масляк - maślak
мастак - artysta
мастацтва - sztuka | artyzm
Масты - Mosty
матка - macica
матч - mecz
матыка - motyka
матылёк - motyl
матэматычны аналіз - analiza matematyczna
матэрыял - materiał
матэрыялістычны - materialistyczny
Маўрыкій - Mauritius
Маўрытанія - Mauretania
маці - matka
мацярык - kontynent
машонка - moszna
машына - pralka
медзь - miedź
медны - miedziany | miedziowy
межаваць - graniczyć
мейтнерый - meitner
Мексіка - Meksyk
мексіканскі - meksykański
мелодыя - melodia
мендзялевій - mendelew
меркаванне - przypuszczenie
мерыдыян - południk
Месапатамія - Mezopotamia
месяц - miesiąc | księżyc
метабалізм - metabolizm
метал - metal
металічны - metalowy | metaliczny
метан - metan
метр - metr
метэарыт - meteoryt
Мехіка - Meksyk
мець - mieć | posiadać
мець галаву на плечах - mieć głowę na karku
мець мухі ў носе - mieć muchy w nosie
меч - miecz
мёртвы - martwy
Міжземнае мора - Morze Śródziemne
міжнародны - międzynarodowy
Мікалай - Mikołaj
мікалогія - mykologia | mikologia
мікарыза - mikoryza
мікрабіялогія - mikrobiologia
міліцыя - milicja
мільён - milion
мімавольны - mimowolny
мінамёт - moździerz
мінерал - minerał
міністр - minister
Мінск - Mińsk
мінскі - miński
мінулы - zeszły | miniony
мір - pokój | spokój
мірмекалогія - myrmekologia
мітынг - miting | spotkanie
Міхаіл - Michał
многа - wiele
мова - język
мовазнавец - językoznawca
мовазнаўства - językoznawstwo
мовазнаўца - językoznawca
мовазнаўчы - językoznawczy
мода - moda
мозг - mózg
мой - mój
моладзь - młodzież
монатэістка - monoteistka
монацукрыд - monosacharyd
мора - morze
мост - most | mostek | most (w samochodzie)
моцны - mocny | silny
мужчына - mężczyzna
мужчынскі - męski
музей - muzeum
музыка - muzyka
мундзір - mundur
мусульманін - muzułmanin
мусульманскі - muzułmański
мухамор - muchomor
мухамор пантэрны - muchomor plamisty
мухамор чырвоны - muchomor czerwony
мы - my
мыла - mydło
мышца - mięsień
мыш'як - arsen
мэлятанін - melatonina
мядзведзь - niedźwiedź
мядовы месяц - miodowy miesiąc
мяжа - granica
М'янмар - Birma
мясцовы - miejscowy
мяцеж - bunt
мяцежнасць - buntowniczość
мяцежнік - buntownik
мяцежніца - buntowniczka
мяцежны - buntowniczy
на - w | na | o | masz!
набелій - nobel
Навагрудак - Nowogródek
на вагу золата - na wagę złota
навальніца - nawałnica | niebezpieczeństwo
нават - nawet
наверсе - na górze
навобмацак - po omacku
навокал - wokół
навошта - po co
навука - nauka
навуковы - naukowy
навучыцца - вучыцца
нага - noga | podpora
надвор'е - pogoda
Надзея - Nadzieja
надкаленнік - rzepka
надта - zbyt
надыход - nadejście
наесціся - najeść się
назаўсёды - na zawsze
назва - nazwa | pozycja (książka w bibliotece)
назіральнік - obserwator
назіраць - obserwować | pilnować
на злодзеі шапка гарыць - na złodzieju czapka gore
на злом галавы - na łeb na szyję
назоўнік - rzeczownik | mianownik
наіўнасць - naiwność
наіўны - naiwny
налета - w przyszłym roku
наліваць - наліць
наліць - nalać
Намібія - Namibia
наперакор - na przekór
напісаць - пісаць
напой - napój
на поўных парусах - na pełnych żaglach
напрыклад - na przykład
Нарач - Narocz
Нарвегія - Norwegia
нарвежац - Norweg
нарвежка - Norweżka
Нарвежскае мора - Morze Norweskie
нарвежскі - norweski
наркоз - narkoza
нармалізаваць - normalizować
нармалізацыя - normalizacja
нармальнасць - normalność
нармальны - normalny
нарматыў - normatyw
нарматыўны - normatywny
народ - naród
нарцыс - narcyz
нарэшце - nareszcie | wreszcie
насельніцтва - ludność
насенны - nasienny
насеньне - nasienie
насмарк - katar
настаўніца - nauczycielka
натрый - sód
натура - natura | przyroda | charakter
натуралізаваць - naturalizować
натуралізм - naturalizm
натураліст - naturalista
натуралістка - naturalistka
натуралістычны - naturalistyczny
натуральнасць - naturalność
натуральны - naturalny
нафта - ropa naftowa
нафталін - naftalen
нацызм - nazizm
нацыст - nazista
нацыяналізаваць - nacjonalizować | upaństwawiać | unaradawiać
нацыяналізацыя - nacjonalizacja
нацыяналізм - nacjonalizm
нацыяналіст - nacjonalista
нацыяналістка - nacjonalistka
нацыяналістычны - nacjonalistyczny
нацыянальны - narodowy | państwowy
начаваць - nocować
начальнік - kierownik | przełożony
начальства - kierownictwo | szefostwo | naczalstwo | wierchuszka (zespół ludzi sprawujących władzę) | kierowanie | zwierzchność | zwierzchnictwo (sprawowanie władzy, czynność kierowania kimś lub czymś) | szef
начальстваванне - kierowanie | szefowanie | zarządzanie | zwierzchność | zwierzchnictwo (sprawowanie władzy, czynność kierowania kimś lub czymś)
начальстваваць - kierować | szefować
начны - nocny
нашэсце - najazd
неабарачальны - niewymienny | bezpowrotny
неадым - neodym
неба - niebo
небяспечны - niebezpieczny
невялікі - niewielki | nieduży
негр - Murzyn
негрыцянка - Murzynka
негрыцянскі - murzyński
недатыкальнасць - nietykalność
недатыкальны - nietykalny
незалежнасць - niezależność | niepodległość
незалежны - niezależny | niepodległy
нейтралітэт - neutralność
нейтральны - neutralny
некалькі - kilka
некаторы - niektóry
не кіем дык палкай - nie kijem (go), to pałką
некультурны - niekulturalny
немец - Niemiec
немка - Niemka
не на жыццё, а на смерць - na śmierć i życie
ненарматыўны - nienormatywny
Непал - Nepal (państwo)
неплацежаздольнасць - niewypłacalność
нептуній - neptun
нерэнтабельны - nieopłacalny
неспадзяваны - niespodziewany
неўролаг - neurolog
Неферціці - Nefertiti
нечаканы - nieoczekiwany | niespodziewany | nagły
Нёман - Niemen
Нігер - Niger (państwo) | Niger (rzeka)
Нігерыя - Nigeria
нігілізм - nihilizm
нігіліст - nihilista
нідзе - nigdzie
нідэрландзец - Holender
нідэрландка - Holenderka
Нідэрланды - Niderlandy | Holandia
ні за якія грошы - za żadne pieniądze | za żadne skarby | za żadne skarby świata
нізкі - niski | słaby | podły | ніжэй найніжэй
Нікарагуа - Nikaragua
нікацін - nikotyna
ніобій - niob
Ніца - Nicea
новы - nowy
нож - nóż
нонканфармізм - nonkonformizm
нонканфарміст - nonkonformista
нонканфармістка - nonkonformistka
нонканфармісцкі - nonkonformistyczny
нос - nos
ноч - noc
ноччу - w nocy | nocą
нырка - nerka
Нью-Йорк - Nowy Jork
няважны - nieważny
нядзеля - niedziela
нямецкі - niemiecki
Нямеччына - Niemcy
няплоднасць - niepłodność
Нясвіж - Nieśwież
няўдзячнасць - niewdzięczność
няўдзячны - niewdzięczny
няшчасце - nieszczęście
Одра - Odra
Одэр - Odra
опера - opera
орган - narząd | organ
Орхус - Aarhus (miasto w Danii)
Орша - Orsza
Осла - Oslo
осмій - osm
па - według | zgodnie | na podstawie | pod względem | po | przez | z | z powodu | na skutek | w | za
паабапал - po obydwu stronach
паазер'е - pojezierze
паведаміць - poinformować | zawiadomić
павека - powieka
павесіць нос на квінту - spuścić nos na kwintę
паветра - powietrze
паветраны - powietrzny
паводзіны - zachowanie
павольны - powolny
павук - pająk
павялічвацца - павялічыцца
павялічыцца - powiększyć się | zwiększyć się | wzrosnąć
павялічыць - zwiększyć
пагадненне - porozumienie | umowa
паглядзець - глядзець
пагода - pogoda
пагодлівы - pogodny
пагодны - pogodny
пагранічны - graniczny | pograniczny
пад - pod
падабацца - podobać się
падарожжа - podróż
падатрад - podrząd
падземны - podziemny
падзея - wydarzenie
падказаць - podpowiedzieć
падказваць - падказаць
паднябенне - podniebienie
падпаха - pacha
падпольны - podziemny | konspiracyjny
падстраўнікавая залоза - trzustka
падчас - podczas
падыходзіць - podchodzić
падэшва - podeszwa | podnóże
паехаць - pojechać
пажадлівасць - pożądliwość
пажадлівы - pożądliwy
пажар - pożar
пажарная каманда - straż pożarna
пажарнік - strażak
пажарны - pożarowy | pożarny | pożarniczy | strażacki | przeciwpożarowy | strażak
пазалаціць - залаціць
пазаўчора - przedwczoraj
пазашлюбны - pozamałżeński
пазбегнуць - пазбягаць
пазбягаць - unikać | stronić | pozbiegać | zbiec (na dół) | pouciekać | uciec
пазваночнік - kręgosłup
паздаравець - здаравець
пазітывізм - pozytywizm
пазітыўны - pozytywny
пазнаёміць - przedstawić
пазногаць - paznokieć
пайсці - pójść
пайсці пад вянец - stanąć na ślubnym kobiercu
пайшоў на хуй - spierdalaj | idź w pizdu
пакаванне - opakowanie
паказ - pokaz
паказаць - pokazać
паказвацца - паказацца
Пакістан - Pakistan
пакой - pokój
пакорлівасць - pokora
пакупка - zakup | kupiona rzecz
палавіна - połowa | połówka
паладый - pallad
паланізацыя - polonizacja
палац - pałac
палеаграфія - paleografia
палеаліт - paleolit
палеанталогія - paleontologia
палеміка - polemika
палемічны - polemiczny
палестра - palestra
палец - palec
паліандрыя - poliandria
паліграфія - poligrafia
паліндром - palindrom
палітык - polityk
палітыка - polityka
палітычны - polityczny | uprzejmy | polityczny (dobrze wychowany, potrafiący właściwie się zachować)
паліхромія - polichromia
паліца - półka | kuszetka
паліэдр - wielościan
палкоўнік - pułkownik
палоній - polon
пальцам не крануць - palcem nie kiwnąć
пальчатка - rękawica
паляванне - polowanie
паляк - Polak
памагаць - pomagać
памадка - pomadka
памерці - umrzeć (паміраць)
памерці пад нажом - umrzeć pod nożem
паміж - pomiędzy | między
паміраць з рогату - umierać ze śmiechu
паміраць са смеху - umierać ze śmiechu
памылка - pomyłka | omyłka | błąd
памылковы - pomyłkowy | błędny | mylny
памяркоўнасць - tolerancja
памяркоўны - tolerancyjny
памяць - pamięć (zdolność umysłu do zapamiętywania) | pamięć (fakt zachowania informacji, możliwość przypominania sobie) | pamięć
Панама - Panama
панамец - Panamczyk
панамскі - panamski
пандэмія - pandemia
пансіянат - pensjonat
пантон - ponton
пантонны - pontonowy
пантэізм - panteizm
паншчына - pańszczyzna
панядзелак - poniedziałek
папа рымскі - papież
паплаціць жыццём - zapłacić życiem
папрасіць - прасіць
папугай - papuga
пара - pora | czas
Парагвай - Paragwaj
паралель - równoleżnik
параўнальны - porównawczy | porównywalny
параўнанне - porównanie | zestawienie
парк - park | zajezdnia
парламенцкі - parlamentarny
парна-бізнес - pornobiznes
парнаграфічны - pornograficzny
парнаграфія - pornografia
парніковы эфект - efekt cieplarniany
партугалец - Portugalczyk
Партугалія - Portugalia
партугалька - Portugalka
партугальскі - portugalski
партызан - partyzant
партыя - partia
парус - żagiel
пасажыр - pasażer
пасажырскі - pasażerski
паслухаць - слухаць
пасля - po
пасляваенны - powojenny
паслядоўнік - wyznawca | uczeń | zwolennik
паслязаўтра - pojutrze
паступовы - stopniowy
паток - strumień
патрон - nabój | patron
патрыёт - patriota
патрыётка - patriotka
патрымаць - трымаць
патрыятызм - patriotyzm
патрыятычны - patriotyczny
патрэбен - potrzebny
патрэбен як у мосце дзірка - potrzebny jak dziura w moście
паўвостраў - półwysep
паўднёваамерыканскі - południowoamerykański
Паўднёва-Афрыканская Рэспубліка - Republika Południowej Afryki
Паўднёвая Амерыка - Ameryka Południowa
Паўднёвая Карэя - Korea Południowa
паўднёвы - południowy
паўночнаамерыканскі - północnoamerykański
Паўночнае мора - Morze Północne
Паўночная Амерыка - Ameryka Północna
Паўночная Ірландыя - Irlandia Północna
паўночны - północny
паўстанец - powstaniec
паўстанне - powstanie
паўстанцкі - powstańczy
паха - pacha
пахмелле - kac
пахнуць - pachnieć
пацалаваць клямку - pocałować klamkę
пацалунак - pocałunek
пацук - szczur
пацыент - pacjent
пачатак - początek
пачацца - zacząć się
пачаць - rozpocząć
пачуццёвы - odczuwalny | wyczuwalny
пачуццё гумару - poczucie humoru
пашпарт - paszport
паявіцца - pojawić się
паяўляцца - паявіцца
педант - pedant
педантызм - pedantyzm
педантычны - pedantyczny
педафіл - pedofil
педафілія - pedofilia
пеніцылін - penicylina
перагаворы - negocjacje | rokowania
перад - przed | wobec | przód
перадапошні - przedostatni
перадплечча - przedramię
перайсці - przejść | przekroczyć | zmienić | przejść (na kogoś) | otrzymać | zmienić się w (coś)
пералом - złamanie
перамагчы - pokonać | zwyciężyć
перамога - zwycięstwo
пераможца - zwycięzca
пераначаваць - начаваць
пераходзіць - перайсці
персідскі - perski
Перу - Peru
першая ластаўка вясны не робіць - jedna jaskółka wiosny nie czyni
першая сусветная вайна - pierwsza wojna światowa
першы - pierwszy
першы шпак вясны не робіць - jedna jaskółka wiosny nie czyni
перыяд - okres
п'еса - przedstawienie | spektakl
Петэр - Piotr | imię męskie
печань - wątroba
печка - piec
піва - piwo
півавар - piwowar
піваварэнне - warzenie piwa | piwowarstwo
пік - szczyt | wierzchołek | szczyt (możliwości)
пікнік - piknik
Піліп - Filip (imię męskie)
Пінск - Pińsk
пісаць - pisać | zwracać się na piśmie | informować (o gazetach) | malować
пісталет - pistolet
пісьмо - list | pisanie | zdolność pisania | pismo | alfabet
Пітсбург - Pittsburgh (stolica Allegheny)
піца - pizza
піць - pić
плаваць як сыр у масле - żyć jak pączek w maśle
плакаць - płakać
планета - planeta
пластмасавы - plastikowy
плацежаздольнасць - wypłacalność
плаціна - platyna
плацінавы - platynowy
плацінавы метал - platynowiec
плаціць - płacić
плацэнта - łożysko
племя - plemię | plemię (pokolenie, potomstwo, ród)
плод - owoc
плошча - plac
плутоній - pluton
пляж - plaża
пляжны - plażowy
плячо - ramię
пнеўмалогія - pneumonologia
поезд - pociąg
Полацк - Połock
поле - pole | margines | tło | rondo (kapelusza) | boisko (piłkarskie)
політэізм - politeizm
польскі - polski | polski (język)
Польшча - Polska
полюс - biegun
порт - port
поспех - sukces | powodzenie | osiągnięcie
посуд - naczynia
потым - potem
поўдзень - południe (kierunek) | południe (pora dnia)
поўнач - północ (kierunek) | północ (pora dnia)
поўны - pełny
похва - pochwa
пошук - poszukiwanie
пояс - pas
прабачце - przepraszam
праблема - problem
правадыр - wódz | przywódca
праваслаўе - prawosławie
праваслаўны - prawosławny
правесці - spędzić | przeprowadzić | poprowadzić | wyznaczyć | wykonać | odprowadzić | pogładzić | przesunąć
праводзіць - правесці
правы - prawy | prawy (który ma rację)
Прага - Praga
прагестэрон - progesteron
прагматык - pragmatyk
прагматыка - pragmatyka
прагматычны - pragmatyczny
праграма - program
праграміст - programista
прадаваць - прадаць
прадукт - produkt | wyrób | прадукты produkty żywnościowe
прадукцыя - produkcja
прадухіленне - ostrzeżenie
праект - projekt
пражываць - zamieszkiwać | mieszkać
празеадым - prazeodym
прайсці - przejść | odbyć się | obejść | pojawić się | przelecieć | spaść (o opadach atmosferycznych) | minąć | zmieścić się | odbyć
практыкаванне - ćwiczenie
практычны - praktyczny
праметый - promet
прамысловасць - przemysł
прапан - propan
прапаршчык - chorąży
прасіць - prosić
прасіць рукі - prosić o rękę
праслухаць - слухаць
прастадушнасць - prostoduszność
прастадушны - prostoduszny
прастытутка - prostytutka | prostytutka (człowiek sprzedajny)
прастытуцыя - prostytucja
пратактыній - protaktyn
пратэктар - protektor
пратэктарат - protektorat
пратэктарка - protektorka
пратэкцыя - protekcja
пратэкцыянізм - protekcjonizm
пратэкцыянісцкі - protekcjonistyczny
пратэст - sprzeciw | protest
пратэставаць - protestować
пратэстант - protestant
пратэстантка - protestantka
пратэстантызм - protestantyzm
пратэстанцкі - protestancki
пратэстанцтва - protestantyzm
праў - правы
праўда - prawda
праўда вочы коле - prawda w oczy kole
праўдападобнасць - prawdopodobieństwo
праўдападобны - prawdopodobny
праўдзівы - prawdziwy
прафесар - profesor
праходзіць - прайсці
праца - praca | praca (działalność)
працавацца - pracować (się)
працаваць - pracować | zajmować się pracą | działać | być otwartym (o sklepach)
працавік - pracuś | bardzo staranny | pracowity człowiek
працавітасць - pracowitość
працавіты - pracowity
працадаўца - pracodawca
працаёмкасць - pracochłonność | nakłady pracy
працаёмкі - wymagający dużych nakładów pracy | pracochłonny
працаздольны - zdolny do pracy
працалюбівы - lubiący pracować
працатэрапеўтычны - jaki leczy pracą
працатэрапія - leczenie pracą | procesami pracy
працаўладкаванне - zatrudnienie | zatrudnianie
працаўладкаваны - zatrudniony
працаўладкавацца - zatrudnić się | znaleźć pracę
працаўладкаваць - zatrudnić
працаўладкоўвацца - працаўладкавацца
працаўладкоўваць - працаўладкаваць
працаўнік - pracownik | robotnik
працоўны - pracujący | robotniczy
працэс - proces | proces sądowy
працягласць - długość
прачытаць - чытаць
представлявам - przedstawiać
проста - po prostu | prosto
проста з моста - prosto z mostu (bezpośrednio) | ni z tego, ni z owego (nagle, niespodziewanie)
просты - prosty | nie krzywy | nieskomplikowany | zwykły | naiwny | niekulturalny
проціпажарны - przeciwpożarowy
прыбытак - zysk
прыватна - prywatnie
прыватнік - prywaciarz
прыватніцкі - prywaciarski
прыватны - prywatny
прыватызацыя - prywatyzacja
прывесці - przyprowadzić | zaprowadzić | doprowadzić | wprawić | przytoczyć
прывітанне - cześć
прывітаньне - przywitanie
прыводзіць - прывесці
прыгажосць - piękno | piękność
прыгожа - pięknie | ładnie
прыгожы - piękny
прыехаць - przyjechać
прыёмны пакой - izba przyjęć
прызыў у армію - powołanie do służby wojskowej
прыйсці - przyjść | nastać | dojść (do siebie) | wpaść
прыкладна - około | mniej więcej | w przybliżeniu
прыляцець - przylecieć
прыметнік - przymiotnik
прыназоўнік - przyimek
прыпынак - przystanek | odpoczynek | przytułek | przystań
прырода - przyroda | natura
прыродны - naturalny | wrodzony | rodowity | przyrodniczy
прыродны газ - gaz ziemny
прыслоўе - przysłówek
прыткі - szybki | szybko
прыток - dopływ | przypływ
прычына - przyczyna | powód
прыяцель - przyjaciel
прэзерватыў - prezerwatywa
прэзідэнт - prezydent | prezes
прэтэнзія - pretensja
прэтэнцыёзны - pretensjonalny
псіхалагічны - psychologiczny
псіхалогія - psychologia
псіхапат - psychopata
псіхапаталагічны - psychopatologiczny
псіхапаталогія - psychopatologia
псіхапатычны - psychopatyczny
псіхапатыя - psychopatia
псіхатычны - psychotyczny
псіхатэрапеўт - psychoterapeuta
псіхатэрапія - psychoterapia
псіхіка - psychika
псіхічны - psychiczny
псіхіятр - psychiatra
псіхіятрычны - psychiatryczny
псіхіятрыя - psychiatria
псіхоз - psychoza
псіхолаг - psycholog
птушка - ptak
публічны дом - dom publiczny
пульманалагічны - pulmonologiczny
пульманалогія - pulmonologia
пульманолаг - pulmonolog
пульс - puls | tętno
пунктуальнасць - punktualność
пунктуальны - punktualny
пупок - pępek
пурпурны - purpurowy
пурызм - puryzm
пурыст - purysta
пурытанін - purytanin
пурытанскі - purytański | purytański (surowy pod względem obyczajowym i moralnym)
пурытанства - purytanizm | purytanizm (surowa moralność i obyczajowość)
пускаць словы на вецер - rzucać słowa na wiatr
пустаслоўе - pustosłowie
пустыня - pustynia
Пуэрта-Рыка - Portoryko
Пхеньян - Pjongjang
пчала - pszczoła
пшаніца - pszenica
пытанне - pytanie | kwestia
пякарня - piekarnia
п'яны - pijany
пястук - kciuk
пята - pięta
пятнаццаты - piętnasty
пятнаццаць - piętnaście 15
пятніца - piątek
пяты - piąty
пяхота - piechota
пяцёрка - piątka
пяціканцовы - pięcioramienny
пяць - pięć 5
пяцьдзесят - pięćdziesiąt 50
пяцьсот - pięćset 500
пячора - jasknia
рабіна - jarzębina
рабіннік - kwiczoł
рабіць - robić | pracować | harować
рабіць вясёлую міну пры дрэннай гульні - robić dobrą minę do złej gry
рабіць з мухі слана - robić z muchy słonia | robić z igły widły
рабіць як чорны вол - harować jak wół
работа - robota | praca
работнік - robotnik
рабро - żebro
равеснік - rówieśnik
радавы - szeregowy
радасць - radość
раджацца - urodzić się
радзіма - ojczyzna
радзіцца - urodzić się
радон - radon
радыеактыўнасць - radioaktywność
радыеактыўны - radioaktywny
радый - rad
разам - razem | wspólnie | w tym samym czasie | za jednym razem | podsumowując
развівацца - rozwijać się
развіцца - развівацца
развіццё - rozwój
размаўляць - rozmawiać
Рак - Rak | ♋
рака - rzeka
ракако - rokoko
раман - powieść | romans
рана - rana | wcześnie | rankiem
раней - wcześniej | kiedyś | najpierw | przed czasem
раніца - poranek
ранні - wczesny
раптоўна - nagle
раптоўны - nagły | niespodziewany | raptowny | gwałtowny
Расійская Федэрацыя - Federacja Rosyjska
расійскі - rosyjski
Расія - Rosja
расіянін - Rosjanin (obywatel Rosji)
расіянка - Rosjanka (obywatelka Rosji)
расліна - roślina
расліннасць - roślinność
раслінны - roślinny
распуснік - rozpustnik
расці - rosnąć | zwiększać się
расцягнуты - rozciągnięty | ciągnący się
раўніна - równina
рачны - rzeczny
рашэнне - decyzja
РНК - RNA
родная мова - język ojczysty
родый - rod
рознічны - detaliczny
розны - różny
розум - rozum
ром - rum
рот - usta | gęba
рота - kompania
ртуць - rtęć
Руанда - Rwanda
рубель - rubel
рубідый - rubid
ружовы - różowy
рука - ręka
румын - Rumun
Румынія - Rumunia
румынка - Rumunka
румынскі - rumuński
Рур - Ruhra
руская мова - język rosyjski
рускі - rosyjski | Rosjanin (człowiek narodowości rosyjskiej)
рутэній - ruten
рух - ruch
рухавік - silnik
рыба - ryba
Рыбы - Ryby | ♓
Рым - Rzym
рымскі - rzymski
Рыо-дэ-Жанейра - Rio de Janeiro
рыс - ryż
рыцар - rycerz
Рычард - Ryszard
рэвалюцыя - rewolucja
рэгіён - region
рэзаць праўду у вочы - walić prawdę między oczy
рэзерфордый - rutherford
Рэйк'явік - Reykjavík
Рэйн - Ren
рэлігія - religia
рэльеф - ukształtowanie | rzeźba terenu | płaskorzeźba
рэлятывізм - relatywizm
рэній - ren
рэнтабельнасць - rentowność | opłacalność
рэнтабельны - rentowny | opłacalny
рэнтгеній - roentgen
рэспубліка - republika
Рэспубліка Зялёнага Мыса - Republika Zielonego Przylądka
Рэспубліка Конга - Republika Konga | Kongo
рэспубліканец - republikanin
рэспубліканскі - republikański
рэстаран - restauracja
рэсурс - zapasy | zasoby | osiągi | środki
рэўматызм - reumatyzm
рэўматычны - reumatyczny
рэфармацыя - reformacja
рэферэндум - referendum
рэчка - rzeczka
сабака - pies | @
сабатаваць - sabotować
сава - sowa
саветнік - doradca
савецкі - radziecki
Савецкі Саюз - Związek Radziecki | ZSRR
сагнуць - zginać | zgiąć
сад - ogród
Садом і Гамора - Sodoma i Gomora
Садружнасць Незалежных Дзяржаў - Wspólnota Niepodległych Państw | WNP
сакавік - marzec
сакавіты - soczysty | świeży | jarki | przyjemny | dźwięczny (o głosie) | trafny | obrazowy (o słowach, mowie)
сакавіцкі - marcowy
саксафаніст - saksofonista
салата - sałata | sałatka
салата з садавіны - sałatka owocowa
салдат - żołnierz
салідарнасць - solidarność
салодкі - słodki
самавар - samowar
самагон - bimber | samogon | samotna pogoń myśliwego za zwierzyną | pieszo lub na nartach | bez psów
самагонаварэнне - pędzenie bimbru | bimbrownictwo
самагонны - bimbrowniczy | samogonowy
самагоншчык - bimbrownik
самагоншчыца - bimbrowniczka (kobieta zajmująca się bimbrownictwem)
самалёт - samolot
Самалі - Somalia
Самалія - Somalia
Самарканд - Samarkanda
самарый - samar
самаўпэўнены - zarozumiały | zbyt pewny siebie | pyszałkowaty
самахвал - samochwała | chwalipięta
самахвальства - samochwalstwo
сандвіч - kanapka
Сан-Марына - San Marino
санскрыт - sanskryt
Сан-Тамэ і Прынсіпі - Wyspy Świętego Tomasza i Książęca
Сан-Томе і Прынсіпі - Wyspy Świętego Tomasza i Książęca
сапраўдны - prawdziwy | ważny | mający ważność
Сараева - Sarajewo
сасна - sosna
сасновы - sosnowy
сасок - sutek
Сафія - Sofia
сацыёлаг - socjolog
сацыялагічны - socjologiczny
сацыялізм - socjalizm
сацыялістычны - socjalistyczny
сацыялогія - socjologia
свабода - wolność | swoboda | niezależność
свабодны - wolny | niezależny | luźny | nieskrępowany
Свазіленд - Swaziland | Suazi
свая кашуля бліжэй да цела - bliższa koszula ciału
свет - światło | świt | świat
светапогляд - światopogląd
светлавы год - rok świetlny
светлы - jasny
свінец - ołów
свой - swój | własny
святар - duchowny
Святлана - Świetlana | Swietłana | imię żeńskie
сейсмічны - sejsmiczny
сейф - sejf
Сейшэльскія Астравы - Seszele
секс - seks
сексалагічны - seksuologiczny
сексалогія - seksuologia
секс-бізнес - seksbiznes
сексуальнасць - seksualność
сексуальная арыентацыя - orientacja seksualna
сексуальны - seksualny
селен - selen
сельская гаспадарка - rolnictwo
селязёнка - śledziona
селянін - mieszkaniec wsi
сем - siedem
семантыка - semantyka
семасіялогія - semazjologia
семдзесят - siedemdziesiąt 70
семнаццаць - siedemnaście 17
Сенегал - Senegal
сенсацыйны - sensacyjny
Сент-Вінсент і Гренадыны - Saint Vincent i Grenadyny
Сент-Кітс і Невіс - Saint Kitts i Nevis
Сент-Люсія - Saint Lucia
сепаратызм - separatyzm
сепсіс - sepsa
сера - siarka
серабро - srebro
серабрыстаць - srebrzystość
серабрысты - srebrzysty | srebrzysty (mający czyste, wysokie i wyraźne brzmienie)
серада - środa
сератанін - serotonina
серб - Serb
Сербія - Serbia
Сербія і Чарнагорыя - Serbia i Czarnogóra
сербскі - serbski
серны - siarkowy
серп - sierp
сесія - sesja
сёлета - w tym roku
сёмы - siódmy
сёння - dziś | dzisiaj
сённяшні - dzisiejszy
сіборгій - seaborg
Сізіф - Syzyf
сіла - siła | moc
сілагізм - sylogizm
Сілезія - Śląsk
сілікон - silikon
сімбіёз - symbioza
сімвал - symbol
сімвалізаваць - symbolizować
сімвалізм - symbolizm
сімваліст - symbolista
сімвалічны - symboliczny
сіметрычны - symetryczny
сіметрыя - symetria
сімпатызаваць - sympatyzować
сімпатычны - sympatyczny | sympatyczny (bezbarwny, niewidoczny) | współczulny
сімпатыя - sympatia
сімптаматычны - symptomatyczny
сімптом - symptom | objaw
сімуляваць - symulować
сімуляцыя - symulacja
сімфанічны - symfoniczny
сімфонія - symfonia
сіналогія - sinologia | chinoznawstwo
сіндром - syndrom | zespół
сіні - niebieski
сініца - sikora | sikorka
сінонім - synonim
сіноптык - synoptyk
сінтаізм - szintoizm | sintoizm | shintoizm
сінтэз - synteza
сінтэзатар - syntezator
сінтэтычны - syntetyczny | sztuczny
сінус - sinus
сінусаідальны - sinusoidalny
сінусоіда - sinusoida
Сірыя - Syria
сістэма - system | układ
сістэматызаваць - systematyzować
сістэматыка - systematyka
сістэматычнасць - systematyczność
сістэматычны - systematyczny
сістэмны - systemowy
сіта - sito
сітаватасць - porowatość
сітаваты - porowaty
Сіэтл - Seattle
сказ - zdanie
сказаць - powiedzieć
скальпель - skalpel
скандал - skandal
скандальны - skandaliczny (stanowiący skandal, mający cechy skandalu) | skandaliczny (taki, który wywołuje oburzenie, zgorszenie i przynosi wstyd)
скандый - skand
Скандынавія - Skandynawia
Скандынаўскі паўвостраў - Półwysep Skandynawski
скарб - skarb
скарбніца - skarbnica | skarbiec
скарбонка - skarbonka (pojemnik przeznaczony do przechowywania oszczędności) | skarbonka (pojemnik przeznaczony dla zbiórek publicznych)
скарпіён - skorpion
Скарпіён - Skorpion
скаўт - skaut
скаўтызм - skauting
скептык - sceptyk
скептыцызм - sceptycyzm
скептычны - sceptyczny
складаць - stanowić | wynosić | składać | kłaść | układać | napisać | tworzyć | dobierać | składać (broń)
скончыцца - skończyć się
Скоп'е - Skopje
скора - wkrótce | niebawem
скорасць - prędkość | szybkość
скоры - prędki | szybki
скронь - skroń
скрупулёзнасьць - skrupulatność
скрупулёзны - skrupulatny
скрыпка - skrzypce
скульптар - rzeźbiarz
скульптура - rzeźba
скура - skóra
слабасць - słabość
слабы - słaby
славак - Słowak
Славакія - Słowacja
славалюбства - próżność | ambicja
Славацкая Рэспубліка - Republika Słowacka | Słowacja
славацкі - słowacki | słowacki (język)
славачка - Słowaczka
славенец - Słoweniec
Славенія - Słowenia
славенка - Słowenka
славенскі - słoweński
славістыка - slawistyka
славянін - Słowianin
славянка - Słowianka
славянскі - słowiański
сладастраснасць - lubieżność
сладастрасны - lubieżny
слова - słowo | głos | obietnica
слон - słoń | goniec
слоўнік - słownik
слухаць - słuchać | osłuchiwać | być posłusznym
смерць - śmierć
смерч - trąba powietrzna
смех - śmiech
смірна - baczność
смоўж - ślimak
снарад - pocisk
СНД - Wspólnota Niepodległych Państw | WNP
снег - śnieg
снегапад - opad śniegu
снеданне - śniadanie
сне́жань - grudzień
сойка - sójka
сок - sok
соль - sól
сонечны - słoneczny
сонца - słońce
сорак - czterdzieści 40
спадабацца - падабацца
спадзяванне - nadzieja
спадкаемец - spadkobierca | dziedzic
спаліць - spalić
спаліць масты за сабой - spalić za sobą mosty
спаліць свае караблі - spalić za sobą mosty | spalić swoje okręty
спальня - sypialnia
спартовец - sportowiec
спартыўны - sportowy
спаць - spać
спектакль - spektakl
сперма - sperma
спецыялізавацца - specjalizować się
спецыялізацыя - specjalizacja
спецыяліст - specjalista | znawca
спецыялістка - specjalistka
спецыяльнасць - specjalność
спецыяльны - specjalny
спёка - upał
спіна - plecy
спіс - spis
спорт - sport
справа - sprawa
справядлівасць - sprawiedliwość
справядлівы - sprawiedliwy
спрадвеку - z dawien dawna | od niepamiętnych czasów
спрадвечны - odwieczny | wieczny
спрытны - zręczny | zwinny | sprytny
спрэчка - kłótnia | sprzeczka | spór
спяваць - śpiewać
срэбны - srebrny
ст. - w. = wiek
стабілізаваць - stabilizować
стабілізатар - stabilizator
стабілізацыя - stabilizacja
стабільнасць - stabilność
стабільны - stabilny
стагоддзе - stulecie
стадыён - stadion
Стакгольм - Sztokholm
сталініст - stalinista | stalinowiec
сталіца - stolica
сталічны - stołeczny
сталы - dojrzały | stateczny | poważny | stały
сталяр - stolarz
стаматалагічны - stomatologiczny
стаматалогія - stomatologia
становішча - położenie | sytuacja | warunki | postawa | ułożenie | stan
старажытны - starożytny | bardzo stary | dawny
старонка - strona
стары - stary | nie nowy | nie młody
стары горад - starówka | stare miasto
статус - status
стаць - stać się
стаяаць - stać
стаяць - stać | nie działać | być | panować | mieć do wykonania | trwać | bronić się | być zwolennikiem
ствол - pień
сто - sto | 100
стол - stół
Стоўбцы - Stołpce
страваванне - trawienie
Стралец - Strzelec
стралковая зброя - broń palna
стратэг - strateg
стратэгічны - strategiczny
стратэгія - strategia
страўнік - żołądek
страўнікава-кішачны тракт - układ pokarmowy
страх - strach
страшны - straszny | mocny
страшыць - straszyć
страшэнны - bardzo straszny | straszliwy
стромкі - stromy
стронцый - stront
стрэптаміцын - streptomycyna
сту́дзень - styczeń
студня - studnia
студэнт - student
ступня - stopa
стылістыка - stylistyka
стылістычны - stylistyczny
стымуляваць - stymulować
стяць - stać
субота - sobota
Судан - Sudan
сумаваць - tęsknić | smucić się
сумны - smutny
супермаркет - supermarket
супернічаць - rywalizować
супрацьпажарны - przeciwpożarowy
сура - sura
сур'ёзны - poważny
сурма - antymon
Сурынам - Surinam
сусветны - światowy
сусед - sąsiad
суседні - sąsiedni
суседства - sąsiedztwo
сустаў - staw
сустрэча - spotkanie
суткі - doba
суфікс - przyrostek
сухажылле - ścięgno
сухі - suchy
Суэцкі канал - Kanał Sueski
сцябло - łodyga
сцяг - flaga | sztandar
сцягно - udo
сцяна - ściana
сцячы - цячы
сшытак - zeszyt
сын - syn
сысці - zejść | wysiąść
Сьера-Леонэ - Sierra Leone
сэрбскі - serbski
сэрца - serce
сэрца кроўю абліваецца - serce krwią się zalewa
сябар - przyjaciel | członek | obrońca | zwolennik
сяброўскі - przyjacielski
сяброўства - przyjaźń
сягоння - dziś | dzisiaj
сядзець як на іголках - siedzieć jak na szpilkach
сямейны - rodzinny
сям'я - rodzina
сям’я - rodzina
сярдзіты - zły | rozgniewany
сярэднявечча - średniowiecze
сястра - siostra
таблетка - tabletka
тавар - towar
тавараабарот - obrót towarami
таварыскі - koleżeński | przyjacielski | towarzyski
таварыства - towarzystwo | stowarzyszenie | spółka
таварыства з абмежаванай адказнасцю - spółka z ograniczoną odpowiedzialnością
таварыш - towarzysz | kolega
Таджыкістан - Tadżykistan
таемны - tajemny
Таіланд - Tajlandia
Тайвань - Tajwan
тайваньскі - tajwański
тайландзкі - tajlandzki | tajski
так - tak
такі - taki
таксама - także | również
таксі - taksówka
талерантнасць - tolerancja
талій - tal
талія - talia
там - tam | potem
Танзанія - Tanzania
танзанскі - tanzański
танк - czołg
танкіст - czołgista
танны - tani
танцаваць - tańczyć
Таскана - Toskania
Тасманія - Tasmania
тата - ojciec
таталітарны - totalitarny
таталітарызм - totalitaryzm
тахта - tapczan
твар - twarz
тканіна - tkanina
Тога - Togo
Токіо - Tokio
толькі - tylko | dopiero
тонкі кішэчнік - jelito cienkie
торый - tor
тост - tost
тоўсты - gruby
трава - trawa
траваедны - roślinożerny
травень - maj
трагікамедыя - tragikomedia
трагікамічны - tragikomiczny
традыцыйна - tradycyjnie
традыцыйны - tradycyjny
традыцыя - tradycja
традыцыяналізм - tradycjonalizm
традыцыяналіст - tradycjonalista
традыцыяналістка - tradycjonalistka
традыцыяналісцкі - tradycjonalistyczny
трамбаніст - puzonista
трамбаністка - puzonistka
трамвай - tramwaj
трансляцыя - transmisja
тратуар - chodnik
трахея - tchawica
тропік - zwrotnik
трошкі - trochę
труба - trąbka
тры - trzy 3
трывога - trwoga | niepokój | obawa | alarm
трымаць - trzymać | trzymać się | wytrzymywać | skierować się | zmienić kierunek | przetrzymywać
трымаць кулакі - trzymać kciuki
трымаць руку на пульсе - trzymać rękę na pulsie
трымаць язык за зубамі - trzymać język za zębami
трынаццаты - trzynasty 13
трынаццаць - trzynaście 13
Трынідад і Табага - Trynidad i Tobago
трыста - trzysta | 300
трыццаты - trzydziesty
трыццаць - trzydzieści 30
трэці - trzeci
туз - as (w kartach) | szycha
тулава - tułów
тулій - tul
туман - mgła
Туніс - Tunezja
туніскі - tunezyjski
тунэль - tunel
тур - runda | kolejka | tura | etap | tur
турак - Turek
туркмен - Turkmen
Туркменістан - Turkmenistan
туркменскі - turkmeński
Турцыя - Turcja
турчанка - Turczynka
турэцкі - turecki
тут - tu | tutaj | wtedy | w tym czasie
туці фруці - bara bara
тхор - tchórz
ты - ty
тыгр - tygrys
тыдзень - tydzień
Тырана - Tirana
тысяча - tysiąc
тысячагоддзе - tysiąclecie (tysiąc lat) | tysiąclecie (rocznica założenia lub wydarzenia, od którego minęło tysiąc lat)
тытан - tytan | tytan (człowiek o wielkim wzroście, potężnej postury) | tytan (człowiek wielkiego ducha, wybitny, przerastający pod każdym względem swoje otoczenie) | tytan (pierwiastek chemiczny) | grzałka
тытанавы - tytanowy (dotyczący pierwiastka tytan, zawierający tytan)
тытанічны - tytaniczny
тэалагічны - teologiczny
тэатр - teatr
тэатральны - teatralny
тэлебачанне - telewizja
тэлевізар - telewizor
тэлефон - telefon
тэлур - tellur
Тэль-Авіў - Tel-Awiw
Тэмза - Tamiza
тэмп - tempo
тэмпература - temperatura | gorączka
тэрапеўт - internista | terapeuta
тэрапеўтычны - internistyczny | terapeutyczny
тэрапія - terapia
тэрарыст - terrorysta
тэрбій - terb
тэрмін - termin
тэрыторыя - terytorium
тэстастэрон - testosteron
тэўтонец - Krzyżak
тэхнецый - technet
у - w | we
увайсці - wejść | zmieścić się | zalogować się
уварвацца - wedrzeć się
увесь - cały | wszystek
увечары - wieczorem
увогуле - w ogóle
уволю - do woli
увосень - jesienią
Уганда - Uganda
ударыць - uderzyć
ужо - już
узбек - Uzbek
Узбекістан - Uzbekistan
узбекскі - uzbecki
узброены - zbrojny
узброены да зубоў - uzbrojony po zęby
узброены нейтралітэт - zbrojna neutralność
узбярэжжа - wybrzeże
узвод - pluton
узмор'е - wybrzeże
узначаліць - stanąć na czele
узначальваць - узначаліць
узрост - wiek
узяць - wziąć | aresztować
узяць Бога за бараду - złapać Pana Boga za nogi
указальны палец - palec wskazujący
Украіна - Ukraina
украінец - Ukrainiec
украінізацыя - ukrainizacja
украінізм - ukrainizm
украінка - Ukrainka
украінскі - ukraiński
улада - władza
Уладзіслаў - Władysław
уласны - własny | swój
умець - umieć
уміраць з рогату - umierać ze śmiechu
уміраць са смеху - umierać ze śmiechu
уначы - w nocy
унізе - na dole
унічыя - remis
уночы - w nocy
унунгексій - ununhexium
унуноктый - ununoctium
унунпентый - ununpentium
унунсептый - ununseptium
унунтрый - ununtrium
унцыя - uncja
упартасць - upór
упарты - uparty | uporczywy | zawzięty | zacięty
упершыню - pierwszy raz | po raz pierwszy
уран - uran
урач - lekarz
урок - lekcja | urok
Уругвай - Urugwaj
урэшце - wreszcie | nareszcie
усё - wszystko | wciąż | coraz
уступаць - wstępować | przystępować | ustępować
уступны - wstępny
уступны экзамен - egzamin wstępny
усход - wschód (kierunek) | wschód (zjawisko)
усходні - wschodni
Усходняя Еўропа - Europa Wschodnia
у цане - być w cenie
учарашні - wczorajszy
учора - wczoraj
учынак - postępek | uczynek | czyn
Уэльс - Walia
ўбачыць - zobaczyć
ўдар ніжэй пояса - cios poniżej pasa
ўдзячнасць - wdzięczność
ўдзячны - wdzięczny
фабрыка - fabryka
фабрыкант - fabrykant
факс - faks
фальсіфікаваць - fałszować
фаналагічны - fonologiczny
фаналогія - fonologia
фанатызм - fanatyzm
фанатык - fanatyk
фанатычны - fanatyczny
фанетыка - fonetyka
фанетычны - fonetyczny
фармакатэрапія - farmakoterapia
фармалізацыя - formalizacja
фармалізм - formalizm
фармаліст - formalista
фармалістка - formalistka
фармалістычны - formalistyczny
фармальнасць - formalność
фармальны - formalny
Фарэрскія астравы - Wyspy Owcze
фасоль - fasola
феадал - feudał
феадалізм - feudalizm
феадальны - feudalny
федэратыўны - federacyjny | federalny
федэрацыя - federacja (państwo federalne) | federacja (związek)
фемінізацыя - feminizacja
фемінізм - feminizm
фемініст - feminista
феміністка - feministka
феміністычны - feministyczny
фенаменальны - fenomenalny
фенілаланін - fenyloalanina
фермій - ferm
фестываль - festiwal
філалогія - filologia
філасофія - filozofia
Філіпіны - Filipiny
фільм - film
фільфак - wydział filologiczny - філалагічны факультэт
фін - Fin
фінікіец - Fenicjanin
фінікійка - Fenicjanka
фінікійскі - fenicki
Фінікія - Fenicja
фінка - Finka | koń fiński | finka | nóż fiński | rodzaj zimowej czapki fińskiej | lekka łódka z wąskim dziobem
Фінляндыя - Finlandia
фінскі - fiński
Фінскі заліў - Zatoka Fińska
фіялетавы - fioletowy
Фларэнцыя - Florencja
флейтыстка - flecistka
флеровій - flerow
флот - flota
флуктуацыя - fluktuacja
форма - forma | mundur
фосфар - fosfor
фосфарны - fosforowy
фраза - zdanie | fraza | frazes
фразеалагічны - frazeologiczny
фразеалогія - frazeologia
францужанка - Francuzka
француз - Francuz
французскі - francuski
францый - frans
Францыя - Francja
фронт - front
фруктоза - fruktoza
фрызура - fryzura
фтор - fluor
футбаліст - piłkarz
футбол - futbol | piłka nożna
футбольны - piłkarski
футуралогія - futurologia
хада - chodzenie
халадзільнік - lodówka
халодная вайна - zimna wojna
халодная зброя - broń biała
халодны - zimny | chłodny
харват - Chorwat
харватка - Chorwatka
Харватыя - Chorwacja
харвацкі - chorwacki
Харкаў - Charków
хасій - has
хата - chata
хатні - domowy | domowej roboty
хацець - chcieć
хваля - fala (na wodzie) | fala
Хведар - Teodor
хвіліна - chwila | sekunda
хвойны - iglasty
Хельсінкі - Helsinki
хіджаб - hidżab
хімічны - chemiczny
хімічны элемент - pierwiastek chemiczny
хімія - chemia
хірург - chirurg
хлапец - chłopiec
хлеб - chleb
хлопец - chłopiec
хлор - chlor
хлусня - kłamstwo
хмара - chmura
холад - chłód | zimno
храсток - chrząstka
хром - chrom
хрыбетнік - kręgosłup
Хрыстос - Chrystus
хрысціянізаваць - chrystianizować
хрысціянін - chrześcijanin
хрысціянка - chrześcijanka
хрысціянскі - chrześcijański
хрысціянства - chrześcijaństwo
хто - kto
хто-небудзь - ktoś | ktokolwiek
худы - chudy | szczupły
хуй - chuj (penis)
хуткі - szybki
цагельня - cegielnia
цагляны - ceglany | murowany | z cegły | ceglasty
цана - cena
цар - król | cesarz
царква - cerkiew | kościół (świątynia) | kościół (wspólnota wyznaniowa)
цвет - kwiat
цвёрды - twardy | nieprzejednany | niezachwiany | stały | niezmienny | sztywny
цвісці - kwitnąć | rozkwitać
цела - ciało
цёмны - ciemny
цёпла - ciepło
цёплы - ciepły | życzliwy
цётка - ciotka
цікавы - ciekawy | interesujący
ціск - ciśnienie | nacisk
Ціхі акіян - Ocean Spokojny
ціша - cisza
цішыня - cisza | spokój
цудоўны - cudowny
цукар - cukier
цыбуля - cebula
цыгарэта - papieros
цыклон - niż atmosferyczny
цынк - cynk
цынкавы - cynkowy
цынкіт - cynkit
цыркон - cyrkon
цырконій - cyrkon
цырымонія - ceremonia
цэзій - cez
цэнзура - cenzura
цэнтр - centrum | środek | ośrodek
цэнтралізаваць - scentralizować | centralizować
цэнтралізм - centralizm
Цэнтральная Азія - Azja Środkowa
цэнтральны - centralny | środkowy
цэрый - cer
цягнік - pociąg
цяжар - ciężar | waga | obowiązek
цяжарнасць - ciąża
цяжкі - ciężki | trudny
Цялец - Byk
цяпер - teraz
цячы - płynąć | przepływać | przeciekać | upływać | mijać
чаго сабе не хочаш, таго і другому не зыч - nie życz drugiemu, co tobie niemiłe
Чад - Czad
чай - herbata
чалавек - człowiek
чалавек чалавеку воўк - człowiek człowiekowi wilkiem
чалавечы - ludzki
чапля - czapla
Чарнагорыя - Czarnogóra
чарнаморскі - czarnomorski
чарнасоценец - czarnoseciniec
чарнасоценны - czarnosecinny
чаромха - czeremcha
час - czas
часта - często
частка - część
часты - częsty
чатырнаццаты - czternasty
чатырнаццаць - czternaście 14
чатыры - cztery 4
чатырыста - czterysta 400
чацвер - czwartek
чацвёрты - czwarty
чацвярговы - czwartkowy
Чачня - Czeczenia
Чорнае мора - Morze Czarne
чорная дзірка - czarna dziura
чорная няўдзячнасць - czarna niewdzięczność
чорны - czarny
чужы - obcy
Чылі - Chile
Чылы - Chile
чым - niż
чырвоны - czerwony
чысты - czysty
чытальны - przeznaczony do czytania
чытальня - czytelnia
чытанка - czytanka
чытаць - czytać
чытач - czytelnik
чэмпіянат - mistrzostwa (zawody) | mistrzostwo
чэрап - czaszka
чэраўная поласць - jama brzuszna
чэрвень - czerwiec
чэрвеньскі - czerwcowy
Чэская Рэспубліка - Republika Czeska
чэх - Czech
Чэхаславакія - Czechosłowacja
чэхаславацкі - czechosłowacki
Чэхія - Czechy
чэшка - Czeszka
чэшскі - czeski | czeski (język)
шаблон - szablon | wzornik
шавінізм - szowinizm (skrajna postawa nacjonalistyczna) | szowinizm (wrogość wobec przedstawicieli innych grup społecznych)
шавініст - szowinista (skrajny nacjonalista) | szowinista (osoba manifestująca wrogość wobec przedstawicieli innych grup społecznych)
шавіністка - szowinistka (skrajna nacjonalistka) | szowinistka (kobieta manifestująca wrogość wobec przedstawicieli innych grup społecznych)
шавіністычны - szowinistyczny
Шалі - Waga
шанаваць - poważać | szanować
шаноўны - szanowny
шапка - czapka | kapelusz
шаснаццаты - szesnasty
шаснаццаць - szesnaście 16
шасцьдзесят - sześćdziesiąt | 60
шатландзец - Szkot
шатландскі - szkocki
Шатландыя - Szkocja
шафер - drużba (weselny)
шафёр - szofer
шахматы - szachy
шахрай - szachraj
шахрайка - szachrajka
шахрайскі - szachrajski
шахрайства - szachrajstwo
Швабія - Szwabia
швед - Szwed
шведка - Szwedka
шведскі - szwedzki
швейцарац - Szwajcar
швейцарка - Szwajcarka
Швейцарская Канфедэрацыя - Konfederacja Szwajcarska
швейцарскі - szwajcarski
Швейцарыя - Szwajcaria
Швецыя - Szwecja
шклянка - szklanka
шкодны - szkodliwy
шкура - skóra | skóra (czyjeś życie, zdrowie, bezpieczeństwo) | futro
шлем - hełm
шмат - wiele | dużo | szmat
шматразовы - wielokrotny
шок - wstrząs
шосты - szósty | 6.
шоу-бізнес - show-biznes
шпіянаж - szpiegostwo
што - co | który | jak | że
штодзённы - codzienny | zwyczajny | na co dzień
што-небудзь - coś | cokolwiek
штраф - kara pieniężna | grzywna | mandat
штурм - szturm
штык - bagnet
шукаць - szukać
шукаць ветру ў полі - szukać wiatru w polu
шчака - policzek
шчаслівы - szczęśliwy
шчасце - szczęście
шчыкалятка - kostka u nogi
шчыры - szczery | prawdziwy
шыйка - szyjka
шыйка маткі - szyjka macicy
шыйны - szyjny
шырокі - szeroki
шыя - szyja
шэры - szary
шэсць - sześć
шэсцьдзесят - sześćdziesiąt 60
Шэтландыя - Szkocja
эбаніт - ebonit
эвакапункт - punkt ewakuacyjny
эвакуацыя - ewakuacja
эвакуіравацца - ewakuować się
эвалюцыя - ewolucja
эвалюцыянізм - ewolucjonizm
эвалюцыяніраваць - ewoluować
эгаізм - egoizm
эгаіст - egoista
эгаістычны - egoistyczny
эгацэнтрызм - egocentryzm
эгацэнтрык - egocentryk
эгацэнтрыст - egocentryk
эгіда - egida
Эзоп - Ezop
эйнштэйній - einstein
экалагічны - ekologiczny
экалогія - ekologia
эканаміст - ekonomista
эканамічны - ekonomiczny
эканом - ekonom
эканоміка - gospodarka | przemysł
эканоміць - oszczędzać
эканомія - ekonomia
эканомны - oszczędny
экасістэма - ekosystem
Эквадор - Ekwador
эквадорка - Ekwadorka
экватар - równik
Экватарыяльная Гвінея - Gwinea Równikowa
эквівалент - ekwiwalent
эквівалентны - równoważny
экзамен - egzamin | wypróbowanie | próba | test
экзаменаваць - egzaminować
экзаменатар - egzaminator
экзаменацыйны - egzaminacyjny
эколаг - ekolog
экран - ekran
экскурсія - wycieczka | podróż | wycieczka (grupa osób)
экспазіцыя - ekspozycja
экспарт - eksport
экспартаваць - eksportować
экспартны - eksportowy
экспедыцыя - ekspedycja (wyprawa) | ekspedycja (wysyłanie towarów i przesyłek) | ekspedytura
эксперт - ekspert
эксперымент - eksperyment
эксперыментальны - eksperymentalny
экстаз - ekstaza
электарат - elektorat
электратэхніка - elektronika
электрык - elektryk
электрыфікаваць - elektryfikować
электрычнасць - elektryczność
электрычны - elektryczny
Элізабет - Elżbieta
Эль-Аюн - Al-Ujun
Эльзас - Alzacja
Эмілі - Emilia
эналогія - enologia
энтамалогія - entomologia
эпідэміялогія - epidemiologia
эпікурэізм - epikureizm
эпікурэйство - epikureizm
эпоха - epoka
эра - era
эрбій - erb
эротыка - erotyka
эрытроміцін - erytromycyna
Эрытрэя - Erytrea
эскалацыя - eskalacja
эспрэса - espresso (kawa)
эстонец - Estończyk
Эстонія - Estonia
эстонка - Estonka
эстонскі - estoński
эстэтыка - estetyka
этан - etan
этнаграфічны - etnograficzny
этнаграфія - etnografia
этналогія - etnologia
этыка - etyka (dział filozofii) | etyka (ogół zasad i norm postępowania przyjętych w danej epoce i środowisku)
этымалогія - etymologia | źródłosłów
этычны - etyczny
эўкаліпт - eukaliptus
эўкаліптавы - eukaliptusowy
эўтаназія - eutanazja
эўфемізм - eufemizm
эфект - efekt | wrażenie
эфектны - efektowny
эфектыўнасць - efektywność
эфектыўны - efektywny | skuteczny | wydajny
Эфіопія - Etiopia
Югаславія - Jugosławia
югаславянскі - jugosławski
юны - młody
ЮНЭСКА - UNESCO
я - ja | ostatnia litera białoruskiego alfabetu
яблык - jabłko | вокавы яблык
яблык ад яблыні недалёка коціцца - niedaleko pada jabłko od jabłoni
яблык ад яблыні недалёка падае - niedaleko pada jabłko od jabłoni
ягада - jagoda
ягня - jagnię
ядзерная зброя - broń jądrowa
ядзерны - jądrowy
язык - język
язычніцкі - pogański
яйка - jajko
яйцаклетка - komórka jajowa
як - jak | co | jako
Якаў - Jakub
як гром з яснага неба - jak grom z jasnego nieba
які - który | jaki | jakiż | co za | jakikolwiek | jakiś
як кот наплакаў - tyle, co kot napłakał
як скрозь зямлю праваліцца - zapaść się jak pod ziemię
як трывога, тады да Бога - jak trwoga, to do Boga
як у Бога за пазухай - jak u Pana Boga za piecem | jak u Boga za pazuchą
як у Бога за печкай - jak u Pana Boga za piecem
як у Хрыста за пазухай - jak u Pana Boga za piecem | jak u Chrystusa za pazuchą
Ялта - Jałta
Ямайка - Jamajka
яна - ona
яны - oni
Японія - Japonia
японка - Japonka
японскі - japoński
ярд - jard
ясны - jasny
яшчэ - jeszcze
