Аахен - Akwizgran
аба - abaja
абаджия - krawiec
абажур - abażur
абазия - abazja
абак - abakus
абака - banan manilski
абанос - heban
абаносов - hebanowy
абат - opat
абатски - opacki
абатство - opactwo
абдал - głupek, idiota, głupiec
абдикация - abdykacja
абдикирам - abdykować
абдоминален - brzuszny
абдуктор - abduktor
абдукция - abdukcja
аберация - aberracja
абзац - akapit, paragraf
абисинец - Abisyńczyk
Абисиния - Abisynia
абисинка - Abisynka
абитуриент - abiturient, maturzysta
абитуриентка - abiturientka, maturzystka
аболиционизъм - abolicjonizm
абонамент - abonament
абонат - abonent, prenumerator
абонирам - abonować, prenumerować
абориген - aborygen
аборт - aborcja
абразив - ścierniwo
абразия - abrazja
абревиатура - skrót
абсент - absynt
абсолвент - absolwent
абсолвентка - absolwentka
абсолютен - absolutny
абсолютизъм - absolutyzm
абсолютно - absolutnie
абсорбирам - absorbować, pochłaniać
абсорбция - absorpcja
абстрактен - abstrakcyjny
абстракция - abstrakcja
абсурд - absurd
абсурден - absurdalny
абсурдно - absurdalnie
абсурдност - absurdalność, niedorzeczność
абсцес - absces, ropień
абсциса - odcięta
Абу Даби - Abu Zabi
Абхазия - Abchazja
абхазки - abchaski
авангард - awangarda, straż przednia
аванпост - posterunek wysunięty, awanpost
аванс - zaliczka, zadatek
авансирам - dawać zaliczkę, awansować
авантюра - przygoda, awantura
авантюрист - poszukiwacz przygód, awanturnik
авантюристичен - pełen przygód, awanturniczy
авантюристка - awanturnica
авариен - awaryjny
авария - awaria
август - sierpień
августовски - sierpniowy
авеню - aleja
авиатор - awiator, lotnik
авиаторка - lotniczka
авиационен - lotniczy
авиация - lotnictwo, awiacja
авизо - awizo, zawiadomienie
авиолиния - linia lotnicza
авитаминоза - awitaminoza
авлига - wilga
авокадо - awokado
австралиец - Australijczyk
австралийка - Australijka
австралийски - australijski
Австралия - Australia
австриец - Austriak
австрийка - Austriaczka
австрийски - austriacki
Австрия - Austria
автаркия - autarkia
автентичен - autentyczny
автентичност - autentyczność
автобиографичен - autobiograficzny
автобиография - autobiografia
автобус - autobus
автобусен - autobusowy
автогара - dworzec autobusowy
автогол - samobój
автограф - autograf
автозавод - fabryka samochodów
автоклав - autoklaw
автократ - autokrata, samowładca
автокрация - autokracja
автомагистрала - autostrada
автомат - automat
автоматизация - automatyzacja
автоматичен - automatyczny
автоматично - automatycznie
автомобил - samochód, pojazd
автомобилен - automobilowy, samochodowy
автономен - autonomiczny
автономия - autonomia
автономно - autonomicznie
автопилот - autopilot, automatyczny pilot
автопортрет - autoportret
автор - autor
авторемонт - naprawa samochodu
авторитет - autorytet
авторитетен - autorytatywny
авторитетно - autorytatywnie
авторка - autorka
авторски - autorski
автостоп - autostop
автострада - autostrada
автотранспорт - transport samochodowy
автохтон - autochton
автохтонен - autochtoniczny
агент - agent
агентка - agentka
агенция - agencja
агитатор - agitator
агитаторка - agitatorka
агитационен - agitacyjny
агитация - agitacja
агитирам - agitować
агне - jagnię
агне в чувал не се купува - nie kupuje się kota w worku
агнешки - jagnięcy
агностик - agnostyk
агностицизъм - agnostycyzm
агонизирам - być w agonii, konać
агония - agonia
агора - agora
агорафобия - agorafobia
аграрен - rolniczy
агрегат - agregat
агресивен - agresywny
агресивност - agresywność
агресия - agresja
агресор - agresor
агробиология - agrobiologia
агроном - agronom
агрономически - agronomiczny
агрономия - agronomia
агрономство - agronomia
агрохимия - agrochemia
ад - piekło
адаптация - adaptacja, przystosowanie
адаптирам - adaptować, przystosowywać
адаш - imiennik
адвентист - adwentysta
адвентистка - adwentystka
адвокат - adwokat
адвокатка - adwokatka
адвокат на дявола - adwokat diabła
адекватен - adekwatny
адекватност - adekwatność
Аделина - Adelina
Аден - Aden
адепт - zwolennik
адет - zwyczaj, obyczaj
Адис Абеба - Addis Abeba
административен - administracyjny
администратор - administrator
администрация - administracja
администрирам - administrować
адмирал - admirał
адреналин - adrenalina
адрес - adres
адресант - nadawca
адресат - adresat
адресирам - adresować
адриатически - adriatycki
Адриатическо море - Morze Adriatyckie
адски - piekielny
адютант - adiutant
аерогара - lotnisko
аеродрум - aerodrom, lotnisko
аероклуб - aeroklub
аеронавтика - aeronautyka
аероплан - samolot
аеростат - aerostat
аеростатика - aerostatyka
аеротранспорт - transport lotniczy
ажио - ażio
ажур - ażur, mereżka
аз - ja
азалия - azalia
азбест - azbest
азбука - abecadło, alfabet
азбучен - alfabetyczny
Азербайджан - Azerbejdżan
азербайджанец - Azer, Azerbejdżanin
азербайджанка - Azerbejdżanka
азербайджански - azerbejdżański, azerski
азиатец - Azjata
азиатка - Azjatka
азимут - azymut
Азия - Azja
азовски - azowski
Азовско море - Morze Azowskie
Азорски острови - Azory
азот - azot
азотен - azotowy
аймара - język ajmara
айнщайний - einstein
Айова - Iowa
айсберг - góra lodowa
академия - akademia
акация - akacja
аквамарин - akwamaryn
акварел - akwarela
акварелист - akwarelista
акварелистка - akwarelistka
аквариум - akwarium
акламация - aklamacja
акламирам - aklamować
аклиматизирам - aklimatyzować
ако - jeśli, jeżeli
акомпанирам - akompaniować
акорд - akord
акордеон - akordeon
акордирам - nastrajać (instrument)
акредитив - akredytywa
акробат - akrobata
акробатика - akrobatyka
акробатка - akrobatka
акробатски - akrobatyczny
акроним - akronim
акростих - akrostych
акселератор - akcelerator
аксиома - aksjomat
акт - akt, czyn, działanie, dokument
активация - aktywacja
активен - aktywny
активист - aktywista
активност - aktywność
актиний - aktyn
актриса - aktorka
актуален - aktualny
актьор - aktor
актюер - aktuariusz
акула - rekin
акумулатор - akumulator
акумулация - akumulacja
акуратен - dokładny, punktualny
акустика - akustyka
акушер - położnik, akuszer
акушерка - akuszerka, położna
акцент - akcent
акцентувам - akcentować
акциденция - akcydencja
акциз - akcyza
акционер - akcjonariusz
акция - akcja
акъл - rozum, rozsądek
ала - ale
Аландски острови - Wyspy Alandzkie
аларма - alarm, hałas, wrzawa
алармирам - alarmować
албанец - Albańczyk
Албания - Albania
албанка - Albanka
албански - albański
албатрос - albatros
албинос - albinos
албум - album
албумин - albumina
алвеола - pęcherzyk płucny
алгебра - algebra
алгебричен - algebraiczny
алгоритъм - algorytm
Алдебаран - Aldebaran
алебарда - halabarda
алегоричен - alegoryczny
алегория - alegoria
Александър - Aleksander
алергия - alergia
алея - aleja
Алжир - Algieria
алжирец - Algierczyk
алжирка - Algierka, algierka
алжирски - algierski
алиби - alibi
алигатор - aligator
алкохол - alkohol
алкохолен - alkoholowy
алкохолизъм - alkoholizm
алманах - almanach
ало - halo!
алпака - alpaka
Алпи - Alpy
алпийски - alpejski
алпийски дисциплини - narciarstwo alpejskie
алпинизъм - alpinizm
алтернатива - alternatywa, wybór
алтруизъм - altruizm
алтруист - altruista
алуминиев - aluminiowy
алуминий - glin
алхимик - alchemik
алхимия - alchemia
алчен - chciwy
алчност - chciwość
алюзия - aluzja
Аляска - Alaska – stan w USA
Амазонка - Amazonka
амалгама - amalgamat
аматьор - amator
амбициозен - ambitny
амбиция - ambicja
амбразура - ambrazura
амеба - ameba
Америка - Ameryka
американец - Amerykanin
американизирам - amerykanizować
американка - Amerykanka
Американска Самоа - Samoa Amerykańskie
американски - związany z Ameryką (kontynentem), związany z USA
Американски Вирджински острови - Wyspy Dziewicze Stanów Zjednoczonych
америций - ameryk
аметист - ametyst
амилоидоза - amyloidoza, skrobiawica, betafibryloza
амин - amen
амнезия - amnezja
амнистия - amnestia
амоняк - amoniak
аморален - amoralny
амортизатор - amortyzator
амортизация - amortyzacja
ампер - amper
амперметър - amperomierz
амплитуда - amplituda
ампула - ampułka
ампутация - amputacja
Амстердам - Amsterdam
амулет - amulet
Амур - Amur
амфибия - amfibia
амфитеатър - amfiteatr
амфора - amfora
анаболизъм - anabolizm
анаграма - anagram
анаконда - anakonda
анален - analny
анализ - analiza
анализирам - analizować
аналитичен - analityczny
аналог - analog
аналогичен - analogiczny
аналогия - analogia
анамнеза - anamneza
ананас - ananas (roślina i owoc)
анархизъм - anarchizm
анархия - anarchia, bezrząd
анасон - anyż
анатема - anatema
анатемосвам - rzucać anatemę, klątwę
анатомия - anatomia
анафора - anafora
анахронизъм - anachronizm
ангажимент - zaangażowanie
ангажирам - angażować
ангел - anioł
ангина - angina
английски - angielski, język angielski
англицизъм - anglicyzm
англичанин - Anglik
англичанка - Angielka
Англия - Anglia
Ангола - Angola
Андалусия - Andaluzja
Андора - Andora
Андромеда - Andromeda
анекдот - anegdota
анексия - aneksja
анемичен - anemiczny
анемия - niedokrwistość, anemia
анемограф - anemograf
анемометър - anemometr
анестезиолог - anestezjolog
анестезия - anestezja, znieczulenie
анимационен - animowany
анимация - animacja
Анкара - Ankara
анкета - ankieta
анкетен - ankietowy
анод - anoda
анонимен - anonimowy
анонс - anons, ogłoszenie
анормален - anormalny
ансамбъл - zespół
антагонизъм - antagonizm
антагонист - antagonista
Антарес - Antares
Антарктида - Antarktyda
Антарктика - Antarktyka
Антверпен - Antwerpia
антена - antena
Антигуа и Барбуда - Antigua i Barbuda
антиквар - antykwariusz
антикварен - antykwaryczny
антилопа - antylopa
антимон - antymon
антипатичен - antypatyczny
антипатия - antypatia, niechęć
антитеза - antyteza
антитяло - antyciało
антифашистки - antyfaszystowski
античен - antyczny
антология - antologia
антоним - antonim
антракт - antrakt
антрацит - antracyt
антре - przedpokój, sień
антрополог - antropolog
антропология - antropologia
антропоморфизъм - antropomorfizm
анулирам - anulować
анус - odbyt
апарат - aparat
апартамент - apartament
апатит - apatyt
апатичен - apatyczny
апатия - apatia
апел - apel
аперитив - aperitif
апетит - apetyt
апетитен - apetyczny
апетитът идва с яденето - apetyt rośnie w miarę jedzenia
аплодирам - oklaskiwać
аплодисменти - oklaski
аполитичен - apolityczny
апологет - apologeta
апоплексия - apopleksja
апостасия - apostazja
апостол - apostoł
апостроф - apostrof
април - kwiecień
априлски - kwietniowy
аптека - apteka
аптекар - aptekarz
аптекарка - aptekarka
аптечен - apteczny
апчих - apsik!, a psik!
апчиху - apsik!, a psik!
ар - ar
арабин - Arab
Арабска лига - Liga Arabska, Liga Państw Arabskich
арабски - arabski
Арабски полуостров - Półwysep Arabski
Арарат - Ararat (masyw)
арбалет - kusza
арбитраж - arbitraż
арбитър - arbiter
аргон - argon
аргумент - argument
аргументация - argumentacja
арена - arena
Арес - Ares
арест - areszt
арестант - aresztant
арестувам - aresztować
Аржентина - Argentyna
аржентински - argentyński
аристократ - arystokrata
аристокрация - arystokracja
Аристотел - Arystoteles
Аристофан - Arystofanes
аритметика - arytmetyka
аритметичен - arytmetyczny
ария - aria
арка - łuk
Арктика - Arktyka
армада - armada
арматура - armatura
арменец - Ormianin
Армения - Armenia
арменка - Ormianka
арменски - armeński, ormiański
армия - armia
арнаутски - albański
арогантен - arogancki
арогантност - arogancja
аромат - aromat
ароматен - aromatyczny
арсен - arsen
арсенал - arsenał
артериосклероза - arterioskleroza
артерия - arteria
артикул - artykuł, produkt
артилерийски - artyleryjski
артилерия - artyleria
артист - artysta, aktor
артистичен - artystyczny
артистка - artystka
Аруба - Aruba
арфа - harfa
архаизъм - archaizm
архаичен - archaiczny
архангел - archanioł
археолог - archeolog
археология - archeologia
архив - archiwum
архива - dokumenty archiwalne, archiwum
архивар - archiwista, archiwariusz
архивен - archiwalny
архиепископ - arcybiskup
архимандрит - archimandryta
архипелаг - archipelag
архитект - architekt
архитектура - architektura
аршин - arszyn
асансьор - winda
асексуалност - aseksualizm, aseksualność
асиметричен - asymetryczny
асимилация - asymilacja
асимптота - asymptota
асирийка - Asyryjka
асистент - asystent
асистирам - asystować
аскер - wojsko, żołnierz
аскет - asceta
аскетизъм - ascetyzm
асортимент - asortyment
асоциация - asocjacja
аспект - aspekt
аспирация - aspiracja
аспирин - aspiryna
астат - astat
астатин - astat
астероид - asteroida
астигматизъм - astygmatyzm
астма - astma, dychawica
астролог - astrolog
астрология - astrologia
астронавт - astronauta
астроном - astronom
астрономически - astronomiczny
астрономия - astronomia
астрофизик - astrofizyk
астрофизика - astrofizyka
Асунсион - Asunción
асфалт - asfalt
асфалтен - asfaltowy
ат - rumak
атавизъм - atawizm
атака - atak
атакувам - atakować
атаман - ataman
атеизъм - ateizm
атеистки - ateistyczny
Атина - Atena, Ateny
атлантически - atlantycki
Атлантически океан - Ocean Atlantycki
атлас - atlas
атлет - atleta
атлетика - atletyka
атмосфера - atmosfera, nastrój
атмосферен - atmosferyczny
атол - atol
атом - atom
атомен - atomowy
атомен номер - liczba atomowa
атомизъм - atomizm
атония - atonia
атракционен - atrakcyjny
атрибут - atrybut
атрофия - atrofia
аудиенция - audiencja
аудитория - audytorium
аукцион - aukcja
ауспух - rura wydechowa
аутопсия - autopsja, sekcja zwłok
афазия - afazja
Афганистан - Afganistan
афганстански - afgański
афект - afekt
афера - afera
афинитет - powinowactwo
афиш - afisz
афоризъм - aforyzm
Африка - Afryka
африкаанс - język afrykanerski
африканка - Afrykanka
африканска република - Republika Środkowoafrykańska
африкански - afrykański
Афродита - Afrodyta
афронт - afront
ахат - agat
Ахил - Achilles
ацетат - octan
ацетилен - acetylen
ацетон - aceton
баба - babcia
Бавария - Bawaria
баварски - bawarski
бавачка - niańka
бавен - wolny, powolny
бавно - powoli, wolno
багаж - bagaż
багажен - bagażowy
Багдад - Bagdad
багра - barwa, barwnik
багрен - purpurowy
бадемов - migdałowy
баджанак - szwagier
бадминтон - badminton
база - baza
базалт - bazalt
базилика - bazylika
базис - podstawa, baza
баир - pagórek
байно - wujek
баклава - baklawa
баксит - boksyt
бактериолог - bakteriolog
бактериологичен - bakteriologiczny
бактериология - bakteriologia
бактерия - bakteria
Баку - Baku
бакшиш - bakszysz, bakczysz
бакър - miedź, kocioł (miedziany)
бакърен - miedziany
бал - bal
балада - ballada
балалайка - bałałajka
баланс - bilans
балансирам - bilansować
балдахин - baldachim
балдъза - szwagierka
Балеарски острови - Baleary
балерина - baletnica
балет - balet
балкан - góra
Балкански полуостров - Półwysep Bałkański
балкон - balkon
балнеотерапия - balneoterapia
балон - balon
балтийски - bałtycki
Балтийско море - Morze Bałtyckie
балюстрада - balustrada
Бамако - Bamako
бамбук - bambus
банален - banalny
банан - banan
Банги - Bangi
Бангладеш - Bangladesz
банда - banda
банджо - banjo, bandżo
бандит - bandyta
бандитски - bandycki
бандура - bandura
банка - bank
банкет - bankiet
банкнота - banknot
банкрут - bankructwo
бански - kąpielowy
баобаб - baobab
бар - bar
бара - strumyk, kałuża
барабан - bęben
барабанист - bębniarz
бараж - zapora
Барбадос - Barbados
бардак - bardak, burdel, bałagan, dom publiczny
Баренцово море - Morze Barentsa
барета - beret
бариера - bariera
барий - bar
барикада - barykada
барион - barion
барометър - barometr
барон - baron
Барселона - Barcelona
бартер - barter
барут - proch strzelniczy
бас - bas, zakład
басейн - basen
басетля - basetla
баскетбол - koszykówka
басня - bajka, baśń
бастун - laska
батальон - batalion
батерия - bateria
Бахамски острови - Wyspy Bahama, Bahamy
Бахрейн - Bahrajn
баща - ojciec, twórca, założyciel
бащиния - ojcowizna, patrymonium
бдение - czuwanie
бдителен - czujny
бебе - niemowlę
беглец - uciekinier, dezerter
бедем - migdałowiec (drzewo), migdał (owoc)
беден - biedny, ubogi
бедност - ubóstwo
беднотия - biedota, bieda
бедняк - biedak, ubogi
бедро - udo
бедуин - Beduin
бежанец - uchodźca
бежанка - uchodźczyni
бежов - beżowy
без - bez
безбожен - bezbożny
безбожие - bezbożność
безбожник - bezbożnik
безбрачен - nieżonaty
безбрачие - celibat
безброен - niezliczony
безвластие - anarchia, bezprawie
безводен - bezwodny
безвреден - nieszkodliwy
безвъзмезден - bezpłatny
безграничен - bezgraniczny
безгрешен - bezgrzeszny, bezbłędny
безгрижен - beztroski
безгръбначен - bezkręgowy
бездеен - bezczynny
безделнича - próżnować
бездетен - bezdzietny
бездна - przepaść, otchłań, głębina
бездомен - bezdomny
бездушен - bezduszny
безжалостен - bezlitosny
беззаконен - bezprawny
беззащитен - bezbronny
безземен - bezrolny
беззъб - bezzębny
безименен - bezimienny
безкомпромисен - bezkompromisowy
безконечен - nieskończony
безкористен - bezinteresowny
безкраен - bezkresny, nieskończony
безкритичен - bezkrytyczny
безкръвен - bezkrwawy
безлихвен - bezprocentowy
безличен - bezosobowy
безлюден - bezludny
безмерен - bezmierny
безмесен - bezmięsny
безмилостен - bezlitosny
безмитен - wolny od cła
безнадежден - beznadziejny
безнаказан - bezkarny
безобиден - nieszkodliwy
безоблачен - bezchmurny
безобразен - ohydny
безопасен - bezpieczny
безоснователен - bezpodstawny
безотговорен - nieodpowiedzialny
безочлив - bezczelny
безпартиен - bezpartyjny
безплатен - bezpłatny
безплоден - bezpłodny
безпогрешен - bezbłędny
безпокоен - niespokojny
безпокойство - niepokój
безполезен - bezużyteczny
безполов - bezpłciowy
безпорядък - bezład, nieporządek
безпристрастен - bezstronny
безработен - bezrobotny
безработица - bezrobocie
безразличие - obojętność
безредие - nieład, nieporządek
безрезултатен - bezskuteczny
безсилен - bezsilny
безсистемен - niesystematyczny
безслънчев - bezsłoneczny
безсмъртен - nieśmiertelny
безсмъртие - nieśmiertelność
безспирен - nieustanny
безспорен - bezsporny
безсрамен - bezwstydny
безсрочен - bezterminowy
безстопанствен - bezpański
безстрашен - nieustraszony
безсънен - bezsenny
безусловен - bezwarunkowy
безформен - bezkształtny
безхарактерен - bez charakteru
безцветен - bezbarwny
безцелен - bezcelowy
безценен - bezcenny
безцеремонен - bezceremonialny
безчислен - niezliczony
безчовечен - nieludzki
безчувствен - nieczuły, nieprzytomny
бейзбол - baseball
Бейрут - Bejrut
бел - łopata
Беларус - Białoruś
белгиец - Belg
белгийка - Belgijka
белгийски - belgijski
Белгия - Belgia
Белград - Belgrad
белег - blizna, znak, oznaka
бележка - uwaga, notatka, nota
бележник - notes, notatnik
белезникав - białawy
Белиз - Belize
белина - biel, wybielacz
белка - kuna domowa
белодробен - płucny
белокож - białoskóry
белокос - białowłosy, siwy
белоруски - białoruski
белота - biel
бельо - bielizna
бенефис - benefis
бенефициент - beneficjent
бензен - benzen
бензин - benzyna
бензиностанция - stacja benzynowa
Бенин - Benin
бент - tama
бербер - fryzjer męski
берилий - beryl
беритба - zbiór, żniwo
берклий - berkel
Берлин - Berlin
Бермудски острови - Bermudy
Берн - Berno
беседа - rozmowa, pogawędka
беседвам - gawędzić
бесен - wściekły
беся - wieszać
бетон - beton
бетонен - betonowy
биатлон - biatlon
библиографичен - bibliograficzny
библиография - bibliografia
библиотека - biblioteka
библиотекар - bibliotekarz
бивол - bawół
бивш - były, niegdysiejszy
Бивша югославска република Македония - Była Jugosłowiańska Republika Macedonii
биде - bidet
бидон - bańka, blaszanka
бижутер - jubiler
бизон - bizon
бик - byk
бикоглав - uparty
билет - bilet
билярд - bilard
бинокъл - lornetka
бинт - bandaż
биографичен - biograficzny
биографически - biograficzny
биография - biografia
биолог - biolog
биологичен - biologiczny
биология - biologia
биометрия - biometria
биосфера - biosfera
биофизика - biofizyka
биохимия - biochemia
биплан - dwupłatowiec, dwupłat
бира - piwo
бирария - piwiarnia
бирен - piwny
Бирма - Birma
бисексуалност - biseksualizm
бисер - perła
бисквита - herbatnik
бисмут - bizmut
бистър - czysty, klarowny, przeźroczysty
бит - byt, bit
битка - bitwa
битпазар - tandeta (bazar)
бич - bat, bicz
бичи - byczy
Бишкек - Biszkek
бия - bić
благо - dobro
благовонен - wonny
благовъзпитан - dobrze wychowany
благодарен - wdzięczny
благодаря - dziękuję
благодушен - dobroduszny
Благоевград - Błagojewgrad
благоразумен - rozsądny
благоразумие - roztropność, rozsądek
благороден - szlachetny
благосклонно - życzliwie, przychylnie
благославям - błogosławić
благословен - błogosławiony
благословя - pobłogosławić
благотворителност - dobroczynność
блажен - szczęśliwy, błogi
блатен - błotny
бленувам - marzyć
ближа - lizać
близнак - bliźniak
близо - blisko
близък - bliski
Близък Изток - Bliski Wschód
бликам - tryskać
блокада - blokada
блокирам - blokować
блондин - blondyn
блондинка - blondynka
блудница - rozpustnica, wszetecznica
блуза - bluza, bluzka
Блумфонтейн - Bloemfontein
блус - blues
блъскам - uderzać, trącać, popychać
блъф - blef
блъфирам - blefować
блюдо - półmisek, potrawa
блян - marzenie
блясвам - błyszczeć
бляскам - błyskać, błyszczeć
блясък - blask, błysk
боб - fasola
бобина - cewka
бобслей - bobsleje
бобър - bóbr
бог - bóg
Бог - Bóg
богат - bogaty
богаташ - bogacz
богиня - bogini
богословие - teologia
богослужебен - liturgiczny
бода - kłuć, bóść
боец - bojownik, żołnierz
божествен - boski
божур - piwonia
бозайник - ssak
бозка - sutek, cycek
бойкотирам - bojkotować
бойлер - bojler
бокс - boks, pięściarstwo
боксьор - bokser
боледувам - chorować
болен - chory
болест - choroba
болестен - chorobowy
боливиец - Boliwijczyk
Боливия - Boliwia
болка - ból, bolączka
болнав - chorowity
болница - szpital
болничен - szpitalny
болт - bolec, sworzeń
боля - boleć
бомба - bomba
бомбардирам - bombardować
бомбардировач - bombowiec
бонбон - cukierek
бонгос - bongosy
бор - sosna, bor
борба - walka, zapasy
борд - burta
бордюр - bordiura, krawężnik
борий - bohr
Борис - Borys
Борнео - Borneo
борса - giełda
борч - dług
босилек - bazylia
Босна - Bośnia
Босна и Херцеговина - Bośnia i Hercegowina
босокрак - bosonogi
ботаник - botanik
ботаника - botanika
ботанически - botaniczny
Ботсвана - Botswana
Ботсуана - Botswana
ботуш - but (z cholewą)
боя - farba
бояджия - farbiarz, malarz (pokojowy)
боязлив - bojaźliwy
брава - zamek (w drzwiach)
браво - brawo!
брада - broda
брадавица - brodawka
брадат - brodaty
брадва - topór
бразда - bruzda
бразилец - Brazylijczyk
Бразилия - Brazylia
бракосъчетавам - dawać ślub
бракувам - brakować, odrzucać braki
брана - brona
бранш - branża
брат - brat, bliski człowiek, przyjaciel, towarzysz, mnich w stosunku do innych mnichów, forma grzecznościowa, używana przy zwracaniu się do mężczyzny, z którym się jest wbliskich, zażyłych, przyjacielskich stosunkach
Братислава - Bratysława
братоубийствен - bratobójczy
братски - braterski, bratni, po bratersku
братство - bractwo, braterstwo
браузър - przeglądarka (internetowa)
брашнен - mączny
брашно - mąka
брег - brzeg
бреза - brzoza
брезент - brezent
бреме - brzemię
бременен - brzemienny
бременност - brzemienność, ciąża
бригада - brygada
бригантина - brygantyna
Бриджтаун - Bridgetown
бриз - bryza
брилянт - brylant
британски - brytyjski
Британски Вирджински острови - Brytyjskie Wyspy Dziewicze
брод - bród
бродерия - broderia, haft
бродяга - włóczęga, bezdomny
брой - liczba, numer czasopisma bądź gazety
бром - brom
бронебоен - przeciwpancerny
броненосец - pancernik
бронз - brąz
бронтозавър - brontozaur
бронхит - bronchit
брошка - broszka
брошура - broszura
броя - liczyć, płacić
брояч - licznik
Бруней - Brunei
брутален - brutalny
бръмбар - chrząszcz
брътвеж - gadanina, paplanina
бръчка - zmarszczka
Брюксел - Bruksela
брюнет - brunet
бряг - brzeg
Бряг на слоновата кост - Wybrzeże Kości Słoniowej
бряст - wiąz
Будапеща - Budapeszt
будизъм - buddyzm
будилник - budzik
будка - budka
буза - policzek
бузест - pucołowaty
бузуки - buzuki
бук - buk
буква - litera
буквален - dosłowny
буквар - elementarz
Букурещ - Bukareszt
булдог - buldog
булдозер - buldożer
булевард - bulwar
бумтеж - huk
бунар - studnia
бункер - bunkier
бунт - bunt
Бургас - Burgas
буре - baryłka, beczułka
бурен - burzliwy
буржоазен - burżuazyjny
буржоазия - burżuazja
буркан - słoik
Буркина Фасо - Burkina Faso
бурма - śruba
Бурунди - Burundi
буря - burza
Бурятия - Buriacja
бут - udziec, udo
бутам - pchać
бутан - butan
Бутан - Bhutan
бутилка - butelka
бутон - guzik, przycisk
буфер - bufor
бухал - puchacz
буца - bryła, gruda
бучка - bryłka, grudka, guzek
бушон - bezpiecznik
бъбрек - nerka
бъбрив - gadatliwy
бъбря - bełkotać, mamrotać
бъда - być
бъз - bez, dziki bez
бъзлив - tchórzliwy, bojaźliwy
българин - Bułgar
България - Bułgaria
българка - Bułgarka
български - bułgarski, po bułgarsku
бълха - pchła
бърдо - wzgórze, wzniesienie, bardo, płocha
бърз - szybki
бързам - śpieszyć się
бързина - szybkość, pośpiech
бързо - prędko, szybko
бързопис - stenografia
бързо пързаляне с кънки - łyżwiarstwo szybkie
бъркани яйца - jajecznica
бъркотия - zamieszanie, zamęt, bałagan
бърлога - barłóg, legowisko
бърна - warga
бърсалка - ścierka
бърша - ścierać, wycierać
бъчва - beczka
бъчвар - bednarz
бюджет - budżet
бюджетарен - budżetowy
бюджетен - budżetowy
бюрократ - biurokrata
бюрократизъм - biurokratyzm
бюрократически - biurokratyczny
бяг - bieg
бягам - uciekać, biegać
бягане - bieganie
бягане с препятствия - bieg przez płotki
бял - biały
бял дроб - płuco
Бяло море - Morze Białe
бяс - wścieklizna, wściekłość, bies
в - w
вагина - pochwa
вагон - wagon
вада - rów wodny
вадя - wydobywać, wyjmować, odejmować
важен - ważny
ваза - wazon, flakon
вазектомия - wazektomia
вайкам - biadać, lamentować
ваканционен - wakacyjny
ваканция - wakacje
валдхорна - waltornia
валиден - ważny
валута - waluta
валутен - walutowy
валя - padać (o deszczu)
вампир - wampir
вана - wanna
ванадий - wanad
вандал - wandal, Wandal
ванилия - wanilia
Вануату - Vanuatu
варвар - barbarzyńca
варварин - barbarzyńca
варварски - barbarzyński
вариант - wariant
вариация - wariacja
Варна - Warna
Варшава - Warszawa
Васил - Wasyl, imię męskie
ват - wat
Ватикан - Watykan
ватман - motorniczy, tramwajarz
ваш - wasz
вбесявам - rozwścieczać, złościć
вбивам - wbijać
вгорчавам - czynić gorzkim
вгъвам - zginać, zaginać
вдигам - podnosić
вдигане - podnoszenie
вдигане на тежести - podnoszenie ciężarów
вдлъбнат - wklęsły
вдлъбнатина - wgłębienie, wklęsłość
вдовишки - wdowi
вдървен - zdrętwiały
вдъхвам - wdychać, wpajać
вдъхновен - natchniony
вдявам - nawlekać igłę
вегетарианство - wegetarianizm
вежда - brew
вежлив - uprzejmy, grzeczny, miły
вездесъщ - wszechobecny
век - wiek
вековен - wiekowy
вексилолог - weksylolog
вексилология - weksylologia
вектор - wektor
велик - wielki
Великден - Wielkanoc
Великобритания - Wielka Brytania
великодушен - wielkoduszny
великолепен - wspaniały
величина - wielkość
велосипед - rower
вена - żyła
Венера - Wenus, Wenera
венерически - weneryczny
Венеция - Wenecja
Венецуела - Wenezuela
венецуелец - Wenezuelczyk - mieszkaniec Wenezueli
венецуелка - Wenezuelka
венецуелски - wenezuelski
вентил - wentyl
вентилатор - wentylator
венчален - ślubny
веранда - weranda
вербувам - werbować
верен - wierny, prawdziwy
вересия - kredyt
верига - łańcuch
верижка - łańcuszek
вермут - wermut
верноподанически - wiernopoddańczy
вероизповедание - wyznanie (wiary)
вероломен - wiarołomny
вероятно - prawdopodobnie
вероятност - prawdopodobieństwo
версия - wersja
вертикален - pionowy, wertykalny
весел - wesoły, uradowany
весло - wiosło
вестник - gazeta
ветеран - weteran
ветеринар - weterynarz
ветроходство - żeglarstwo
вече - już
вечен - wieczny
вечер - wieczór
вечерен - wieczorny, wieczorowy
вечеря - kolacja
вечно - wiecznie
вещ - rzecz, biegły, obeznany
веществен - rzeczowy
вещество - substancja, materia
вещина - wiedza, umiejętność, biegłość, mistrzostwo
взаимен - wzajemny
взвод - pluton
взема - wziąć
вземам - brać
взор - spojrzenie
взрив - wybuch, materiał wybuchowy
взривен - wybuchowy
вибрафон - wibrafon
видеоигра - gra wideo
видим - widoczny, widzialny
видра - wydra
вие - wy
виелица - zamieć, zawieja
Виена - Wiedeń
виенски - wiedeński
Виетнам - Wietnam
виждам - widzieć
виза - wiza
византийски - bizantyjski
Византия - Bizancjum
визита - wizyta
визитка - wizytówka
викам - krzyczeć, wołać, wzywać
вилица - widelec
Вилнюс - Wilno
вина - wina
винаги - zawsze
вино - wino
винт - śruba, wkręt
виня - obwiniać
виола - altówka
виолетов - fioletowy
виолончело - wiolonczela
Виракоча - Wirakocza
виржинал - wirginał
вирус - wirus
Висла - Wisła
висок - wysoki
високоговорител - głośnik
висококачествен - wysokogatunkowy
високопарен - górnolotny
висок скок - skok wzwyż
висота - wysokość
височина - wysokość
витаминен - witaminowy
витраж - witraż
вихър - wicher
виц - wic, dowcip
Виченца - Vicenza (miasto)
вишна - wiśnia (drzewo), wiśnia (owoc)
вковавам - wbijać
вкус - smak
вкусвам - smakować, próbować
вкусен - smaczny
влага - wilgoć
влагалище - wagina, pochwa
влагам - wkładać
владика - biskup
влажен - wilgotny, mokry
влажност - wilgotność, wilgoć
влак - pociąg
влакнест - włóknisty
влакно - włókno, włos
власат - włochaty
власт - władza
властелин - władca
вледенен - zlodowaciały
влека - wlec
влечуго - gad
влизам - wchodzić
влияние - wpływ
влиятелен - wpływowy
влог - wkład
влошавам - pogarszać
влюбен - zakochany
влюбчив - kochliwy
вляза - wejść
вменяем - poczytalny
вместо - zamiast
внезапен - nagły
внимание - uwaga
внимателен - uważny
внос - import
внук - wnuk
внучка - wnuczka
воал - woalka, woal
вода - woda
воден - wodny, wodnisty
воденичен - młyński
водка - wódka
водна топка - piłka wodna
водни ски - narciarstwo wodne
водно конче - ważka
водовъртеж - wir (wodny)
вододел - dział wód, wododział
водолаз - nurek
водолечебен - wodoleczniczy
водопад - wodospad
водопровод - wodociąg
водопроводчик - hydraulik
водоравен - poziomy
водород - wodór
военачалник - dowódca
вожд - wódz, przywódca
возило - wehikuł, środek transportu
возя - wozić, wieźć
воин - żołnierz
война - wojna
войник - żołnierz
войнишки - żołnierski
войнствен - wojowniczy
войска - wojsko
войскови - wojskowy
вол - wół, o człowieku głupiec, prostak, dziwak
Волгоград - Wołgograd
волейбол - siatkówka
волност - wolność
волт - wolt
волтметър - woltomierz
волфрам - wolfram
воля - wola
воня - smród, fetor
восък - wosk
восъчен - woskowy
вот - wotum
воювам - walczyć
впечатлителен - wrażliwy
вплитам - wplatać, wplątywać
врабец - wróbel
врабче - wróbel
враг - wróg, oponent
вражда - wrogość
враждебен - wrogi
врана - wrona
врат - kark
врата - brama, wrota
вратар - portier, bramkarz
вратовръзка - krawat
вреда - szkoda
вреден - szkodliwy
време - czas, pogoda
временен - czasowy, tymczasowy
вроден - wrodzony
връв - sznurek
връзвам - wiązać
връх - wierzchołek, szczyt
връщам - wracać
врява - wrzawa
всеизвестен - powszechnie znany
всеки - każdy
всекидневен - codzienny
вселена - wszechświat
всемирен - wszechświatowy
всемогъщ - wszechmogący
всенароден - ogólnonarodowy
всеобщ - powszechny
всесилен - wszechmocny
всестранен - wszechstronny
всесъюзен - wszechzwiązkowy
всичко - wszystko
всмуквам - wsysać
встъпвам - wstępować
втиквам - wtykać
втори - drugi
вторник - wtorek
вуйчо - wuj
вулва - srom
вулгарен - wulgarny
вулкан - wulkan
вулканичен - wulkaniczny
вход - wejście
входен - wejściowy
вцепенен - zdrętwiały
вчера - wczoraj
във - w, в
въведа - wprowadzić (np. pojęcie, termin)
въвеждам - wprowadzać
въвеждане - wprowadzenie
въвличам - wciągać
въглен - węgiel
въглерод - węgiel
възглавница - poduszka
възглед - pogląd
въздух - powietrze
възел - węzeł
възможен - możliwy
възможност - możliwość
възниквам - powstawać, tworzyć (się)
възпирам - zatrzymywać, powstrzymywać
възраст - wiek (ilość lat u człowieka)
възсин - niebieskawy
вълк - wilk
вълна - wełna, fala (wody), fala
вълнен - wełniany
вълнист - falisty
вълшебен - czarodziejski
въпрос - pytanie
върба - wierzba
вървеж - chód
вървя - iść
върколак - wilkołak
върна - wrócić, zwrócić
вътрешен - wewnętrzny
въшка - wesz
вяра - wiara
вярвам - wierzyć, ufać
вятър - wiatr
вятърничав - lekkomyślny
габардин - gabardyna
Габон - Gabon
гага - dziób
гаден - wstrętny, ohydny
гадже - dziewczyna, chłopak
газ - gaz, gaza
газета - gazeta
газиран - gazowany
газов - gazowy
гайда - dudy
гайка - nakrętka
галактика - galaktyka
галактическа година - rok galaktyczny
Галапагос - Galapagos
галерия - galeria
галий - gal
гальовен - pieszczotliwy
Гамбия - Gambia
Гана - Ghana
Ганг - Ganges
гангрена - gangrena, zgorzel
Ганимед - Ganimedes
гара - dworzec kolejowy
гараж - garaż
гаранция - gwarancja
гарван - kruk
Гаргантюа - Gargantua
гардероб - garderoba (ubrania), garderoba (szafa), szatnia
гатанка - zagadka
гаф - gafa
Гаяна - Gujana
Гваделупа - Gwadelupa
Гватемала - Gwatemala (państwo)
гватемалец - Gwatemalczyk
Гвиана - Gujana
гвинейски - gwinejski
Гвинейски залив - Zatoka Gwinejska
Гвинея - Gwinea
Гвинея-Бисау - Gwinea Bissau
гвоздей - gwóźdź
Гданск - Gdańsk
гевгир - durszlak, cedzak
гей - gej
гейзер - gejzer
ген - gen
генеалогичен - genealogiczny
генеалогия - genealogia
генерал - generał
генерален - generalny
генерация - generacja
генетика - genetyka
гениален - genialny
гений - geniusz
геноцид - ludobójstwo
географичен - geograficzny
география - geografia
географски - geograficzny
геодезия - geodezja
геология - geologia
геометричен - geometryczny
геометрия - geometria
геоморфология - geomorfologia
Георги - imię męskie
герб - godło, herb
гердан - naszyjnik, obroża
германец - Niemiec
германий - german
Германия - Niemcy
германка - Niemka
Германска демократична република - Niemiecka Republika Demokratyczna
героизъм - bohaterstwo, heroizm
героичен - bohaterski, heroiczny
герой - bohater
геройски - bohaterski
Гибралтар - Gibraltar
гигантски - gigantyczny
гиздав - urodziwy
гимназиален - gimnazjalny
гимназия - gimnazjum
гимнастика - gimnastyka
гимнастически - gimnastyczny
гинеколог - ginekolog
гинекологичен - ginekologiczny
гинекология - ginekologia
гипс - gips
глава - głowa, rozdział, przywódca (państwowy)
главен - główny
главня - głownia
главоболие - ból głowy
главоломен - karkołomny
глагол - czasownik
глаголица - głagolica
глад - głód
гладен - głodny
гладиола - mieczyk
гладна кокошка просо сънува - głodnemu chleb na myśli
гладувам - głodować
гладък - gładki
гламавщина - głupota
глас - głos
гласен - głośny, głosowy
гласувам - głosować
гласуване - głosowanie
глациология - glacjologia
гледам - oglądać
глезен - kostka (u nogi), rozpieszczony
глина - glina
глинен - gliniany
глинест - gliniasty
глицеринов - glicerynowy
глоба - grzywna, kara pieniężna
глобален - globalny
глобус - globus
глог - głóg
глокеншпил - dzwonki
глума - żart
глупав - głupi
глупак - głupiec, głupek
глупец - głupiec
глух - głuchy
глухар - głuszec
глухоням - głuchoniemy
глухота - głuchota
глътвам - połykać, pochłaniać
глътка - łyk, haust
глъчка - zgiełk, gwar
гневен - gniewny, zagniewany
гнездо - gniazdo
гнил - zgniły, zbutwiały
гноен - ropny
гном - gnom, krasnal
гностицизъм - gnostycyzm
гнусен - obrzydliwy, wstrętny
гняв - gniew, złość
говедо - bydlę
говно - gówno
говор - mowa, gwara
говоря - mówić
годеник - narzeczony
годеница - narzeczona
година - rok
годишен - roczny
годишнина - rocznica
годишно - rocznie
годолиний - gadolin
гол - goły, gol
голем - golem
големина - wielkość
голословен - gołosłowny
голота - golizna, nagość
голф - golf
голям - duży, wielki
гонг - gong
гонорея - rzeżączka, gonorea
гоня - gonić, ścigać, prześladować
гора - las
горе - na górze, w górę
горещ - gorący
горещина - gorąco, upał, zapał
гориво - paliwo
горила - goryl
горист - lesisty
Горна Волта - Górna Wolta
горчив - gorzki
горчивина - gorycz
горчица - musztarda
горя - palić się, płonąć
господар - gospodarz
господарка - gospodyni
господин - pan
господствувам - panować
госпожа - pani
гост - gość
гостолюбив - gościnny
гостоприемен - gościnny
готвач - kucharz
готвачка - kucharka
готов - gotowy, gotów
грабител - grabieżca
граблив - drapieżny
гравирам - grawerować
гравитация - grawitacja
град - miasto, grad, opad atmosferyczny
градеж - budowa, budowanie
градина - ogród
градинар - ogrodnik
градинарски - ogrodniczy
градински - ogrodowy
градски - miejski
градус - stopień (geograficzny), stopień (temperatura)
градушка - grad
гражданин - obywatel, mieszczanin
гражданска война - wojna domowa
гражданство - obywatelstwo
гракам - krakać
грам - gram
граматика - gramatyka
граматически - gramatyczny
граната - granat
гранит - granit
гранитен - granitowy
граница - granica
гранича - graniczyć
грапав - chropowaty
гратис - gratis, bezpłatnie, bilet bezpłatny
графит - grafit
графичен - graficzny
графология - grafologia
грах - groch
грахов - grochowy
гребен - grzebień
греда - belka
грейпфрут - grejpfrut
Гренада - Grenada (państwo)
Гренландия - Grenlandia
греховен - grzeszny
грешка - błąd, pomyłka
грешник - grzesznik
грива - grzywa
гривна - bransoleta, obręcz
григориански - gregoriański
грижа - troska
грижа се - troszczyć się
грижлив - troskliwy
гриза - gryźć
гризач - gryzoń
грим - makijaż
гримаса - grymas
грип - grypa
гроб - grób
гробар - grabarz
гробен - grobowy
грог - grog
грозде - winogrona
гроздов - winogronowy
грозен - brzydki
грузинец - Gruzin
грузински - gruziński, język gruziński
Грузия - Gruzja
група - grupa
групирам - grupować
групировка - ugrupowanie
групов - grupowy
гръб - grzbiet, plecy, tył
гръбнак - kręgosłup
гръбначен - kręgowy
гръден - piersiowy
грък - Grek
гръклян - krtań
гръм - grom, piorun
гръмотевица - grzmot
грънчар - garncarz
грънчарски - garncarski
гръцки - grecki, język grecki
грях - grzech
Гуам - Guam
губер - kobierzec, kilim
губернатор - gubernator
губерния - gubernia
губя - gubić, tracić
гумен - gumowy
гургулица - turkawka
гущер - jaszczurka
гъба - grzyb, gąbka
гъбен - grzybowy
гъвкав - giętki, gibki
гъделичкам - łaskotać
гъдулка - gadułka
гълтам - łykać, połykać
гълъб - gołąb
гълъбица - gołębica
гърбав - garbaty
гърбат - garbaty
гърда - pierś (kobieca)
гъркиня - Greczynka
гърлен - gardłowy
гърло - gardło
Гърнси - Guernsey
Гърция - Grecja
гърч - kurcz, spazm
гъсеница - gąsienica
гъска - gęś
гъст - gęsty
гъстота - gęstość
гътвам - przewracać
гъши - gęsi
гьол - kałuża, bajoro
гюле - kula
гюрултия - zgiełk, wrzawa
гяур - giaur
да - tak
давам - dawać
далак - śledziona
далеко - daleko
далекогледство - nadwzroczność
далече - daleko
далечен - daleki
далновиден - dalekowzroczny
дам - dać
Дамаск - Damaszek
дамски - damski
дандания - wrzawa, zgiełk
Дания - Dania
дансинг - dansing
данък - podatek
дар - dar, prezent, talent
дарба - dar, talent, uzdolnienie
дарвинизъм - darwinizm
дармщадтий - darmsztadt
даровит - utalentowany
дарявам - darować
дата - data
датирам - datować (się)
датски - duński
датчанин - Duńczyk
два - dwa, 2
двадесет - dwadzieścia, 20
дванадесет - dwanaście, 12
двегодишен - dwuletni
двигател - silnik, motor
движение - ruch
двоен - podwójny
двойка - dwójka, para
дворец - pałac
двояк - dwojaki
двубой - pojedynek
двудневен - dwudniowy
двуезичен - dwujęzyczny
двуетажен - dwupiętrowy
двузначен - dwuznaczny, dwucyfrowy
двуколка - dwukółka
двукрак - dwunogi
двукратен - dwukrotny
двуличен - dwulicowy
двумесечен - dwumiesięczny
двуседмичен - dwutygodniowy
двусмислен - dwuznaczny
двусмислица - dwuznaczność
двустаен - dwupokojowy
двустранен - dwustronny
двучасов - dwugodzinny
двучленен - dwuczłonowy, dwuosobowy
дебел - gruby
дебелоглав - uparty
дебелокож - gruboskórny
дебелоок - bezczelny
дебит - debet
девалвация - dewaluacja
девет - dziewięć
деветгодишен - dziewięcioletni
деветдесет - dziewięćdziesiąt, 90
девети - dziewiąty
деветка - dziewiątka
деветкратен - dziewięciokrotny
деветнадесет - dziewiętnaście, 19
девиация - dewiacja
девиз - dewiza
девица - dziewczę, dziewczyna
девически - dziewczęcy
деградирам - degradować
дедукция - dedukcja
деен - czynny, aktywny
дезертирам - dezerterować
дейност - działalność
действам - działać
действие - działanie, czynność, postępowanie, czyn, akt
действителност - rzeczywistość
декември - grudzień
декемврийски - grudniowy
декларация - deklaracja
декларирам - deklarować
декомпозиция - dekompozycja
декоративен - dekoracyjny
декорация - dekoracja
декорирам - dekorować
декрет - dekret
делегация - delegacja
делегирам - delegować
деликатен - delikatny
делир - delirium
дело - sprawa, robota, czyn, dzieło
делтапланеризъм - lotniarstwo
делфин - delfin
демагогски - demagogiczny
демобилизация - demobilizacja
демократичен - demokratyczny
Демократична република Конго - Demokratyczna Republika Konga
Демократична република Сао Томе и Принсипи - Demokratyczna Republika Wysp Świętego Tomasza i Książęcej
демокрация - demokracja
демон - demon
демоничен - demoniczny
демонстративен - demonstracyjny
демонстрация - demonstracja
демонстрирам - demonstrować
демонтирам - demontować
ден - dzień
департамент - departament
депресия - depresja
депутат - poseł
десен - deseń
десерт - deser
десет - dziesięć
десети - dziesiąty
десетилетие - dziesięciolecie
десетичен - dziesiętny
десетка - dziesiątka
десетобой - dziesięciobój
десетократен - dziesięciokrotny
деспотизъм - despotyzm
деспотичен - despotyczny
дестилация - destylacja
детайл - detal, szczegół
детайлен - szczegółowy
дете - dziecko
детектив - detektyw
детелина - koniczyna
детерминизъм - determinizm
детонация - detonacja
дефект - defekt
дефилирам - defilować, maszerować
дефинирам - definiować
дефинитивен - definitywny
дефиниция - definicja
дефицит - deficyt
дефицитен - deficytowy
деформация - deformacja
джавкам - szczekać, ujadać
джаз - jazz
джамия - meczet
джендем - i  piekło
Джибути - Dżibuti
джин - dżin, gin
джинджифил - imbir
джинси - dżinsy
джиросвам - żyrować
джоб - kieszeń
джудже - karzeł
джудо - dżudo
Джърси - Jersey
диагноза - rozpoznanie, diagnoza
диагонал - przekątna
диаграма - diagram, wykres
диалект - dialekt
диалектика - dialektyka
диалог - dialog
диамант - diament
диария - biegunka
диафрагма - przepona
див - dziki
диван - kanapa
диверсант - dywersant
дивидент - dywidenda
дивизион - dywizjon
дивизия - dywizja
дигам - podnosić
диета - dieta
диетичен - dietetyczny
дизайнер - projektant
диктатор - dyktator
диктатура - dyktatura
диктовка - dyktat
дилема - dylemat
дилетант - dyletant
дилетантски - dyletancki
дим - dym
диморфизъм - dymorfizm
динамит - dynamit
динамичен - dynamiczny
династия - dynastia
динозавър - dinozaur
диня - arbuz
диод - dioda
дипла - fałda
диплома - dyplom
дипломатичен - dyplomatyczny
директен - bezpośredni
директива - dyrektywa, wytyczna
директор - dyrektor
директория - folder, katalog
дирекция - dyrekcja
диригент - dyrygent
дирижирам - dyrygować
диря - ślad, trop, szukać, poszukiwać
дисертация - dysertacja
диск - dysk
дискредитирам - dyskredytować
дискретен - dyskretny
дискриминация - dyskryminacja
дискусия - dyskusja, debata
дискутирам - dyskutować
дислексия - dysleksja
дисонанс - dysonans
диспропорция - dysproporcja
диспросий - dysproz
диспут - dysputa
дистанция - dystans
дистрибуция - dystrybucja
дисциплина - dyscyplina
дисциплинарен - dyscyplinarny
дисциплинирам - dyscyplinować
дисциплиниран - zdyscyplinowany
дифракция - dyfrakcja
дифтонг - dwugłoska, dyftong
дифузия - dyfuzja
дихание - dech, tchnienie
дихателен - oddechowy
дишам - oddychać
дишане - oddychanie, oddech
длан - dłoń
длето - dłuto
дневен - dzienny
дневник - dziennik, diariusz
днес - dzisiaj
днеска - dziś, dzisiaj
днешен - dzisiejszy
до - do, przy, obok
добавка - dodatek
добавъчен - dodatkowy
добавя - dodać
доберман - doberman
добивам - uzyskiwać, otrzymywać, rodzić
добитък - dobytek, bydło, bydlę
доблестен - odważny, dzielny
добре - dobrze
доброволен - dobrowolny
добродетел - cnota, prawość
добродушен - dobroduszny
доброжелателен - życzliwy
доброта - dobroć
добро утро - dzień dobry
добър - dobry
добър вечер - dobry wieczór
добър ден - dzień dobry
доведа - doprowadzić
довеждам - doprowadzać
доверие - zaufanie
довиждане - do widzenia
довод - dowód
довоенен - przedwojenny
доволен - zadowolony
довършвам - dokańczać
догадка - domysł
догма - dogmat
догматичен - dogmatyczny
договор - umowa, porozumienie
доживотен - dożywotni
доживявам - dożywać
доисторически - przedhistoryczny
доказвам - wykazywać, udowadniać
докача - dosięgnąć, dotknąć, obrazić
доклад - odczyt, wykład, referat
докосвам - dotykać
доктор - doktor
докторски - doktorski
доктрина - doktryna
документ - dokument
документален - dokumentalny
документирам - dokumentować
долар - dolar
долепвам - dolepiać
долина - dolina
долнокачествен - niskogatunkowy
долу - na dole, na dół
дом - dom
домат - pomidor
доматен - pomidorowy
домашен - domowy
Доминика - Dominika
Доминиканска република - Dominikana, Republika Dominikańska
доминикански - dominikański
доминирам - dominować
доморасъл - domorosły
домра - domra
донасям - donosić
донос - donos
допирам - dotykać
допотопен - przedpotopowy
допра - dotykać
допринасям - przyczyniać się
допускам - dopuszczać, przypuszczać
допустим - dopuszczalny
допълвам - dopełniać, uzupełniać
дораствам - dorastać
досада - nuda
досаден - nudny, dokuczliwy
досаждам - nudzić, dokuczać
досегашен - dotychczasowy
дословен - dosłowny
дост - przyjaciel
доста - wiele, dużo
доставка - dostarczanie, doręczanie, dostawa
достатъчен - dostateczny, wystarczający
достатъчно - dość, wystarczająco, dostatecznie
достойнство - godność
достъп - dostęp
достъпен - dostępny
дотичам - dobiec
доход - dochód
доя - doić, karmić piersią
драг - drogi, miły
драгоценен - drogocenny
дракон - smok
драматург - dramaturg, dramatopisarz
драперия - draperia
драскам - drapać
дреболия - drobiazg, błahostka
древен - starożytny
древност - starożytność
дресировач - treser
дреха - ubranie
дроб - ułamek
дрозд - drozd
друг - inny, drugi
другар - towarzysz, kolega, mąż
другарка - towarzyszka, przyjaciółka, żona
другарски - koleżeński
дружба - przyjaźń
дружелюбен - przyjazny
дружина - drużyna, batalion
друсам - trząść
дръзвам - odważać się
дръмбой - drumla
дрямка - drzemka
дублирам - dublować
дубний - dubn
дуел - pojedynek
дузина - tuzin
дума - słowo, wyraz
думам - mówić
Дунав - Dunaj
дупка - dziura
дух - duch
духам - wiać
духовен - duchowy, duchowny
духовит - dowcipny
духовитост - uduchowienie
душ - prysznic
душа - dusza, osoba
душман - wróg
дъб - dąb
Дъблин - Dublin
дъвка - guma do żucia
дъвча - żuć
дъга - tęcza
дъжд - deszcz
дъждовен - deszczowy
дъждовен червей - dżdżownica
дъждовник - salamandra
дълбок - głęboki
дълбочина - głębokość
дълг - dług, obowiązek
дълговременен - długotrwały
дългогодишен - długoletni
дългосрочен - długoterminowy
дълготраен - długotrwały
дължина - długość
дълъг - długi
дънер - pień
дървар - drwal
дървен - drewniany
дървеница - pluskwa
дървесен - drzewny
дървесина - drewno
дърво - drzewo
дърводелец - cieśla
държава - państwo
държавен - państwowy
дърпам - ciągnąć, szarpać
дъска - deska
дъх - oddech, dech
дъхав - wonny, pachnący
дъщеря - córka
дюйм - cal
дюля - pigwa (drzewo), pigwa (owoc)
дявол - diabeł
дяволски - diabelski
дядо - dziadek
дядов - dziadkowy
дял - dział, część, udział, los, dola
е - szósta litera bułgarskiego alfabetu, съм
еба - jebać, pieprzyć
евакуация - ewakuacja
евангелие - ewangelia
Евангелие - Ewangelia
евкалипт - eukaliptus
евнух - eunuch
еволюирам - ewoluować
еволюционен - ewolucyjny
еволюция - ewolucja
Евразия - Eurazja
еврейски - żydowski
евро - euro
Европа - Europa
европейски - europejski
Европейски съюз - Unia Europejska
европий - europ
евтин - tani
евфемизъм - eufemizm
егейски - egejski
Егейско море - Morze Egejskie
Египет - Egipt
египетски - egipski
егоистичен - egoistyczny
едва - zaledwie, ledwie, ledwo
един - jeden
единадесет - jedenaście, 11
единадесети - jedenasty
един за всички, всички за един - jeden za wszystkich, wszyscy za jednego
единица - jednostka
единичен - pojedynczy, jednostkowy
единодушен - jednomyślny
единствен - jedyny
единство - jedność
еднакъв - jednakowy
едничък - jedyny
едновременен - jednoczesny
едногласен - jednogłośny
едногодишен - jednoroczny
еднодневен - jednodniowy
еднозначен - jednoznaczny, jednocyfrowy
еднократен - jednorazowy
едноличен - jednoosobowy
едномесечен - jednomiesięczny
еднообразен - jednostajny, monotonny
еднореден - jednorzędowy
еднороден - jednorodny
едностаен - jednopokojowy
едноцветен - jednobarwny
едночасов - jednogodzinny
еж - jeż
ежедневен - codzienny
езеро - jezioro
език - język, część ciała, przedmiot, o podłużnym kształcie, lub w jakiś sposób przypominający tę część ciała, jęzor, serce dzwonu, lub dzwonka, dźwiękowy, naturalny system znaków, umożliwiający porozumiewanie się i mający możliwość wyrażenia całokształtu wiedzy oraz wyobrażeń na temat świata, całokształt środków wyrazu w odniesieniu do pewnej dziedziny lub pewnej osoby
езикознание - językoznawstwo
езически - pogański
Ейре - Irlandia
Еквадор - Ekwador
екватор - równik
екваториален - równikowy
Екваториална Гвинея - Gwinea Równikowa
еквивалент - ekwiwalent
екзекутирам - dokonywać egzekucji
екземпляр - egzemplarz, okaz
екип - ekwipunek, ekipa
екипаж - ekwipaż, załoga
екипирам - ekwipować
екология - ekologia
екскаватор - koparka
екскурзия - wycieczka
екслибрис - ekslibris
експанзия - ekspansja
експедирам - wysyłać, ekspediować
експедиция - ekspedycja
експеримент - eksperyment
експерт - ekspert
експлоатация - eksploatacja
експлоатирам - eksploatować
експлодирам - eksplodować
експлозия - eksplozja
експорт - eksport, wywóz
експортен - eksportowy
експортирам - eksportować
екстравагантен - ekstrawagancki
екстракт - ekstrakt, wyciąg
екстремист - ekstremista
ексцентричен - ekscentryczny
еластичен - elastyczny
елда - gryka
елеватор - elewator, podnośnik
елегантен - elegancki
елегантна масловка - maślak żółty
електрически - elektryczny
електричество - elektryczność
електролиза - elektroliza
електромагнетизъм - elektromagnetyzm
електромотор - silnik elektryczny
електрон - elektron
електроника - elektronika
елемент - pierwiastek
елементарен - elementarny
елен - jeleń
елипса - elipsa
елитен - elitarny
елов - jodłowy
елша - olsza, olcha
емайл - emalia
емблема - emblemat
ембриология - embriologia
ембрион - embrion
емиграция - emigracja
емоция - emocja
ему - emu
ендокринология - endokrynologia
енергичен - energiczny
енергия - energia
енигма - enigma
енория - parafia
ентомология - entomologia
ентропия - entropia
ентусиазиран - entuzjastyczny
енциклопедия - encyklopedia
епархия - eparchia
епидемиология - epidemiologia
епидемичен - epidemiczny
епидемия - epidemia
епилепсия - padaczka, epilepsja
епископ - biskup
епоха - epoka
епохален - epokowy
епруветка - probówka
ера - era
ербий - erb
Ереван - Erywań
еретичен - heretycki
Еритрея - Erytrea
еротика - erotyka
еротичен - erotyczny
ерудиция - erudycja
ЕС - UE (Unia Europejska)
есе - esej
есен - jesień
есенен - jesienny
есенция - esencja
ескорт - eskorta
ескортирам - eskortować
еснаф - cech, rzemieślnik
есперанто - esperanto
естествен - naturalny
естетика - estetyka
естетичен - estetyczny
естонец - Estończyk
Естония - Estonia
естонски - estoński, język estoński
естрада - estrada
етаж - piętro
етажерка - etażerka
етатизъм - etatyzm
етер - eter
етика - etyka
етикет - etykieta, nalepka
етимология - etymologia
Етиопия - Etiopia
етиопски - etiopski
етичен - etyczny
етнически - etniczny
етнография - etnografia
етнографски - etnograficzny
ето - oto
етърва - bratowa
ефект - efekt
ефикасен - skuteczny
ефирен - eteryczny
ефрейтор - starszy kapral, starszy szeregowy
ехо - echo
ехтеж - odgłos, huk
ечемик - jęczmień
ечемичен - jęczmienny
ешафод - szafot
жаба - żaba
жабешки - żabi
жадувам - pragnąć, łaknąć
жажда - pragnienie, żądza
жакет - żakiet
жалба - żal, zażalenie
жален - żałosny, smutny
жандарм - żandarm
жанр - gatunek
жанров - rodzajowy
жар - żar
жаргон - żargon
жарък - gorący
жега - upał, skwar
желан - pożądany, upragniony
желание - życzenie, pragnienie, chęć
желая - pragnąć, życzyć sobie
железен - żelazny
железничар - kolejarz
железопътен - kolejowy
желязо - żelazo
жена - kobieta, żona, małżonka
женитба - ożenek
жених - narzeczony, pan młody
женкар - kobieciarz
женски - żeński, kobiecy
женствен - kobiecy
жерав - żuraw
жертва - ofiara
жестикулация - gestykulacja
жесток - okrutny
жетон - żeton
жив - żywy
живак - rtęć
живея - żyć, mieszkać
живителен - ożywczy
живот - życie
животворен - życiodajny
животински - zwierzęcy
животно - zwierzę
животопис - biografia
живущ - zamieszkały
жигосвам - piętnować
жизнен - życiowy, żywotny
жила - żyła
жилест - żylasty
жилетка - kamizelka
жилище - mieszkanie, dom, siedziba
жилищен - mieszkaniowy, mieszkalny
жираф - żyrafa
жирафа - żyrafa
житейски - życiowy
жител - mieszkaniec
жителство - zamieszkanie
житница - spichlerz
жица - drut, nić, nitka
жлеб - wyżłobienie
жлеза - gruczoł
жлъчен - żółciowy
жлъчка - pęcherzyk żółciowy, żółć
жребец - ogier
журнал - żurnal
журналист - dziennikarz
журналистика - dziennikarstwo
жълт - żółty
жълтеникав - żółtawy
жълтеница - żółtaczka
Жълто море - Morze Żółte
жълъд - żołądź
жътвен - żniwny
за - do, na
забава - rozrywka
забавен - zabawny, rozrywkowy
забавлявам - zabawiać
забележим - dostrzegalny
забележка - uwaga, adnotacja
забелязвам - zauważać
забивам - zaczynać bić, wbijać
заблуда - błąd, omyłka
заблуждавам - wprowadzać w błąd
забождам - wtykać, przypinać
заболяване - choroba
забрава - zapomnienie
забравя - zapomnieć
забравям - zapominać
забрана - zakaz
забраня - zabronić, zakazać
забранявам - zabraniać, zakazywać
забременявам - zachodzić w ciążę
завардвам - bronić, osłaniać
заведа - zaprowadzić
завербувам - zwerbować
завеса - kurtyna, zasłona
завещавам - legować, zapisywać w testamencie
завещание - testament
завивам - zakręcać, zawijać
завиждам - zazdrościć
завирам - wścibiać, wtykać, zaczynać wrzeć
зависим - zależny, zawisły, uzależniony
завист - zawiść
завистлив - zawistny
завладявам - podbijać, opanowywać
завличам - zawlekać, porywać
завод - zakład, fabryka
заводски - fabryczny
завоевател - zdobywca
завоювам - zawojować, podbić
завчера - przedwczoraj
завързвам - zawiązywać
завъртам - zakręcać
завършвам - kończyć (się)
загадка - zagadka
загадъчен - zagadkowy
загасявам - gasić, tłumić
загивам - ginąć
заглавие - nagłówek
заглушавам - zagłuszać
заглъхвам - głuchnąć
заграждам - zagradzać, ogradzać
Загреб - Zagrzeb
загрявам - zagrzewać, ogrzewać
загуба - strata
загубвам - tracić, gubić
зад - za, pozaA
задача - zadanie
задграничен - zagraniczny
задгробен - pozagrobowy
заден - tylny
задигам - zabierać, kraść
задминавам - przewyższać, wyprzedzać
задморски - zamorski
задоволен - zadowolony
задоволявам - zadowalać
задръствам - zatykać, zapychać
задух - zaduch, upał, skwar, astma
задушавам - dusić
задушен - duszny, parny
задълбавам - zagłębiać się
задължавам - zobowiązywać
задължителен - obowiązkowy, konieczny
заек - zając
заеквам - jąkać się
заемам - zajmować
зает - zajęty
Заир - Zair
закалявам - hartować
закачалка - wieszak
закачвам - zawieszać, zahaczać, zaczepiać
заклеймявам - piętnować
заключавам - wnioskować, konkludować
заключвам - zamykać
заключение - wniosek, konkluzja
заключителен - końcowy
заковавам - wbijać, przykuwać
закон - prawo (zbiór przepisów prawnych)
закопавам - zakopywać
закопчавам - zapinać na guziki
закопчалка - zapięcie
закривам - zakrywać, skrywać
закуска - śniadanie
закърпвам - łatać, naprawiać
зала - sala
залив - zatoka, zalew
заливам - zalewać
заличавам - przekreślać, zacierać
залп - salwa
замайвам - odurzać, oszałamiać
Замбия - Zambia
замествам - zastępować
замина - pojechać, udać się (dokądś)
заминавам - wyjeżdżać
замрежвам - cerować
замръзвам - zamarzać, zastygać
замък - zamek, pałac
замърсявам - zabrudzać
замяна - zamiana, zastępstwo
занасям - zanosić
занаят - rzemiosło, fach
занаятчия - rzemieślnik
занимавам - zajmować, uczyć
запад - zachód
западам - podupadać
западен - zachodni
Западна Сахара - Sahara Zachodnia
запазвам - zachowywać, rezerwować
запалвам - zapalać, zaświecać
запалка - zapalniczka
запас - zapas, zasób, rezerwa
запетайка - przecinek
запетая - przecinek
запирам - zatrzymywać
записвам - zapisywać
запитване - zapytanie
запичам - zapiekać
заплата - płaca, pensja
заплаха - pogróżka, groźba
заплашвам - grozić, zagrażać
заплитам - zaplatać, zaplątywać
заповядвам - rozkazywać
заподозирам - podejrzewać
започвам - zaczynać, rozpoczynać
започна - zacząć
заптие - żandarm, policjant (zwłaszcza turecki)
запушалка - zatyczka, korek
зародиш - zarodek
заряд - ładunek, nabój
заслужавам - zasługiwać
засрамвам - zawstydzać
затвор - więzienie
затворник - więzień
захар - cukier
захарен - cukrowy
зашивам - zaszywać, zszywać, przyszywać
защита - obrona, ochrona
защитник - obrońca
защо - dlaczego?, po co?, na co?
защото - ponieważ, dlatego, że…
заявявам - oświadczać, zawiadamiać
заяждам - zaczynać jeść
звезда - gwiazda
звезден куп - gromada gwiazd
зверски - zwierzęcy
звук - dźwięk
звуков - dźwiękowy
звукозапис - nagrywanie dźwięku
звукооператор - dźwiękowiec, realizator dźwięku
звучен - dźwięczny
звън - dźwięk, brzęk
звънец - dzwonek
звяр - zwierz, zwierzę
здание - budynek, gmach
здрав - zdrowy
здраве - zdrowie
здравей - cześć!, hej!
здрасти - cześć!
здрач - zmierzch, zmrok
зеаборгий - seaborg
зебра - zebra
зеле - kapusta
зелен - zielony
зелена мухоморка - muchomor sromotnikowy, muchomor zielonawy
зеленикав - zielonawy
зеленчуков - jarzynowy, warzywny
земеделец - rolnik
земеделие - rolnictwo
земеделски - rolniczy
земемер - mierniczy, geometra
земен - ziemski
земетресение - trzęsienie ziemi
земноводно - płaz
земя - ziemia
Земя - Ziemia
зенит - zenit, szczyt
зеница - źrenica
зестра - posag
зет - zięć, szwagier
зехтин - oliwa z oliwek
зигзаг - zygzak, gzygzak
зид - mur
зидам - murować, budować
зидар - murarz
зима - zima
Зимбабве - Zimbabwe
зимен - zimowy
златен - złoty
златист - złocisty
злато - złoto
зле - źle
злина - zło, nieszczęście
зло - zło
злоба - złość, gniew
злобен - złośliwy, zły
зловещ - złowieszczy
злополука - nieszczęśliwy wypadek
злост - złość
злоупотреба - nadużycie
злоупотребявам - nadużywać, popełniać nadużycia
злочестина - nieszczęście
змей - smok, latawiec
змиорка - węgorz
змия - wąż
знак - znak
знаме - flaga
знаменит - znamienity, znakomity
значение - znaczenie
значителен - znaczny
зная - wiedzieć, umieć
зов - zew, wezwanie
зова - wzywać, zwać
зоо- - zoo-
зоогеография - zoogeografia
зоологически - zoologiczny
зоология - zoologia
зоопланктон - zooplankton
зор - trud, przymus, potrzeba
зурна - surma
зъб - ząb
зъбец - ząb
зъболекар - dentysta
зъболекарка - dentystka
зъболекарски - dentystyczny
зъл - zły
зърно - ziarno
и - i
Иван - Iwan
ивица - pasek, pasmo, wstęga
и вълкът сит и агнето цяло - wilk syty i owca cała
игла - igła
игра - gra
играч - gracz, tancerz
играчка - zabawka
играя - grać, bawić się, tańczyć
игрище - boisko
игумен - igumen, ihumen
идвам - przychodzić, przybywać, nadchodzić
идеал - ideał
идеализъм - idealizm
идеолог - ideolog
идеология - ideologia
идея - idea
идиом - idiom
идиот - idiota
идиотизъм - idiotyzm (upośledzenie umysłowe)
идиш - jidysz
идол - bożek, idol, bożyszcze
избелявам - bieleć, płowieć
избирам - wybierać
избирател - wyborca
избирателен - wyborczy
избликвам - wytryskać, wybuchać
избор - wybór
изборен - wyborczy
избори - wybory
изброявам - wyliczać, zliczać
избухвам - wybuchać
избълвам - zwymiotować
избърборвам - mamrotać
избърсвам - wycierać, ścierać
избягвам - uciekać, unikać
извадка - wyciąg
изваждам - wydobywać, wyjmować, odejmować
изваждане - odejmowanie
изведа - wyprowadzić, doprowadzić
извеждам - wyprowadzać, doprowadzać
известен - znany
известие - wiadomość
известявам - zawiadamiać, ogłaszać
извивка - zakręt, skręt, zagięcie
извишавам - wznosić, podnosić
извличам - wyciągać, wywlekać
извод - wniosek
извор - źródło
извънземен - pozaziemski
извънредно положение - stan wyjątkowy
извървявам - przechodzić
извършвам - wykonywać
изгасвам - wygasać, zagasać
изгасявам - gasić, zagaszać
изглаждам - prasować, wygładzać
изглед - widok, wygląd, widokówka
изглеждам - oglądać, spoglądać, wyglądać
изговарям - wymawiać
изговор - wymowa
изговоря - wymówić
изгода - korzyść
изгонвам - wyganiać, wypędzać
изграждам - budować
изгрев - wschód (słońca)
изгрявам - wschodzić, świtać
изгубвам - gubić, tracić
изгубя - zgubić, stracić
издавам - wydawać
изделие - wyrób
издигам - podnosić, wznosić
издръжка - utrzymanie
издувам - nadymać
издълбавам - wydrążać, wyżłabiać
издънка - latorośl, potomek
издържам - wytrzymywać, utrzymywać
издъхвам - umierać
изискан - wytworny, wyszukany
изисквам - wymagać, domagać się
изключвам - wykluczać, wyłączać
изкопавам - wykopywać, odkopywać
изкоренявам - wykorzeniać
изкривявам - zakrzywiać, wykrzywiać
изкупвам - okupywać, wykupywać
изкупувам - odkupywać, wykupywać
изкусител - kusiciel
изкуство - sztuka
изкушавам - kusić, zachęcać
изкъртвам - wyłamywać, wyrywać
излизам - wychodzić, występować
излишен - zbędny, niepotrzebny
излишък - nadwyżka, nadmiar
изложба - wystawa
изляза - wyjść
измама - oszustwo, złudzenie
изменение - zmiana
измислица - wymysł
измитам - wymiatać, zmiatać
измяна - zdrada
изнасилвам - zmuszać, gwałcić
изнасям - wynosić, wywozić
изневерявам - sprzeniewierzać się, zdradzać
изненада - zaskoczenie, niespodzianka
изненадвам - zaskakiwać, robić niespodziankę
изнудвам - wymuszać
изобразявам - wyobrażać
изобретател - wynalazca
изобретателка - wynalazczyni
изобретение - wynalazek
изобретявам - wynajdywać, odkrywać
изолация - izolacja
изолирам - izolować
изопачавам - wypaczać, przekręcać
изоставам - pozostawać w tyle, zalegać
изотоп - izotop
изпивам - wypijać, wyniszczać
изпит - egzamin
изпичам - wypiekać
изпия - wypić
изплашвам - przestraszać
изплета - spleść, upleść
изплитам - splatać, wyplatać
използвам - używać, posługiwać się, stosować
изпразвам - wypróżniać
изпратя - wysłać
изпращам - wysyłać
изработвам - wyrabiać
Израел - Izrael
изречение - zdanie
изсичам - wycinać
изстрел - wystrzał
изтичам - wypływać, upływać
изток - wschód
източен - wschodni
Източен Тимор - Timor Wschodni
източник - źródło
източнокарибски - wschodniokaraibski
изтребител - samolot myśliwski, myśliwiec
изумруд - szmaragd
изумявам - zdumiewać, zapominać
изучавам - badać, studiować
изход - wyjście
изцеждам - wyciskać
изцяло - całkiem, całkowicie
изчаквам - wyczekiwać
изчезвам - znikać
изчерпвам - wyczerpywać
изчислявам - wyliczać, obliczać
изявявам - wyrażać
изяждам - zjadać
изяснявам - wyjaśniać
изящен - wytworny, piękny
икона - ikona
икономика - gospodarka
икономист - ekonomista
икономичен - ekonomiczny, oszczędny
икономия - oszczędność, ekonomia
иконопис - ikonografia
или - lub, albo
илюстрация - ilustracja
имам - mieć, posiadać, być, znajdować się, imam
име - imię, nazwa
имот - majątek
император - imperator
империя - imperium
импулс - impuls, bodziec
имунитет - immunitet
имущество - mienie, dobytek, majątek
иначе - inaczej, w innym przypadku
инвалид - inwalida
инвестирам - inwestować
инвеститор - inwestor
инвестиция - inwestycja
индианец - Indianin
индивидуално - indywidualnie
индий - ind
Индийски океан - Ocean Indyjski
индийско орехче - gałka muszkatołowa
индиректно - pośrednio
Индия - Indie
индонезийски - indonezyjski
Индонезия - Indonezja
индустрия - przemysł
инерция - inercja
инженер - inżynier
инициатива - inicjatywa
инкубация - inkubacja
иностранец - obcokrajowiec, cudzoziemiec
инсектицид - środek owadobójczy, insektycyd
инспекция - inspekcja
инстинкт - instynkt
инструкция - instrukcja
инструмент - instrument
инсулин - insulina
инсулт - udar mózgu
интеграция - integracja
интелект - intelekt
интелигентен - inteligentny
интензивен - intensywny
интензивно - intensywnie
интервал - odstęp (w przestrzeni), przerwa (w czasie), interwał
интервенция - interwencja
интерес - interes, zainteresowanie
интересен - ciekawy, interesujący
интересувам - interesować
интересувам се - interesować się
интерференция - interferencja
интонация - intonacja
интродукция - introdukcja
интуиция - intuicja
инфаркт - zawał
инфекция - infekcja
инфилтрация - infiltracja
инфинитив - bezokolicznik
инфлация - inflacja
информатика - informatyka
информация - informacja
информирам - informować
инхибитор - inhibitor
инцидент - incydent
инч - cal
ипотека - hipoteka
Ирак - Irak
Иран - Iran
иридий - iryd
ирландец - Irlandczyk
Ирландия - Irlandia
ирландски - irlandzki, język irlandzki
Ирландско море - Morze Irlandzkie
иск - powództwo
искам - chcieć
искра - iskra
искрен - szczery
исландец - Islandczyk
Исландия - Islandia
исландка - Islandka
исландски - islandzki, język islandzki
Ислямска Република Иран - Islamska Republika Iranu
ислямски - islamski
испанец - Hiszpan
Испания - Hiszpania
испански - hiszpański
истина - prawda
истински - prawdziwy
историк - historyk
исторически - historyczny
история - historia
Исус - Jezus
италианец - Włoch
италиански - włoski
Италия - Włochy
итербий - iterb
итрий - itr
ихтиология - ichtiologia
Йемен - Jemen
йероглиф - hieroglif
Йерусалим - Jerozolima
йод - jod
йонийски - joński
Йонийско море - Morze Jońskie
Йордания - Jordania
кабала - kabała
кабел - kabel
кабина - kabina
кабинет - gabinet
Кабо Верде - Republika Zielonego Przylądka
кабър - ćwiek
кавалерист - kawalerzysta
кавалерия - kawaleria
кавга - kłótnia
кавгаджия - awanturnik
кавички - cudzysłów
кадифе - aksamit
кадмий - kadm
кадънка - szczygieł
кадър - kadra
кадя - kadzić, dymić
кажа - powiedzieć
казарма - koszary
Казахстан - Kazachstan
казвам - powiedzieć
казу - mirliton
каиш - rzemień, pas
Кайманови острови - Kajmany
Каймански острови - Kajmany
Кайро - Kair
кайсия - morela
как - jak
кака - starsza siostra
какавида - poczwarka
какао - kakao
какво - co
кактус - kaktus
кал - błoto
калай - cyna
календар - kalendarz
календарен - kalendarzowy
калибър - kaliber
калиграфия - kaligrafia
калий - potas
калинка - biedronka
калифорний - kaliforn
Калифорния - Kalifornia
калкан - skarp, turbot
калкулатор - kalkulator
калкулация - kalkulacja
калкулирам - kalkulować
калник - błotnik
калоричен - kaloryczny
калория - kaloria
калпав - zły, kiepski
калугер - zakonnik
калугерка - zakonnica
калфа - czeladnik
калций - wapń
калъф - pokrowiec, futerał
кама - sztylet
камара - parlament
камбана - dzwon
камбанария - dzwonnica
Камбоджа - Kambodża
каменар - kamieniarz
каменен - kamienny
Камерун - Kamerun (państwo)
камила - wielbłąd
камион - ciężarówka, samochód ciężarowy
кампания - kampania
камуфлаж - kamuflaż
камък - kamień
кана - dzban
канавка - rynsztok
Канада - Kanada
канал - kanał
канализирам - kanalizować
канап - szpagat, sznurek
канара - skała
канарист - skalisty
канарски - kanaryjski
Канарски острови - Wyspy Kanaryjskie
канарче - kanarek
кандидат - kandydat
кандидатура - kandydatura
канела - cynamon
канибализъм - kanibalizm
канонизация - kanonizacja
кантар - waga
канцелария - kancelaria
капак - pokrywa, wieko
капан - potrzask, pułapka
Капернаум - Kafarnaum
капитал - kapitał
капитализъм - kapitalizm
капиталист - kapitalista
капитан - kapitan
капитулация - kapitulacja
капитулирам - kapitulować
капка - kropla, kapka
каприз - kaprys
капризен - kapryśny
карабина - karabin
каракуда - karaś
карамел - karmel
карамелен - karmelowy
карамфил - goździk
караница - kłótnia
карат - karat
карате - karate
караул - warta, straż
кардамон - kardamon
кардинален - kardynalny
кардиология - kardiologia
Карелия - Karelia
карибски - karaibski
Карибско море - Morze Karaibskie
кариерист - karierowicz
карийон - carillon, karylion
карикатура - karykatura
карикатурен - karykaturalny
карнавал - karnawał
карта - mapa, karta
картечница - karabin maszynowy
картина - obraz, malowidło
картоиграч - karciarz
картон - karton, tektura
картоф - ziemniak
каруца - wóz
карфиол - kalafior
каса - kasa
касапин - rzeźnik
касиер - kasjer
касис - czarna porzeczka
каскет - kaszkiet
каспийски - kaspijski
Каспийско море - Morze Kaspijskie
каста - kasta
кат - piętro, warstwa
каталог - katalog
каталонски - kataloński, język kataloński
Катар - Katar
катастрофа - katastrofa
категория - kategoria
катедрала - katedra
катерица - wiewiórka
като - jak, niczym
кафе - kawa
кафене - kawiarnia
кафяв - brązowy
каца - kadź, beczka
кашалот - kaszalot
кашкавал - kaszkawał
кашлица - kaszel
квадрат - kwadrat
квартира - mieszkanie
квас - kwas chlebowy
кедров - cedrowy
Кейптаун - Kapsztad
келнер - kelner
келнерка - kelnerka
келтски - celtycki
кенгуру - kangur
кенийски - kenijski
Кения - Kenia
керамика - ceramika
керкенез - pustułka
кефал - kleń
кехлибар - bursztyn
кибрит - zapałki, zapałka
киви - kiwi
Киев - Kijów
килер - spiżarnia, piwnica, komórka
килим - kilim
килограм - kilogram
километър - kilometr
ким - kminek
кинжал - kindżał
кино - kino
кипарис - cyprys
Кипър - Cypr
кипърска турска република - Turecka Republika Cypru Północnego
Киргизстан - Kirgistan
Кирибати - Kiribati
кирилица - cyrylica
кирпич - cegła
кисел - kwaśny
киселец - szczaw
кислород - tlen
кит - wieloryb
Китай - Chiny
Китайска народна република - Chińska Republika Ludowa
китайски - chiński, język chiński
китара - gitara
клавесин - klawesyn
клавиатура - klawiatura
клавикорд - klawikord
кладенец - studnia
кларинет - klarnet
клас - klasa (np. w szkole), klasa (jakości), kłos
класификация - klasyfikacja
класицизъм - klasycyzm
клевета - oszczerstwo
клен - klon
клепач - powieka
клетва - przysięga, klątwa, przekleństwo
клетка - komórka
клещи - kleszcze, obcęgi
клиент - klient
климат - klimat
климатология - klimatologia
клин - klin
клиника - klinika
клитор - łechtaczka
клуб - klub
клуп - pętla, kluczka
клюн - dziób
ключ - klucz
ключалка - zamek (w drzwiach), dziurka od klucza
ключица - obojczyk
кмет - burmistrz
книга - książka
книговезец - introligator
книжарница - księgarnia
княгиня - księżniczka
княз - książę
коалиция - koalicja
кобалт - kobalt
кобила - kobyła
ковач - kowal
ковчег - trumna, skrzynia
кога - kiedy
когато - kiedy, gdy
кожа - skóra
кожух - kożuch, futro
коза - koza
козел - kozioł
Козирог - Koziorożec
козметичен - kosmetyczny
кой - kto
който - który
кокал - kość
кокос - kokos
кокосов орех - kokos
кокошка - kura, kokoszka
кол - kołek, kół
кола - samochód, coca cola, rodzaj napoju
колан - pas
колба - kolba
колбас - kiełbasa, salami
колега - kolega
Коледа - Boże Narodzenie
колектив - kolektyw, zespół
колело - rower
колесница - rydwan
количество - ilość
колко - ile
колоездене - kolarstwo
колона - kolumna
колония - kolonia
Колумб - Kolumb (odkrywca)
колумбиец - Kolumbijczyk
колумбийски - kolumbijski
коляно - ścięgno, pokolenie
команда - komenda, rozkaz, oddział
командване - dowództwo, dowodzenie
комар - komar
комбинация - kombinacja
комбинирам - kombinować
комедия - komedia
коментар - komentarz
комерсиален - komercyjny
комета - kometa
комин - komin
комисия - komisja
комитет - komitet
Коморски острови - Komory
компания - towarzystwo, paczka, kompania, spółka
компаньон - kompan, towarzysz
компас - kompas
компетентен - kompetentny
компетенция - kompetencja
комплект - komplet
компрометирам - kompromitować
компютър - komputer
компютърен - komputerowy
комунизъм - komunizm
комунист - komunista
комутация - komutacja
комшия - sąsiad
кон - koń
конвенция - konwencja
Конго - Kongo (państwo)
конгрес - kongres
кондуктор - konduktor
конен - konny
конен спорт - jeździectwo
конец - nitka
конкурс - konkurs
коноп - konopie
консервирам - konserwować
конспирация - konspiracja
конституция - konstytucja
консумирам - konsumować
контингент - kontyngent
континент - kontynent
контрабас - kontrabas
контракт - kontrakt, umowa
контраст - kontrast
контрол - kontrola
контрола - kontrola
конус - stożek
конференция - konferencja
конфитюр - konfitura
конформизъм - konformizm
конхология - konchiologia
концепция - koncepcja
концерт - koncert
кончина - zgon
координата - współrzędna
копая - kopać, wykopywać
Копенхаген - Kopenhaga
копие - włócznia, kopia, oszczep
копирам - kopiować
копито - kopyto
коприва - pokrzywa
коприна - jedwab (przędza), jedwab (tkanina)
копринарка - jemiołuszka
копринен - jedwabny
копче - guzik
копър - koper
кора - kora
кораб - statek
корал - koral
коралов - koralowy
Коралово море - Morze Koralowe
Коран - Koran
Корейска народнодемократична република - Koreańska Republika Ludowo-Demokratyczna
корейски - koreański, język koreański
коректен - poprawny, bez zarzutu
корем - brzuch
корен - korzeń
кореспонденция - korespondencja
Корея - Korea
кориандър - kolendra
коридор - korytarz
корито - koryto
корица - okładka
корона - korona
корпорация - korporacja
корпус - korpus
корупция - korupcja
кос - kos
коса - włosy
косатка - orka
космология - kosmologia
космонавт - kosmonauta
космос - kosmos
Косово - Kosowo
кост - kość
Коста Рика - Kostaryka
костариканец - Kostarykanin
костенурка - żółw
костюм - kostium
косъм - włos
котак - kocur
котарак - kot, kocur
котва - kotwica
Кот д'Ивоар - Wybrzeże Kości Słoniowej
котка - kot
кото - koto
кофа - wiadro
коч - tryk, baran
кош - kosz
кошмар - koszmar
кошница - koszyk
кошуля - koszula
крава - krowa
крада - kraść
кражба - kradzież
край - koniec, kraniec
крайбрежие - wybrzeże
крак - noga
Краков - Kraków
крал - król
кралица - królowa
кралски - królewski
кралство - królestwo
крамола - kłótnia, sprzeczka, bunt
кран - kran
красавица - piękność, piękna kobieta
красив - piękny
краска - kolor, barwa
красота - uroda, piękno, piękność
краставица - ogórek
кратък - krótki
крачол - nogawka
креативен - kreatywny
креда - kreda
кредитор - wierzyciel
крем - krem
кремък - krzemień
кренвирш - parówka
крепост - twierdza
криза - kryzys
крикет - krykiet
крило - skrzydło
криптон - krypton
кристал - kryształ
кристален - kryształowy
критик - krytyk
крокодил - krokodyl
круша - grusza (drzewo), gruszka (owoc)
кръв - krew
кръг - krąg, koło, zakres
кръгъл - okrągły
кръпка - łatka
кръст - krzyż
кръстопът - skrzyżowanie
ксенон - ksenon
ксилофон - ksylofon
Куала Лумпур - Kuala Lumpur - stolica Malezji
куб - sześcian
Куба - Kuba
кубизъм - kubizm
Кувейт - Kuwejt
кукувица - kukułka
кукуригам - piać
кула - wieża
култ - kult
култура - kultura
културизъм - kulturystyka
кумир - bożyszcze, idol
купец - handlowiec, kupiec
купол - kopuła
купон - impreza
купувам - kupować
купя - kupić
кураж - odwaga
курва - prostytutka, kurwa
курорт - kurort, uzdrowisko
курс - kurs
кускус - kuskus
кусур - wada, defekt
кутия - pudełko, puszka
кухня - kuchnia (pomieszczenie), kuchnia (zbiór dań charakterystycznych dla danej narodowości)
куче - pies
кучка - suka
къдрав - kędzierzawy
кълбо - kula, kłębek
кълбообразен - kulisty
кълвач - dzięcioł
къпина - jeżyna (krzew), jeżyna (owoc)
къпя - kąpać
кърлинг - curling
кърсердар - dowódca wiejskiej / polowej policji (za czasów tureckich)
къртица - kret
къс - krótki (o przestrzeni)
късно - późno
къща - dom
кюрий - kiur
лабиринт - labirynt
лаборант - laborant
лабораторен - laboratoryjny
лаборатория - laboratorium
лавандула - lawenda
лавина - lawina
лагер - obóz, łożysko
лазер - laser
лазурен - lazurowy
лай - szczekanie, ujadanie
Лайпциг - Lipsk
лак за нокти - lakier do paznokci
лаконичен - lakoniczny
лактаза - laktaza
лакът - łokieć
лалугер - suseł
Ла Манш - kanał La Manche
лампа - lampa
лански - zeszłoroczny
лантан - lantan
Лаос - Laos
лаптоп - laptop, notebook
ларинкс - krtań
латвиец - Łotysz
латвийски - łotewski, język łotewski
Латвия - Łotwa
латерна - lira korbowa
латински - łaciński
лауреат - laureat
лебед - łabędź
лев - lew
левица - lewica
левичарски - lewicowy
легален - legalny
легализирам - legalizować
легенда - legenda
легло - łóżko
лед - lód
лежа - leżeć
лежбище - legowisko, leże
лейтенант - podporucznik
лек - lekki, łatwy, lek, lekarstwo
лека атлетика - lekkoatletyka, lekka atletyka
лекар - lekarz
лекарски - lekarski
лекарство - lek, lekarstwo
лекоатлетически - lekkoatletyczny
лековерен - łatwowierny
лековит - leczniczy
лекомислен - lekkomyślny
лекция - wykład
леля - ciocia
ленен - lniany
ленив - leniwy
лента - taśma, wstążka
леопард - lampart, leopard
лепило - klej
лес - las
лесбийка - lesbijka
лесен - łatwy, lekki
лесничей - leśniczy
лесно - łatwo
Лесото - Lesotho
летен - letni
летец - lotnik
летище - lotnisko
летлив - lotny
летя - lecieć
лечебен - leczniczy
леш - padlina
лешник - orzech laskowy
лешояд - sęp
леща - soczewica, soczewka
лещарка - jarząbek
ли - czy
либерален - liberalny
либерализъм - liberalizm
Либерия - Liberia
либийски - libijski
Либия - Libia
ливада - łąka
Ливан - Liban
лидер - lider
лижа - lizać
ликопен - likopen
лимон - cytryna
лимонен - cytrynowy
лимфа - limfa
лин - lin
лингвистика - lingwistyka
линеен - liniowy
липа - lipa
липан - lipień
липса - brak
лира - lira
Лисабон - Lizbona
лисица - lis
лиска - łyska
лист - liść
Литва - Litwa
литераторски - literacki
литература - literatura
литий - lit
литовец - Litwin
литовски - litewski, język litewski
литър - litr
лихва - procent
Лихтенщайн - Liechtenstein
лице - twarz, oblicze
лицей - liceum
лицемер - obłudnik
личен - osobisty
лично - osobiście
ловджия - łowca, myśliwy
ловен - łowiecki
ловец - łowca, myśliwy
ловкост - zręczność, zwinność
логичен - logiczny
-логия - -logia
лодка - łódka, łódź
лоза - winorośl
лозе - winnica
лой - łój
локален - lokalny
локомотив - lokomotywa
локум - rachatłukum, łokum
Лондон - Londyn
лопата - łopata
лоуренсий - lorens
лош - zły
лоялен - lojalny
луд - szalony, stuknięty
Луизиана - Luizjana
лук - cebula
луксозен - luksusowy
лула - fajka
луна - księżyc
Луна - Księżyc
лунен - księżycowy
лутеций - lutet
Лхаса - Lhasa
лъв - lew
лъвица - lwica
лъжа - łgać, kłamać, kłamstwo
лъжица - łyżka
лъжлив - kłamliwy, fałszywy
лък - łuk
лъчезарен - promienny
лъчист - promienisty
Льовен - Leuven
любезен - grzeczny, uprzejmy
любим - ulubiony
любителски - amatorski
любов - miłość
любопитен - ciekawy
любопитство - ciekawość
Люксембург - Luksemburg
люлка - kołyska, huśtawka
лют - ostry (w smaku), pikantny, ostry, wielki
лютня - lutnia
ляв - lewy
лягам - kłaść się
лястовица - jaskółka
лято - lato
мавзолей - mauzoleum
Мавритания - Mauretania
мавритански - mauretański
Мавриций - Mauritius
магазин - sklep
магазинер - sklepikarz, magazynier
магаре - osioł, idiota (wyzwisko)
магарешки - ośli
магданоз - pietruszka
магически - magiczny
магия - magia
магма - magma
магнат - magnat
магнезий - magnez
магнит - magnes
магьосник - czarodziej, mag
Мадагаскар - Madagaskar
Мадейра - Madera
маджарин - Madziar, Węgier
маджарски - madziarski, węgierski
маджун - kit
маджунирам - kitować
мазе - piwnica
мазилка - tynk
мазнина - tłuszcz
мазол - odcisk, nagniotek, modzel
май - maj
майка - matka, teściowa, źródło, przyczyna
маймуна - małpa
Майот - Majotta
майстор - mistrz, majster
майтнерий - meitner
мак - mak (roślina), mak (nasiona)
Макао - Makao
македонец - Macedończyk
Македония - Macedonia
македонски - macedoński, język macedoński
макромолекула - makromolekuła, makrocząsteczka
Малави - Malawi
Малайзия - Malezja
малакология - malakologia
малария - malaria
Малдиви - Malediwy
Мали - Mali
малина - malina (krzew), malina (owoc)
малинов - malinowy
Малки Антили - Małe Antyle
малко - trochę, mało
малодушие - małoduszność
малолетен - małoletni
малоценен - małowartościowy
Малта - Malta
малтиец - Maltańczyk
малцинство - mniejszość
малък - mały
мама - mama
мамут - mamut
манастир - klasztor
манастирски - klasztorny
манган - mangan
манго - mango
мандарина - mandarynka
мандолина - mandolina
маневрирам - manewrować
манекен - manekin
манерка - manierka
маниак - maniak
маниер - maniera
маникюр - manicure
Манила - Manila
манипулирам - manipulować
манифест - manifest
манифестация - manifestacja
мансарда - mansarda
маратон - maraton
маргарин - margaryna
маримба - marimba
марина - flota
марионетка - marionetka
марксизъм - marksizm
марксист - marksista
марксистки - marksistowski
мармалад - marmolada
Мароко - Maroko
Марс - Mars
март - marzec
мартенски - marcowy
Мартиника - Martynika
марш - marsz
маршал - marszałek
Маршалови острови - Wyspy Marshalla
маса - masa, stół, stolik
масаж - masaż
маска - maska
маслен - maślany, olejny, oliwny
маслина - oliwka
масло - masło, olej
масловка - maślak
математик - matematyk
математика - matematyka
материал - materiał
материк - kontynent
матка - macica
матрос - marynarz (stopień wojskowy, odpowiadający szeregowemu w siłach lądowych)
Маугли - Mowgli
мафия - mafia
мач - mecz
мачкам - gnieść, miąć
машина - maszyna
машинист - maszynista
мащеха - macocha
мебел - mebel
мегдан - plac
мед - miedź, miód
медал - medal
медицина - medycyna
медицински - medyczny
Медуза - Meduza
между - między
междукултурен - wielokulturowy
международен - międzynarodowy
мек - miękki, łagodny
мексиканец - Meksykanin
Мексико - Meksyk
меланхолия - melancholia
мелизъм - melizmat
мелница - młyn
мелничар - młynarz
мелодичен - melodyjny
мелодия - melodia
менделеевий - mendelew
мента - mięta
ментов - miętowy
Меркурий - Merkury
месар - rzeźnik, sprzedawca mięsa
месец - miesiąc
месечен - miesięczny
месечина - księżyc
месинг - mosiądz
месо - mięso, ciało
месояден - mięsożerny
местен - miejscowy
местожителство - miejsce zamieszkania
местоимение - zaimek
местопрестъпление - miejsce przestępstwa
мета - zamiatać
метаболизъм - metabolizm
метал - metal
метач - zamiatacz
метеор - meteor
метеорит - meteoryt
метеорология - meteorologia
метла - miotła
метод - metoda
метро - metro
метър - metr
механизация - mechanizacja
механизъм - mechanizm
механик - mechanik
механика - mechanika
механичен - mechaniczny
мехур - pęcherz, bąbel
меч - miecz
мечка - niedźwiedzica
мечок - niedźwiedź
мечта - marzenie
мечтател - marzyciel
мечтая - marzyć
ми - mój, moja, moje, swój, mi, mnie
Мианмар - Mianmar
мивка - zlewozmywak, umywalka
миг - chwila, mgnienie
мигам - migać, mrugać
мигновен - momentalny
мигрена - migrena
мизерия - nędza, podłość
микология - mykologia, mikologia
микроб - mikrob
микробиология - mikrobiologia
микроелектроника - mikroelektronika
Микронезия - Mikronezja
микрофон - mikrofon
милиардер - miliarder
милилитър - mililitr
милиметър - milimetr
милион - milion
мимоза - mimoza
мина - kopalnia, mina, minąć, przejść obok
минал - zeszły, miniony
минаре - minaret
минерал - minerał
минералог - mineralog
минералогия - mineralogia
министър - minister
министър-председател - premier
минута - minuta
миньор - górnik
мир - pokój, spokój
миризма - zapach
мирмекология - myrmekologia
мисия - misja
мисля - myśleć
мисъл - myśl, zamysł
митница - urząd celny
митничар - celnik
митология - mitologia
мишка - mysz
мия - myć
млад - młody
младост - młodość
млекар - mleczarz
млечен - mleczny
Млечен път - Droga Mleczna
мляко - mleko
мнение - mniemanie, opinia, pogląd, zdanie
много - bardzo, wiele, dużo
мобилен телефон - telefon komórkowy
мога - móc
могила - pagórek, mogiła
модел - model
модернизация - modernizacja
Мозамбик - Mozambik
мозък - mózg
мой - mój
мокър - mokry
Молдова - Mołdawia
молдовец - Mołdawianin
молдовски - mołdawski
молекула - molekuła, cząsteczka
молибден - molibden
молив - ołówek
молитва - modlitwa
моля - prosić
моля се - modlić się
мома - dziewczyna, panna
момент - moment, chwila
моментален - momentalny, chwilowy
момиче - dziewczynka
момче - chłopiec, chłopak
момък - chłopak, młodzieniec
Монако - Monako
монарх - monarcha, władca
монархия - monarchia
монах - zakonnik, mnich
Монголия - Mongolia
монета - moneta
монозахарид - monosacharyd
монумент - monument
мор - zaraza, mór
Моравия - Morawy
море - morze
морков - marchew
морски слон - słoń morski
морфема - morfem
моряк - marynarz
Москва - Moskwa
московски - moskiewski
мост - most
мотика - motyka
мра - umrzeć
мравка - mrówka
мравояд - mrówkojad
мраз - mróz, chłód
мразя - nienawidzić
мрак - mrok, ciemność
мрамор - marmur
мрежа - sieć, siatka
мръсен - brudny, wstrętny, plugawy
му - on), jego
музей - muzeum
музика - muzyka
музикален - muzyczny
музикант - muzykant, muzyk
мултикултурализъм - wielokulturowość
мура - sosna
мускул - mięsień, muskuł
мустак - wąsy
муха - mucha
мухоморка - muchomor
мъгла - mgła
мъглив - mglisty
мъглявина - mgławica
мъдрост - mądrość
мъдър - mądry
мъж - mężczyzna
мъжки - męski
мъка - męka
мълния - błyskawica
мълча - milczeć
мъничък - malutki
мързалив - leniwy
Мъртво море - Morze Martwe
мъртъв - martwy
мърша - padlina
Мюнхен - Monachium
мярка - miara, waga, miernik, kryterium
място - miejsce
мятам - miotać, rzucać
мях - miech
на - na, do
наблюдателен - spostrzegawczy, obserwacyjny
наблюдение - obserwacja, spostrzeżenie
набождам - nakłuwać, kłuć
набожен - pobożny
наборен - poborowy
навалица - tłum
навеки - na zawsze, na wieki
навестявам - odwiedzać
навирам - wpychać, wciskać
навлизам - wchodzić
наводнение - powódź
наводнявам - wylewać, zalewać
навсякъде - wszędzie
нагоре - w górę, wzwyż
Нагорни Карабах - Górski Karabach
награда - nagroda
над - nad, ponad
надебелявам - grubieć, pogrubiać
надежда - nadzieja
надкласов - ponadklasowy
надлъжен - podłużny
надпис - napis
надпланов - ponadplanowy
наедно - razem
наем - czynsz
наемен - najemny
назад - wstecz
наздраве - na zdrowie!
назовавам - nazywać
наивен - naiwny
наистина - naprawdę, rzeczywiście
най - naj-
Найроби - Nairobi
наказание - kara
налог - podatek, opłata
наложителен - konieczny
намаление - zmniejszenie, zniżka
намеря - znaleźć
Намибия - Namibia
намирам - znajdować, odnajdywać, znajdować się
намирам се - znajdować się
напитка - picie, napój
напиша - napisać
направление - kierunek
направя - zrobić
напредничав - postępowy
напречен - poprzeczny
например - na przykład
напълно - zupełnie, całkowicie
нар - granat (owoc)
наречие - przysłówek, narzecze
наричам - nazywać
наричам се - nazywać się
наркоман - narkoman
наркотик - narkotyk
народ - naród
народен - ludowy
народнодемократичен - ludowodemokratyczny
насекомо - owad
население - ludność
наситен - nasycony
наслада - rozkosz
наследствен - dziedziczny
наследя - odziedziczyć
наследявам - dziedziczyć
насока - kierunek
наставка - przyrostek
насърчавам - dodawać otuchy, pobudzać
натискам - naciskać, nalegać
НАТО - NATO
натрий - sód
наука - nauka
Науру - Nauru
научен - naukowy
находчив - pomysłowy
нацизъм - nazizm
национализъм - nacjonalizm
начало - początek
наш - nasz
не - nie
небе - niebo, firmament, niebiosa, raj, Bóg, opatrzność
небесен - niebieski, niebiański
небесно тяло - ciało niebieskie
небивал - niebywały
неблагодарен - niewdzięczny
неблагополучен - niepomyślny
неблагоразумен - nierozsądny, nieroztropny
небостъргач - drapacz chmur
Небраска - Nebraska
небрежен - niedbały, niechlujny
небце - podniebienie
неважен - nieważny
невежлив - nieuprzejmy, niegrzeczny
невероятен - nieprawdopodobny
невесел - niewesoły
невидим - niewidoczny, niewidzialny
невинен - niewinny
невралгичен - newralgiczny
невъзможен - niemożliwy
невъзмутим - niewzruszony
неграмотен - niepiśmienny
недалновиден - krótkowzroczny
неделикатен - niedelikatny
неделя - niedziela
недисциплиниран - niezdyscyplinowany
недобър - niedobry
недоволен - niezadowolony
недоволство - niezadowolenie
недоизказан - niedomówiony
недопустим - niedopuszczalny
недостатъчен - niewystarczający, niedostateczny
незабравка - niezapominajka
независим - niezależny, niezawisły
независимост - niezależność, niepodległość, niezawisłość
немец - Niemiec
немски - niemiecki
ненавист - nienawiść
необходимост - konieczność
неодим - neodym
неон - neon
Непал - Nepal (państwo)
неприятел - nieprzyjaciel
непрозрачен - nieprzejrzysty, nieprzezroczysty
Нептун - Neptun
нептуний - neptun
нерв - nerw
неутралитет - neutralność
нефт - ropa naftowa
нещо - coś
нива - pole, niwa
Нигер - Niger
Нигерия - Nigeria
Нидерландия - Niderlandy, Holandia
Нидерландски Антили - Antyle Holenderskie
ние - my
низина - nizina
низък - nikczemny, niski
никак - wcale, w ogóle
Никарагуа - Nikaragua
никел - nikiel
никога - nigdy
нимфа - nimfa
ниобий - niob
нисък - niski
нишесте - skrobia
нишка - nitka, nić
нищо - nic
но - ale, lecz
нобелий - nobel
нов - nowy
Нова Зеландия - Nowa Zelandia
Новосибирск - Nowosybirsk
нога - noga
ноември - listopad
нож - nóż
нозология - nozologia
нокът - paznokieć
номер - numer
Норвегия - Norwegia
норвежец - Norweg
норвежка - Norweżka
норвежки - norweski
Норвежко море - Morze Norweskie
норма - norma
Нормандски острови - Wyspy Normandzkie
нос - nos, przylądek
носорог - nosorożec
носталгия - nostalgia
нота - nuta, nota (dyplomatyczna)
нотариус - notariusz
нощ - noc
нужда - potrzeba
нуждая се - potrzebować
нужен - potrzebny
нула - zero
Ню Йорк - Nowy Jork
ням - niemy
нямам - nie mieć
обаяние - czar, urok
обвинявам - oskarżać
обед - obiad
обединен - zjednoczony
Обединени арабски емирства - Zjednoczone Emiraty Arabskie
Обединено кралство - Zjednoczone Królestwo
Обединеното кралство - Zjednoczone Królestwo
обезмаслен - odtłuszczony
обект - obiekt, przedmiot
обективен - obiektywny, bezstronny, rzeczywisty
обем - objętość, zakres
обещавам - obiecywać
обещание - obietnica
обещая - obiecać
обзавеждам - urządzać, zagospodarowywać
обикновен - zwykły, pospolity
обикновена масловка - maślak zwyczajny
обикновено - zwykle
обилен - obfity
обица - kolczyk
обич - miłość
обичаен - zwykły
обичай - obyczaj, zwyczaj
обичам - kochać, lubić
облак - chmura, obłok
облачен - pochmurny, chmurny
обличам - ubierać, oblekać
обмяна - wymiana
обожавам - uwielbiać
обой - obój
образ - obraz, postać
образцов - wzorowy, wzorcowy
обратно - odwrotnie, przeciwnie
обременителен - uciążliwy
обричам - obiecywać
обряд - ceremonia
обсерватория - obserwatorium
обувка - but
обущар - szewc
обявя - ogłosić
овен - baran
овошка - drzewo owocowe
овулация - owulacja, jajeczkowanie
овца - owca
овчар - pasterz
овчарски - owczarski
овчарски скок - skok o tyczce
огледало - lustro
ограда - ogrodzenie, płot
ограничавам - ograniczać
огън - ogień
одежда - szata
одеколон - woda kolońska
одеяло - koc
одобря - zaakceptować, zaaprobować, przyjąć
озон - ozon
окапи - okapi
окарина - okaryna
океан - ocean
Океания - Oceania
око - oko
около - około
окрадвам - okradać
оксид - tlenek
окситански - oksytański, prowansalski, język oksytański, język prowansalski
октомври - październik
октопод - ośmiornica
окулист - okulista
окултация - okultacja
окултизъм - okultyzm
окуражавам - dodawać odwagi, ośmielać
олигарх - oligarcha
олимпийски - olimpijski
олио - olej
олово - ołów
олтар - ołtarz
Оман - Oman
омански - omański
омраза - nienawiść
Омск - Omsk
онзи - tamten, ów
оникс - onyks
онкология - onkologia
ООД - spółka z ograniczoną odpowiedzialnością
ООН - ONZ, Organizacja Narodów Zjednoczonych
опаковка - opakowanie
опал - opal
опасвам - opasywać
опасен - niebezpieczny
опасност - niebezpieczeństwo
опашка - ogon, ogonek, kolejka
опера - opera
операция - operacja
оперение - upierzenie
определен - określony
опустоша - spustoszyć, opustoszyć
оранжев - pomarańczowy
орбита - orbita
оргазъм - orgazm, szczytowanie
орган - narząd, organ, organy
организация - organizacja
организирам - organizować
организъм - organizm
оргия - orgia
орел - orzeł
ориз - ryż
Орион - Orion
ортография - ortografia
оръжие - broń
ос - oś
оса - osa
освен - oprócz, poza
осем - osiem
осемдесет - osiemdziesiąt, 80
осемнадесет - osiemnaście, 18
ослепявам - oślepiać
осми - ósmy
осмий - osm
основен - podstawowy, główny
оставка - dymisja
остатък - pozostałość, resztka
Остия - Ostia
остров - wyspa
островен - wyspiarski
остър - ostry
от - od, w, z (czegoś)
отбор - drużyna
отварям - otwierać
отвеждам - odprowadzać
отвличам - porywać, odciągać
отвор - otwór
отворен - otwarty
отворя - otworzyć
отвъдморски - zamorski
отговор - odpowiedź
отека - puchnąć
отец - ojciec
отивам - pójść, pojechać, udać się
отида - pójść
отичам - puchnąć
открит - odkryty, otwarty
откъде - skąd
отново - na nowo, znowu
отплата - odpłata
отравям - truć, zatruwać, odkopywać, wykopywać
отричам - zaprzeczać
отрова - trucizna
отсичам - odcinać, ścinać
отстъпка - zniżka, rabat, ustępstwo
отсъствие - nieobecność, brak
отхапвам - odgryzać
официален - oficjalny
официално - oficjalnie
охлюв - ślimak
охотски - ochocki
Охотско море - Morze Ochockie
охранител - ochroniarz
охранявам - ochraniać, strzec
оцелея - ocaleć, przetrwać
оцет - ocet
очакване - oczekiwanie
очила - okulary
още - jeszcze
падам - padać, spadać
падеж - przypadek deklinacji (forma rzeczownika cechująca jego użycie w zależności od pytania, na jakie odpowiada)
падишах - sułtan
пазар - rynek, bazar
пазач - stróż, dozorca
пак - znowu, ponownie
Пакистан - Pakistan
пакистанец - Pakistańczyk
пакост - szkoda
пакт - pakt
паладий - pallad
палатка - namiot
Палау - Palau
палач - kat
палачинка - naleśnik
Палестина - Palestyna
палестинец - Palestyńczyk
палестински - palestyński
палец - kciuk
памук - bawełna, wata
памучен - bawełniany
панаир - jarmark
Панама - Panama
панамец - Panamczyk
панделка - wstążka
пандемия - pandemia
Пандора - Pandora
панкреас - trzustka
панорама - panorama
пансексуалност - panseksualizm
пантера - pantera
папагал - papuga
папая - papaja
Папуа Нова Гвинея - Papua-Nowa Gwinea
папуняк - dudek
парабен - paraben
парагваец - Paragwajczyk
Парагвай - Paragwaj
параграф - paragraf
парадокс - paradoks
паразит - pasożyt
параклис - kaplica
парапланеризъм - paralotniarstwo
параход - parowiec, parostatek
парашут - spadochron
парашутизъм - spadochroniarstwo
пари - pieniądze
Париж - Paryż
паричен - pieniężny, płatniczy
парк - park
парламент - parlament
пародия - parodia
партизанин - partyzant
партия - partia
парфюм - perfumy
парче - kawałek
паста за зъби - pasta do zębów
пастир - pasterz
Патагония - Patagonia
патица - kaczka
патка - kaczka
патладжан - bakłażan
паток - kaczor
патриотизъм - patriotyzm
пауза - pauza, przerwa
паун - paw
пащърнак - pasternak
паяк - pająk
певец - śpiewak, piosenkarz, piewca
педиатър - pediatra
пейка - ławka
пека - piec, grzać
пекар - piekarz
Пекин - Pekin
пелена - pielucha
пемза - pumeks
пенис - penis
пепел - popiół
пепелник - popielniczka
пеперуда - motyl
пера - prać
перачка - praczka
пергел - cyrkiel
периодична таблица - układ okresowy
перо - pióro
персийски - perski
Персийски залив - Zatoka Perska
Персия - Persja
Перу - Peru
перуански - peruwiański
пес - pies
песен - piosenka, pieśń
пестя - oszczędzać
пет - pięć
пета - pięta
петдесет - pięćdziesiąt, 50
петел - kogut
пети - maj
петнадесет - piętnaście, 15
петнайсет - piętnaście
петобой - pięciobój
петрография - petrografia
петък - piątek
Петър - Piotr
печат - pieczęć, druk
пещера - jaskinia
пея - śpiewać
пианист - pianista
пиано - fortepian
пианола - pianola
пиво - piwo
пивовар - browarnik, piwowar
пикантен - pikantny
пиле - kurczak
пилот - pilot
пингвин - pingwin
пирамида - piramida
пираня - pirania
пиренейски - pirenejski
Пиренейски полуостров - Półwysep Pirenejski
писалка - pióro
писател - pisarz
писмо - list
писоар - pisuar
пистолет - pistolet
питам - pytać
питане - pytanie
питие - napój
Питсбърг - Pittsburgh (stolica Allegheny)
пица - pizza
пицария - pizzeria
пиша - pisać
пия - pić
пиявица - pijawka
плавам - pływać
плаж - plaża
плажен - plażowy
плажен волейбол - siatkówka plażowa
плазма - plazma
план - plan
планета - planeta
планетоид - planetoida
планина - góra, góry
планински - górzysty, górski
планирам - planować
платина - platyna
платно - płótno
плача - płakać
плашило - straszydło
плащам - płacić
племе - plemię
племенница - siostrzenica, bratanica
плесен - pleśń
плешив - łysy
Пловдив - Płowdiw
плод - owoc, płód
плосък - płaski
площ - powierzchnia, obszar
плувам - pływać
плуване - pływanie
плуг - pług
плутоний - pluton
плъх - szczur
плюс - plus, zaleta
плюя - pluć, wypluwać
плячка - łup, zdobycz
пневмония - zapalenie płuc
победа - zwycięstwo
поведение - zachowanie, postępowanie
повече - więcej
повличам - pociągać, wlec
повреда - uszkodzenie
повръщам - zwracać, wymiotować
повтарям - powtarzać
повярвам - uwierzyć
поганец - poganin
погледна - spojrzeć
поглеждам - spoglądać, patrzeć
поглъщам - połykać, pochłaniać
под - pod, podłoga
подарък - podarunek, prezent
подвиг - wyczyn, czyn (bohaterski)
Подгорица - Podgorica
подготовка - przygotowanie
поддръжка - poparcie, wsparcie, pomoc
подир - za, po
подиробед - popołudnie
подклаждам - rozniecać, podsycać
подкуп - łapówka
подкупвам - przekupywać
подмишница - pacha
подобен - podobny
подпиша - podpisać
поезия - poezja
поет - poeta
пожар - pożar
пожарникар - strażak
позиция - pozycja
познат - znany, znajomy
поискам - zażądać
показалец - palec wskazujący
показвам - pokazywać, wskazywać
покойник - nieboszczyk
поколение - pokolenie, generacja
покрив - dach
пола - spódnica
поле - pole, margines
полезен - pożyteczny, korzystny
Полинезия - Polinezja
политик - polityk
политика - polityka
политически - polityczny
политолог - politolog
полицай - policjant
полиция - policja
полк - pułk
полковник - pułkownik
половина - połowa
полоний - polon
полски - polski, polny
полукълбо - półkula
полунощ - północ (określenie czasu)
полуостров - półwysep
Полша - Polska
полюс - biegun
поляк - Polak
полякиня - Polka
помагам - pomagać
помежду - pomiędzy
помитам - zamiatać, zmiatać
помня - pamiętać
помощ - pomoc
поне - przynajmniej
понеделник - poniedziałek
понеже - ponieważ
понятие - pojęcie, termin, określenie, nazwa czegoś, zrozumienie, wiedza o czymś
поощрявам - zachęcać, pobudzać
поп - pop
популярен - popularny
популярност - popularność
пор - tchórz
порнографичен - pornograficzny
порнография - pornografia
порой - potok, struga, ulewa
порт - port
портокал - pomarańcza
портокалов - pomarańczowy
портрет - portret
Португалия - Portugalia
португалски - portugalski
поръча - zamówić
Посейдон - Posejdon
посещавам - odwiedzać, zwiedzać, uczęszczać
посещение - odwiedziny, wizyta, uczęszczanie, chodzenie
посланик - ambasador, poseł
после - potem, następnie
последен - ostatni
пословица - przysłowie
посока - kierunek
посолство - ambasada
постеля - pościel, posłanie, pościelić
постройка - budowla, budowa
построявам - budować, szeregować
постъпка - postępek, uczynek
поток - potok
потреба - potrzeba
похвала - pochwała
почва - gleba, grunt
почвам - zaczynać
почивка - odpoczynek, wypoczynek
почитам - czcić, szanować
почти - prawie
поща - poczta
пощальон - listonosz
появя се - pojawić się
прав - prosty, prawy, uczciwy, prawdziwy, słuszny
правда - prawda, sprawiedliwość
правилен - prawidłowy
правителство - rząd
правник - prawnik
правота - słuszność, racja
правоъгълник - prostokąt
правя - robić
праг - próg
Прага - Praga
праз - por
празен - próżny, pusty
празеодим - prazeodym
празник - święto
прасец - łydka
праскова - brzoskwinia
прах - kurz, pył, proszek, 1    пера: prałem, prałam
прахосмукачка - odkurzacz
пращам - posyłać
превеждам - przenosić, przeprowadzać, przekładać, tłumaczyć
превод - przekład, tłumaczenie
преводач - tłumacz
превръзка - opatrunek
прегръщам - obejmować
пред - przed (w przestrzeni)
преда - prząść, mruczeć
предателство - zdrada
предимно - głównie, przede wszystkim
предложение - propozycja, wniosek
предмет - przedmiot, rzecz, temat rozmowy, badania, zawartość czegoś, cel
предпазлив - ostrożny
предпочитам - woleć (coś), przedkładać (coś nad coś)
предприятие - przedsiębiorstwo, przedsięwzięcie
предричам - przepowiadać, prorokować
предсрочен - przedterminowy
представител - przedstawiciel
през - przez, w
президент - prezydent
президентски - prezydencki
презирам - pogardzać, lekceważyć
прекарам - spędzić
прекрасен - prześliczny, wspaniały
премиер - premier
премия - premia
преподавател - wykładowca
препоръка - polecenie
препятствие - przeszkoda
прераждане - reinkarnacja
пресен - świeży
пресечка - przecznica
престъпление - przestępstwo, występek
престъпник - przestępca
префектура - prefektura
приготвя - przygotować, przygotować się
Приднестровие - Naddniestrze
призная - przyznać, uznać
прилагателно - przymiotnik
прилагателно име - przymiotnik
прилеп - nietoperz
примамка - przynęta
пример - przykład
примка - pętla
принтер - drukarka
принц - książę
принцип - zasada, reguła
припев - refren
припирам - nalegać
припра - nalegać
природа - przyroda
природен - naturalny, związany z przyrodą, przyrodniczy
приспособление - przyrząd, urządzenie
приспособяване - adaptacja, akomodacja
пристанище - przystań, port, schronienie
пристигам - przyjeżdżać
пристигане - przybycie, przyjazd
пристигна - przybyć, przyjechać
прическа - fryzura
причина - przyczyna, źródło
приятел - przyjaciel
приятелка - przyjaciółka
приятелство - przyjaźń
приятен - przyjemny
проблем - problem
проверка - kontrola, sprawdzenie
провинция - prowincja
програма - program
програмист - programista
прогрес - progres, postęp
продавам - sprzedawać
продавач - sprzedawca
продажба - sprzedaż
продам - sprzedać
продукт - produkt
продукция - produkcja
продължавам - przedłużać
проект - projekt
проза - proza
прозорец - okno
прозрачен - przezroczysty, przejrzysty
произвеждам - produkować, wytwarzać
производител - producent
произношение - wymowa
произход - pochodzenie
произхождам - pochodzić, wywodzić się
проклятие - przekleństwo
прокурор - prokurator
пролет - wiosna
пролетарски - proletariacki
пролонгация - prolongata
прометий - promet
промяна - zmiana
пророк - prorok
проститутка - prostytutka
простъпка - przestępstwo, wykroczenie, występek
протактиний - protaktyn
протекторат - protektorat
протест - protest
противник - przeciwnik
протичам - przepływać, płynąć, przeciekać
проток - kanał
професия - zawód, profesja
професор - profesor
процедура - procedura
процент - procent
процес - proces
прочета - przeczytać
пружина - sprężyna
пръв - pierwszy
пръст - palec, ziemia
пръстен - pierścień
прът - pręt
пръчка - patyk, pałeczka
псевдоним - pseudonim
психология - psychologia
псувам - przeklinać
псувня - przekleństwo
птица - ptak
птицечовка - dziobak
публика - publiczność, publika
Пуерто Рико - Portoryko
пуйка - indyk
пулсар - pulsar
пура - cygaro
пурпурен - purpurowy
пусна - puścić, zapuścić
пустинен - pustynny
пустиния - pustynia
пустиня - pustynia
пуша - palić papierosy
пушка - karabin
пчела - pszczoła
пчелар - pszczelarz
пшеница - pszenica
пъб - pub
пъдпъдък - przepiórka
пъкъл - piekło
пълен - pełen, pełny
пълня - napełniać
пъп - pępek
пъпеш - melon
пъпка - pączek, pryszcz, krosta
първи - pierwszy
пъргавина - żwawość, zwinność
пързалка - ślizgawka
пъстърва - pstrąg
път - droga, raz
пътека - ścieżka, dróżka
пътник - podróżny
пътувам - jechać, podróżować
пътуване - podróż
пясък - piasek
Рабат - Rabat
раболепен - służalczy
работа - praca
работен - roboczy, pracowity
работлив - pracowity
работник - pracownik, robotnik
работнически - robotniczy
работодател - pracodawca
работоспособен - zdolny do pracy
работя - pracować
рабски - niewolniczy
равен - równy
равнина - równina
равнобедрен - równoramienny
равнодушен - obojętny
равнозначен - równoznaczny, równoważny
равномерен - równomierny
равноправен - równouprawniony
равностранен - równoboczny
радиация - radiacja, promieniowanie
радий - rad
радикален - radykalny
радио - radio
радиоактивен - radioaktywny
радон - radon
радост - radość
радостен - radosny
разбирам - rozumieć
разбойник - rozbójnik, zbójca
развалям - rozwalać, psuć
развод - rozwód
разговарям - rozmawiać, gawędzić
разговор - rozmowa
раздвоен - rozdwojony
раздяла - rozstanie, rozłąka
разлика - różnica
различен - różny, rozmaity
разменям - rozmieniać, wymieniać
размер - rozmiar, wielkość
разнообразен - zróżnicowany
разположен - położony, leżący, umiejscowiony, usytuowany, usposobiony
разстояние - odległość, dystans
разум - mądrość
рай - raj
район - region
районен - rejonowy
рак - rak (zwierzę), rak (choroba)
Рак - Rak, ♋
ракета - rakieta
ракетен - rakietowy
рамазан - ramadan
рамо - ramię
рана - rana
раница - plecak
рапира - rapier, floret
раста - rosnąć, róść
растение - roślina
растителен - roślinny
ратификация - ratyfikacja
ратифицирам - ratyfikować
рационален - racjonalny
реагент - odczynnik
реакционен - reakcyjny
реакция - reakcja
реален - realny
реалност - rzeczywistość, realność
ребро - żebro
рева - ryczeć
ревизионен - rewizyjny
ревматичен - reumatyczny
революционен - rewolucyjny
революция - rewolucja
регионален - regionalny
регистрирам - rejestrować
редник - szeregowy
режа - rżnąć, ciąć, krajać
режисьор - reżyser
резба - rzeźba
резервоар - zbiornik (np. na paliwo), pojemnik, zbiornik, rezerwuar (wody)
резолюция - rezolucja
резултат - rezultat, wynik
Рейкявик - Reykjavík
река - rzeka
реклама - reklama
реколта - zbiór, plon
рекорден - rekordowy
религиозен - religijny
религия - religia
ренде - hebel, tarka
рений - ren
рентгенов - rentgenowski
репичка - rzodkiewka
реплика - replika
република - republika
Република Зелени нос - Republika Zielonego Przylądka
Република Китай - Republika Chińska, Tajwan
Република Конго - Republika Konga, Kongo
Република Корея - Republika Korei, Korea Południowa
Република Сейшели - Republika Seszeli, Seszele
Република Южна Африка - Republika Południowej Afryki
респект - respekt
ресторан - restauracja
ресторант - restauracja
рецепта - recepta, przepis
реч - mowa
речник - słownik
решение - decyzja, rozstrzygnięcie
решетка - krata
Реюнион - Reunion, wyspa na Oceanie Indyjskim
риба - ryba
рибар - rybak
рибарка - rybitwa
рибарски - rybacki
рибен - rybny, rybi
риболовец - rybak
Рига - Ryga
риж - ryży, rudy
риза - koszula
Рим - Rzym
рима - rym
рис - ryś
риск - ryzyko
рискуват - ryzykować
рисувателен - rysunkowy
рисунка - rysunek
ритъм - rytm
рицар - rycerz
РНК - RNA
робот - robot
рог - róg
рогат - rogaty
род - ród, rodzaj
родий - rod
родина - ojczyzna
родител - rodzic
родителски - rodzicielski
родолюбив - patriotyczny
рожба - dziecko, młode
Рождество Христово - Boże Narodzenie
роза - róża
розов - różowy
рой - rój
рок - rock
рокля - suknia
роля - rola
ром - rum
роман - powieść
романтичен - romantyczny
роса - rosa
рота - kompania
Руанда - Rwanda
рубидий - rubid
рубин - rubin
рубрика - rubryka
руда - ruda
рудник - kopalnia
румънец - Rumun
Румъния - Rumunia
румънски - rumuński, język rumuński
руно - runo owcze
рус - jasnowłosy, blond, jasny (o włosach)
Русия - Rosja
Руска федерация - Federacja Rosyjska
руски - rosyjski
рутений - ruten
рушвет - łapówka
ръб - krawędź
ръдърфордий - rutherford
ръж - żyto
ръжда - rdza
ръка - ręka
ръкав - rękaw, mający formę przypominającą rękaw, ramię
ръкавица - rękawica
ръководство - kierownictwo, podręcznik
ръст - wzrost
рядко - rzadko
рядък - rzadki
с - z, ze
сабя - szabla
сайт - strona internetowa
сак - worek, torba
саксофон - saksofon
сал - tratwa
салата - sałatka
Салвадор - Salwador
сало - sadło
салон - salon, sala
сам - sam
Самара - Samara
самарий - samar
Самарканд - Samarkanda
само - tylko
Самоа - Samoa
самовар - samowar
самолет - samolot
самотен - samotny
Сана - Sana
сандал - sandał
сандък - skrzynia
санкция - sankcja
Сан Марино - San Marino
Сао Пауло - Sao Paulo
Сао Томе и Принсипи - Wyspy Świętego Tomasza i Książęca
сапун - mydło
сапфир - szafir
Сараево - Sarajewo
сардина - sardynka
Сардиния - Sardynia
сарказъм - sarkazm
сатана - szatan
Сатана - Szatan
сатира - satyra
Сатурн - Saturn
сатър - tasak
Саудитска Арабия - Arabia Saudyjska
Сахарска арабска демократична република - Saharyjska Arabska Republika Demokratyczna
САЩ - Stany Zjednoczone, USA
Свазиленд - Suazi
Свалбард - Svalbard
свастика - swastyka
сватба - wesele
светец - święty
свети - święty
светкавица - błyskawica
светлина - światło
светлинна година - rok świetlny
световен - światowy
светъл - jasny, światły
свещ - świeca
свещеник - duchowny, kapłan
свидетел - świadek
свиня - świnia
свирка - fujarka, gwizdek
свобода - wolność
свобода на словото - wolność słowa
свободен - wolny
сврака - sroka
свят - świat
сграда - budynek, gmach
се - się
север - północ
северен - północny
Северен ледовит океан - Ocean Arktyczny
Северна Америка - Ameryka Północna
Северна Африка - Afryka Północna
Северна Ирландия - Irlandia Północna
Северна Корея - Korea Północna
Северно море - Morze Północne
сега - teraz
седалище - siedziba
седем - siedem
седемдесет - siedemdziesiąt, 70
седемнадесет - siedemnaście, 17
седеф - masa perłowa
седми - siódmy
седмица - tydzień
седя - siedzieć
сезон - sezon
сеизмология - sejsmologia
Сейнт Винсент и Гренадини - Saint Vincent i Grenadyny
Сейнт Китс и Невис - Saint Kitts i Nevis
Сейнт Лусия - Saint Lucia
Сейшелски острови - Seszele
сека - ciąć, siec, ścinać
секира - siekiera
секретар - sekretarz
секс - seks
сексуална ориентация - orientacja seksualna
секта - sekta
секунда - sekunda
селен - selen
село - wieś
селска лястовица - jaskółka dymówka, dymówka
селски - wiejski, chłopski
семе - ziarno
семейство - rodzina
семка - ziarenko, nasiono
сенатор - senator
Сенегал - Senegal
сено - siano
сепаратизъм - separatyzm
септември - wrzesień
сервитьор - kelner
сержант - sierżant
сериозен - poważny
серия - seria
серотонин - serotonina
сестра - siostra, pielęgniarka, sanitariuszka, mniszka, zakonnica
си - swój, jesteś
сив - szary
сигурен - pewny, niezawodny
сигурност - bezpieczeństwo
Сиера Леоне - Sierra Leone
Сизиф - Syzyf
сила - siła
Силезия - Śląsk
силен - mocny, silny
силиций - krzem
символ - symbol
символизирам - symbolizować
симпатичен - sympatyczny
син - syn, niebieski (kolor)
синагога - synagoga
Сингапур - Singapur
синдикат - syndykat
синигер - sikora
синоним - synonim
синтагма - syntagma
синтаксис - składnia, syntaktyka
синхронен - synchroniczny
синхронно плуване - pływanie synchroniczne
сирене - ser
Сирия - Syria
сиромах - biedak
система - system, układ
сит - syty
ситар - sitar
сито - sito
ситуация - sytuacja
скала - skała
скамейка - ławka
скандал - skandal
скандий - skand
скандинавски - skandynawski
скапан - zepsuty, zgniły, parszywy
скарида - krewetka
скелет - szkielet
ски бягане - narciarstwo biegowe
скок - skok
скок на дължина - skok w dal
скорец - szpak
скорост - prędkość
скорпион - skorpion
скот - krowa
скромност - skromność
скулптор - rzeźbiarz
скумрия - makrela atlantycka
скучен - nudny
скъп - drogi, kosztowny
слаб - słaby, szczupły
слабина - pachwina
слава - sława, chwała
славянознание - slawistyka
сладкар - cukiernik
сладкарница - cukiernia
сладкарски - cukierniczy
сладкиш - ciasto, placek
сладолед - lody
сладък - słodki
слама - słoma
слана - szron
след - za, po
следвам - studiować
следобед - popołudnie
слива - śliwka
Словакия - Słowacja
словашки - słowacki, język słowacki
словенец - Słoweniec
Словения - Słowenia
словенски - słoweński
слово - słowo, wyraz
сложен - złożony, skomplikowany
слой - warstwa
слон - słoń
слонов - słoniowy
служба - praca, posada, służba, funkcja
слух - słuch
случай - wypadek, zdarzenie, sytuacja, okazja, sposobność, przypadek, traf
слушам - słuchać
слънце - słońce
Слънце - Słońce
слънчев - słoneczny
слънчоглед - słonecznik
сляп - ślepy
смел - śmiały
смелост - śmiałość
сменя - zmienić
сметана - śmietana
сметанов - śmietankowy
сметка - rachunek
смокиня - figowiec, figa (owoc)
смола - żywica, smoła
Смолян - Smolan
смрад - odór, smród
смърт - śmierć
смяна - zmiana
смях - śmiech
снаха - synowa, bratowa
снежинка - śnieżynka, płatek śniegu
снимка - zdjęcie, fotografia
сноп - snop
сноуборд - snowboard
сняг - śnieg
сова - sowa
совалка - przedramię
сойка - sójka
сок - sok
сокол - sokół
Сократ - Sokrates
сол - sól
солдат - żołnierz
солен - słony
Соломонови острови - Wyspy Salomona
сом - sum
Сомалиленд - Somaliland
Сомалия - Somalia
сорт - rodzaj, gatunek, odmiana
сортировач на вълна - zszywacz
София - Sofia
социализъм - socjalizm
социолог - socjolog
социология - socjologia
сочен - soczysty
спазване - przestrzeganie, zachowanie
спалния - sypialnia
спалня - sypialnia
спанак - szpinak
спелеология - speleologia
спестявам - oszczędzać
спечеля - zdobyć
спинет - szpinet
спирала - spirala
спирален - spiralny
спирка - przystanek
списание - czasopismo
списък - spis, lista
спокоен - spokojny
спокойствие - spokój
спор - spór, kłótnia
според - według
спорт - sport
спортен - sportowy
спортист - sportowiec
способен - zdolny
спрежение - koniugacja
спътник - satelita
спя - spać
сражение - bitwa, walka
срам - wstyd
сребрист - srebrzysty
сребро - srebro
сребърен - srebrny
сред - wśród, pośród
среда - środowisko
Средиземно море - Morze Śródziemne
средиземноморски - śródziemnomorski
среща - spotkanie
срещна - spotkać
сръбски - serbski, język serbski
сряда - środa
стабилен - stabilny
става - staw
ставам - wstawać, stawać, stawać się, robić się, dziać się, odbywać się
стадион - stadion
стадо - stado
стандарт - standard
станция - stacja
стар - stary
старец - starzec, staruszek
старица - staruszka
статистика - statystyka
статия - artykuł
статут - status
статуя - posąg, statua
стачка - strajk
стая - pokój, pomieszczenie domowe
ствол - pień, łodyga
стена - ściana
степ - step
стигам - wystarczać, dostawać
стигна - dotrzeć
стил - styl
стимулирам - stymulować
стипендия - stypendium
стипца - ałun, sknera
сто - sto, 100
Стокхолм - Sztokholm
стол - krzesło, stołówka
столар - stolarz
столетие - stulecie
столица - stolica
столова - jadalnia
стомана - stal
стомах - żołądek
стон - jęk
стоя - stać
страдание - cierpienie
страна - kraj, państwo
странен - dziwny
страница - strona
страх - strach
страшен - straszny, przerażający
стрела - strzała
стрелба - strzelectwo
стрелба с лък - łucznictwo
стрелям - strzelać
стреме - strzemię
стрина - stryjenka
стронций - stront
строя - budować
струвам - kosztować
стругар - tokarz
структура - struktura
струна - struna
струнен - strunowy
струя - struga, strumień
студен - zimny
студено - zimno
студент - student
стъклен - szklany
стъкло - szkło
стълб - słup
стъпало - stopa
стюардеса - stewardesa
стяг - chorągiew, sztandar
суахили - suahili
субективен - subiektywny, stronniczy, jednostronny, osobisty, indywidualny
суграшица - deszcz ze śniegiem
Судан - Sudan
суеверие - przesąd
сука - suka biłgorajska
султанство - sułtanat
сума - suma, kwota
супа - zupa
сура - sura
Суринам - Surinam
сутрин - rano, poranek
суфикс - sufiks, przyrostek
сух - suchy, wytrawny
сухар - suchar
сухожилие - ścięgno
суша - susza, ląd, suszyć, wysuszać
сфера - kula
сцена - scena
счетоводител - księgowy
събитие - wydarzenie
събота - sobota
съвет - rada
Съветски съюз - Związek Radziecki
съвсем - zupełnie
съгласно - zgodnie z, według
съд - naczynie, sąd
съдба - los, przeznaczenie
съдия - sędzia
Съединени американски щати - Stany Zjednoczone Ameryki
Съединени щати - Stany Zjednoczone, USA
съжалявам - żałować
съзвездие - gwiazdozbiór
създавам - stwarzać, tworzyć
съм - być
сън - sen
сънувам - śnić, śnić się
съобщение - wiadomość, komunikat, komunikacja
съперник - rywal
съпруг - mąż, małżonek
съпруга - małżonka, żona
сърбин - Serb
Сърбия - Serbia
Сърбия и Черна гора - Serbia i Czarnogóra
сърдит - gniewny, zagniewany
сърна - sarna
сърце - serce
със - z, ze
съсед - sąsiad
състезание - zawody
състоя се - składać się, zawierać
съчетание - połączenie
съществително - rzeczownik
съществително име - rzeczownik
същество - istota, żywy byt, sedno, istota (np. sprawy)
съществувам - istnieć
съществуване - istnienie
също - także, też, również
съюз - związek, sojusz, spójnik
сядам - siadać
сянка - cień
сяра - siarka
табла - tabla
таблетка - tabletka
таблица - tablica
табу - tabu
таван - sufit, strych, pułap, limit
Таджикистан - Tadżykistan
тази - ta
Тайван - Tajwan
Тайланд - Tajlandia
тайландски - tajlandzki
тайна - tajemnica
тайски - tajski
такса - taksa, opłata
таксон - takson
талий - tal
Талин - Tallinn
талк - talk
там - tam
Танзания - Tanzania
танк - czołg
тантал - tantal
танц - taniec
танцувам - tańczyć
таралеж - jeż
Тасмания - Tasmania
татко - tatko
татуировка - tatuaż
тафта - tafta
Ташкент - Taszkent
тая - ta
Тбилиси - Tbilisi
твой - twój
творчество - twórczość
твърд - twardy
театър - teatr
тебешир - kreda
теглилка - waga
тежа - ważyć
тежест - ciężar, waga
тежък - ciężki
тека - ciec, cieknąć, przeciekać, biec
текст - tekst
тел - drut
телбод - zszywacz
теле - cielę
телевизия - telewizja
телевизор - telewizor
телеграма - telegram
телескоп - teleskop
телефон - aparat telefoniczny, telefon
телефонирам - telefonować
телур - tellur
тема - temat
температура - temperatura
тенис - tenis
тениска - koszulka, T-shirt
тенис на маса - tenis stołowy
теология - teologia
теорема - twierdzenie, teoremat
теория - teoria
терапевт - terapeuta, internista
тербий - terb
територия - terytorium
термин - termin, pojęcie
терминология - terminologia
Термопили - Termopile
термос - termos
тесен - wąski, ciasny
тесто - ciasto
тетрадка - zeszyt
тетрев - cietrzew
технеций - technet
техника - technika
технология - technologia
течност - płyn
ти - ty, twój
Тибет - Tybet
тиган - patelnia
тигър - tygrys
тиква - dynia
тиквичка - cukinia
Тимор - Timor
тимпан - kocioł
тимус - grasica
тиня - muł, szlam
типичен - typowy
Тирана - Tirana
тирбушон - korkociąg
тиренски - tyrreński
Тиренско море - Morze Tyrreńskie
тис - cis
титан - tytan
Тихи океан - Ocean Spokojny
тичам - biec, biegać
тичане - bieganie, bieg
тишина - cisza
тласкане на гюле - pchnięcie kulą
тлъстина - tłuszcz
тоалетна - toaleta, ubikacja
тоалетна хартия - papier toaletowy
това - to
товар - ciężar
Того - Togo
този - ten
той - on
ток - prąd, obcas
токачка - perlica
Токио - Tokio
токсикология - toksykologia
толерирам - tolerować
тон - ton, tona
Тонга - Tonga
топ - działo, zwój, bela
топаз - topaz
топка - piłka, kula, gałka
топло - ciepło
топола - topola
топор - siekiera, topór
топъл - ciepły
торба - torba, worek
торий - tor
торта - tort, ciasto, ciastko
торф - torf
Тоскана - Toskania
тостер - toster, opiekacz
точилка - wałek do ciasta
точка - kropka, punkt
точност - dokładność
традиционно - tradycyjnie
традиция - tradycja
трактор - traktor
трамвай - tramwaj
трая - trwać
трева - trawa
тревога - obawa, lęk, trwoga, alarm
треска - dorsz
трети - trzeci
три - trzy
трибология - tribologia
тригонометрия - trygonometria
тридесет - trzydzieści, 30
тризъбец - trójząb
тринадесет - trzynaście, 13
Тринидад и Тобаго - Trynidad i Tobago
Тристан да Куня - Tristan da Cunha - archipelag na Atlantyku, Tristan da Cunha - największa wyspa w archipelagu Tristan da Cunha
трихология - trychologia
трицветен - trójkolorowy
триъгълник - trójkąt, trzy osoby
троен - potrójny
троен скок - trójskok
тролей - trolejbus
тромб - zakrzep
тромбон - puzon
тромпет - trąbka
труд - praca, trud, wysiłek
трудолюбие - pracowitość
труп - trup
трупа - trupa
трус - wstrząs
тръба - rura, trąbka
тръгвам - ruszać, wyruszać
тръгна - ruszyć
трябва - trzeba, należy, musi się
туба - tuba
тугрик - tugrik
тук - tutaj
тулий - tul
туловище - tułów
Тунис - Tunezja, Tunis
тунисец - Tunezyjczyk
туниски - tunezyjski
тупалка - trzepaczka
турист - turysta
туристически - turystyczny
туркиня - Turczynka
Туркменистан - Turkmenistan
турски - turecki, język turecki
Турция - Turcja
турчин - Turek
тухла - cegła
тъжен - smutny
тъка - tkać
тъкач - tkacz
тъмен - ciemny
тъмнина - ciemność, ciemnota
тънък - cienki
тъп - tępy, nieostry, głuchy (o dźwięku)
тъпан - bęben
търбух - żwacz
търг - przetarg, licytacja
търговец - handlowiec
търговия - handel
търговски - handlowy
Търкс и Кайкос - Turks i Caicos, wyspy na Morzu Karaibskim
търсене - szukanie, zapotrzebowanie, popyt
търся - szukać
тютюн - tytoń
тя - ona
тяло - ciało
убеждавам - przekonywać
убежище - azyl, schronienie
убивам - zabijać
убиец - zabójca, morderca
убийство - morderstwo
убит - zabity
убия - zabić, zbić, stłuc
увеличавам - zwiększać, powiększać
увертюра - uwertura
увод - wstęp (np. do książki)
уволнявам - uwalniać, zwalniać
Уганда - Uganda
уговорка - umowa, zastrzeżenie
удар - cios, uderzenie
удобен - wygodny
удрям - uderzać, bić
Уелс - Walia
Узбекистан - Uzbekistan
Уикипедия - Wikipedia
Уикиречник - Wikisłownik
уиндсърфинг - windsurfing
уиски - whisky
Украйна - Ukraina
украса - dekoracja, ozdoba
улица - ulica
ултиматум - ultimatum
ум - rozum, umysł
умен - mądry
умивалник - umywalka
умирам - umierać
умора - zmęczenie
умра - umrzeć
унгарец - Węgier
Унгария - Węgry
унгарски - węgierski, język węgierski
университет - uniwersytet
уникален - unikalny, unikatowy
униформа - mundur
унищожавам - niszczyć, unieważniać
уплашвам - przerażać
ураган - huragan
уран - uran
Уран - Uranos, Uran
уред - przyrząd, urządzenie
урок - lekcja
Уругвай - Urugwaj
условие - warunek, umowa
усмивка - uśmiech
уста - usta
устие - ujście, wylot
устна - warga
устна хармоника - harmonijka ustna
утайка - osad
утре - jutro
утро - rano, ranek, poranek
ухо - ucho
уча - uczyć
участ - los, dola
участвам - uczestniczyć, brać udział
участник - uczestnik
учебник - podręcznik
учен - uczony, wykształcony
ученик - uczeń
ученичка - uczennica
училище - szkoła
учител - nauczyciel
учителка - nauczycielka
учудя - zadziwić, zdziwić
учудя се - zdziwić się
фабрика - fabryka
фабрикация - fabrykacja
фагот - fagot
фаза - faza
фазан - bażant
факс - faks
фалцет - falset
фалшив - fałszywy
фамилия - rodzina
фантазия - fantazja
фантом - fantom
фармакология - farmakologia
фармацевт - farmaceuta
фарси - farsi
Фарьорски острови - Wyspy Owcze
фас - niedopałek (papierosa), pet
фасул - fasola
фашизъм - faszyzm
февруари - luty
федерален - federalny
Федерална Република Германия - Republika Federalna Niemiec, Niemcy
федерация - federacja
фен - fan, amator
фенилаланин - fenyloalanina
ферма - farma
фермий - ferm
фес - fez (nakrycie głowy)
фехтовка - szermierka, fechtunek
фея - czarodziejka
фигура - figura
фигурно пързаляне - łyżwiarstwo figurowe
Фиджи - Fidżi
физик - fizyk
физика - fizyka
физиология - fizjologia
физически - fizyczny
Филипини - Filipiny
филм - film
филмче - filmik
филолог - filolog
филология - filologia
философия - filozofia
филтър - filtr
филхармония - filharmonia
Финландия - Finlandia
финландски - fiński
фиорд - fiord
фирма - firma, przedsiębiorstwo, napis reklamowy nad wejściem do jakiegoś lokalu, szyld, wywieszka
флаг - flaga
флейта - flet
флигорна - skrzydłówka, flugelhorn
флора - flora
Флоренция - Florencja
Флорида - Floryda
флуор - fluor
фобия - fobia
Фолкландски острови - Falklandy - archipelag na Atlantyku
фонема - fonem
фонология - fonologia
форма - forma
фосфат - fosforan
фосфор - fosfor
фотограф - fotograf
фотография - fotografia, zdjęcie
фотьойл - fotel
фраза - fraza
франций - frans
Франция - Francja
французин - Francuz
Френска Гвиана - Gujana Francuska
Френска Полинезия - Polinezja Francuska
френски - francuski, język francuski
фризер - zamrażarka
фризьор - fryzjer
фундамент - fundament
функция - funkcja
фурма - daktyl
футбол - futbol, piłka nożna
футурология - futurologia
хабсбургски - habsburski
Хавана - Hawana
Хага - Haga
Хаити - Haiti
хайдутин - hajduk, powstaniec, buntownik, walczący z okupantem (głównie Turkami)
халва - chałwa
халифат - kalifat
хамбар - stodoła
Хамбург - Hamburg
хамелеон - kameleon
хамстер - chomik
хан - gospoda, zajazd, oberża, chan
хандбал - piłka ręczna
Ханой - Hanoi
хаос - chaos
хаплотип - haplotyp
хапя - kąsać, gryźć
характер - charakter
характерен - charakterystyczny
характеристика - charakterystyka
харесвам - podobać się, lubić
Харков - Charków
хармониум - fisharmonia
хартия - papier
хасий - has
хафний - hafn
хвана - chwycić, złapać
хвойна - jałowiec
хвърлям - rzucać
хвърляне - rzucanie, rzut
хвърляне на диск - rzut dyskiem
хвърляне на копие - rzut oszczepem
хвърляне на чук - rzut młotem
хегемония - hegemonia
хедонизъм - hedonizm
Хелзинки - Helsinki
хелий - hel
хеликоптер - helikopter, śmigłowiec
хероин - heroina
хетеросексуалност - heteroseksualizm
хигиена - higiena
хидрология - hydrologia
хиена - hiena
хиляда - tysiąc
хиляден - tysięczny
хилядолетие - tysiąclecie
Хималаи - Himalaje
химик - chemik
химикалка - długopis
химически - chemiczny
химия - chemia
хипербола - hiperbola
хиперсексуалност - hiperseksualność
хипопотам - hipopotam
хипотеза - hipoteza
хипофиза - przysadka mózgowa
хирзутизъм - hirsutyzm
хирург - chirurg
хит - hit
хитър - sprytny
хлад - chłód
хладен - chłodny, zimny
хладилник - lodówka
хлебарка - karaluch
хлебче - bułka
хлор - chlor
хляб - chleb
хмел - chmiel
хоби - hobby
ход - chód, ruch
ходя - chodzić
хокей - hokej
хокей на лед - hokej na lodzie
хокей на трева - hokej na trawie
Холандия - Holandia
холандски - holenderski
Холандски Антили - Antyle Holenderskie
холмий - holm
хомеопатия - homeopatia
хомосексуален - homoseksualny
хомосексуалност - homoseksualizm
хомяк - chomik
Хонг Конг - Hongkong
Хондурас - Honduras
хондураски - honduraski, związany z Hondurasem
хор - chór
хора - ludzie, човек, tańce (ludowe), хоро
хоризонт - horyzont
хоризонтален - poziomy, horyzontalny
хотел - hotel
храбър - dzielny, odważny, mężny
храм - świątynia
храна - jedzenie, pokarm, żywność
хранопровод - przełyk
храносмилане - trawienie
храст - krzak, krzew
хрема - katar
хризантема - chryzantema
християнин - chrześcijanin
християнка - chrześcijanka
христология - chrystologia
хром - chrom
хроника - kronika
хроничен - chroniczny
хронология - chronologia
хрущял - chrząstka
хрян - chrzan
хубав - ładny, piękny
художествен - artystyczny
художествена гимнастика - gimnastyka artystyczna
художник - artysta, malarz
хуй - chuj (penis)
хуманизъм - humanizm
хунта - junta
хълм - wzgórze, wzniesienie
Хърватия - Chorwacja
Хърватска - Chorwacja
хърватски - chorwacki
цар - car
царевица - kukurydza
царица - caryca, carowa
царство - carstwo, królestwo
цаца - szprot, potrawa ze smażonych szprotek
цвекло - burak
цвете - kwiat
цветен - kolorowy, barwny
цвят - kolor, kwiat
цедка - cedzak, durszlak, sitko
цезий - cez
цел - cel
целина - seler
целувам - całować
целулоза - celuloza
целуна - pocałować
цена - cena
цензура - cenzura
цент - cent
централен - centralny
център - centrum
церемония - ceremonia
церий - cer
цех - oddział, hala (fabryczna), cech
цивилизация - cywilizacja
цигара - papieros
цигулар - skrzypek
цигулка - skrzypce
цимбал - cymbały
цимент - cement
цинк - cynk
цирконий - cyrkon
цитат - cytat
цитра - cytra
цифра - cyfra
цунами - tsunami
църква - cerkiew, kościół
цъфтя - kwitnąć
Цюрих - Zurych
цял - cały
цяр - lek, lekarstwo
чавка - kawka
Чад - Czad
чадър - parasol
чай - herbata
чайка - mewa
чакал - szakal
чакам - czekać
чанта - torebka, torba
чапла - czapla
чаршаф - prześcieradło
час - godzina
часовник - zegar, zegarek, czasomierz
часовникар - zegarmistrz
част - część
частица - cząstka, partykuła
чат - czat, chat
чаша - szklanka, filiżanka, kubek, kieliszek
че - że
чек - czek
челеста - czelesta
челик - stal
чело - czoło
челюст - szczęka, żuchwa
червей - robak
червен - czerwony
червена мухоморка - muchomor czerwony
червен касис - czerwona porzeczka
червеногръдка - rudzik, raszka
Червено море - Morze Czerwone
черво - jelito
черен - czarny
черен дроб - wątroba
череп - czaszka
череша - czereśnia (drzewo), czereśnia (owoc)
черква - cerkiew, kościół
Черна гора - Czarnogóra - państwo w Europie
черна дупка - czarna dziura
Черно море - Morze Czarne
черта - cecha
черупка - skorupka
чеснов лук - czosnek
чест - zaszczyt, honor
честитя - powinszować
честно - szczerze, uczciwie
честота - częstotliwość
чесън - czosnek
чета - czytać
четвърти - czwarty
четвъртък - czwartek
четен - parzysty
четина - szczecina, szczeć
четири - cztery
четиридесет - czterdzieści, 40
четиридневен - czterodniowy
четиринадесет - czternaście, 14
четка - szczotka, pędzel
Чехия - Czechy
Чехословакия - Czechosłowacja
чешки - czeski, język czeski
Чикаго - Chicago
чили - chili
Чили - Chile
чин - stopień, ranga
чиния - talerz, miska
число - liczba
чист - czysty
читател - czytelnik
чифт - para, dwa egzemplarze jakiegoś przedmiotu
чичо - wuj, wujek
член - członek, penis, rodzajnik
членка - członkini, członek
членство - członkostwo
човек - człowiek
човка - dziób
чорап - skarpetka, skarpeta
чрез - poprzez, dzięki (czemuś)
чувал - worek
чувам - słyszeć, słuchać
чувство - uczucie, poczucie
чугун - żeliwo
чудесен - cudowny
чудо - cud
чудовище - stwór
чужбина - obczyzna, zagranica
чужденец - cudzoziemiec
чук - młotek
чул - derka
чупя - tłuc, łamać, łupać
чучулига - skowronek
чуя - usłyszeć
шаблон - szablon, wzornik
шаблонен - szablonowy
шайка - szajka
шал - szal
шампион - mistrz, champion
шампионат - mistrzostwo
шампоан - szampon
шанец - szaniec
шанс - szansa
шантаж - szantaż
шапка - czapka
шапкарка - modystka
шаран - karp
шарен - różnokolorowy
шарф - szalik, szal
шатра - namiot
шафер - drużba (weselny)
шах - szach
шахмат - szachy
шахматен - szachowy
шахматист - szachista
шахта - szyb
швед - Szwed
шведка - Szwedka
шведски - szwedzki
Швейцария - Szwajcaria
Швеция - Szwecja
шейна - sanie, sanki
шейх - szejk
шенг - szeng
шепа - garść (przybliżona ilość)
шепот - szept
шеснайсет - szesnaście, 16
шест - sześć, 6
шестдесет - sześćdziesiąt, 60
шести - szósty
шестнадесет - szesnaście, 16
шеф - szef
шибам - smagać
шивач - krawiec
шивачка - szwaczka
шизофреничка - schizofreniczka
шизофрения - schizofrenia
шип - kolec
шипка - róża dzika, szypszyna
ширина - szerokość
широк - szeroki
широчина - szerokość
шише - butelka
шия - szyć, szyja
шкаф - szafa
школа - szkoła
шнур - sznur
шок - szok
шоколад - czekolada
шорти - szorty, spodenki
Шотландия - Szkocja
шотландски - szkocki
шофьор - szofer, kierowca
шпация - spacja
шпионаж - szpiegostwo
шпионин - szpieg
Шпицберген - Spitsbergen
Шри Ланка - Sri Lanka
шум - szum, hałas
шума - liście, listowie
шунка - szynka
шурей - szwagier (brat żony)
шут - błazen, głupiec
ща - chcieć, życzyć sobie
щаб - sztab
щанд - stoisko
щастие - szczęście
щастлив - szczęśliwy
щат - stan (jednostka administracyjna)
щателен - staranny, szczegółowy, skrupulatny
щерка - córka
щета - szkoda, strata
щит - tarcza
щраус - struś
щука - szczupak
щурец - świerszcz
щурм - szturm
щуротия - idiotyzm, głupota
щъркел - bocian
ъглополовяща - dwusieczna
ъгъл - kąt, róg
юбилеен - jubileuszowy
юбилей - jubileusz
юбиляр - jubilat
юг - południe
югозапад - południowy zachód
югозападен - południowo-zachodni
югоизточен - południowo-wschodni
Югославия - Jugosławia
югославски - jugosłowiański
югославянин - Jugosłowianin
югославянка - Jugosłowianka
юдаизъм - judaizm
южен - południowy
Южна Америка - Ameryka Południowa
Южна Африка - Afryka Południowa
Южна Корея - Korea Południowa
Южноафриканска република - Republika Południowej Afryki
южнокитайски - południowochiński
Южнокитайско море - Morze Południowochińskie
юзда - uzda, cugle
юзина - elektrownia
юли - lipiec
юлски - lipcowy
юмрук - pięść
юнакиня - bohaterka
юни - czerwiec
юница - jałówka
юноша - młodzieniec
юношески - młodzieńczy, młodzieżowy
юнски - czerwcowy
Юпитер - Jowisz, Jupiter
юрган - kołdra
юридически - prawny, prawnie
юрисдикция - jurysdykcja
юрисконсулт - doradca prawny
юриспруденция - jurysprudencja, prawoznawstwo
юрист - prawnik
Юта - Utah
ютия - żelazko
ябълка - jabłoń, jabłko
явен - jawny, oczywisty
явор - jawor
ягода - truskawka
ягуар - jaguar
яд - gniew, złość
ядене - jedzenie, potrawa
ядивен - jadalny
ядосам - zezłościć
ядосан - zły, rozgniewany
ядосано - ze złością, gniewnie
ядосвам - złościć
ядрен - jądrowy, nuklearny
ядро - jądro
яз - jaz
язва - wrzód
язвителен - zjadliwy, złośliwy
язовец - borsuk
яйце - jajo, jajko
яйценосен - jajorodny
яйцепровод - jajowód
яйцепроводен - jajowodowy
яйчен - jajeczny, jajowy
яйчник - jajnik
як - silny, mocny
яка - kołnierz, kołnierzyk
якост - wytrzymałość
ялов - jałowy
ям - jeść
яма - jama, dół
Ямайка - Jamajka (państwo)
ямайски - jamajski
Ян Майен - Jan Mayen
януари - styczeń
януарски - styczniowy
японец - Japończyk
Япония - Japonia
японка - Japonka
японски - japoński, po japońsku
Японско море - Morze Japońskie
яребица - kuropatwa
ярко - jaskrawo
яркост - jaskrawość
ярост - wściekłość
яростен - wściekły, rozwścieczony
ярък - jaskrawy
ясен - jasny, jesion
ясла - żłób
ясно - jasno, wyraźnie
ясновидец - jasnowidz
ясновидство - jasnowidztwo, jasnowidzenie
ясност - jasność
ястие - potrawa
ястреб - jastrząb
ястребов - jastrzębi
ято - stado (ptaków)
яхвам - dosiadać
яхта - jacht
яхър - stajnia
