10è - dziesiąty
1a - pierwsza
1r - pierwszy
2n - drugi
3r - trzeci
4t - czwarty
5è - piąty
6è - szósty
7è - siódmy
8è - ósmy
9è - dziewiąty
àbac - liczydło | abakus
abadessa - przeorysza
abandó - porzucenie
abandonar - porzucać | opuszczać
abat - opat
abdicació - abdykacja
abdomen - brzuch
abdominal - brzuszny
abecedari - alfabet
Abel - Abel
abella - pszczoła
abeurar - poić (zwierzęta) | moczyć | zamaczać | namaczać | podlewać
abisme - otchłań
abolició - abolicja | zniesienie
abominable - odrażający | wstrętny
abr. - kwiecień
abreviació - skrót | skrócenie
abreviatura - skrót
abric - płaszcz
abril - kwiecień
absent - nieobecny
absolut - absolutny
absolutament - absolutnie
absolutisme - absolutyzm
absorbir - absorbować
absorció - absorpcja
abstracció - abstrakcja
abstracte - abstrakcyjny
absurd - absurdalny | absurd
acadèmia - akademia
acadèmic - akademicki
accadi - akadyjski
acceleració - przyspieszenie
accelerar - przyspieszać | przyśpieszać
accent - akcent
acceptable - do przyjęcia | zadowalający
acceptació - akceptacja
acceptar - akceptować
accessibilitat - dostępność
accidental - przypadkowy
accidentalment - przypadkowo
acció - akcja
acer - stal
àcid - kwas | kwaśny
acidesa - kwasowość
acolorir - kolorować
acord - zgoda
acordió - akordeon
acrònim - skrótowiec | akronim
actini - aktyn
actiu - aktywny
activació - aktywacja
activar - aktywować | aktywizować | uaktywnić
activitat - aktywność
actor - aktor
actriu - aktorka
actualment - obecnie
acusar - oskarżać
acústic - akustyczny
acústica - akustyka | acústic
adaptació - adaptacja
addicció - nałóg
addicional - dodatkowy
adequat - adekwatny
adéu - do widzenia
adjectiu - przymiotnik
administració - administracja
admirable - godny podziwu
adob - nawóz
adoberia - garbarnia | garbarstwo
adopció - adopcja
adoptar - adoptować
adoptiu - adoptowany | przybrany | adoptujący
adoració - adoracja
adreça - adres
Adrià - Adrian
Adriana - Adriana | Adrianna
adverbi - przysłówek
adverbial - przysłówkowy
advocat - prawnik
aerolliscador - poduszkowiec
aeroport - lotnisko
afalagar - schlebiać
Afganistan - Afganistan
afirmar - potwierdzać
aforisme - aforyzm
afortunat - szczęśliwy | mający szczęście
Àfrica - Afryka
afront - afront | zniewaga | obraz
afrontar - znieważać | obrażać
ag. - sierpień
agència - agencja
agorafòbia - agorafobia
agost - sierpień
agradar - lubić
agredir - atakować
agressió - agresja
agressiu - agresywny
agrest - wiejski
agrícola - rolniczy
agricultura - rolnictwo
àguila - orzeł
agusar - ostrzyć
ahir - wczoraj
aigua - woda
aire - powietrze
aixecar-se - podnosić się
aixeta - kran
ajuda - pomoc
ajudar - pomóc | pomagać
ajuntament - rada miejska | ratusz
al - a + el
alabastre - alabaster
Alacant - Alicante
a la quinta forca - na drugim końcu świata | gdzie diabeł mówi dobranoc
a la vegada - w tym samym czasie | naraz | jednocześnie
albanès - albański
Albània - Albania
albercoc - morela
albergínia - bakłażan
alcalde - burmistrz
alcassaba - kasba
alció - zimorodek
alcohòlic - alkoholik | alkoholowy
alcoholisme - alkoholizm
Alcorà - Koran
alè - oddech
aleatori - przypadkowy
Alemània - Niemcy
alemany - niemiecki | Niemiec
alemanya - alemany | Niemka
Alemanya - Niemcy
alenar - oddychać
aleta - płetwa
Alexandre - Aleksander
alfabet - alfabet
àlgebra - algebra
Algèria - Algieria
algo - coś
alguerès - mieszkaniec Alghero | dialekt języka katalońskiego używany w Alghero
Alícia - Alicja
all - czosnek
al·legoria - alegoria
al·lèrgia - alergia
al·lèrgic - alergiczny
al·ligàtor - aligator
al·literació - aliteracja
al·lusió - wzmianka | aluzja
almanac - almanach
almanjanec - trebusz
almenys - przynajmniej
alquímia - alchemia
alquimista - alchemik | alchemiczka
alt - wysoki | górny
altar - ołtarz
alternatiu - alternatywny
altímetre - wysokościomierz
altrament - inaczej | w przeciwnym razie
altruisme - altruizm
alumini - glin
alumna - uczennica | studentka
alumne - uczeń | student
amanida - sałatka
Amazones - Amazonka
amb - z
ambaixada - ambasada
ambaixador - ambasador
ambició - ambicja
ambiciós - ambitny
ambigüitat - niejednoznaczność
amè - przyjemny
Amèrica - Ameryka
americà - amerykański
Amèrica del Nord - Ameryka Północna
Amèrica del Sud - Ameryka Południowa
americi - ameryk
ametlla - midgał
àmfora - amfora
amhàric - amharski
amic - przyjaciel
amiloïdosi - amyloidoza | skrobiawica | betafibryloza
aminoàcid - aminokwas
amistat - przyjaźń
amistós - przyjazny
amor - miłość
ampere - amper
amperímetre - amperomierz
amperòmetre - amperomierz
ampolla - butelka
amputació - amputacja
anabolisme - anabolizm
anacronisme - anachronizm
anàlisi - analiza
analitzar - analizować
analogia - analogia
anar - iść
anarquia - anarchia
anarquisme - anarchizm
anatomia - anatomia
anatòmic - anatomiczny
àncora - kotwica
andalusí - andaluzyjski
Andalusia - Andaluzja
Andes - Andy
Andorra - Andora
ànec - kaczka
àngel - anioł
angèlic - anielski
Anglaterra - Anglia
anglès - angielski
Angola - Angola
ànima - dusza
animació - animacja
animal - zwierzęcy | zwierzę
aniversari - rocznica | urodziny
ànode - anoda
anònim - anonimowy
anormal - nienormalny
anormalitat - anormalność | nienormalność
ansietat - niepokój
ansiós - niespokojny
Antàrtida - Antarktyda
antibiòtic - antybiotyk
antic - stary
anticòs - antyciało
antídot - antidotum
antílop - antylopa
antimoni - antymon
Antoni - Antoni
antropòleg - antropolog
antropologia - antropologia
anunci - ogłoszenie | reklama
any - rok
anyal - coroczny | doroczny
aorta - aorta
apàtic - apatyczny
apatxe - Apacz
apetit - apetyt
api - seler
apiari - pasieka
apolític - apolityczny
apol·linarisme - apolinaryzm
apologitzar - przepraszać
apòstrof - apostrof
aprendre - uczyć się
aproximadament - około
aproximat - przybliżony
Aquari - Wodnik
aquàrium - akwarium
aqüeducte - akwedukt
aquell - tamten
aquest - ten
aquí - tutaj
ara - teraz | ołtarz
àrab - Arab | arabski
Aràbia Saudita - Arabia Saudyjska
aracnofòbia - arachnofobia
aragonès - aragoński
arameu - język aramejski
aranja - grejpfrut
aranya - pająk
arbitrari - arbitralny
arbitràriament - dowolnie
arbre - drzewo
arbust - krzew
arc de Sant Martí - tęcza
areng - śledź
argent - srebro
Argentina - Argentyna
argó - argon
ària - aria
Àries - Baran
aristocràcia - arystokracja
aristocràtic - arystokratyczny
Aristòtil - Arystoteles
arítmia - arytmia | zaburzenie rytmu
arma de foc - broń palna
armadillo - pancernik
armar - zbroić
Armènia - Armenia
armistici - rozejm
arner - zimorodek
arnès - uprząż
arpa - harfa
arpó - harpun
arquebisbe - arcybiskup
arqueòleg - archeolog
arqueologia - archeologia
arquer - łucznik
arquitecte - architekt
arquitectònic - architektoniczny
arquitectura - architektura
arracada - kolczyk
arrendar - wynająć
arrest - areszt
arrestar - aresztować
arribar - przybyć | zdarzyć się
arriscar - ryzykować
arrogància - arogancja
arrogant - arogancki
arròs - ryż
arsènic - arsen
artèria - arteria
article - artykuł | publikacja | rodzajnik | paragraf
artificial - sztuczny
artilleria - artyleria
arxipèlag - archipelag
ascetisme - ascetyzm | asceza
ase - osioł
asexualitat - aseksualność
Àsia - Azja
asiàtic - azjatycki
asma - astma
assecar - suszyć
assegurança - ubezpieczenie
assertivitat - asertywność
assetjament - molestowanie
assetjar - oblegać
assimilació - asymilacja
àstat - astat
asterisc - asterysk
asteroide - asteroida
astre - gwiazda
astrofísica - astrofizyka
astronau - statek kosmiczny
astrònom - astronom
astronomia - astronomia
atac - atak
atacar - atakować
ateisme - ateizm
ateista - ateista
atenció - uwaga
ateu - ateista
atmosfèric - atmosferyczny
àtom - atom
atòmic - atomowy
atrocitat - okrucieństwo
atur - bezrobocie
atxa - pochodnia
atxem - apsik! | a psik!
atxim - apsik! | a psik!
au - ptak
aura - aura
aus - au
Austràlia - Australia
australià - australijski | Australijczyk
australiana - australià | Australijka
Àustria - Austria
autobiografia - autobiografia
autocràcia - autokracja
automòbil - samochód | pojazd
autòpsia - autopsja
autor - autor
avall - w dół
avanç - postęp
avançat - zaawansowany
avantatjós - korzystny
avantbraç - przedramię
avantpassat - przodek
avar - skąpy
avellana - orzech laskowy
avena - owies
aversió - awersja | niechęć
avet - jodła
avi - dziadek
àvia - babcia
aviat - wkrótce | wcześnie
avinguda - aleja
avió - samolot
avis - avi
avís - powiadomienie | ostrzeżenie
avortament - aborcja
avui - dziś | dzisiaj
axil·la - pacha
axioma - aksjomat
Azerbaidjan - Azerbejdżan
àzeri - azerski | azerbejdżański | język azerski (azerbejdżański) | Azer | Azerbejdżanin
bac - prom
bacteri - bakteria
bacteriologia - bakteriologia
badallar - ziewać
baf - para
Bahames - Bahamy
baix - niski | dolny | bas
baixkir - baszkirski
bala - pocisk
Balança - Waga
balcó - balkon
balena - wieloryb
ball - taniec
ballar - tańczyć
ballarí - tancerz
ballarina - tancerka
banana - banan
banc - bank
bandera - flaga
Bangla Desh - Bangladesz
banquer - bankier
banyera - wanna
baptisme - chrzest
barat - tani | tanio
barba - broda
barbacoa - grill
Barbados - Barbados
bàrbar - barbarzyńca
Barça - Futbol Club Barcelona
Barcelona - Barcelona
barco - statek (wodny)
bari - bar
baró - baron
baròmetre - barometr
baronessa - baronowa
barral - beczka
barretina - rodzaj tradycyjnej katalońskiej czapki
barri - dzielnica
barroc - barok | barokowy
bàsquet - koszykówka
basquetbol - koszykówka
bastir - budować
batalló - batalion
batejar - chrzcić
batre - bić
bé - dobrze
beguda - napój
Bèlgica - Belgia
Belize - Belize
bell - piękny
bellesa - piękno
ben - dobrze
benefici - korzyść
beneficiós - korzystny
beneir - błogosławić
bengalí - bengalski
Benín - Benin
berenar - podwieczorek | śniadanie | jeść podwieczorek
beril·li - beryl
berkeli - berkel
besar - całować
besavi - pradziadek
besàvia - prababcia
besnét - prawnuk
besnéta - prawnuczka
bèstia - zwierzę
bestiar - żywy inwentarz
beure - pić
Bíblia - Biblia
biblioteca - biblioteka
bicicleta - rower
Bielarús - Białoruś
Bielorússia - Białoruś
bigot - wąsy
bigoti - wąsy
bilingüe - dwujęzyczny
bilió - bilion
bilirubina - bilirubina
biografia - biografia
biografiala - biograficzny
biogràfic - biograficzny
biòleg - biolog
biologia - biologia
biològic - biologiczny
biosíntesi - biosynteza
Birmània - Birma | Mjanma
bisexualitat - biseksualizm
bismut - bizmut
blanc - biały
blancor - biel
blancúria - biel
blanquinós - białawy
blasfèmia - blasfemia | bluźnierstwo
blat - pszenica
blau - kolor niebieski | siniak | niebieski
blauet - zimorodek
blavenc - niebieskawy
blavís - niebieskawy
blavós - niebieskawy
ble - knot
bo - dobry
boca - usta
bohri - bohr
boira - mgła
Bolívia - Boliwia
bomba - bomba | pompa
bomber - strażak
bona nit - dobranoc
bon dia - dzień dobry
bonesa - dobroć
bonic - ładny | miły
Bon Nadal - Wesołych Świąt (Bożego Narodzenia)
bor - bor
bord - bękart
bordell - dom publiczny
borni - jednooki
borsa - giełda
bosc - las
boscós - drewniany
Bòsnia - Bośnia
bota - but
botànica - botanika
botiga - sklep
Botswana - Botswana
bou - wół
braç - ramię
Brasil - Brazylia
brau - byk
breu - krótki | zwięzły
breument - zwięźle
brillar - błyszczeć
britànic - brytyjski
brom - brom
brotar - kiełkować
brou - rosół
bruixa - wiedźma | czarownica
Brunei - Brunei
Brussel·les - Bruksela
brut - głupi | brudny | surowy (niewykończony)
bruxisme - bruksizm
budisme - buddyzm
bufanda - szalik
buidesa - pustka
buidor - pustka
búlgar - bułgarski
Bulgària - Bułgaria
bulímia - bulimia
Buriàtia - Buriacja
Burundi - Burundi
buscar - szukać
butxaca - kieszeń | portmonetka
ca - pies
cabestrell - temblak
cacau - kakao
cacauet - orzech ziemny
cacera - polowanie
cada - każdy
cadàver - zwłoki | trup
cadenat - kłódka
cadernera - szczygieł
cadira - krzesło
cadira de rodes - wózek inwalidzki
cadmi - kadm
Cafarnaüm - Kafarnaum
cafè - kawa
cafeïna - kofeina
caiac - kajak
caixa - pudełko | skrzynka | obudowa | trumna
caixa negra - czarna skrzynka
cala - zatoczka | mała zatoka
calamar - kalmar
calb - łysy
calçat - but
calci - wapń
calcular - obliczać | kalkulować | liczyć
calendari - kalendarz
càlid - ciepły
calidoscopi - kalejdoskop
californi - kaliforn
cal·ligrafia - kaligrafia
calm - spokojny
calúmnia - oszczerstwo | kalumnia
calze - kielich
cama - noga
camaleó - kameleon
Cambodja - Kambodża
cambrer - kelner
camell - wielbłąd
Camerun - Kamerun
càmfora - kamfora
camisa - koszula
campanya - kampania
camp de batalla - pole bitwy
Canadà - Kanada
canari - kanarek | Kanaryjczyk | kanaryjski
càncer - rak
Càncer - Rak
cançó - pieśń | piosenka
canell - nadgarstek
cangur - kangur
canícula - kanikuła
canonització - kanonizacja
cantar - śpiewać
cantata - kantata
canya de sucre - trzcina cukrowa
canyella - cynamon | część goleni
caos - chaos
caòtic - chaotyczny
cap - głowa | talent | łeb | szef | dyrektor | naczelnik | czubek | koniec | końcówka | wcale | zero | do | w kierunku
capaç - zdolny
cap de setmana - weekend
capibara - kapibara
capità - kapitan
capitalisme - kapitalizm
Capricorn - Koziorożec
Cap Verd - Republika Zielonego Przylądka
caqui - persymona | kaki
car - drogi | kosztowny | kochany | drogo | kosztownie | serdecznie
carabassa - dynia
característic - charakterystyczny
caracteritzar - charakteryzować
caragol - ślimak
carbó - węgiel
carboni - węgiel
card - oset
cardar - pierdolić
cardiòleg - kardiolog
careta - maska
cargol - ślimak
cariàtide - kariatyda
caricatura - karykatura
carn - mięso
carnatge - rzeź
carnaval - karnawał
carnisser - rzeźnik | mięsożerny
carnisseria - sklep mięsny
carota - marchew
carpeta - folder | katalog
carrer - ulica
carretera - droga
carro - wóz
carruatge - kareta (pojazd)
carter - listonosz
cartílag - chrząstka
carxofa - karczoch
casa - dom | mieszkanie
casada - zamężna
casat - zamężny
casolà - domowy
caspa - łupież
castell - zamek
castor - bóbr
castrar - kastrować
català - kataloński | kataloński (język) | Katalończyk
catalana - Katalonka | català
catàleg - katalog
Catalunya - Katalonia
cataplexia - katapleksja
catàstrofe - katastrofa
catedral - katedra
categoria - kategoria
catifa - dywan
càtode - katoda
catòlic - katolicki
catolicisme - katolicyzm
catorze - czternaście (14) | czternastka
catorzè - czternasty
causar - powodować
cavall - koń
cavalla - makrela
cavaller - rycerz
cavalleria - kawaleria | konnica
caviar - kawior
ceba - cebula
cec - ślepy
cegament - ślepo
ceguesa - ślepota
cel - niebo
celebració - celebracja | świętowanie
cella - brew
cèl·lula - komórka
cementiri - cmentarz
cent - sto | 100
centaure - centaur
centè - setny
centèsim - setny
centímetre - centymetr
centralitzar - centralizować
cèntric - centralny
cep - pnącze
cercar - szukać
cercle - kółko
ceri - cer | woskowany
cerimònia - ceremonia
cert - prawdziwy | pewien
certament - na pewno
certificat - certyfikat
cervell - mózg
cervesa - piwo
cérvol - jeleń
cesi - cez
cicatriu - blizna
ciclop - cyklop
ciència - nauka
científic - naukowy | eksperymentalny | naukowiec
cigar - cygaro
cigarret - papieros
cigarreta - papieros
cigne - łabędź
cigonya - łabędź
cim - szczyt
cinc - pięć (5) | piątka
cinema - kino
cinquanta - pięćdziesiąt | 50
cinquantè - pięćdziesiąty
cinquè - piąty
cinturó - pasek
circumcidar - obrzezać
circumcisió - obrzezanie
circumferència - obwód
circumstància - okoliczność
ciríl·lic - cyrylicki
cirurgia - chirurg
cirurgià - chirurg
citologia - cytologia
ciutadella - cytadela
ciutat - miasto
civada - owies
clar - jasny | bezsporny | oczywisty
clarinet - klarnet
clàssic - klasyczny
classificació - klasyfikacja
cleptomania - kleptomania
climatologia - klimatologia
clítoris - łechtaczka
clor - chlor
coala - koala
cobai - świnka morska
cobalt - kobalt
còccix - kość guziczna
codi - kod
cognom - nazwisko
cogombre - ogórek
coincidència - zbieg okoliczności
coixí - poduszka
colesterol - cholesterol
colibrí - koliber
col·laborar - współpracować
collaret - naszyjnik
col·lecció - kolekcja
col·leccionar - kolekcjonować
col·legi - szkoła
colló - jądro
col·loquial - kolokwialny
colom - gołąb
Colom - Kolumb (odkrywca)
Colòmbia - Kolumbia
colonitzar - kolonizować
colonoscòpia - kolonoskopia
color - kolor
coltell - nóż
columna - kolumna
colze - łokieć
combat - walka | bój
comboi - konwój
comèdia - komedia
començament - początek | rozpoczęcie
començar - rozpocząć
comentari - komentarz
comerç - handel
comercial - komercyjny
cometa - kometa
comiat - pożegnanie
comissari - komisarz
comitè - komitet
còmodament - wygodnie
còmode - wygodny
comparable - porównywalny
comparar - porównać
compartir - dzielić | współdzielić | dzielić się | podzielić się
compassió - współczucie
competir - rywalizować
complet - kompletny
complexitat - złożoność
complicat - skomplikowany
complot - konspiracja
comprar - kupić
comtessa - hrabina
comunament - powszechnie
comunicació - komunikacja
comunisme - komunizm
comunitat - społeczność | wspólnota
còncau - wklęsły
concavitat - wklęsłość
concepte - koncepcja
condició - warunek
condó - prezerwatywa
conduir - prowadzić
coneixement - wiedza | znajomość
conèixer - znać
confiar - ufać
confirmar - potwierdzać
conflicte - konflikt
conill - królik
cònjuge - małżonek | małżonka
connotació - konotacja
consciència - świadomość
considerablement - znacząco | istotnie
constel·lació - gwiazdozbiór
constitució - konstytucja
constitucional - konstytucyjny
contagiar - zarazić
contaminat - zanieczyszczony
context - kontekst
continent - kontynent
continental - kontynentalny
continuació - kontynuacja
contínuament - bezustannie
continuar - kontynuować
contra - przeciw
contracte - umowa
contrasenya - hasło
convèncer - przekonywać
conveniència - wygoda
convenient - wygodny
conversació - rozmowa
convex - wypukły
convidar - zaprosić
convulsió - paroksyzm
conyac - koniak
cooperar - współpracować
copagorja - sztylet
copernici - kopernik
còpia - kopia
cor - serce | odwaga
coratge - odwaga
coratjós - odważny
corb - wrona
Corea - Korea
coreà - koreański
Corea del Nord - Korea Północna
Corea del Sud - Korea Południowa
coronació - koronacja
coronar - koronować
correctament - poprawnie
correcte - poprawny | prawidłowy
corregir - poprawiać
correspondència - korespondencja | połączenie
correu - poczta
corrosió - korozja
cortès - grzeczny | serdeczny | miły
cortina - zasłona | firana
cos - ciało
cosí - kuzyn
cosina - kuzynka
cosir - szyć
còsmic - kosmiczny
cost - koszt
costa - wybrzeże | zbocze | stok
costaner - przybrzeżny
Costa Rica - Kostaryka
cotó - bawełna
cotxe - samochód
coure - miedź | gotować
cova - jaskinia
cranc - krab
crani - czaszka
creació - kreacja | tworzenie
creatinina - kreatynina
creativitat - kreatywność
creditor - wierzyciel
creença - wiara | wierzenie
creïble - wiarygodny
creïlla - ziemniak
crepuscle - zmierzch
creure - wierzyć | uważać | sądzić
criatura - stworzenie
criptó - krypton
crisi - kryzys
Crist - Chrystus
cristall - kryształ
cristianisme - chrześcijaństwo
cristologia - chrystologia
criteri - kryterium
criticar - krytykować
Croàcia - Chorwacja
crom - chrom
cromosfera - chromosfera
cronologia - chronologia
cronològic - chronologiczny
crucificar - ukrzyżować
crucifix - krucyfiks
crucifixió - ukrzyżowanie
cruel - okrutny
cruelment - okrutnie
crueltat - okrucieństwo
crusant - rogalik
cub - sześcian | kostka
Cuba - Kuba
cubisme - kubizm
cuc - robak
cuc de seda - jedwabnik
cuc de terra - dżdżownica
cucut - kukułka
cuina - kuchnia | gotowanie
cuinar - gotować
cuiner - kucharz
cuir - skóra
cullera - łyżka
cultura - kultura
cunyada - szwagierka | bratowa
cunyat - szwagier
curar - leczyć | kurować
cúrcuma - kurkuma
curi - kiur
curt - krótki
curta - curt
cuscús - kuskus
daga - sztylet
d'ahir - przedwczoraj
danès - duński
dansar - tańczyć
danyós - szkodliwy
darmstadti - darmsztadt
dàtil - daktyl
dc. - środa
dea - bogini
dèbil - słaby
dècada - dekada
decenni - dekada
decidir - zdecydować
dècim - dziesiąty
decisió - decyzja
declaració - deklaracja
declinació - deklinacja
dèdal - labirynt
deessa - bogini
defecació - defekacja
defecte - defekt | wada
defensar - bronić
deficiència - niedobór
dèficit - deficyt
definició - definicja
definir - definiować | określać
deixar - zostawiać | opuszczać | porzucać | pozostawiać | wyjeżdżać | pozwalać | umożliwiać
delicat - delikatny
demà - jutro
democràcia - demokracja
democràtic - demokratyczny
demografia - demografia
densitat - gęstość
dent - ząb
dentifrici - pasta do zębów
dependent - ekspedient | zależny | podległy
deport - sport
dermatologia - dermatologia
des. - grudzień
desafiament - wyzwanie
desafiu - wyzwanie
desaparèixer - zniknąć
descloure - otwierać
descobriment - odkrycie
descontent - nieszczęśliwy
descortès - niegrzeczny | niemiły
descripció - opis
descriptiu - opisowy
descriure - opisać
des de - od
desè - dziesiąty
desembre - grudzień
desenvolupar - rozwijać | rozbudowywać
deshonest - nieuczciwy
desídia - bezczynność | zaniedbanie | zwłoka
deslleial - nielojalny
desobediència - nieposłuszeństwo
desobedient - nieposłuszny
de sobte - nagle
despatx - biuro
destil·lació - destylacja
destinatari - adresat
destral - siekiera | topór
destruir - zniszczyć
deu - dziesięć (10) | dziesiątka | fontanna
déu - bóg
Déu - Bóg
deute - dług
deutor - dłużnik
dg. - niedziela
dia - dzień
diabetis - cukrzyca
diable - diabeł
diabòlic - diabelski | diaboliczny
diaca - diakon
dialecte - dialekt
diàmetre - średnica
diari - dzienny | dziennik
diatomea - okrzemka
diatriba - diatryba
dibuix - rysunek
dibuixar - rysować
diccionari - słownik
dièresi - diereza
dies - dia
dieta - dieta | sposób odżywiania się
diferència - różnica | spór
diferent - inny | różny
diferentment - inaczej
difícil - trudny
dificultat - trudność
diftong - dyftong
digestió - trawienie
dignitat - godność
dijous - czwartek
dilluns - poniedziałek
dimarts - wtorek
dimecres - środa
dimensió - wymiar
dimoni - demon
dimorfisme - dymorfizm
Dinamarca - Dania
dinàmic - dynamiczny
dinàmica - dynamika
dinar - jeść obiad | obiad | dinar
diners - pieniądze
dinosaure - dinozaur
dinou - dziewiętnaście (19) | dziewiętnastka
dinovè - dziewiętnasty
dir - powiedzieć
directament - bezpośrednio
directe - bezpośredni
discrepància - rozbieżność
discussió - dyskusja
disenteria - dyzenteria | czerwonka
disparar - strzelać
disponible - dostępny
disprosi - dysproz
dissabte - sobota
disseny - projekt | szkic
dissenyador - projektant
disset - siedemnaście (17) | siedemnastka
dissetè - siedemnasty
dissonància - dysonans
distància - dystans
distant - odległy
dit - palec
diumenge - niedziela
divendres - piątek
Divendres Sant - Wielki Piątek
diví - boski
divinitat - boskość
divorci - rozwód
divorciada - rozwódka | rozwiedziona | divorciat
divorciar - rozwodzić się
divorciat - rozwodnik | rozwiedziony
divuit - osiemnaście (18) | osiemnastka
divuitè - osiemnasty
dj. - czwartek
Djibouti - Dżibuti
dl. - poniedziałek
doble - podwójny
dòcil - uległy | posłuszny
doctrina - doktryna
documentació - dokumentacja
dofí - delfin
dogmatisme - dogmatyzm
dòlar - dolar
dolç - słodki
dolent - zły | zły (1.1) człowiek
dolorós - bolesny
domèstic - domowy
Dominica - Dominika
dona - kobieta | żona
donar - dać
dormir - spać
dos - 2 (dwa) | dwójka
dosi - dawka
dotze - dwanaście (12) | dwunastka
dotzè - dwunasty
drac - smok
dragó - smok
dramàtic - dramatyczny
dret - prawo | prawa strona | prawy
drets dels animals - prawa zwierząt
dromedari - dromader
ds. - sobota
dt. - wtorek
dubni - dubn
dubtar - wątpić
dubte - wątpliwość
duel - pojedynek
dues - 2 (dwa)
duquessa - księżna
dutxa - prysznic
dv. - piątek
eclesiàstic - kościelny
eco - echo
ecòleg - ekolog
ecologia - ekologia
ecològic - ekologiczny
ecosistema - ekosystem
edat - wiek (liczba lat życia) | epoka | okres
edifici - budynek
edredó - kołdra
educar - edukować
eficaç - efektywny
egipcià - egipski
Egipte - Egipt
egua - klucz
eina - narzędzie
einsteini - einstein
Eivissa - Ibiza
eixutesa - suchość
eixutor - suchość | susza
elaborar - dopracowywać
ela geminada - L·L | l·l
elecció - wybory
electricista - elektryk | elektryczny
electricitat - elektryczność
electró - elektron
electromagnètic - elektromagnetyczny
electrònic - elektroniczny
elefant - słoń
elegant - elegancki
elf - elf
eliminació - eliminacja
eliminar - eliminować | likwidować
ell - on
ella - ona
elles - one
el·lipse - elipsa
ells - oni
eloqüència - elokwencja
El Salvador - Salwador
em - się (1.  )
emascular - kastrować
embut - lejek
emoció - emocja
emocional - emocjonalny
empatia - empatia
emperador - cesarz
empleat - pracownik
empresonar - uwięzić
encarnació - inkarnacja
enciclopèdia - encyklopedia
ènema - lewatywa
energia - energia
enginyer - inżynier
enginyeria - inżynieria
enigma - zagadka
enigmàtic - enigmatyczny
enllaç - link
enlloc - nigdzie
enologia - enologia
ensenyar - uczyć
entendre - rozumieć
enterrament - pogrzeb
entomologia - entomologia
entrar - wejść
entre - między
entrepà - kanapka
enviar - wysyłać
envoltar - otaczać
enzim - enzym
epíleg - epilog | zakończenie
epitafi - epitafium
època - epoka
equador - równik
Equador - Ekwador
equilibri - równowaga
equinocci - równonoc
equip - zespół | drużyna
erbi - erb
erecció - erekcja
eremita - pustelnik
eriçó - jeż
eròtic - erotyczny
erupció - erupcja
esborrany - szkic
escalfament - rozgrzewka
escalfament global - globalne ocieplenie
escalfar - rozgrzewać
escandi - skand
escàndol - skandal
escapar - uciec
escarabat - żuk
escassesa - rzadkość
escassetat - rzadkość
esclau - niewolnik
esclavatge - niewolnictwo
Escòcia - Szkocja
escola - szkoła
escolar - uczeń | uczennica | szkolny
escollir - wybrać | wybierać
escoltar - słuchać
escopir - pluć
Escorpí - Skorpion
Escorpió - Skorpion
escriptor - pisarz
escriure - pisać
escut - tarcza
esdeveniment - wydarzenie
esfera - sfera
esfèric - sferyczny
esfinx - sfinks
església - kościół
Eslovàquia - Słowacja
Eslovènia - Słowenia
esmaragda - szmaragd
esmorzar - śniadanie | jeść śniadanie
esòfag - przełyk
espaiós - przestrzenny
Espanya - Hiszpania
espanyol - hiszpański
especialista - specjalista
espècie - przyprawa
específicament - szczególnie
espelma - świeca
esperanto - esperanto
esperar - czekać | mieć nadzieję
esperar-se - spodziewać się
espiar - szpiegować
espill - lustro
espiritual - duchowy
espiritualment - duchowo
esponja - gąbka
espontani - spontaniczny
esport - sport
espòs - mąż
esquelet - szkielet
esquena - plecy
esquirol - wiewiórka
esquizofrènia - schizofrenia
ésser humà - człowiek
est - wschód | wschodni
estable - stabilny | stajnia
estació - stacja | sezon
estadant - najemca
estany - cyna
estar - być | znajdować się
estat - państwo
estatal - państwowy
Estats Units - Stany Zjednoczone
Estats Units d'Amèrica - Stany Zjednoczone Ameryki
estàtua - posąg | statua
estatus - status
estel - gwiazda
esternudar - kichnąć
esternut - kichnięcie
estètica - estetyka
Esteve - Stefan
estiu - lato
Estocolm - Sztokholm
estómac - żołądek
Estònia - Estonia
estratègia - strategia
estratègic - strategiczny
estrella - gwiazda
estret - wąski | ciasny
estronci - stront
estruç - struś
estudiant - student
estudianta - studentka
estudiar - studiować | uczyć się
estúpid - głupi
estupidesa - głupota
estúrnid - szpak
et - tobie | ci | tobą | się
etcètera - i tak dalej
ètic - etyczny
etimologia - etymologia
Etiòpia - Etiopia
ètnia - narodowość
eufòria - euforia
euga - klucz
euro - euro
Europa - Europa
europi - europ
evitable - do uniknięcia
evolució - ewolucja
exageració - przesada
exagerar - przesadzać
excel·lent - wspaniały
excepció - wyjątek
excepcional - wyjątkowy
excessiu - nadmierny
excessivament - nadmiernie
exclamar - wykrzyknąć
exemple - przykład
exercici - ćwiczenie
existència - egzystencja
èxit - sukces
exocitosi - egzocytoza
exòtic - egzotyczny
experiència - doświadczenie
experiment - eksperyment
experimental - eksperymentalny
explicació - wyjaśnienie
explicar - wyjaśniać
exploració - eksploracja
explosió - wybuch | eksplozja
explotació - eksploatacja | wykorzystywanie
expressiu - ekspresyjny
extint - wymarły
extraordinari - nadzwyczajny
fàbrica - fabryka
fàcil - łatwy
faisà - bażant
falç - sierp
faldilla - spódnica
falguera - paproć
fal·lus - penis
fals - fałszywy
falsedat - fałsz
faltar - brakować
fam - głód
família - rodzina
fang - błoto
fantàstic - fantastyczny
faraó - faraon
farina - mąka
farmàcia - apteka
farmacologia - farmakologia
feble - słaby
feblesa - słabość
febr. - luty
febre - gorączka
febrer - luty
feina - praca
feliç - szczęśliwy
felicitar - gratulować
felicitat - radość
fenilalanina - fenyloalanina
fenilcetonúria - fenyloketonuria | oligofrenia fenylopirogronowa
fenomen - zjawisko
fer - robić | tworzyć
fèretre - trumna
fermi - ferm
ferradura - podkowa
ferro - żelazo
ferrocarril - kolej
ferroviari - kolejarz | kolejowy
fetge - wątroba
fidelitat - wierność
filferro - drut
Filipines - Filipiny
fill - syn
filla - córka
fillastra - pasierbica
fillastre - pasierb
filmar - filmować
filòleg - filolog
filologia - filologia
filòsof - filozof
filosòfic - filozoficzny
finançar - finansować
financer - finansowy
finestra - okno
finlandès - fiński | finlandzki
Finlàndia - Finlandia
firmar - podpisać
física - físic | fizyka
físicament - fizycznie
fisiologia - fizjologia
fitxer - plik
flamenc - flaming | flamenco | Flamand | flamandzki
flauta - flet
fleca - piekarnia
flerovi - flerow
flexibilitat - elastyczność
flexible - elastyczny
floema - łyko
flor - kwiat
fluor - fluor
foc - ogień
folklore - folklor
fonamental - podstawowy | zasadniczy
fonètic - fonetyczny
fonètica - fonetyka
fonologia - fonologia
fora - na zewnątrz
forat - dziura
forat negre - czarna dziura
força - siła | moc
forçar - zmusić
formalment - formalnie
formatge - ser
formiga - mrówka
formós - piękny
fórmula - formuła
forn - piec | piekarnik
forn de pa - piekarnia
fornejar - piec
forner - piekarz
forquilla - widelec
fortament - mocno | silnie
fosc - ciemny
fosca - ciemność
foscor - ciemność
foscúria - ciemność
fòsfor - fosfor
fotògraf - fotograf
fragata - fregata
fràgil - delikatny
França - Francja
francès - francuski
Francesc - Franciszek
franci - frans
franctirador - snajper
fre - hamulec
fred - zimny | zimno
freqüència - częstotliwość
fricció - tarcie
frontal - przedni | kość czołowa
fructosa - fruktoza
frugivorisme - frutarianizm
fruit - owoc
fuet - bicz | bat | rodzaj tradycyjnej katalońskiej kiełbasy
fuita - ucieczka
full - kartka papieru
fulla - liść | ostrze
fum - dym
fumar - palić
funció - funkcja
fundador - założyciel
furiós - wściekły
furóncol - czyrak
fusell - karabin
fusta - drewno | fusta | galera
fuster - stolarz | drewniany
futbol - futbol | piłka nożna
futur - przyszły | przyszłość | czas przyszły
gadolini - gadolin
gairebé - prawie
galàctic - galaktyczny
galàxia - galaktyka
Galilea - Galilea (kraina) | Galilea (miasto w Hiszpanii)
gall - kogut
galleda - wiadro
gal·li - gal
gallina - kura
galta - policzek
gamba - krewetka
ganivet - nóż
garantir - gwarantować
garatge - garaż
Gargantua - Gargantua
gat - kot
gavina - mewa
gel - lód
Gèminis - Bliźnięta
gen - gen
gen. - styczeń
gendre - zięć
genealogia - genealogia
genealogista - genealog
gener - styczeń
generació - generacja
generalment - generalnie | ogólnie
gènere - rodzaj
genètic - genetyczny
genocidi - ludobójstwo
genoll - kolano
gens - trochę | wcale | ani trochę
gent - ludzie
gentilici - termin określający miejsce pochodzenia osoby (miejscowość, region, kraj)
geògraf - geograf
geografia - geografia
geogràfic - geograficzny
geòleg - geolog
geologia - geologia
geomètric - geometryczny
Geòrgia - Gruzja | Georgia
germà - brat
germana - siostra
germanastra - siostra przyrodnia
germanastre - brat przyrodni
germani - german
gerundi - gerundium | rzeczownik odczasownikowy
gessamí - jaśmin
ginebra - gin | dżin
gingebre - imbir
girafa - żyrafa
gira-sol - słonecznik
gla - żołądź
glaç - lód
glacera - lodowiec
glaciologia - glacjologia
gnom - gnom
Godzilla - Godzilla
golf - zatoka | golf
golfista - golfista | golfistka
goril·la - goryl
gos - pies
gràcies - dziękuję | gràcia
gradual - stopniowy
gradualment - stopniowo
gramàtica - gramatyka
gran - duży
granja - farma
granota - żaba
gras - gruby
gratacel - drapacz chmur | wieżowiec
gratar - drapać
gratitud - wdzięczność
gratular - gratulować
gravetat - grawitacja | siła ciążenia
Grècia - Grecja
Grenlàndia - Grenlandia
gripau - ropucha
griu - gryf | gryfon
groc - żółty
grogós - żółtawy
groguenc - żółtawy
gronxador - huśtawka
grup - grupa
Guadalupe - Gwadelupa
guant - rękawica | rękawiczka
guanyador - zwycięzca
guanyar - wygrywać
guardiola - skarbonka
guatla - przepiórka
guatlla - przepiórka
guerra - wojna
guineu - lis
guionet - myślnik
guitarra - gitara
guspira - iskra
gustar - smakować
habitació - pokój (pomieszczenie)
habitant - mieszkaniec
hafni - hafn
Haití - Haiti
haixix - haszysz
hamaca - hamak
hàmster - chomik
handbol - piłka ręczna
harmonia - harmonia
harmoniós - harmonijny
hassi - has
haver - być | nie ma | musieć
hebreu - hebrajski
hectàrea - hektar
hedonisme - hedonizm
heli - hel
helicòpter - helikopter | śmigłowiec
hematúria - hematuria | krwiomocz
hemisferi - półkula
hereditari - dziedziczny
heretar - dziedziczyć
heretgia - herezja
herètic - heretycki
hereu - spadkobierca
Heribert - Herbert
heroi - bohater
heroic - bohaterski
heroïcitat - heroiczność
heroïna - heroina
heroisme - bohaterstwo
hesitar - wahać się
heterogeni - niejednorodny
heterosexualitat - heteroseksualizm
heura - bluszcz
hexagonal - sześciokątny
hi - tu
hidràulic - hydrauliczny
hidrogen - wodór
hidrogenació - uwodornianie | uwodornienie | hydrogenizacja
hiena - hiena
himne - hymn
hiperlipèmia - hiperlipidemia
hipermetropia - nadwzroczność
hipersòmnia - hipersomnia
hipòfisi - przysadka mózgowa
hipopòtam - hipopotam
hipoteca - hipoteka
hipòtesi - hipoteza
histerectomia - usunięcie macicy | histerektomia
història - historia | opowieść
històricament - historycznie
hivern - zima
ho - to
hola - cześć | dzień dobry
holandès - holenderski
holmi - holm
home - mężczyzna | mąż
home llop - wilkołak
homosexualitat - homoseksualizm
Hondures - Honduras
hongarès - Węgier
Hongria - Węgry
hoquei - hokej
hora - godzina | pora
horitzó - horyzont
horitzontal - poziomy
hormona - hormon
horrible - straszny
hortalissa - warzywo
Horus - Horus
hospital - szpital
hoste - gość
hostil - wrogi
hotel - hotel
humanitat - ludzkość
huracà - huragan
i - i
iac - jak
iaia - babcia
iaio - dziadek
ictiòleg - ichtiolog
ideal - idealny | ideał
idèntic - identyczny
ideologia - ideologia
idioma - język
ídol - idol
Iemen - Jemen
igualtat - równość
illa - wyspa
il·legal - nielegalny
illes Fèroe - Wyspy Owcze
il·lusió - iluzja | nadzieja | szczęście
imaginació - wyobraźnia
imaginari - urojony
imam - imam
imatge - obraz | podobizna | wizerunek
imitació - imitacja
imitar - imitować | naśladować
immoral - niemoralny
immortal - nieśmiertelny
immortalitat - nieśmiertelność
immunitat - odporność
immunosupressió - immunosupresja
imperatiu - tryb rozkazujący | rozkazujący
imperfecció - niedoskonałość
imperi - imperium
importància - istotność | ważność
important - ważny
impossible - niemożliwy
imprescindible - nieodzowny
impressionant - imponujący
imprimir - drukować
impuls - impuls
impulsivitat - impulsywność
inacceptable - nieakceptowalny
inadequat - nieadekwatny
inaugurar - inaugurować | rozpoczynać
incentiu - zachęta
incert - niepewny
incòmode - niewygodny
incomplet - niekompletny
incomprensible - niezrozumiały
inconsistent - niespójny
independència - niepodległość
independent - niezależny | niepodległy | suwerenny
independentisme - separatyzm | dążenie do niepodległości
indi - ind
Índia - Indie
indicatiu - tryb oznajmujący | tryb orzekający | wskazujący
indiferència - obojętność
indirectament - pośrednio
indirecte - pośredni
indispensable - nieodzowny
individu - osoba
individualment - indywidualnie
Indonèsia - Indonezja
indret - miejsce
inesperadament - niespodziewanie
inesperat - nieoczekiwany
inexplicable - niewytłumaczalny
infame - niesławny
infecció - infekcja
infeccionar - zarazić
infectar - zakażać | zarażać
infeliç - nieszczęśliwy
infern - piekło
infinitiu - bezokolicznik
inflació - inflacja
inflexible - sztywny
influència - wpływ
influir - wpływać | mieć wpływ
informació - informacja
infraestructura - infrastruktura
infraroig - podczerwony | podczerwień
injecció - zastrzyk
injectar - wstrzyknąć
injustícia - niesprawiedliwość
innecessari - niepotrzebny
innocent - niewinny
innovació - innowacja
inoblidable - niezapomniany
insecte - owad
inseparable - nierozłączny
insistir - nalegać
inspecció - inspekcja
instal·lació - instalacja
institut - instytut
instrument musical - instrument muzyczny
insuficient - niewystarczający
insultar - obrażać
integració - integracja
intel·ligent - inteligentny
intenció - zamiar
intensitat - intensywność
interacció - interakcja
interjecció - wykrzyknik
intern - wewnętrzny
internacional - międzynarodowy
internacionalisme - internacjonalizm
intèrpret - tłumacz
interrompre - przerwać
intervenció - interwencja
intransitiu - nieprzechodni
intuïció - intuicja
inútil - bezużyteczny
invasió - inwazja
invencible - niezwyciężony
inventar - wynaleźć
invitació - zaproszenie
invitar - zaprosić
iode - jod
iogurt - jogurt
iot - jacht
Iran - Iran
Iraq - Irak
iridi - iryd
Irlanda - Irlandia
irlandès - irlandzki | Irlandczyk
ironia - ironia
irracional - irracjonalny
irregular - nieregularny
irresistible - nieodaprty
irresponsable - nieodpowiedzialny
Isis - Izyda
islandès - islandzki
Islàndia - Islandia
Isop - Ezop
Israel - Izrael | Izrael (imię)
istme - przesmyk
Itàlia - Włochy
italià - włoski
iterbi - iterb
itri - itr
ivori - kość słoniowa
Jamaica - Jamajka
Japó - Japonia
japonès - japoński
jaqueta - kurtka
jardí - ogród
javelina - oszczep
jazz - jazz | dżez
jerarquia - hierarchia
jersei - sweter
Jesús - Jezus
jo - ja
joc - gra
joguet - zabawka
joguina - zabawka
jònic - joński
jorn - dzień
jou - jarzmo
jove - młody | młodzieniec | synowa
judaisme - judaizm
judeoàrab - język judeo-arabski | język żydowsko-arabski
jul. - lipiec
Júlia - Julia
juliol - lipiec
julivert - pietruszka
juny - czerwiec
jurisdicció - jurysdykcja
justícia - sprawiedliwość
justificar - usprawiedliwiać
jutge - sędzia
jutgessa - sędzia
Kazakhstan - Kazachstan
Kirguizistan - Kirgistan
kuwaití - kuwejcki | Kuwejtczyk | Kuwejtka
l' - el | la
la - la
laberint - labirynt | chaos | plątanina | błędnik
laboratori - laboratorium
l'Alguer - Alghero
lantani - lantan
laringe - krtań
làrix - modrzew
làser - laser
laurenci - lorens
legalització - legalizacja
legió - legion
legislació - ustawodawstwo
legislatiu - ustwodawczy
lentament - powoli
lent de contacte - soczewka kontaktowa
lentícula - soczewka kontaktowa
lentilla - soczewka kontaktowa
letargia - letarg
Letònia - Łotwa
Líban - Liban
libèl·lula - ważka
Libèria - Liberia
Líbia - Libia
licopè - likopen
limitació - ograniczenie
lingüista - językoznawca
lingüístic - lingwistyczny
lingüística - językoznawstwo | lingwistyka | lingüístic
línia - linia
linx - ryś
liposoluble - rozpuszczalny w tłuszczu
liposucció - liposukcja
líquid - płynny | płyn
literalment - dosłownie
literari - literacki
literatura - literatura
liti - lit
Lituània - Litwa
litúrgia - liturgia
litúrgic - liturgiczny
livermori - liwermor
llac - jezioro
lladre - złodziej | złodziejka
llagosta - szarańcza | homar
llàgrima - łza
llamprea - minóg
llana - wełna
llangardaix - jaszczurka
llapis - ołówek
llarg - długi
llatí - łaciński
llebre - zając
llegenda - legenda
llegendari - legendarny
llegible - czytelny
llegir - czytać
llegum - warzywo
llei - prawo
lleial - lojalny
lleialtat - lojalność
lleig - brzydki
lleixa - półka
llengua - język
llenguatge - język
llentilla - soczewica
lleó - lew
Lleó - Lew
lleona - lwica
llet - mleko
lletgesa - brzydota
lletjor - brzydota
lletra - litera
llevar-se - wstawać (z łóżka) | podnosić się
llevataps - korkociąg
llibertat - wolność
llibre - książka
llibreter - księgarz
lliçó - lekcja
llimona - cytryna
llimonada - lemoniada
lliri - lilia
llis - gładki
llit - łóżko
lliure - wolny
lloar - chwalić
llop - wilk
lloro - papuga
llot - błoto
lluir - popisywać się | przechwalać się | błyszczeć
lluita - walka
lluitador - zapaśnik
lluna - księżyc
lluny - daleko
local - lokalny
lògic - logiczny
Londres - Londyn
lupa - lupa
luteci - lutet
Luxemburg - Luksemburg
luxúria - żądza
mà - ręka
Macedònia - Macedonia
maco - ładny
macromolècula - makromolekuła | makrocząsteczka
Madagascar - Madagaskar
madrastra - macocha
maduixa - truskawka
màgia - magia
màgic - magiczny
màgicament - magicznie
magnesi - magnez
magnètic - magnetyczny
magnetisme - magnetyzm
magnífic - wspaniały
magrana - granat
mai - nigdy
maig - maj
maionesa - majonez
majoria - większość
malabarista - żongler
Malàisia - Malezja
malalt - chory
malària - malaria
maleir - przeklinać
maliciós - złośliwy
maliciosament - złośliwie
malson - koszmar
Malta - Malta
maltès - maltański
mamífer - ssak
mamut - mamut
mandíbula - szczęka
mandra - lenistwo
manganès - mangan
màniga - rękaw
manipulació - manipulacja
mantega - masło
manuscrit - rękopis | manuskrypt
maó - cegła
màquina - maszyna
màquina d'escriure - maszyna do pisania
mar - morze
maragda - szmaragd
mar Bàltic - Morze Bałtyckie
Mar Bàltica - Morze Bałtyckie
març - marzec
mare - matka
marea - pływ
marit - mąż
Mar Mediterrània - Morze Śródziemne
marró - brązowy
Marroc - Maroko
marroquí - marokański | Marokańczyk | Marokanka
mart - kuna
màrtir - męczennik | męczennica
màscara - maska
masculí - męski
masmorra - loch
massacrar - masakrować | robić rzeź | wyrzynać
mastegar - żuć
masticar - żuć
matalaf - materac
matalàs - materac
matar - zabić
matemàtic - matematyczny | matematyk
matemàtica - matematyka | matemàtic
matinada - ranek
matrimoni - małżeństwo
Mauritània - Mauretania
mausoleu - mauzoleum
mecatrònica - mechatronika
mèdic - medyczny
meitneri - meitner
mel - miód
melatonina - melatonina
meló - melon
menció - wzmianka
mendelevi - mendelew
menjar - jeść | jedzenie
menstrual - miesiączkowy | menstruacyjny
mentida - kłamstwo
mentir - kłamać | mówić nieprawdę
menú - menu
menys - mniej
mercat - rynek
mercat negre - czarny rynek
mercuri - rtęć
Mercuri - Merkury
merda - gówno
meridional - południowy
mes - miesiąc
més - więcej
mesquita - meczet
mestressa de casa - gospodyni domowa
metabolisme - metabolizm
metafísic - metafizyczny
metàfora - metafora
metall - metal
metàl·lic - metaliczny
metamorfosi - metamorfoza | przeobrażenie
meteor - meteor
meteorit - meteoryt
meteorologia - meteorologia
metge - lekarz
metgessa - lekarka
mètode - metoda
metròpoli - metropolia
metzina - trucizna
meu - mój
meus - moi
meva - moja
meves - moje
Mèxic - Meksyk
mico - małpa
micologia - mikologia | mykologia
microbiologia - mikrobiologia
micròfon - mikrofon
micròmetre - mikrometr
microorganisme - mikroorganizm
microscopi - mikroskop
microscòpic - mikroskopowy
midó - skrobia
migdia - południe
migració - migracja
mil - tysiąc
milè - tysięczny
milícia - żołnierz
milió - milion
mill - proso
mil·lenni - tysiąclecie | millenium
mil·lèsim - tysięczny
mil·ligram - miligram
mil·límetre - milimetr
millorar - udoskonalić
mineralogia - mineralogia
mineralogista - mineralog | mineralog (kobieta)
mínim - minimum
minut - minuta
miopia - krótkowzroczność
miracle - cud
miraculós - cudowny
mirall - lustro
missió - misja
misteri - tajemnica
misto - zapałka
mitjanit - północ
mitjó - skarpeta | skarpetka
mòbil - telefon komórkowy
Moçambic - Mozambik
mòdem - modem
modern - nowoczesny
Moldàvia - Mołdawia
molècula - cząsteczka | molekuła
molibdè - molibden
molí de vent - wiatrak
molsa - mech
món - planeta | świat
Mònaco - Monako
monarquia - monarchia
moneda - moneta
monestir - klasztor
monetari - pieniężny
Mongòlia - Mongolia
monjo - mnich
monogàmia - monogamia
monosacàrid - monosacharyd
Montenegro - Czarnogóra
Montserrat - Montserrat
monument - pomnik
morfologia - morfologia
morir - umrzeć
mort - śmierć
mortalitat - śmiertelność
mosca - mucha
Moscou - Moskwa
mosquit - komar
mossegar - gryźć
Mostar - Mostar
mostatxo - wąsy
motivació - motywacja
motocicleta - motocykl
moviment - ruch
mul - muł
muller - żona
munt - sterta
muntanya - góra
muntanyós - górzysty
múscul - mięsień
museu - muzeum
músic - muzyk
música - muzyka
mutació - mutacja
n - odchodzić | wychodzić | opuścić | iść | oddalić się
nació - naród | nacja
nacionalisme - nacjonalizm
nacionalista - nacjonalistyczny | nacjonalista | nacjonalistka
nacionalitat - narodowość
Nadal - Boże Narodzenie
naixement - narodziny | urodzenie
Namíbia - Namibia
Nàpols - Neapol
narcolèpsia - narkolepsja
nariu - nozdrze
narratiu - narracyjny
narval - narwal
nas - nos
nasal - nosowy
nat - urodzony
natació - pływanie
naturalesa - natura
nau - statek
nau espacial - statek kosmiczny
naufragi - wrak
neboda - siostrzenica | bratanica
nebot - siostrzeniec | bratanek
necessitar - potrzebować
necessitat - potrzeba | konieczność
nedar - pływać
neerlandès - Holender | holenderski
negociació - negocjacje
negociar - negocjować
negre - czarny
nen - chłopczyk
nena - dziewczynka
neó - neon
neodimi - neodym
neoliberalisme - neoliberalizm
neologisme - neologizm
Nepal - Nepal
neptuni - neptun
nervi - nerw
nét - wnuk
néta - wnuczka
netejar - czyścić
neu - śnieg
neurologia - neurologia
neurotoxina - neurotoksyna
neutralitat - neutralność
neutre - neutralny
nevar - padać | śnieżyć
nevera - lodówka
nevós - śnieżny
Nicaragua - Nikaragua
nihilisme - nihilizm
nina - lalka
ningú - nikt
niobi - niob
níquel - nikiel
nit - noc
nitrogen - azot
niu - gniazdo
no - nie
nobeli - nobel
nocturn - nocny
nodrir - karmić | odżywiać
noi - chłopak
noia - dziewczyna
nom - imię | rzeczownik
nombrós - liczny
només - tylko | jedynie
nom propi - nazwa własna
nora - synowa
noranta - dziewięćdziesiąt | 90
norantè - dziewięćdziesiąty
Norbert - Norbert
nord - północ
Nord-amèrica - Ameryka Północna
nord-est - północny wschód | północno-wschodni
nord-oest - północny zachód | północno-zachodni
normalment - zwykle
Noruega - Norwegia
nosaltres - my
nostàlgia - nostalgia
nostàlgic - nostalgiczny
nostra - nasza
nostre - nasz
nostres - nasi | nasze
notable - znaczący | godny uwagi
nou - dziewięć (9) | dziewiątka | orzech | nowy
nov. - listopad
Nova York - Nowy Jork
Nova Zelanda - Nowa Zelandia
novè - dziewiąty
novel·lista - powieściopisarz | powieściopisarka
novembre - listopad
nuclear - jądrowy | nuklearny
nucli - jądro | rdzeń
nuesa - nagość
nutrició - żywienie
núvol - chmura
o - lub | albo
o bé - lub
obediència - posłuszeństwo
obedient - posłuszny
obelisc - obelisk
obert - otwarty
obès - otyły
obesitat - otyłość
objectiu - obiekt | cel | obiektywny
oblidar - zapomnieć
oblong - podłużny
obra - praca
obrer - pracownik
obrir - otwierać
obscè - obsceniczny
observatori - obserwatorium
obsessió - obsesja
obvi - oczywisty
òbviament - oczywiście
oca - gęś
ocapi - okapi
ocasional - sporadyczny
ocasionalment - sporadycznie
oceà - ocean
oceà Atlàntic - Ocean Atlantycki
oceà Índic - Ocean Indyjski
Oceania - Oceania
oceà Pacífic - Ocean Spokojny | Pacyfik
ocell - ptak
oct. - październik
octubre - październik
ocultisme - okultyzm
odi - nienawiść
odiar - nienawidzić
oest - zachód | zachodni
oferir - proponować
ofici - zawód | fach
oficialment - oficjalnie
oliva - oliwa
oliver - drzewo oliwne
olivera - drzewo oliwne
olla - garnek
om - wiąz
on - gdzie
ona - fala
onada - fala
oncle - wuj | wujek
oncologia - onkologia
onomatopeia - onomatopeja
onze - 11 (jedenaście) | jedenastka
onzè - jedenasty
oologia - owologia | oologia
opac - nieprzezroczysty
òpal - opal
opció - opcja
opinió - opinia
oponent - oponent
oposició - opozycja
or - złoto
orangutan - orangutan
orar - modlić się
orchestrion - orchestrion
ordinador - komputer
ordinari - zwykły
orella - ucho
òrgan - organ
organisme - organizm
organització - organizacja
organitzar - organizować
organogènesi - organogeneza
orgasme - orgazm
orgull - duma
orgullós - dumny
orientació - orientacja
orientació sexual - orientacja seksualna
oriental - wschodni | orientalny
orinar - sikać
ornitologia - ornitologia
ornitorinc - dziobak
orquestra - orkiestra
ortus - wschód Słońca
os - kość
ós - niedźwiedź
Osaka - Osaka
ós blanc - niedźwiedź polarny
os frontal - kość czołowa
osmi - osm
ós polar - niedźwiedź polarny
ostatge - zakładnik
Òstia - Ostia
ostra - ostryga
ou - jajko
oval - owalny | owal
ovella - owca
ovulació - owulacja | jajeczkowanie
òxid - tlenek
oxigen - tlen
pa - chleb
paciència - cierpliwość
pacient - cierpliwy | pacjent
pacte - pakt | układ
padrastre - ojczym
padrí - ojciec chrzestny
padrina - matka chrzestna
paella - patelnia
pàgina - strona
país - kraj
paisatge - krajobraz
País Basc - Kraj Basków
Països Baixos - Holandia
Països Catalans - ziemie katalońskie | ogół terytorium zamieszkiwanego przez ludność posługującą się językiem katalońskim | kraje katalońskie
Pakistan - Pakistan
palau - pałac
Palestina - Palestyna
palíndrom - palindrom
palla - słoma
pal·ladi - pallad
pallasso - klaun
pàl·lid - blady
Palma - Palma de Mallorca
Panamà - Panama
Panchen Lama - panczenlama
panda - panda
pànic - panika
pansexualitat - panseksualizm
pantaló - spodnie
panteisme - panteizm
panxa - brzuch
paó - paw
papa - tata | papież
Papa - papież
papada - podwójny podbródek
papagai - papuga
papallona - motyl
paper - papier
paràbola - parabola
paracaigudes - spadochron
paradís - raj
paradoxa - paradoks
Paraguai - Paragwaj
paraigua - parasol
paràlisi - paraliż
paraula - słowo
parc - park
pare - ojciec
parent - krewny
paret - ściana
parir - urodzić
París - Paryż
parlament - parlament
parlar - mówić
paròdia - parodia
parpella - powieka
parròquia - parafia
participar - brać udział
participi - imiesłów
partícula - cząstka
partit - partia | mecz | gra
passaport - paszport
passar - przechodzić | wchodzić | dziać się | studiować | analizować
passiu - bierny
pastanaga - marchew
pastís - ciasto | placek | anyżówka | pastis
pastisseria - cukiernia
patata - ziemniak
patiment - cierpienie
patir - cierpieć
patologia - patologia
pàtria - ojczyzna
patriarca - patriarcha
patriòtic - patriotyczny
patriotisme - patriotyzm
pau - pokój
pauta - zasada | wytyczna
pebre - pieprz
pecar - grzeszyć
pedra - kamień
pedra foguera - krzemień
pedrenyal - krzemień
pedrenyera - krzemień
peix - ryba
Peixes - Ryby
Peixos - Ryby
pelegrí - pielgrzym
pelegrinatge - pielgrzymka
pelicà - pelikan
pell - skóra
pel·lícula - film
penar - karać
península - półwysep
pensador - myśliciel
pensament - myśl
pentàgon - pięciokąt
penya-segat - klif
pera - gruszka
percebre - zauważać | dostrzegać
percepció - percepcja
per cert - przy okazji
perdiu - kuropatwa
perdut - zaginiony
perill - niebezpieczeństwo
perillós - niebezpieczny
perímetre - obwód
període - okres
periòdic - gazeta
periodisme - dziennikarstwo
perir - ginąć
perla - perła
permissió - pozwolenie
perpetu - wieczny | bezustanny
perpetual - wieczny | bezustanny
perquè - ponieważ | powód
persiana - żaluzja
persistència - wytrwałość
persona - osoba | persona
personalitat - osobowość
personalment - osobiście
pescador - rybak
pescar - łowić
pestanya - rzęsa
pètal - płatek
petit - mały
petó - pocałunek
peu - stopa
pic - szczyt
piezoelectricitat - piezoelektryczność
piga - pieg
pingüí - pingwin
pintallavis - szminka
pintar - malować
pirata - pirat
piromania - piromania
Pisces - Ryby
piscina - basen
pisco - pisco
pistola - pistolet (broń) | pistolet (narzędzie)
pit - pierś
pitet - śliniak | śliniaczek
Pittsburgh - Pittsburgh (stolica Allegheny)
pizza - pizza
plaça - miejsce
plaer - przyjemność
plantació - plantacja
plantofa - kapeć
planxa - żelazko
plàstic - plastik | plastikowy
plat - talerz
plata - srebro
plàtan - platan | banan
platí - platyna
platja - plaża
plegar - skończyć pracę
pleocroisme - pleochroizm
pler - przyjemność
plom - ołów
plorar - płakać
ploure - padać
pluja - deszcz
pluja àcida - kwaśny deszcz
plujós - deszczowy
plutoni - pluton
poblar - zasiedlać | zaludniać
poblat - zamieszkały | zaludniony
poble - ludzie | lud
poc - mały | mało
poderós - silny | mocny
podologia - podologia
poema - wiersz
poesia - poezja
poeta - poeta
poetessa - poetka
policia - policja
polígon - wielokąt
Polinèsia Francesa - Polinezja Francuska
polisacàrid - polisacharyd
politeisme - politeizm
polític - polityczny
política - polityka | polític
poll - kurczak | wesz
pollastre - kurczak
pol·len - pyłek kwiatowy
polonès - polski | Polak
polonesa - polonès | Polka
poloni - polon
Polònia - Polska
polzada - cal
polze - kciuk
poma - jabłko
pomer - jabłoń
pomera - jabłoń
pont - most
por - strach
porc - świnia | wieprzowina
porcellana - porcelana
porció - porcja
porc senglar - dzik
pornografia - pornografia
pornogràfic - pornograficzny
porta - drzwi
portaavions - lotniskowiec
Portugal - Portugalia
portuguès - portugalski | Portugalczyk
possibilitat - możliwość
possible - możliwy
possiblement - prawdopodobnie
pota - łapa
potassi - potas
potser - może
Praga - Praga
praseodimi - prazeodym
prat - łąka
precipici - przepaść
preferència - preferencja
preferir - woleć
prefix - przedrostek
prehistòric - prehistoryczny
premi - nagroda
prenatal - prenatalny
preparació - przygotowanie
preparatiu - przygotowanie
preposició - przyimek
prepuci - napletek
presentació - prezentacja
presentar - prezentować | przedstawiać
preservatiu - prezerwatywa
presó - więzienie
presoner - więzień
presonera - więzień
préssec - brzoskwinia
préstec - pożyczka
preu - cena
prim - szczupły
primavera - wiosna
primer - pierwszy | pierwsze piętro
primer ministre - premier
príncep - książę
princesa - księżniczka
principi - zasada | reguła
prioritat - priorytet
privilegi - przywilej
probable - prawdopodobny
probablement - prawdopodobnie
profecia - przepowiednia
professió - profesja | zawód
professor - profesor | nauczyciel
profeta - prorok
pròleg - prolog
promès - narzeczony
promesa - obietnica | narzeczona
prometi - promet
pronúncia - wymowa
pronunciació - wymowa
propi - własny | właściwy
prosa - proza
prostitució - prostytucja
protactini - protaktyn
protoactini - protaktyn
prou - wystarczająco
proverbi - przysłowie
pròxim - bliski | następny
prudència - roztropność
pruna - śliwka
pseudociència - pseudonauka
pseudònim - pseudonim
psicòleg - psycholog
psicologia - psychologia
psicològic - psychologiczny
psiquiatre - psychiatra
Ptah - Ptah
públic - publiczny
publicació - publikacja
públicament - publicznie
puça - pchła
pulmó - płuco
punir - karać
purgatori - czyściec
qualitat - jakość
quan - kiedy
quantitat - ilość
quaranta - 40 | czterdzieści
quarantè - czterdziesty
quart - czwarty | kwarta | kwadrans
quasi - prawie
quatre - 4 (cztery) | czwórka
què - co | który | rzecz
queixar-se - narzekać
qüestió - pytanie
qüestionari - kwestionariusz
qui - kto | kogo | komu | który
quilla - kil
quilogram - kilogram
quilòmetre - kilometr
químic - chemik | chemiczny
quint - piąty
quinze - piętnaście (15) | piętnastka
quinzè - piętnasty
quítxua - keczua (język)
rabí - rabin
ràbia - gniew | wściekłość
racisme - rasizm
radar - radar
radi - rad
radiació - promieniowanie
ràdio - radio
radioactiu - radioaktywny
radioactivitat - radioaktywność | promieniotwórczość
radó - radon
raïm - winogrono
rar - rzadki
rat - szczur
rata - szczur
ratolí - mysz | myszka
rave - rzodkiewka
reacció - reakcja
realitat - rzeczywistość
rebel·lió - bunt
recapitulació - streszczenie
recomanació - rekomendacja
recomanar - zalecać
rectangle - prostokąt
reemplaçar - zastąpić
reencarnació - reinkarnacja
refrany - przysłowie
refusar - odmawiać
regió - region
regional - regionalny
Regne Unit - Zjednoczone Królestwo
regularitat - regularność
regularment - regularnie
rei - król
reial - królewski
relació - relacja
relativament - względnie
religió - religia
religiós - religijny
religiosament - religijnie
rellotge - zegar
rememorar - przypominać | pozbierać | poskładać
ren - renifer
renéta - prawnuczka
reni - ren
renovar - odnawiać
rentable - zmywalny
rentaplats - zmywarka
rentar - zmywać
repetidament - wielokrotnie | raz po raz | wiele razy
repetir - powtarzać
rèptil - gad
república - republika
República Dominicana - Republika Dominikańska
República Txeca - Republika Czeska
reputació - reputacja
res - nic
rescat - ratunek | okup
rescatar - ratować
resina - żywica
respectable - szanowany
respectar - szanować | respektować
respecte - szacunek
respectivament - odpowiednio
respectuós - pełen szacunku
respirar - oddychać
responsabilitat - odpowiedzialność
responsable - odpowiedzialny
resposta - odpowiedź
retrat - portret
retsina - retsina
revenja - zemsta
revolució - rewolucja
revòlver - rewolwer
rialla - śmiech
riba - brzeg | wybrzeże
ric - bogaty
rinoceront - nosorożec
risc - ryzyko
ritme - rytm
riu - rzeka
riure - śmiać się | śmiech
roba - ubranie | odzież
Roberta - Roberta
robí - rubin
robot - robot
roda - koło
rodi - rod
roentgeni - roentgen
rogenc - czerwonawy
rol - rola
rom - rum
Roma - Rzym
Romania - Rumunia
rombe - romb
ronyó - nerka
ros - blond
rossinyol - słowik
roure - dąb
rovell - rdza
rubidi - rubid
rusc - ul
russa - Rosjanka | rus
Rússia - Rosja
ruteni - ruten
rutherfordi - rutherford
sa - zdrowy
sabata - but
saber - wiedzieć | wiedza
sabó - mydło
sacarina - sacharyna
sacrificar - poświęcić
safir - szafir
safrà - szafran
Sagitari - Strzelec
sal - sól
salada - salat
salat - słony
salmó - łosoś
salsa de soia - sos sojowy
salsitxa - kiełbasa
salt - skok
sàlvia - szałwia
salze - wierzba
Samarcanda - Samarkanda
samari - samar
samarreta - bluzka | koszulka
Samoa - Samoa
sandvitx - kanapka
sang - krew
sangonera - pijawka
sanitat - zdrowie
sànscrit - sanskryt
santcrist - krucyfiks
São Tomé i Príncipe - Wyspy Świętego Tomasza i Książęca
sarcasme - sarkazm
sarcàstic - sarkastyczny
sastre - krawiec
sàtir - satyr
sàtira - satyra
satisfacció - satysfakcja
satisfactori - zadowalający
sauna - sauna
saxòfon - saksofon
seaborgi - seaborg
seda - jedwab
seduir - uwodzić
segar - zbierać plony
segle - wiek | stulecie
sègol - żyto
segon - drugi
segrestar - porwać
segur - bezpieczny
segurament - na pewno
seixanta - sześćdziesiąt
seixantè - szesnasty
seleni - selen
semàntic - semantyczny
sempre - zawsze
senat - senat
senda - ścieżka | dróżka
sender - ścieżka | dróżka
sendera - ścieżka | dróżka
senglar - dzik
senil - starczy
sensació - odczucie | wrażenie
sense - bez
senyor - pan
senyora - pani
separació - separacja | rozdzielenie | oddzielenie
separadament - osobno
separar - oddzielić
separatisme - separatyzm
septentrional - północny
sèptim - siódmy
ser - być
Sèrbia - Serbia
seriós - poważny
serotonina - serotonina
serp - wąż
serpent - wąż
sèsam - sezam
set - siedem (7) | siódemka
set. - wrzesień
setanta - siedemdziesiąt | 70
setè - siódmy
setembre - wrzesień
setmana - tydzień
setze - szesnaście (16) | szesnastka
setzè - szesnasty
seu - jego | ich | siedziba | katedra
seure - siadać
seus - ich
seva - jej
seves - ich
sexisme - seksizm
sext - szósty
sexual - seksualny
sexualitat - seksualność
sexualment - seksualnie
si - jeśli
sí - tak
Sicília - Sycylia
SIDA - AIDS
signar - podpisać
signatura - podpis
significatiu - znaczący
significativament - znacząco
sikhisme - sikhizm
silenci - cisza
silenciosament - cicho
silici - krzem
síl·laba - sylaba
sil·làbic - sylabiczny
silueta - sylwetka
símbol - symbol
simbòlic - symboliczny
similar - podobny
simpàtic - miły | współczujący
simultàniament - równocześnie
sincer - szczery
síndria - arbuz
síndrome - syndrom
Singapur - Singapur
sinònim - bliskoznaczny | synonim
sintaxi - składnia
síntesi - synteza
sintètic - syntetyczny
Síria - Syria
sis - sześć (6) | szóstka
sisè - szósty
sisme - trzęsienie ziemi
sismologia - sejsmologia
sisplau - proszę | przepraszam
sistema - system | układ
sistema nerviós - układ nerwowy
sistemàtic - systematyczny
si us plau - proszę | przepraszam
so - dźwięk
sobirania - suwerenność
sobrenom - przydomek
socialisme - socjalizm
societat - społeczeństwo
sociòleg - socjolog
sociologia - socjologia
sodi - sód
sofà - sofa | kanapa
sofre - siarka
sogra - teściowa
sogre - teść
sol - słońce
solemne - uroczysty
solidaritat - solidarność
soll - chlew
solstici - przesilenie
solubilitat - rozpuszczalność
Somàlia - Somalia
somrís - uśmiech
somriure - uśmiechać się | uśmiech
sonet - sonet
sopa - zupa
sopar - jeść kolację | kolacja
sord - głuchy
soroll - hałas
sorollós - głośny
sorra - piasek
sortida - wyjście
sostre - dach
sou - pensja | płaca | ser
sovint - często
spirulina - spirulina
sua - suar
suar - pocić się
subjuntiu - tryb łączący
substantiu - rzeczownik
suburbi - przedmieście
suc - sok
sucós - soczysty
sucre - cukier
sud - południe | południowy
Sud-àfrica - Republika Południowej Afryki
Sud-amèrica - Ameryka Południowa
Sudan - Sudan
sud-est - południowy wschód | południowo-wschodni
sud-oest - południowy zachód | południowo-zachodni
Suècia - Szwecja
sufix - przyrostek
suggerir - sugerować
Suïssa - Szwajcaria
sumac - sumak
suor - pot | wilgoć
superàvit - nadmiar
supermercat - supermarket
superstició - przesąd
suposar - mieć powinność
sutge - sadza | kopeć
tabac - tytoń
Tailàndia - Tajlandia
Taj Mahal - Tadź Mahal
tal·li - tal
també - również | także | też
tambor - bęben
tampoc - też nie | także nie | również nie
tancar - zamykać
tàntal - tantal
Tanzània - Tanzania
taquicàrdia - częstoskurcz | tachykardia
tard - późno
tarda - popołudnie
tardor - jesień
targeta de crèdit - karta kredytowa
taronja - pomarańcza | barwa pomarańczowa | pomarańczowy
tatuar - tatuować
tatuatge - tatuaż
taula - stół | deska | tablica | tabela
tauló - deska
Taure - Byk
tauró - rekin
taxidèrmia - taksydermia
taxímetre - taksometr | taksomierz
taxonomía - taksonomia
te - herbata
teatre - teatr
teclat - klawiatura
tecneci - technet
tecnologia - technika
tecnològic - techniczny
teista - teista
telèfon - telefon
telegrama - telegram
telenovel·la - opera mydlana
televisió - telewizja
tel·luri - tellur
témer - bać się
temperatura - temperatura
tempesta - burza
templa - skroń
temporalment - tymczasowo
temps - czas
tendó - ścięgno
tenir - mieć
teologia - teologia
teoria - teoria
teòric - teoretyczny
teràpia - terapia
terbi - terb
tercer - trzeci
terminar - skończyć
terminologia - terminologia
tèrmit - termit
termodinàmic - termodynamiczny
termodinàmica - termodynamika
termòmetre - termometr
Termòpiles - Termopile
terra - świat | ziemia | ląd
Terra - Ziemia
terratrèmol - trzęsienie ziemi
territori - terytorium
terrorisme - terroryzm
testicle - jądro
teu - twój
teulada - dach
teus - twoi
teva - twoja
te verd - zielona herbata
teves - twoje
text - tekst
tia - ciotka | ciocia
tiet - wuj | wujek
tieta - ciotka | ciocia
tigre - tygrys
timó - ster
típic - typowy
tipus - typ | rodzaj
tirania - tyrania
tiroide - tarczyca
tisores - nożyczki
titani - tytan
toc - dotyk
tolerància - tolerancja
tolerar - tolerować | znosić
tomàquet - pomidor
tomba - grób
tori - tor
tortuga - żółw
torturar - torturować | męczyć
tossir - kaszleć
tossut - uparty
tot - wszystko
totalment - totalnie
tothom - wszyscy
tou - miękki
tovallola - ręcznik
tòxic - trujący
toxicitat - toksyczność
tradició - tradycja
traducció - tłumaczenie
traductor - tłumacz
traduir - tłumaczyć
tragèdia - tragedia
tràgic - tragiczny
traïdor - zdrajca
trair - zdradzić
trajectòria - tor | trajektoria
trampa - pułapka
tranquil - spokojny | cichy
transitiu - przechodni
transmissió - transmisja
transparent - przeźroczysty
treballador - pracownik
treballar - pracować
tren - pociąg
trenta - trzydzieści | 30
trenta-cinc - trzydzieści pięć | 35
trenta-dos - trzydzieści dwa | 32
trenta-nou - trzydzieści dziewięć | 39
trenta-quatre - trzydzieści cztery | 34
trenta-set - trzydzieści siedem | 37
trenta-sis - trzydzieści sześć | 36
trenta-tres - trzydzieści trzy | 33
trenta-un - trzydzieści jeden | 31
trenta-vuit - trzydzieści osiem | 38
trentè - trzydziesty
tres - 3 (trzy) | trójka
tretze - trzynaście (13) | trzynastka
tretzè - trzynasty
Triàsic - trias
tribuna - trybuna
tricicle - pojazd na trzech kołach | trójkołowiec
tridimensional - trójwymiarowy
trist - smutny
tristesa - smutek
trobada - spotkanie | trobar
trofeu - trofeum
trompeta - trąbka
tron - tron
tronar - grzmieć
trucada - połączenie (telefoniczne)
truita - pstrąg | omlet
tu - ty
tuli - tul
tungstè - wolfram
túnica - tunika
Tunísia - Tunezja
turbant - turban
turisme - turystyka
Turkmenistan - Turkmenistan
turmell - kostka
turment - tortura
Turquia - Turcja
tustar - uderzać
Txad - Czad
txec - język czeski | Czech
u - 1 (jeden)
uapití - wapiti
ubicació - pozycja | lokalizacja
Ucraïna - Ukraina
ull - oko
ulleres - okulary
un - 1 (jeden)
una - 1 (jedna)
una altra vegada - znów | znowu | jeszcze raz
unanimitat - jednomyślność
ungla - paznokieć
únic - jedyny
uniforme - jednolity | mundur
unió - unia
Unió Europea - Unia Europejska
unitat - jednostka
universitat - uniwersytet
urani - uran
urbà - miejski
urologia - urologia
urpa - pazur
Uruguai - Urugwaj
usuari - użytkownik
utopia - utopia
vaca - krowa
vague - niejasny
vaixell - statek (wodny)
vall - dolina
vampir - wampir
vanadi - wanad
vapor - para | opar
Varsòvia - Warszawa
vasectomia - wazektomia
vaselina - wazelina
VeB - niech żyje Barça! (zawołanie kibiców FC Barcelona)
vegetarianisme - wegetarianizm
vehicle - wehikuł | środek transportu
vell - stary
velocitat - prędkość
vena - żyła
vendre - sprzedawać
Venècia - Wenecja
Veneçuela - Wenezuela
vent - wiatr
ventall - wachlarz
verat - makrela
verb - czasownik
verd - barwa zielona | zielony
verdós - zielonkawy
verdura - warzywo
Verge - Panna
vergonya - wstyd
verí - trucizna
veritable - prawdziwy
veritablement - naprawdę
veritat - prawda
verm - robak
vermellós - czerwonawy
versió - wersja
vertical - pionowy
verticalment - pionowo
vespa - osa
veu - głos
veure - widzieć
vexil·lologia - weksylologia
vi - wino
Via Làctia - Droga Mleczna
viarany - ścieżka | dróżka
viatge - podróż
viatjar - podróżować
Viccionari - Wikisłownik
víctima - ofiara
victòria - zwycięstwo
victoriós - zwycięski
vida - życie
videojoc - gra wideo
vidu - wdowiec
vídua - wdowa
Vietnam - Wietnam
vigorós - energiczny
vint - 20 (dwadzieścia)
vintè - dwudziesty
vint-i-cinc - dwadzieścia pięć | 25
vint-i-dos - dwadzieścia dwa | 22
vint-i-nou - dwadzieścia dziewięć | 29
vint-i-novè - dwudziesty dziewiąty
vint-i-quatre - dwadzieścia cztery | 24
vint-i-set - dwadzieścia siedem | 27
vint-i-sis - dwadzieścia sześć | 26
vint-i-tres - dwadzieścia trzy | 23
vint-i-un - dwadzieścia jeden | 21
vint-i-vuit - dwadzieścia osiem | 28
violència - przemoc
violí - skrzypce
Viquipèdia - Wikipedia
virginitat - dziewictwo
virus - wirus
visible - widoczny
visió - widok
visitar - odwiedzić
visual - wizualny
vitamina - witamina
viu - żywy
viure - żyć | mieszkać
volcà - wulkan
volcànic - wulkaniczny
voler - chcieć
voltor - sęp
volum - objętość
voluntàriament - dobrowolnie
vòmit - wymiociny
vomitar - wymiotować
vòrtex - wir
vosaltres - wy
vostè - pan | pani
vostès - państwo
vostra - wasza
vostre - wasz
vostres - wasz|wasi | wasze
votar - głosować
vuit - osiem (8) | ósemka
vuitanta - osiemdziesiąt | 80
vuitè - ósmy
xacal - szakal
xai - jagnię
xal - szal
xampany - szampan
xampú - szampon
xarxa - sieć
xemeneia - komin
xenó - ksenon
xeringa - strzykawka
xicot - chłopak (sympatia)
xicota - dziewczyna (sympatia)
Xile - Chile
xilè - chilijski
ximpanzé - szympans
Xina - Chiny
xinès - chiński
Xipre - Cypr
xiular - gwizdać
xiuxiuejar - szeptać
xocolata - czekolada
xovinisme - szowinizm
yacht - jacht
zas - plask! | bum! | pac!
zebra - zebra
zero - zero | 0
zinc - cynk
zirconi - cyrkon
zodíac - zodiak
zombi - zombi
zona - strefa
zona erògena - strefa erogenna
zoo- - zoo-
zoòleg - zoolog
zoologia - zoologia
zooplàncton - zooplankton
zum-zum - brzęczenie | buczenie | pomruk | mruczenie
