〇 - zero, 0
zh| 彩虹 - tęcza
zh| 战争 - wojna
一 - jeden, 1, raz, sam, pojedynczy, jednorazowy
一下 - jeden raz，jednokrotnie, trochę, na krótką chwilę, nagle
一下儿 - jeden raz，jednokrotnie, trochę, na krótką chwilę, nagle
一月 - styczeń
七 - siedem, 7
三 - trzy, 3
三月 - marzec
不丹 - Bhutan
不好意思 - przepraszam (za kłopot), zmieszany, zakłopotany, zawstydzony, wstydzić się (coś zrobić)
世界 - świat, Ziemia, kula ziemska
世界语 - esperanto
世纪 - wiek, stulecie
东 - wschód (kierunek), właściciel, gospodarz
东西 - coś, rzeczy (+ klasyfikatory 个, 件 lub 种), człowiek, zwierzę
两 - dwa, dwoje, para, oba, każdy
个 - osób, ludzi, pojedynczy, jeden, około
中 - środek, wśród, pomiędzy, mający związek z Chinami, chiński
中华人民共和国 - Chińska Republika Ludowa
中国 - Chiny
中国人 - Chińczyk
中國 - 中国
中國人 - 中国人
中学 - szkoła średnia
中文 - język chiński (pisany)
中華人民共和國 - 中华人民共和国
中華民國 - Republika Chińska, Tajwan
丹麦 - Dania
为 - działać
乌克兰 - Ukraina
乌拉圭 - Urugwaj
九 - dziewięć, 9
也 - również, też, nawet, mniej więcej, w zasadzie, tylko
书 - książka
买 - kupić, wynająć
乳糖酶 - laktaza
了 - wiedza
事 - rzecz, kwestia
二 - dwa, 2
二月 - luty
亍 - 彳亍
五 - pięć, 5
五行 - pięć żywiołów budujących — według filozofii chińskiej — wszechświat, Wu xing
亚洲 - Azja
亞美尼亞 - Armenia
人 - człowiek, ludzie, osoba
人人为我，我为人人 - jeden za wszystkich, wszyscy za jednego
人人為我，我為人人 - jeden za wszystkich, wszyscy za jednego
人们 - ludzie, osoby
今天 - dziś, dzisiaj
介詞 - przyimek
介词 - przyimek
他 - on
以色列 - Izrael
伊朗 - Iran
伦敦 - Londyn
伯利兹 - Belize
佛教 - buddyzm
你 - ty
你们 - wy
你好 - cześć, witaj
侠 - heroiczny
俄罗斯 - Rosja
俄语 - język rosyjski
保加利亚 - Bułgaria
信 - list, poczta, korespondencja, uwierzyć (komuś), dawać wiarę
倫敦 - Londyn
先生 - nauczyciel
克罗地亚 - Chorwacja
八 - osiem, 8
公共汽车 - autobus
六 - sześć, 6
内罗毕 - Nairobi
冈比亚 - Gambia
再 - znowu
再见 - do widzenia!
写 - pisać
冥王星 - Pluton
冬 - zima
冬天 - zima
冰岛 - Islandia
几 - ile, kilka, trochę
几内亚 - Gwinea
利比亚 - Libia
前年 - przedostatni rok
剎那 - chwila, moment
副詞 - przysłówek
副词 - przysłówek
办法 - metoda, sposób robienia czegoś, dokonania czegoś, wzór tworzenia zdań, schemat zdania
加拿大 - Kanada
动物 - zwierzę
匈牙利 - Węgry
北 - północ (kierunek)
北京 - Pekin
医学 - medycyna, nauki medyczne
医生 - lekarz
十 - dziesięć, 10
单词 - słowo
南 - południe (kierunek)
南极洲 - Antarktyda
卢森堡 - Luksemburg
印度尼西亚 - Indonezja
厄立特里亚 - Erytrea
厌恨 - pogardzać, nienawidzić
口 - usta, buzia
可 - móc, być w stanie, może, pewnie, bardzo (cząstka używana do emfazy)
可以 - znośny, całkiem dobry, niezły, okropny, straszny, być wartym (zrobienia)
台湾 - Tajwan (wyspa), Republika Chińska
吉尔吉斯斯坦 - Kirgistan
吉布提 - Dżibuti
名字 - imię
名词 - rzeczownik
吗 - czy
听 - słuchać, słyszeć, brać pod rozwagę, wykonywać polecenia, zarządzać, pozwalać
和 - i, pokój, spokojny
和平 - pokój, zgoda
咖啡 - kawa
咖啡馆 - kawiarnia, sklep kawowy, bar kawowy
哈萨克斯坦 - Kazachstan
哥斯拉 - Godzilla
哥本哈根 - Kopenhaga
哪儿 - gdzie, gdziekolwiek, nigdzie, Używany w pytaniach retorycznych do wyrażenia negacji
商店 - sklep
啊 - och, ach, także: no
啊嚏 - apsik!, a psik!
啤酒 - piwo
喀布尔 - Kabul
喂 - cześć!, hej!
喝 - pić, wykrzyczeć
四 - cztery, 4
四月 - kwiecień
国 - Stany Zjednoczone, USA
图书馆 - biblioteka
國立 - 国立
土星 - Saturn
土耳其 - Turcja
圣多美和普林西比 - Wyspy Świętego Tomasza i Książęca
地中海 - Morze Śródziemne
地图 - mapa, atlas
地壳 - skorupa ziemska
地拉那 - Tirana
地球 - Ziemia
埃及 - Egipt
埃塞俄比亚 - Etiopia
城 - miasto
墨西哥 - Meksyk
夏 - lato, Chińska Dynastia Xia (Sia), Kataj, katajski, odnoszący się do średniowiecznych Chin
夏天 - lato
多少 - ile, jaki to numer
大 - duży, dorosły, starszy, nazwisko
大夫 - lekarz, doktor, urzędnik wyższej rangi
大小 - rozmiar, wielkość czegoś, starszeństwo, osoba starsza, dzieci i dorośli, osoby w różnym wieku
大豆 - soja
天王星 - Uran
天空 - niebo
太阳 - słońce
太阳系 - Układ Słoneczny
奥地利 - Austria
女孩儿 - dziewczyna
她 - ona, jej
妇女 - kobieta
妈妈 - mama
妹妹 - młodsza siostra
姐姐 - starsza siostra
姓 - nazwisko, nazwisko rodowe, nazywać się
姓名 - pełne imię i nazwisko
姜 - Jiāng, imbir
婚禮 - ślub
字典 - słownik
字母 - litera
孟加拉国 - Bangladesz
学习 - studiować, uczyć się
学生 - student, uczeń, zwolennik, wyznawca, chłopiec, chłopak
它 - to
安哥拉 - Angola
安道尔 - Andorra
宏 - szeroki, wielki, przestronny, obszerny, nazwisko
宗教 - religia
宾馆 - hotel
宿舍 - akademik, kwatery mieszkalne
小 - mały, niewielki, młody, odnoszący się do dzieci lub dzieciństwa
小时 - godzina
尼日尔 - Niger
山 - góra
工程师 - inżynier
巴哈马 - Bahamy
巴基斯坦 - Pakistan
巴巴多斯 - Barbados
巴拉圭 - Paragwaj
巴林 - Bahrajn
巴西 - Brazylia
希腊 - Grecja
帮助 - pomoc, asysta
常 - często, zazwyczaj
开始 - zaczynać, rozpoczynać
弟弟 - młodszy brat
录音 - nagranie dźwiękowe, nagrywać dźwięk
形容词 - przymiotnik
彳亍 - spacerować powoli
很 - bardzo
德国 - Niemcy
德语 - język niemiecki
心脏 - serce
忙 - zajęty
念 - myśleć o kimś, tęsknić, czytać na głos, studiować, uczęszczać do szkoły
性感 - seksapil
总统 - prezydent
恨 - nienawidzić
您 - ty: pan, pani (także: wy, państwo)
意大利 - Włochy
愛國 - patriotyzm, patriotyczny
愛沙尼亞 - Estonia
愛沙尼亞人 - Estończyk
我 - ja
我们 - my
房子 - dom
手指 - palec
手紙 - papier toaletowy
扎莫希奇 - Zamość
打 - zadawać cios, uderzać, walczyć, skonstruować, wykuć, wymieszać
拉脱维亚 - Łotwa
挪威 - Norwegia
捷克 - Czechy
摩洛哥 - Maroko
数学 - matematyka
文莱 - Brunei
斋 - pościć, unikać wina lub mięsa
斯洛文尼亚 - Słowenia
新 - nowy
新加坡 - Singapur
新年 - Nowy Rok
新聞 - 新闻
新闻 - wiadomość, nowina, nius
无风不起浪 - nie ma wiatru – nie ma fal (: nie ma dymu bez ognia)
日本人 - Japończyk, Japończycy
早上好 - dzień dobry
时间 - czas, okres czasu
明天 - jutro
星期 - tydzień
星期一 - poniedziałek
星期三 - środa
星期二 - wtorek
星期五 - piątek
星期六 - sobota
星期四 - czwartek
星期日 - niedziela
春 - wiosna
春天 - wiosna
春季 - wiosna
是 - być, tak
智利 - Chile
最 - naj-, najbardziej
月球 - księżyc
朋友 - przyjaciel, chłopak, dziewczyna
木星 - Jowisz
未来 - przyszłość
本 - korzeń, łodyga rośliny, podstawa, stolica, książka, wydanie
杯 - kubek, filiżanka, szklanka, kieliszek
杯子 - kubek, filiżanka, szklanka, kieliszek itp. (ogólnie: naczynie, z którego pije się napoje)
東西 - 东西
林 - las
柬埔寨 - Kambodża
柿 - hurma, persymona, kaki
格鲁吉亚 - Gruzja
桃子 - brzoskwinia
梵语 - sanskryt
棺材 - trumna
橄榄球 - rugby
橄欖球 - rugby
欧洲 - Europa
欧洲联盟 - Unia Europejska
欧西坦语 - język prowansalski
死亡 - śmierć
母亲 - matka
母牛 - krowa
比利时 - Belgia
比利時 - Belgia
毛里塔尼亚 - Mauretania
水 - woda (ciecz), jeden z pięciu żywiołów budujących wszechświat według tradycyjnej filozofii chińskiej wu xing
水星 - Merkury
水果 - owoc
汉 - chiński (język), człowiek
汉语 - język chiński
汉语拼音方案 - pinyin – schemat fonetyzacji języka chińskiego
汽车 - samochód
沙漠 - pustynia
沙特阿拉伯 - Arabia Saudyjska
法国 - Francja
波兰 - Polska
波羅地大陸 - Bałtyka
波蘭 - Polska
注音符号 - system transkrypcji języka chińskiego, często nazywany  (ㄅㄆㄇㄈ) od czterech pierwszych znaków w tabeli trankrypcyjnej
泰国 - Tajlandia
海 - morze, ocean, bardzo duża ilość czegoś
海王星 - Neptun, dosłownie: Planeta Władcy Oceanów
海豚 - delfin
源 - źródło
溫泉關 - Termopile
演化 - ewolucja
漢 - 汉
漢語拼音方案 - 汉语拼音方案
澳大利亚 - Australia
澳大利亚人 - Australijczyk
火 - ogień, jeden z pięciu żywiołów budujących wszechświat według tradycyjnej filozofii chińskiej wu xing
火星 - Mars
火车 - pociąg
火鍋 - 火锅
火锅 - [http://pl.wikipedia.org/wiki/Huoguo gorący kociołek (Huoguo)], tradycyjne naczynie kuchni chińskiej, służące do przyrządzania potraw bezpośrednio na stole, obecnie potocznie słowo to używane jest też jako nazwa potrawy w takim naczyniu przyrządzanej
灰尘 - pył
炸弹 - bomba
烟尘 - zanieczyszczenie powietrza
無風不起浪 - nie ma wiatru – nie ma fal (: nie ma dymu bez ognia)
煥 - brylant, błyszczący
爱 - miłość, kochać
爱人 - współmałżonek (żona lub mąż), kochanek/kochanka, ukochany/ukochana
爱尔兰 - Irlandia
爱沙尼亚 - Estonia
爱米莉亚 - Emilia
父亲 - ojciec
爸 - ojciec
爸爸 - tata
牛 - wół, bawół, krowa (generalnie: bydło rogate), Zodiak chiński
牛奶 - mleko krowie
牝 - płci żeńskiej, głęboka gardziel
物理学 - fizyka
犬 - pies
狐狸 - lis
狗 - pies
猪 - świnia, wieprz, dzik, prosię, Świnia: ostatni, Zodiak chiński
玩具 - zabawka
现在 - teraz, obecnie, dzisiaj, współczesne czasy, czasy dzisiejsze
玻利維亞 - Boliwia
玻利维亚 - Boliwia
珍珠奶茶 - herbata z tapioką, popularny napój orzeźwiający na bazie herbaty, znany jako bubble tea
瑞典 - Szwecja
瑞士 - Szwajcaria
瑞士人 - Szwajcar
生物 - organizm, stworzenie, istota żywa
生物学 - biologia
生词 - nowe słowo, jednostka słownikowa
用功 - ciężko pracujący, pracowity
电脑 - komputer
电话 - telefon
电车 - tramwaj
画报 - ilustrowany magazyn, ilustrowana gazeta
癌 - rak
白俄罗斯 - Białoruś
的 - mój, twój itd., jasny, przejrzysty, dokładny
直径 - średnica
眼睛 - oko
知識 - wiedza
矮 - niski (o ludziach i roślinach)
石油 - ropa naftowa, ropa
硝酸 - kwas azotowy
祝 - życzyć, składać życzenia
禀 - petycja, składać petycję
禅 - buddyzm chan, zen, medytacja zen, abdykować
禪 - 禅
秋 - jesień
秋天 - jesień
科威特 - Kuwejt
科特迪瓦 - Wybrzeże Kości Słoniowej
秘鲁 - Peru
立陶宛 - Litwa
篮球 - koszykówka
簿子 - notatnik, notes
米 - ryż
糖 - cukier
純素食主義 - 纯素食主义
素食主义 - wegetarianizm
維基百科 - Wikipedia
红海 - Morze Czerwone
纯素食主义 - weganizm
维琴察 - Vicenza (miasto)
网球 - tenis, piłka tenisowa
美國 - Ameryka, USA
翻译 - tłumaczyć, przekładać
老师 - nauczyciel
老鼠 - szczur, mysz
肯尼亚 - Kenia
肺 - płuco
能量 - energia
自由 - wolność
臺灣 - 台湾
色拉 - sałatka
芬兰 - Finlandia
花儿 - kwiat
花店 - kwiaciarnia
英语 - język angielski
苹果 - jabłko
茶 - herbata
茶叶 - herbata, liście herbaty
荷兰 - Holandia
莲属 - lotos
葡萄牙 - Portugalia
蔅 - piękny, przystojny, uwodzicielski
藍色 - barwa niebieska
蘋果 - jabłko
虎 - tygrys
蜂蜜 - miód
蝙蝠 - nietoperz
西 - zachód (kierunek), lub
西班牙 - Hiszpania
西瓜 - arbuz
西藏 - Tybet, Xizang
註音符號 - 注音符号
語系 - 语系
語言 - 语言
认识 - znać, rozpoznawać, wiedza, zrozumienie
记下 - zanotować
词 - słowo, wyraz, wyrażenie, gatunek poezji chińskiej, Ci
词典 - słownik, leksykon
话 - mowa, rozmowa, konwersacja, słowa, powiedzenia, język, dialekt, rozmawiać, opowiadać
语法 - gramatyka
语系 - rodzina języków, grupa językowa
语言 - język
说 - mówić, rozmawiać, wyjaśniać, zrugać, działać jako swatka, odnosić się, wskazywać
谢谢 - dziękować
豆腐 - tofu
贝宁 - Benin
质量 - jakość, masa
赞比亚 - Zambia
越南 - Wietnam
足球 - piłka nożna
身体 - ciało, zdrowie
车 - pojazd, maszyna poruszająca się na kołach
这 - to, ten, ta, to (2.1)
这儿 - tutaj
这里 - tu, tutaj
那 - tamto, tamten, starożytne barbarzyńskie księstwo w regionie [http://pl.wikipedia.org/wiki/Syczuan Syczuan]
那儿 - tam
那里 - tam
郁金香 - tulipan
都 - wszyscy, każdy, nawet, już
酗酒 - nałogowe picie alkoholu, alkoholizm, upijać się, pić nałogowo/nadmiernie
金星 - Wenus
鍋 - 锅
铅笔 - ołówek
银河系 - Droga Mleczna
锅 - garnek, kocioł, naczynie używane do przygotowywania jedzenia
锕 - aktyn
長笛 - flet
长笛 - flet
阿 - schlebiać, pochlebiać
阿公 - ojciec męża, teść, dziadek
阿基来司腱 - ścięgno Achillesa
阿基米德 - Archimedes
阿基里斯腱 - ścięgno Achillesa
阿塞拜疆 - Azerbejdżan
阿姆斯特丹 - Amsterdam
阿富汗 - Afganistan
阿尔卑斯 - Alpy
阿尔及利亚 - Algieria
阿尔巴尼亚 - Albania
阿尔申 - arszyn
阿尔茨海默病 - choroba Alzheimera
阿德克索林 - adexolin
阿拉伯 - Arab, arabski
阿拉伯人 - Arab
阿拉伯半岛 - Półwysep Arabski
阿拉伯建筑 - architektura arabska
阿拉伯海 - Morze Arabskie
阿拉伯联合酋长国 - Zjednoczone Emiraty Arabskie
阿拉伯聯合酋長國 - 阿拉伯联合酋长国
阿拉伯胶 - guma arabska
阿拉伯诗歌 - poezja arabska
阿拉伯酋长 - szejk arabski
阿拉斯加 - Alaska
阿拉木图 - Ałma Ata
阿昌族 - mniejszość narodowa Achang
阿曼 - Oman
阿根廷 - Argentyna
阿波罗 - Apollo
阿爾及爾 - Algier
阿狗 - pies
阿米巴 - ameba
阿訇 - imam, mułła
阿赛拜疆 - Azerbejdżan
阿飞 - chuligan, żul, łobuz
雅典 - Ateny
雨 - deszcz
雨水 - deszczówka, woda deszczowa
零 - zero, 0
電子 - elektron
非常 - nadzwyczajnie, niezwykle, specjalnie, w najwyższym stopniu, wyjątkowo
非洲 - Afryka
顏色 - barwa, kolor
風水 - 风水
风水 - odmiana geomancji, sztuka harmonizacji życia z otaczającym człowieka światem, osiągania równowagi z naturą Feng shui
食物 - jedzenie
香港 - Hongkong
香蕉 - banan
马 - koń, Zodiak chiński
马上 - natychmiast, od razu, w tej chwili
马来西亚 - Malezja
马马虎虎 - tak sobie, przeciętnie, ani dobrze, ani źle, taki sobie, średni, przeciętny, ani dobry, ani zły
骆驼 - wielbłąd
高兴 - szczęśliwy, zadowolony
鱷魚 - krokodyl
鳄鱼 - krokodyl
鸟 - ptak, w chińskiej astronomii: północny sektor nieba, nazwisko, penis
麒麟 - qilin
麥可 - Michał, imię męskie
龙 - smok
