a - a | ale
abažur - abażur
abeceda - alfabet
abhaski - abchaski | abchaski (język)
adresa - adres
adresat - adresat
advokat - adwokat | prawnik
aerodrom - lotnisko
afrički - afrykański
Afrika - Afryka
agencija - agencja
agresija - agresja
ajvar - ajwar
akademizam - akademizm
akcija - akcja
ako - jeśli | jeżeli
akvarel - akwarela
akvarij - akwarium
Albanija - Albania
albanski - albański | albański (język)
albatros - albatros
alergija - alergia | uczulenie
ali - ale | lecz
Aljaska - Alaska
alkoholičar - alkoholik
alpinizam - alpinizm
Alžir - Algieria
ambicija - ambicja
ambon - ambona
ambulanta - ambulans
Amerikanac - Amerykanin
Amerikanka - Amerykanka
anatomija - anatomia
Andaluzija - Andaluzja
Ande - Andy
anđeo - anioł
anđeo čuvar - anioł stróż
Andora - Andora
antropologija - antropologia
aplikacija - zastosowanie | aplikacja | program | naszywka | przyszywana ozdoba
apoteka - apteka
arabistika - arabistyka
aragonski - aragoński
aramejski - aramejski
arapski - arabski
arčinski - arczyński
arhitrav - architraw
aritmija - arytmia | zaburzenie rytmu serca
armija - armia
Arnaut - Albańczyk
Arnautkinja - Albanka
arnautski - albański
arterija - arteria
astenosfera - astenosfera
asterisk - gwiazdka | asterysk
astronomija - astronomia
ateist - ateista
ateizam - ateizm
australopitek - australopitek
Austrija - Austria
autobus - autobus
autobusni - autobusowy
autocesta - autostrada
automobil - samochód
avangarda - awangarda
avangardistički - awangardowy
azerski - azerski | azerski (język)
Azija - Azja
baba - baba | babcia (rzadko)
baciti - rzucić
bačva - beczka
Bahami - Bahamy
bajka - bajka | baśń
baka - babcia
bakar - miedź
bakren - miedziany
balkon - balkon
balon - balon
banana - banan
banka - bank
baraka - barak
barun - baron
baškirski - baszkirski | baszkirski (język)
bazen za kupanje - basen kąpielowy
beba - niemowlę | dziecko
Beč - Wiedeń
bedro - udo
bengalski - bengalski | bengalski (język)
Benin - Benin
benzin - benzyna
beznadan - beznadziejny | pełen desperacji
bezsmrtan - nieśmiertelny
bezukusan - pozbawiony smaku
bezuman - bezrozumny
bič - bicz
bicikl - rower
bijel - biały
biljar - bilard
biljka - roślina
bilo gdje - byle gdzie | gdziekolwiek
biokemija - biochemia
biologija - biologia
biskup - biskup
biti - być
biti na sedmom nebu - być w siódmym niebie
biti svoj - być sobą
biti u sedmom nebu - być w siódmym niebie
bitka - bitwa
Bjelorusija - Białoruś
bjeloruski - białoruski | język białoruski
blato - błoto
blijed - blady
blizak - bliski
blues - blues
boca - butelka
bog - bóg
Bog - Bóg
bogat - bogaty
bogoslužje - liturgia
bogu za leđima - dosłownie | w oddalonym lub w jakiś sposób zacofanym miejscu | w zabitej dechami dziurze
boja - kolor
bojati se - bać się
bolesna ambicija - chora ambicja
bolesnik - chory (osoba dotknięta chorobą)
bolest - choroba
bolestan - chory
bolje ikad nego nikad - lepiej późno niż wcale
boljeti - boleć
bolnica - szpital
borba - walka
borovnica - jagoda (czarna)
bošnjački - bośniacki | bośniacki (język)
Božić - Boże Narodzenie
brada - broda
brak - małżeństwo
brana - tama
brašno - mąka
brat - brat
Bratislava - Bratysława
brdina - wzgórze
brdo - wzgórze | góra | kupa czegoś | wielka ilość czegoś
brdski - wzgórzowy
breskva - brzoskwinia
bretonski - bretoński | bretoński (język)
brežuljak - pagór | pagórek
brijeg - pagór | pagórek
britanski - brytyjski
brod - statek
brodogradilište - stocznia
broj - liczba
brojati - liczyć
brokula - brokuł
brz - szybki
brzo - szybko
bubanj - bęben
bubreg - nerka
bučni - głośny | hałaśliwy
budala - głupiec | dureń
budizam - buddyzm
Bugarska - Bułgaria
bugarski - bułgarski | język bułgarski
bundeva - dynia
burza - giełda
busola - busola | kompas
but - udziec | udo
čaj - herbata
čajnik - czajnik
čamac - łódka
car - cesarz | car
čarapa - skarpeta
carina - cło
car je gol - król jest nagi
čaša - szklanka
čavao - gwóźdź
čečenski - czeczeński | czeczeński (język)
čekaonica - poczekalnia
čekati - czekać
čekić - młotek
ćelav - łysy
celer - seler
čelo - czoło
centar - centrum
češalj - grzebień
Češka - Czechy
češki - czeski | czeski (język)
češnjak - czosnek
cesta - droga
čestica - cząstka | cząsteczka | partykuła
često - często
četiri - cztery | 4
četka - szczotka
četrdeset - czterdzieści
četrnaest - czternaście
četrnaesti - czternasty
četvrt - kwadrans
četvrtak - czwartek
četvrti - czwarty
cigareta - papieros
cigla - cegła
cijel - cały
cijena - cena
cikla - burak
cilj - cel
cilj opravdava sredstvo - cel uświęca środki
cimet - cynamon
činjenica - fakt
cipela - but
čipka - koronka
čist - czysty
čist kao suza - czysty jak łza
čitati - czytać
civilizacija - cywilizacja
čokolada - czekolada
čovjek - człowiek
crijevo - jelito | rura gumowa | szlauch
crkva - kościół
crn - czarny
crv - robak
crven - czerwony
čudan - dziwny
ćuk - pójdźka
cura - dziewczyna
čuti - słyszeć
cvijeće - kwiaty
cvijet - kwiat
cvjetača - kalafior
cvrčak - świerszcz
da - tak | że | żeby
daleko - daleko
dalekovidnost - nadwzroczność
dalmatinski - dalmatyński | dalmatyński (język)
dan - dzień
danas - dzisiaj | dziś
Danska - Dania
danski - duński | duński (język)
dar - prezent | talent | dar
dati - dać
davati - dawać
davno - dawno
debeo - gruby | otyły
definicija - definicja
deka - koc
deset - dziesięć | 10
deseti - dziesiąty
desni - prawy (strona)
deva - wielbłąd
devet - dziewięć | 9
deveti - dziewiąty
devetka - dziewiątka
devetnaest - dziewiętnaście | 19
devetnaesti - dziewiętnasty
difrakcija - dyfrakcja
dijete - dziecko
dim - dym
dimnjak - komin
dinastija - dynastia
dirigent - dyrygent
disciplina - dyscyplina
divan - kanapa | sofa | tapczan | wspaniały | cudowny | piękny
dječak - chłopiec | chłopak
djed - dziadek
djevojčica - dziewczynka
djevojka - dziewczyna
dlan - dłoń
dobar - dobry
dobar dan - dzień dobry
dobar tek - smacznego
dobro - dobro (litera) | dobro (gitara) | dobrze
dodati - dodać | podać | wręczyć
dodavati - dodawać | podawać | wręczać
dojka - pierś
dokaz - dowód
dolaziti - przychodzić
dolina - dolina
dolje - na dole | w dole
domovina - ojczyzna
domovinski - ojczyźniany | ojczysty
doručak - śniadanie
dosadan - nudny
dosta - dosyć | dość | wystarczająco
dostojan - dostojny | godny | wart
drag - drogi
drugi - drugi | inny
drugorazredan - drugorzędny | drugiej klasy
drvo - drzewo | drewno
duda - smoczek
dug - długi | dług
duga - tęcza
dugme - guzik | przycisk
dugo - długo
duhan - tytoń
đumbir - imbir
duša - dusza
dva - dwa | 2
dvadeset - dwadzieścia
dvadeseti - dwudziesty
dvanaest - dwanaście | 12
dvanaesti - dwunasty
dvoboj - pojedynek
dvodijelan - dwuczęściowy
dvojba - dylemat
džamija - meczet
džem - dżem
džep - kieszeń
džul - dżul
Egipat - Egipt
ekonomija - ekonomia
eksergija - egzergia
Ekvador - Ekwador
elektrana - elektrownia
električni - elektryczny
elektroliza - elektroliza
Elzas - Alzacja
Emilia - Emilia
Emilija - Emilia
emocija - emocja
enciklopedija - encyklopedia
energija - energia
engleski - angielski | angielski (język)
epidemiologija - epidemiologia
erbij - erb
estetika - estetyka
estonski - estoński | estoński (język)
Europa - Europa
evolucija - ewolucja
fazan - bażant
federacija - federacja
fenički - fenicki | fenicki (język)
filharmonija - filharmonia
Filipini - Filipiny
filologija - filologia
filozofija - filozofia
Finska - Finlandia
finski - fiński | fiński (język)
fizičar - fizyk
fizika - fizyka
fotoalbum - album fotograficzny
Francuska - Francja
francuski - francuski | francuski (język)
frizer - fryzjer
fruktoza - fruktoza
futuristički - futurystyczny
futurizam - futuryzm
gaće - majtki
galeb - mewa
galerija - galeria
gdje - gdzie
genetika - genetyka
geografija - geografia
geometrija - geometria
gitara - gitara
glačalo - żelazko
glaciologija - glacjologia
gladan - głodny
glagol - czasownik
glas - głos
glasno - głośno
glava - głowa
glavni - główny
glazba - muzyka
glazben - muzyczny
gljiva - grzyb
glumac - aktor
glup - głupi
glupak - głupek
gmaz - gad
gnoj - ropa | nawóz | błoto | glina
gnojidba - nawożenie
gnojivo - nawóz
godina - rok
gol - nagi | gol
golem - ogromny
gordijski - gordyjski
gordijski čvor - węzeł gordyjski
gore - na górze | w górze
gost - gość
govedina - wołowina
govnast - gówniany | jak gówno
govnjen - gówniany | jak gówno | bardzo niskiej jakości
govno - gówno
govoriti - mówić
grad - miasto | grad
građevina - budynek | budowla
graditi - budować
gradski - miejski
gramatika - gramatyka
grana - gałąź
granica - granica
graviton - grawiton
grb - godło
Grčka - Grecja
grčki - grecki | grecki (język)
greška - błąd
gristi - gryźć
grlo - gardło
grob - grób
groblje - cmentarz
grožđica - rodzynek
grudnjak - biustonosz
grupa - grupa
gruzijski - gruziński | gruziński (język)
gulaš - gulasz
guma - guma
guska - gęś
gust - gęsty
gustoća - gęstość
gvožđe - żelazo | potrzask (pułapka myśliwska) | kajdany
Haiti - Haiti
haljina - sukienka
harmonika - akordeon
hedonizam - hedonizm
hemoliza - hemoliza
hitar - prędki | szybki | zwinny
hlače - spodnie
hladan - zimny
hladnjak - lodówka
hobotnica - ośmiornica
hodati - chodzić
hodočasnik - pielgrzym
homeopatija - homeopatia
horizont - horyzont
Horus - Horus
hrana - jedzenie
hrast - dąb
hrčak - chomik
Hrvat - Chorwat
Hrvatica - Chorwatka
Hrvatska - Chorwacja
hrvatski - chorwacki | chorwacki (język)
hvala - dziękuję
i - i
ići - iść
igla - igła
igra - gra
igrač - gracz
igračka - zabawka
ili - lub | albo
ilustracija - ilustracja
imati - mieć
ime - imię
imenica - rzeczownik
imenjak - imiennik
Indija - Indie
informacija - informacja
instrumentalni - instrumentalny
integracija - integracja
interesantan - interesujący | ciekawy
intuicija - intuicja
inženjer - inżynier
irački - iracki
Irska - Irlandia
islamistika - islamistyka
islandski - islandzki | islandzki (język)
ispovjediti - spowiadać się | wyznać
istina - prawda
istobojan - jednakowego koloru
istoimen - o jednakowej nazwie lub imieniu
istok - wschód
izgledati - wyglądać
izgristi - dogryźć | obgryźć (gryząc zjeść w całości) | zjeść (zniszczyć gryząc, np.: o molach) | pogryźć | pokąsać | doprowadzić się do stanu niezadowolenia ciągłym myśleniem o czymś lub zazdrością
izlaz - wyjście
izmet - kał
izmetina - pozostawiony kał | fekalia
iznutra - od wewnątrz
izuzetno - wyjątkowo
izvan - na zewnątrz (położenie, nie kierunek)
izvana - z zewnątrz
izvor - źródło
izvoz - eksport
ja - ja
jabuka - jabłko
Jadran - Adriatyk
Jadransko more - Morze Adriatyckie
jagoda - truskawka
jaje - jajko
japanski - japoński | japoński (język)
jastuk - poduszka
jedan - jeden | 1
jedanaest - jedenaście
jedanaesti - jedenasty
jednom riječju - jednym słowem
jeftin - tani
jelen - jeleń
jelo - danie
jer - bo | ponieważ
jesen - jesień
jesti - jeść
jestiv - jadalny
jestovan - jadalny
jetra - wątroba
jež - jeż
jezero - jezioro
jezik - język
jezikoslovac - językoznawca
jezikoslovlje - językoznawstwo
jezikoslovni - językoznawczy
JNA - JAL | Jugosłowiańska Armia Ludowa
jučer - wczoraj
jug - południe
Jugoslaven - Jugosłowianin
Jugoslavenka - Jugosłowianka
jugoslavenski - jugosłowiański
Jugoslavija - Jugosławia
juha - zupa
jutro - rano | ranek | poranek
jutros - dziś rano
Južna Amerika - Ameryka Południowa
kad - kiedy
Kafarnaum - Kafarnaum
kako - jak
kalendar - kalendarz
kalorija - kaloria
kamen - kamień
kamion - ciężarówka
kao - jak | jako
kao u bajci - jak w bajce
kapa - czapka
kapitalizam - kapitalizm
kardamom - kardamon
karta - mapa | bilet
kaša - kasza
kasno - późno
kašubski - kaszubski | kaszubski (język)
kat - piętro
katalanski - kataloński | kataloński (język)
Katalonija - Katalonia
katalonski - kataloński | kataloński (język)
katedrala - katedra
katolički - katolicki
kava - kawa
kaval - kaval
kavez - klatka
kazalište - teatr
kazna - kara
kći - córka
kemičar - chemik
kemija - chemia
kemijski - chemiczny
kihati - kichać
Kijev - Kijów
kinematografija - kinematografia
kinetički - kinetyczny
kip - posąg
Kirgistan - Kirgistan
kiša - deszcz
kišan - deszczowy
kisik - tlen
kišobran - parasol
klasicizam - klasycyzm
klasifikacija - klasyfikacja
klavir - fortepian
kleptomanija - kleptomania
ključ - klucz
klupa - ławka
knjiga - książka
knjižara - księgarnia
knjižnica - biblioteka
kobasica - kiełbasa
kočiti - hamować
kocka - sześcian
kočnica - hamulec
kod - u
kod kuće - w domu
koji - który
kokoš - kura
kolač - ciastko
količina - ilość
koliko - ile
koljeno - kolano
kolnik - jezdnia
kolodvor - dworzec
kolovoz - sierpień
koma - przecinek | gazowa otoczka jądra komety | rodzaj aberracji optycznej
komedija - komedia
Komori - Komory
komparativ - stopień wyższy
kompozicija - kompozycja
komunizam - komunizm
koncert - koncert
konfederacija - konfederacja
konj - koń
konjak - koniak
konjar - hodowca koni | koniarz
konjarstvo - hodowla koni
konjogojac - hodowca koni | koniarz
konjogojstvo - hodowla koni
konobar - kelner
kontinent - kontynent
koptski - koptyjski | koptyjski (język)
korak - krok
korice - okładka | pochwa (broni białej)
korijen - korzeń | pierwiastek
korisnik - użytkownik
koristiti - używać
kornet - kornet | stożek | rożek | tuba
kosa - włosy | kosa (rzadko)
košarka - koszykówka
kosilica - kosiarka
kost - kość
koštati - kosztować
kostim - kostium
košulja - koszula
kotao - kocioł
koza - koza
koža - skóra
krafna - pączek
kraj - koniec | okolica | strona | kraina | kraj
Krakov - Kraków
kralj - król
kraljica - królowa
krastavac - ogórek
kratak - krótki
kratkorep - o krótkim ogonie
kratkovidnost - krótkowzroczność
krava - krowa
kravata - krawat
kreda - kreda
kreten - kretyn
krevet - łóżko
krivica - wina
križ - krzyż
kroasan - croissant
krov - dach
kruh - chleb
krumpir - ziemniak | kartofel
kruna - korona
kruška - gruszka
krv - krew
krvnik - kat
kuća - dom
kugla - kula
kuharica - kucharka | książka kucharska
kuhati - gotować
kuhinja - kuchnia
kukac - owad
kukavica - kukułka | figurka ptaka w ściennych zegarach | wysuwająca się ze środka w równych odstępach czasu | tchórz
kukuruz - kukurydza
kula - wieża
kumin - kminek
kupiti - kupić
kupovati - kupować
kurdski - kurdyjski
kurva - kurwa
kut - kąt
kvadrat - kwadrat
kvartal - kwartał
labud - łabędź
ladica - szuflada
lagati - kłamać
laku noć - dobranoc!
lastavica - jaskółka
latinski - łaciński | latyński
latvijski - łotewski | łotewski (język)
laž - kłamstwo
led - lód
lekcija - lekcja
leptir - motyl
letjeti - lecieć
letonski - łotewski | łotewski (język)
ležaj - łóżko | miejsce do spania | łożysko
ležati - leżeć
li - czy
Libanon - Liban
lice - twarz
liječiti - leczyć
liječnica - lekarka
liječnik - lekarz
lijek - lekarstwo
lijep - piękny
lijes - trumna
lijevi - lewy
limun - cytryna
limunada - lemoniada
lipanj - czerwiec
list - liść | arkusz papieru
listopad - październik
litavski - litewski | litewski (język)
Litva - Litwa
livada - łąka
ljekarna - apteka
ljestve - drabina
ljeto - lato | rok
ljubav - miłość
ljubav je slijepa - miłość jest ślepa
ljubiti - całować | kochać
ljudi - ludzie
ljudski - ludzki (człowieka)
London - Londyn
lopata - łopata | szufla
lopov - złodziej
lopta - piłka
lubenica - arbuz
lud - szalony
ludilo - szaleństwo
ludnica - szpital psychiatryczny | chaos
luk - cebula | łuk
lupež - złodziej
luster - żyrandol
lutka - lalka
mač - miecz
mačka - kot
Mađarska - Węgry
mađarski - węgierski | język węgierski
magarac - osioł
magla - mgła
majka - matka
majmun - małpa
majoneza - majonez
makar - przynajmniej | choćby (i)
makedonski - macedoński | macedoński (język)
Maldivi - Malediwy
mali - mały
malo - mało | trochę
mandarina - mandarynka
marelica - morela
margarin - margaryna
marka - znaczek (pocztowy) | marka
maslac - masło
mast - tłuszcz
matematika - matematyka
materijal - materiał | tworzywo
med - miód
medicina - medycyna
medvjed - niedźwiedź
mek - miękki
meso - mięso
metafizika - metafizyka
metar - metr
meteorit - meteoryt
metla - miotła
Mezopotamija - Mezopotamia
mezopotamski - mezopotamski
mi - my
Mihovil - Michał
mikrobiologija - mikrobiologia
milijun - milion
milimetar - milimetr
ministarstvo - ministerstwo
Minsk - Mińsk
minuta - minuta
mir - pokój
miraz - posag
mirijada - miriada
miš - mysz
misa - msza
misliti - myśleć
mjesec - miesiąc | księżyc
mjesto - miejsce
mlad - młody
mlijeko - mleko
mnogo - dużo | wiele
množina - liczba mnoga
mobitel - telefon komórkowy
moći - móc
moj - mój
mokar - mokry
mokraća - mocz
moldavski - mołdawski | mołdawski (język)
molitva - modlitwa
monosaharid - monosacharyd
morati - musieć
more - morze
morski krastavac - strzykwa
Moskva - Moskwa
most - most
Mostar - Mostar
motivacija - motywacja
motocikl - motocykl
mozak - mózg
možda - może
mrak - ciemność | mrok
mrav - mrówka
mreža - sieć
mrkva - marchew
mršav - szczupły
mrtav - martwy | nieżywy
mrtvac - zmarły
mrziti - nienawidzić
mržnja - nienawiść
muha - mucha
munja - piorun
muškarac - mężczyzna
muški rod - rodzaj męski
musliman - muzułmanin
mutacija - mutacja
muž - mąż | małżonek
muzej - muzeum
muzika - muzyka
mužjak - samiec
naći - znaleźć
nada - nadzieja
nadjev - nadzienie
nadoknada - rekompensata | wynagrodzenie za coś straconego lub odebranego
nadolje - na dół
naglasak - akcent
naglo - nagle
nagore - na górę
nagrada - nagroda
nagristi - nadgryźć | uszkodzić (o czasie, kwasie lub robakach)
naknada - rekompensata | wynagrodzenie za coś straconego lub odebranego
naočale - okulary
naprasan - niespodziewany | nagły
naranča - pomarańcza
narančast - pomarańczowy
naš - nasz
naslon - oparcie (część mebla)
naslonjač - fotel
naslov - tytuł
nastavnica - nauczycielka
nastavnik - nauczyciel
ne - nie
nebesko tijelo - ciało niebieskie
nebo - niebo
neboder - drapacz chmur
nećak - bratanek | siostrzeniec
nedjelja - niedziela
neka - niech
nekim čudom - jakimś cudem
nekoliko - kilka
nema dima bez vatre - nie ma dymu bez ognia
nemati - nie mieć
nenormalan - nienormalny
Nepal - Nepal
neprekidan - nieprzerwany
nesanica - bezsenność
nešto - coś
nesvršeni glagol - czasownik niedokonany
netko - ktoś
netopir - nietoperz
nigdje - nigdzie
nigerijski - nigeryjski
nihilizam - nihilizm
nikad - nigdy
ništa - nic
nitko - nikt
nizak - niski
njegov - jego
Njemačka - Niemcy
njemački - niemiecki | niemiecki (język)
noć - noc
noga - noga
nogomet - futbol | piłka nożna
nogometaš - osoba grająca w futbol | piłkarz
nokat - paznokieć
normalan - normalny
norveški - norweski | norweski (język)
nos - nos
nositi - nieść | nosić
nov - nowy
novac - pieniądze
novčanik - portfel
novine - gazeta
novogrčki - nowogrecki | nowogrecki (język)
nož - nóż
nula - zero | 0
nulti - zerowy
nutarnji - wewnętrzny
obećanje - obietnica
obelisk - obelisk
običan - zwykły | zwyczajny
obični ćuk - pójdźka zwyczajna
običnost - zwyczajność | zwykłość
obitelj - rodzina
objašnjenje - objaśnienie | wyjaśnienie
objektiv - obiektyw
oblak - chmura
oblik - kształt | figura | forma
obožavati - uwielbiać
obraz - policzek
obrok - posiłek
obrva - brew
obuhvat - objęcie (czegoś rękami)
obujam - objętość
obzor - horyzont | widnokrąg
ocat - ocet
ocean - ocean
od - od
odavno - od dawna
odbojka - siatkówka
odgovor - odpowiedź
odgristi - odgryźć
odijelo - garnitur | ubranie
odjeća - ubranie | odzież
odluka - decyzja
odozdo - od dołu
odozgo - od góry
odvjetnik - adwokat | prawnik
ogledalo - lustro
oko - oko
okrutan - okrutny
okultizam - okultyzm
okvir - rama
olovka - ołówek
oltar - ołtarz
oluja - burza | sztorm
on - on
ona - ona | one (zob. uwagi)
one - one -
oni - oni
ono - ono
operacija - operacja
opet - znowu | znów
orao - orzeł
organizam - organizm
orijentalistika - orientalistyka
orkestar - orkiestra
ormar - szafa
oružje - broń
osa - osa
osam - osiem | 8
osamnaest - osiemnaście
osamnaesti - osiemnasty
osjećati - czuć | czuć się
oslonac - podpora | podpórka | oparcie | podłokietnik
osmi - ósmy
osoba - osoba
oštar - ostry
Ostia - Ostia
oštriti - ostrzyć
otac - ojciec
otići - wyjść | pójść
otok - wyspa
otrov - trucizna
otrovan - trujący
otrovati - otruwać
otvoren - otwarty
otvoreni skup - gromada otwarta
ovca - owca
ovulacija - owulacja | jajeczkowanie
ozbiljan - poważny
ožujak - marzec
pa - potem (a) | wtedy (a) | po czym | więc | nawet gdyby | choćby | no | czyż | czyżby | i? no i co (dalej)? | doprawdy | właśnie | jednak | ale | a mimo to
padati - padać
padež - przypadek
pahulja - śnieżynka | płatek śniegu
pakost - złośliwość
pakostan - złośliwy
palac - kciuk
palačinka - naleśnik
Palermo - Palermo
pametan - mądry
pamtiti - pamiętać
pamuk - bawełna
panslavizam - panslawizm
papa - papież
papar - pieprz
papiga - papuga
papir - papier
Pariz - Paryż
park - park
pas - pies
pašteta - pasztet
patka - kaczka
patlidžan - oberżyna
patnja - cierpienie
pauk - pająk
pčela - pszczoła
pedeset - pięćdziesiąt
pedeseti - pięćdziesiąty
pelena - pielucha
Pepelnica - Środa Popielcowa
pepeo - popiół
perad - drób
peršin - pietruszka
pet - pięć | 5
petak - piątek
Petar - Piotr
peti - piąty
petnaest - piętnaście
petnaesti - piętnasty
petsto - pięćset | 500
petstoti - pięćsetny
piće - napój
pička - cipa
pijan - pijany
pijanac - pijak
pijanica - pijak | pijany (człowiek)
pijesak - piasek
pisati - pisać
pitanje - pytanie
pitati - pytać
piti - pić
pivo - piwo
pjena - piana
pjenušac - szampan
pjesma - piosenka
pjevati - śpiewać
planetarni sustav - układ planetarny
planina - góra
platiti - zapłacić
plav - niebieski | blond
plavuša - blondynka
plaža - plaża
ples - taniec
plesati - tańczyć
plin - gaz
plinski - gazowy
plivati - pływać (o ludziach i zwierzętach)
pločnik - chodnik
pobjeda - zwycięstwo
početak - początek
pod - podłoga
podne - południe (czas)
podrum - piwnica
pogled - widok
pogledati - zajrzeć
pokazati - pokazać
poklon - prezent | ukłon
pokojnik - nieboszczyk
pola - pół
polako - powoli
policija - policja
političar - polityk
politika - polityka
politologija - politologia
Poljak - Polak
Poljakinja - Polka
polje - pole
Poljska - Polska
poljski - polski | polny | polski (język)
poljubac - pocałunek
pomagati - pomagać
pomoć - pomoc
pomoću - za pomocą
ponedjeljak - poniedziałek
ponoć - północ (24:00)
populizam - populizm
popust - zniżka | obniżka
poraz - porażka
porez - podatek | opodatkowanie
poriluk - por
portugalski - portugalski | portugalski (język)
posao - praca
pošta - poczta
postajan - stały | ciągły | niezachwiany (o charakterze, cechach itd.)
poštanska marka - znaczek pocztowy
potpis - podpis
potresan - szokujący | poruszający
povijest - historia
povod - przyczyna | powód
povraćati - wymiotować
povrće - warzywo
povremen - okazjonalny | epizodyczny | pojawiający się od czasu do czasu
površina - powierzchnia
požar - pożar
pozdrav - pozdrowienie
poziv - zaproszenie
poznat - znany
pozor - uwaga
praćka - proca
prag - próg
Prag - Praga
praksa - praktyka
prati - prać | myć
pravda - sprawiedliwość
pravo - prawo
predgrađe - przedmieście
predgradski - przedmiejski
predmet - przedmiot
predveče - pod wieczór
pregristi - przegryźć | odgryźć (przerwać gryząc)
prehrambeni - żywieniowy | spożywczy
prehrana - żywienie
preporučiti - polecić
prepucij - napletek
preša - prasa
previše - za dużo
prevoditelj - tłumacz
prevoditeljica - tłumaczka
prezime - nazwisko
prezir - pogarda
prgav - kłótliwy | swarliwy
pridjev - przymiotnik
prigristi - przegryźć coś | zjeść trochę lub na szybko
prijatelj - przyjaciel
prijateljica - przyjaciółka
prijateljstvo - przyjaźń
prijedlog - propozycja | przyimek
prijepodne - przedpołudnie
prijevod - tłumaczenie
prilog - przysłówek | dodatek | załącznik
primatelj - adresat | odbiorca
primjer - przykład
pripizdina - wypiździewo | zadupie
pripravan - gotowy | przygotowany
priroda - natura | przyroda
prirodan - naturalny
prirodni - przyrodniczy
prirodni jezik - język naturalny
pristojan - odpowiedni | przyzwoity | zgodny z zasadami grzeczności | godziwy | godny
privremen - tymczasowy
prljav - brudny
prljavština - brud
probati - próbować | spróbować
problem - problem
prodavati - sprzedawać
produkt - produkt
profesionalni - profesjonalny | zawodowy
progristi - przegryźć (zrobić otwór gryząc) | przeżreć (o kwasach)
prohladan - chłodny | zimnawy
prokulica - brukselka
proljeće - wiosna
proljev - biegunka
promet - transport
promjena - zmiana
prosinac - grudzień
prostak - cham | prostak
prostakinja - chamka | prostaczka
protivnik - przeciwnik
protudržavni - przeciwpaństwowy
proziran - przejrzysty | oczywisty | widoczny | jasny (mimo prób ukrycia)
prozor - okno
prozračan - przewiewny
prst - palec
prtljaga - bagaż
prvi - pierwszy
prvorazredan - pierwszorzędny | pierwszej klasy
psihologija - psychologia
psovati - kląć | przeklinać | kląć na kogo/co | wyzywać kogo/co (koga/što)
ptica - ptak
puhati - dmuchać | wiać
pušiti - palić (papierosy, cygara itd.) | dymić się | parować
pušiti kao Rus - palić jak smok | palić jak Rosjanin
pušiti kao Turčin - palić jak smok | palić jak Turek
puška - karabin
pustinja - pustynia
putovati - podróżować
putovnica - paszport
puž - ślimak
račun - rachunek
računalo - komputer
raditi - pracować | robić
ragbi - rugby
rajčica - pomidor
rame - bark
rano - wcześnie
rat - wojna
razglednica - pocztówka
razgovarati - rozmawiać
razgovor - rozmowa | dyskusja
razlika - różnica
razred - klasa
razredba - klasyfikacja
razredbeni - klasyfikacyjny
razumjeti - rozumieć | zrozumieć
rđa - rdza
reakcija - reakcja | odpowiedź na coś
rečenica - zdanie
reći - powiedzieć
rep - ogon
restoran - restauracja
riba - ryba
riječ - słowo
rijeka - rzeka
Rim - Rzym
riža - ryż
rječnik - słownik
roba - towar
roda - bocian
rođendan - urodziny
roditelj - rodzic
rog - róg
roj - rój
romantizam - romantyzm
roščić - od | różek | rogalik
rt - przylądek
rub - krawędź | skraj | kraniec | rąbek
ručak - obiad
ručnik - ręcznik
rudar - górnik
rudnik - kopalnia
rujan - wrzesień
ruka - ręka
rukav - rękaw
rukavica - rękawica
rukomet - piłka ręczna
Rumunjska - Rumunia
rumunjski - rumuński | rumuński (język)
rupa - dziura
rupetina - dziursko | od dziura
rupica - dziurka | od dziura
Rusija - Rosja
ruža - róża
ružan - brzydki
sad - teraz
šafran - szafran
šah - szachy | szach
šahovnica - szachownica
sala - sala
šalica - filiżanka | kubek
samo - tylko
šampon - szampon
san - sen
šaptati - szeptać
sapun - mydło
šaren - kolorowy
sasvim - całkiem | całkowicie | zupełnie
sat - godzina | zegar
šator - namiot
šećer - cukier
sedam - siedem | 7
sedamnaest - siedemnaście
sedamnaesti - siedemnasty
sedam smrtnih grijeha - siedem grzechów głównych
sedmi - siódmy
Sejšeli - Seszele
seksologija - seksuologia
sekunda - sekunda
selekcija - selekcja
selendra - oddalona lub zacofana wieś | dziura zabita dechami
selo - wieś
semantika - semantyka
sendvič - kanapka
senf - musztarda
šesnaest - liczba 16 | szesnaście
šesnaesti - szesnasty
šest - sześć | 6
šesti - szósty
sestra - siostra
šetati - spacerować
sida - AIDS
sidro - kotwica
siječanj - styczeń
silicij - krzem
silicijski - krzemowy
šiljilo - temperówka
simpatičan - sympatyczny
simptom - symptom
sin - syn
sir - ser
Sirija - Syria
širok - szeroki
šišmiš - nietoperz
sit - najedzony | syty
siv - szary
sivi ćuk - pójdźka zwyczajna
sjediti - siedzieć
sjena - cień
sjever - północ
skladatelj - kompozytor
škola - szkoła
škotski - szkocki | szkocki (język)
skup - drogi | zbiór
slab - słaby
sladak - słodki
sladoled - porcja lodów
slap - wodospad
slavina - kran
sličan - podobny
slikarstvo - malarstwo
šljiva - śliwa | śliwka
sloboda - wolność
slobodan - wolny | swobodny
slon - słoń
Slovačka - Słowacja
slovački - słowacki
Slovenija - Słowenia
slovenski - słoweński | słoweński (język)
slovo - litera
slušati - słuchać
slutiti - przeczuwać | podejrzewać
sluz - śluz
sluznica - błona śluzowa
smeđ - brązowy
smijati se - śmiać się
smrad - smród
smrdjeti - śmierdzieć
smrt - śmierć
snijeg - śnieg
snjegović - bałwan
soba - pokój
sociologija - socjologia
šogun - szogun
sol - sól
sova - sowa
Španjolska - Hiszpania
španjolski - hiszpański | hiszpański (język)
spavati - spać
spojka - połączenie | łącznik | sprzęgło
spol - płeć
spor - wolny | powolny
sportski - sportowy
sprud - mielizna
sraćka - sraczka
srce - serce
sreća - szczęście
srednji rod - rodzaj nijaki
Sredozemno More - Morze Śródziemne
sretan - szczęśliwy
srijeda - środa
srpanj - lipiec
srpski - serbski | serbski (język)
staklo - szkło
štakor - szczur
stan - mieszkanie
stanovati - mieszkać
stanovnik - mieszkaniec
star - stary
starogrčki - starogrecki | starogrecki (język)
sto - sto | 100
što - co
stol - stół
stolica - krzesło
stoti - setny
strah - strach
stranac - cudzoziemiec | obcokrajowiec | nieznajomy
stranica - strona
stric - stryj
strog - surowy | srogi
stroj - maszyna
strpljiv - cierpliwy
studeni - listopad
student - student
studentski - studencki
studirati - studiować
stvar - rzecz
stvarnost - rzeczywistość
subota - sobota
suh - suchy
šuma - las
sumnjati - wątpić
sunce - słońce
Sunce - Słońce
suncobran - parasol (od słońca)
suncokret - słonecznik
superlativ - stopień najwyższy
supratekućina - nadciekłość
suprematizam - suprematyzm
suprug - małżonek
supruga - małżonka
susjed - sąsiad
susret - spotkanie
sustav - system | układ
sutra - jutro
suza - łza
svadljiv - kłótliwy
svaki - każdy
svećenik - ksiądz
Švedska - Szwecja
svet - święty
Sveti Toma i Princip - Wyspy Świętego Tomasza i Książęca
sveučilište - uniwersytet
svibanj - maj
Švicarska - Szwajcaria
svijeća - świeca | świeczka
svijećnjak - świecznik
svijet - świat
svinja - świnia
svinjetina - wieprzowina
svjetlo - światło
svjež - świeży
svršeni glagol - czasownik dokonany
tahikardija - częstoskurcz | tachykardia
tajan - tajny | tajemny
tajna - tajemnica
tajnica - sekretarka
tajski - tajski | tajski (język)
taksi - taksówka
talijanski - włoski | włoski (język)
taman - ciemny
tamno - ciemno
tanak - cienki
tanjur - talerz
Tantal - Tantal
tava - patelnia
tehnologija - technologia
tekućina - ciecz | płyn
teletina - cielęcina
tenk - czołg
teologija - teologia
teorija - teoria
tepih - dywan
terapija - terapia
termodinamički - termodynamiczny
termodinamika - termodynamika
Termopil - Termopile
težak - ciężki | trudny
ti - ty
tih - cichy
Tihi ocean - Ocean Spokojny
tiho - cicho
tijelo - ciało
tišina - cisza
tisućiti - tysięczny
tisuću - tysiąc | 1000
tjedan - tydzień
tjestenina - makaron
tko - kto
to - to
točka - kropka | punkt
topao - ciepły
toplina - ciepło
Tora - Tora
tradicija - tradycja
tragedija - tragedia
trajan - trwały | długowieczny
trajekt - prom
tramvaj - tramwaj
transfer - przelew
trava - trawa
travanj - kwiecień
tražiti - szukać
trbuh - brzuch
trebati - potrzebować
treći - trzeci
treset - torf
tresetište - torfowisko
trg - plac
trgovina - sklep | handel
tri - trzy | 3
trideset - trzydzieści
trinaest - trzynaście | 13
trinaesti - trzynasty
trokut - trójkąt
trp - strzykwa
truba - trąbka
trup - tułów | kadłub
tuđ - cudzy | obcy (niepodobny)
tuga - smutek
Turčin - Turek
Turkinja - Turczynka
tužan - smutny
tvorivo - tworzywo
tvornica - fabryka
tvrd - twardy
u - w | do
ubiti - zabić
ubiti jednim udarcem dvije muhe - upiec dwie pieczenie na jednym ogniu
ubojica - zabójca
ubojstvo - zabójstwo
učenik - uczeń
učitelj - nauczyciel
učiteljica - nauczycielka
učiti - uczyć się | uczyć
ugljen - węgiel (ruda)
ugovor - umowa
ugristi - ugryźć (przy jedzeniu) | wgryźć się | przygryźć | dogryźć komu
uho - ucho
ujak - wujek
Ujedinjeni Arapski Emirati - Zjednoczone Emiraty Arabskie
Ukrajina - Ukraina
ukrasti - ukraść
ukus - gust | smak
ukusan - smaczny
ulaz - wejście
ulica - ulica
ulje - olej
uljudan - uprzejmy | grzeczny
umoran - zmęczony
unuk - wnuk
unuka - wnuczka
unutar - wewnątrz
unutarnji - wewnętrzny
unutra - wewnątrz
upravo - właśnie
urez - wcięcie | nacięcie | cięcie
urin - uryna
Uskrs - Wielkanoc
usluga - usługa
uspjeh - sukces
uspješan - udany | pomyślny | zakończony sukcesem | który odnosi lub odnosił sukcesy
usta - usta
ustavna monarhija - monarchia konstytucyjna
utapati tugu u alkoholu - topić smutki w alkoholu
utorak - wtorek
uvijek - zawsze
uvreda - zniewaga | obraza (czyn i uczucie nim wywołane)
uzdah - westchnienie
uzeti - wziąć
užitak - rozkosz
vaga - waga
vagina - pochwa
val - fala
valuta - waluta
vani - wewnątrz
vanjski - zewnętrzny
varan - waran
Varšava - Warszawa
vatra - ogień | ognisko
važan - ważny
već - już
večer - wieczór
večera - kolacja
veganka - weganka
vegetarijanka - wegetarianka
vegetarijanski - wegetariański
vektor - wektor
velik - duży | wielki
veljača - luty
veznik - spójnik
Vezuv - Wezuwiusz
vi - wy
vic - dowcip | kawał
vidjeti - widzieć
vilica - widelec
viljuška - widelec
Vilnius - Wilno
vino - wino
viola - altówka
violina - skrzypce
visok - wysoki
vjenčanje - ślub
vjerovati - wierzyć
vješalica - wieszak
vještica - czarownica
vjetar - wiatr
vjeverica - wiewiórka
vlak - pociąg
vlažan - wilgotny
voće - owoc
voda - woda
vojnik - żołnierz
vojska - armia
voljeti - lubić | kochać
votka - wódka
vozačka dozvola - prawo jazdy
voziti - jechać
vrabac - wróbel
vrat - szyja
vrata - drzwi
vrč - dzban
vreo - gorący (bardzo) | wrzący
vrhnje - śmietana
vrijednost - wartość
vrijeme - czas | pogoda
vrlo - bardzo
vrt - ogród | ogródek
vrtlog - wir
vrtložan - wirowy
vruć - gorący
vruće - gorąco
vuk - wilk
vukojebina - zadupie
Wales - Walia
Wikipedija - Wikipedia
žaba - żaba
zaboraviti - zapomnieć
začin - przyprawa
zadnji - ostatni
zadovoljstvo - zadowolenie | przyjemność
Zagreb - Zagrzeb
zagrebački - zagrzebski
Zagrepčanin - zagrzebianin
Zagrepčanka - zagrzebianka
zagristi - zagryźć | przegryźć | przekąsić | z zapałem zacząć | zabrać się za co
zagrljaj - uścisk | objęcie | przytulenie
zaljev - zatoka
zamjenica - zaimek
zamrzivač - zamrażarka
zanimljiv - ciekawy | interesujący
zao - zły
zapad - zachód
zarez - przecinek | karb | nacięcie | cięcie
žargon - żargon
žarulja - żarówka
zastava - flaga
zašto - dlaczego
zavodnik - uwodziciel
zbor - chór
zdrav - zdrowy
zdravlje - zdrowie
zec - zając
žedan - spragniony
zelen - zielony
željeti - chcieć
željeznica - kolej | transport kolejowy
željeznički - kolejowy
željezo - żelazo
zemlja - kraj | ziemia
žena - kobieta | żona
Ženeva - Genewa
ženka - samica
ženski - żeński
ženski rod - rodzaj żeński
zid - ściana | mur
ziherica - agrafka
zima - zima
žirafa - żyrafa
žito - pszenica
živ - żywy
živjeti - żyć | mieszkać
život - życie
životinja - zwierzę
zlatan - złoty
zlato - złoto
žlica - łyżka
zloba - złośliwość | zła wola
zloban - złośliwy | pełen złej woli
zmaj - smok | latawiec
zmija - wąż
značenje - znaczenie
znak - znak
znanost - nauka
znati - wiedzieć | znać | umieć
znoj - pot
zrak - powietrze
zrakoplov - samolot
zrakoplovstvo - lotnictwo
zrno - ziarno
zub - ząb
zubar - dentysta
zubarica - dentystka
župa - parafia
žut - żółty (kolor)
žvaka - guma do żucia
žvakati - żuć
zvati se - nazywać się
zvijezda - gwiazda
zvono - dzwon
zvučnik - głośnik
zvuk - dźwięk
