å - strumyk, rzeczka
Aalborg - miasto w Danii, gmina w Danii
abbed - przeor, opat
abbedi - opactwo
abdikation - abdykacja
abe - małpa, małpa (osoba nieokrzesana, prostak), małpa (o czarnoskórych), gastarbajter, małpować
abekat - małpa
åben - otwarty, szczery, nie ukrywający niczego
abkhaser - Abchaz
ablativ - ablatyw
åbne - otwierać
abonnere - prenumerować, subskrybować, abonować
aborre - okoń, okoń pospolity
abortiv - aborcyjny, poronny
abrikos - morela
abstrakt - abstrakcja, abstrakcyjny
absurd - absurdalny, niedorzeczny
acceleration - przyśpieszenie
acceptabel - akceptowalny, dopuszczalny
acceptere - akceptować, przyjmować
actinium - aktyn
adamsæble - jabłko Adama
adgang - dostęp
adjektiv - przymiotnik
adjø - żegnaj
adoptivbarn - adoptowane dziecko
adresse - adres
ådsel - ścierwo, padlina
advare - ostrzegać, przestrzegać
advarsel - ostrzeżenie
advarselsskilt - tablica ostrzegawcza
adverbium - przysłówek
advokat - adwokat
æble - jabłko
æblet falder ikke langt fra stammen - niedaleko pada jabłko od jabłoni
æde - żreć
ædru - trzeźwy
æg - jajo, jajko
ægte - prawdziwy
ægtemand - mąż, małżonek
ægteskab - małżeństwo
Ægypten - Egipt
ækel - obrzydliwy, wstrętny
ælde - starość, postarzać
ændre - zmieniać, przekształcać
ændring - zmiana
ære - honor
ærkebiskop - arcybiskup
ærlig - szczery, uczciwy
aerofobi - aerofobia
ært - groch
æsel - osioł
æske - pudełko
Æsop - Ezop
æstetik - estetyka
af - z, z powodu, przez
afbryde - przerwać
afdeling - część, sekcja
affald - śmieć, odpad
afføring - stolec, kał, defekacja
afgang - odjazd, wyjazd, odlot, wylot
Afghanistan - Afganistan
afgørende - decyzyjny, kluczowy, decydujący
afhængighed - uzależnienie, zależność
aflyse - odwoływać
afpresser - szantażysta
Afrika - Afryka
afrikaans - afrykanerski
afrikaner - Afrykanin
afs. - nad. (nadawca (listu, paczki)), afsender
afsked - pożegnanie
afskyelig - obrzydliwy, wstrętny, odrażający
afspiller - odtwarzacz
afsporing - wykolejenie, wykolejenie (zachowanie niemoralne lub nienormalne)
afstand - odległość, dystans
afstemning - głosowanie
aftale - umowa, kontrakt, ustalać, umawiać się
aften - wieczór
agerhøne - kuropatwa
aggression - agresja
aggressiv - agresywny
agurk - ogórek
akkusativ - biernik
akt - akt (czyn, działanie), akt (część sztuki teatralnej), akt (urzędowy dokument)
aktie - akcja (papier wartościowy)
aktieselskab - spółka akcyjna
aktion - akcja (działanie)
aktuel - aktualny
akvamarin - akwamaryn, akwamaryna, akwamaryna (kamień szlachetny w biżuterii)
akvarium - akwarium
al - orsztyn, rudawiec, cały, wszyscy, wszystkie
ål - węgorz
albaner - Albańczyk, Albanka
Albanien - Albania
albansk - albański
albinisme - albinizm
albino - albinos
albue - łokieć, rozpychać się łokciami, torować sobie drogę łokciami
alder - wiek, epoka
aldrig - nigdy
alfabet - alfabet
alfabetisk - alfabetyczny
alfonseri - stręczycielstwo
Algeriet - Algieria
alkohol - alkohol
alkoholfri - bezalkoholowy, wolny od alkoholu, niebędący pod wpływem alkoholu (o osobie lub trybie życia)
alkoholiker - alkoholik
alkoholisk - alkoholowy
alkoholisme - alkoholizm
alle - wszyscy, wszystkie, al
alle gode gange tre - do trzech razy sztuka
allegori - alegoria
allerede - już
allergi - alergia, uczulenie
allergiker - alergik
allergisk - alergiczny
alle veje fører til Rom - wszystkie drogi prowadzą do Rzymu
allike - kawka, kawka zwyczajna
almen - publiczny, powszechny
almindelig - zwykły, zwyczajny
almisse - jałmużna
alter - ołtarz
alternativ - alternatywa, alternatywny
altid - zawsze
altruistisk - altruistyczny
aluminium - glin
alvorlig - poważny
amatør - amator (nie profesjonalista), amator (źle wykonujący swoją pracę), amator, amatorski
amatøragtig - amatorski
ambassade - ambasada
ambassadør - ambasador
ambitiøs - ambitny
ambolt - kowadło
americium - ameryk
amerika - Ameryka Środkowa
Amerika - Ameryka, Stany Zjednoczone
amerikaner - Amerykanin
amerikanerinde - Amerykanka
amerikansk - amerykański
ammunition - amunicja
amøbe - ameba
amputation - amputacja
ananas - ananas
anarki - anarchia
anbefale - polecać, zalecać
and - kaczka, kaczka dziennikarska
ånde - oddech
åndedræt - oddech, oddychanie
anden - drugi, inny (nie ten sam)
Anders - Andrzej
Andorra - Andora
anglofil - anglofil, anglofilski
Angola - Angola
angribe - atakować
angst - strach, obawa, przestraszony, bojący się
ankel - kostka (u nogi)
anker - kotwica, jednostka pojemności, 37,68 l
anklage - oskarżenie, zarzut
ankomst - przybycie, przyjazd
Anna - Anna
Anne - Anna
annullere - anulować
anpartsselskab - spółka z ograniczoną odpowiedzialnością
ansætte - zatrudnić
anse - uważać (coś/kogoś za coś)
ansigt - twarz
anstifter - prowodyr
ansvar - odpowiedzialność
ansvarlig - odpowiedzialny
antageligvis - prawdopodobnie
antagonisme - antagonizm
antal - ilość, liczba
antilope - antylopa
antimon - antymon
antisemitisme - antysemityzm
antropomorf - antropomorficzny
anvende - używać, stosować, wykorzystywać
apotek - apteka
apparat - aparat
appelsin - pomarańcza
appendicitis - zapalenie wyrostka robaczkowego
appetit - apetyt
april - kwiecień
ApS - sp. z o.o. (spółka z ograniczoną odpowiedzialnością)
ar - blizna, ar (100 metrów kwadratowych)
år - rok
arabisk - arabski, arabski (język)
aragonisk - aragoński
araknofobi - arachnofobia
arbejde - praca, pracować
arbejder - robotnik
arbejdsgiver - pracodawca
arbejdsløs - bezrobotny
arbejdsløshed - bezrobocie
Argentina - Argentyna
argon - argon
århundrede - wiek (stulecie)
arie - aria
-årig - -roczny, -letni
aritmetik - arytmetyka
arkæologi - archeologia
arkæologisk - archeologiczny
arkitekt - architekt
årlig - roczny, coroczny
årligt - rocznie
arm - ramię, ręka, gałąź (organizacji), biedny (budzący litość), ubogi
Armenien - Armenia
armensk - armeński, ormiański
aroma - aromat, zapach
aromatisk - aromatyczny
årsag - przyczyna, powód
arsen - arsen
årstid - pora roku
arterie - tętnica, arteria
artikel - rodzajnik, artykuł
artilleri - artyleria
A/S - spółka akcyjna, SA
Aserbajdsjan - Azerbejdżan
aserbajdsjaner - Azerbejdżanin
aserbajdsjansk - azerbejdżański
Asien - Azja
aske - popiół
askebæger - popielniczka
askepot - kopciuszek
asparges - szparag
ass. - asystent
astat - astat
asterisk - gwiazdka, asterysk
astma - astma
astrologisk - astrologiczny
astronomi - astronomia
astronomisk - astronomiczny
asyl - azyl, przytułek
at - że
atju - apsik!, a psik!
atlas - atlas
atlet - atleta
atmosfære - atmosfera
atombombe - bomba atomowa
atomnummer - liczba atomowa
atonal - atonalny
atten - osiemnaście, 18
attende - osiemnasty, 18.
attrap - atrapa
atypisk - atypowy
august - sierpień
auktion - aukcja
Australien - Australia
australsk - australijski
autentisk - autentyczny
automat - automat
autopsi - autopsja
avantgarde - awangarda
avis - gazeta
bad - kąpiel, łazienka
båd - łódź
bade - kąpać, kąpać się
badekar - wanna
bænk - ławka
bæver - bóbr
bage - piec
bageri - piekarnia
bajer - butelka piwa
bakteriel - bakteryjny
bal - bal (zabawa), bila (kula używana do gry w bilard lub krykiet)
bål - ognisko
banan - banan
bandit - bandyta
banegård - dworzec kolejowy
bange - bojący się, wystraszony
Bangladesh - Bangladesz
bar - bar (lokal), miejsce w lokalu, przy którym odbiera się lub konsumuje posiłki lub alkohol, jednostka ciśnienia, nagi, nieosłonięty, czysty, zwykły, prosty
-bar - umożliwiający, możliwy, zdolny
Barbados - Barbados
barbere - golić
barberkniv - brzytwa
bare - tylko, po prostu
barium - bar
bark - kora
barn - dziecko
barnebarn - wnuk, wnuczek, wnuczka
barnløs - bezdzietny
baron - baron
basal - podstawowy
bede - skop, burak, prosić, modlić się, zapraszać
bedrøvet - smutny
bedst - god, vel (= pl. najlepszy)
bedste - babcia
bedstemor - babcia
befinde sig - znajdować się
befolkningstæthed - gęstość zaludnienia
begå - popełnić
begynde - zacząć, zaczynać
begyndelse - początek
behagelig - miły, przyjemny
beherske - opanować (= podbić), opanować (= nauczyć się), opanować (= powstrzymać)
beholder - pojemnik, zasobnik
behøve - potrzebować
beige - beżowy
bekræfte - potwierdzić, uwierzytelnić
Belgien - Belgia
Belize - Belize
beløb - kwota, suma
ben - noga, kość, ość
bengali - bengalski (język)
Benin - Benin
benytte - wykorzystywać, używać
benzin - benzyna
beplante - zalesiać
berkelium - berkel
berømt - sławny, słynny
berøre - dotykać
beruse - upijać
beruset - pijany, nietrzeźwy
beryllium - beryl
besættelse - okupacja, zajęcie (np. stanowiska), obsesja
beskrive - opisać, opisywać
beskrivelse - opis
beskytte - chronić
besøg - wizyta
besøge - odwiedzić, odwiedzać
bestå - istnieć, składać się, zdać (egzamin)
bestemme - decydować, postanawiać
bestemmelse - przepis, rozporządzenie, ustalenie, przeznaczenie
bestikke - przekupić, przekupywać
bestille - zamawiać, robić
betændelse - zapalenie
betale - płacić
betegnelse - określenie, nazwa, termin
betle - żebrać
beton - beton
betyde - znaczyć, znaczyć (odgrywać ważną rolę)
bevægelse - ruch
bevare - zachowywać, zachować
bh - biustonosz, stanik
bi - pszczoła
bibliotek - biblioteka
bide - gryźć, ugryźć, połknąć przynętę, powodować lekki ból
bihule - zatoka
bikube - ul
bil - samochód
bilde ind - wmawiać
bilist - kierowca
billede - obraz, obrazek, zdjęcie, wyobrażenie, wizja, koncepcja danego zagadnienia, osoby lub sytuacji
billig - tani
bindeord - spójnik
bio - kino
bio- - bio-
biograf - kino, biograf (autor biografii)
biologi - biologia
biologisk - biologiczny
biord - przysłówek
bismut - bizmut
bitter - gorzki, ciężki, trudny, poważny, gorzki napój alkoholowy, gorzki likier
bizar - dziwaczny
bjælde - dzwon
bjerg - góra
bjørn - niedźwiedź, miś
bjørnetjeneste - niedźwiedzia przysługa
bl.a. - (m.in., między innymi)
blå - niebieski (kolor), błękit, kolor niebieski
blåbær - borówka, jagoda
blad - liść, płatek
blæk - atrament, tusz
blækhus - kałamarz
blæse - dmuchać, dmąć, wiać (o wietrze)
blande - mieszać
blandt - między, pomiędzy, wśród
blandt andet - między innymi
blåt blod - błękitna krew
bleg - blady
blind - ślepy, niewidomy, ślepy (nie biorący czegoś lub niczego pod uwagę), zamknięty, nie prowadzący donikąd
blindtarmsbetændelse - zapalenie wyrostka robaczkowego
blive - stać się, stawać się, zostać, zostawać, pozostać, pozostawać, akumulować się do pewnego stanu, pewnej liczby/ilości
blod - krew
blød - miękki, delikatny
blødning - krwawienie
blodtryk - ciśnienie krwi
blogge - blogować, prowadzić bloga
blomkål - kalafior
blomst - kwiat
bly - ołów
blyant - ołówek
bo - mieszkać
bøde - mandat, kara pieniężna, być/zostać ukranym
bog - książka, księga, tom (część dzieła), owoc buku
bøg - buk, drewno buku
bogstav - litera
bohrium - bohr
bøjning - odmiana, fleksja, zgięcie
boks - boks (wydzielone pomieszczenie)
bølge - fala (zaburzenie na powierzchni wody), fala (włosów, protestów), fala
Bolivia - Boliwia
bolt - śruba
bombe - bomba, bombardować
bomber - bombowiec
bomuld - bawełna
bøn - modlitwa, apel, wezwanie
bo på polsk - żyć na kocią łapę
bor - bor
bord - stół
borgerkrig - wojna domowa
børnehjem - dom dziecka
børnesang - piosenka dziecięca, piosenka dla dzieci
Bosnien-Hercegovina - Bośnia i Hercegowina
botanik - botanika
brække - łamać, wymiotować
brænder - nagrywarka
brætspil - gra planszowa
brand - pożar
brandslukker - gaśnica
Brasilien - Brazylia
bred - szeroki, brzeg rzeki, jeziora lub morza
bredde - szerokość
bremse - hamulec, hamować
brev - list
bringe - przynosić
brint - wodór
bro - most
broche - brosza, broszka
brochure - broszura
brød - chleb
broder - brat
brom - brom
brombær - jeżyna
bror - brat
brud - panna młoda
brug - użycie, potrzeba
bruge - używać, użyć, korzystać
bruger - użytkownik
brun - brązowy (kolor), opalony
Brunei - Brunei
bryde - łamać
bryggeri - browar
bryllup - ślub
bryst - pierś, klatka piersiowa
brystben - mostek
brystholder - biustonosz, stanik
buddhisme - buddyzm
budget - budżet
bue - łuk
buket - bukiet (wiązanka kwiatów), bukiet (aromat wina)
bukser - spodnie
Bulgarien - Bułgaria
bulgarsk - bułgarski, bułgarski (język)
bulgur - bulgur
bums - krosta, kloszard
bunker - bunkier (schron), bunkier (pomieszczenie na paliwo na statku)
bur - klatka
burde - powinien, należy
Burkina Faso - Burkina Faso
bus - autobus
butik - sklep
by - miasto
bydeform - tryb rozkazujący
bygge - budować
bygning - budynek, budowa ciała, budowa, budowanie, czynność budowania
bykort - plan miasta, mapa miasta
ca. - około, ok.
cæsium - cez
californium - kaliforn
Cambodja - Kambodża
Camilla - Kamila
Canada - Kanada
carbon-tiden - karbon
Catalonien - Katalonia
cement - cement
centimeter - centymetr
ceremoni - ceremonia
cerium - cer
chador - czador
chauffør - kierowca, szofer
chilener - Chilijczyk
chimpanse - szympans
chinchilla - szynszyla
chokere - szokować
chokolade - czekolada
Christian - Krystian
ciffer - cyfra
cigaret - papieros
cirkel - okrąg, kółko (grupa osób o wspólnych zainteresowaniach)
citere - cytować
citron - cytryna
Colombia - Kolumbia
Columbus - Kolumb (odkrywca)
computer - komputer
curium - kiur
cykel - rower
cykle - jechać na rowerze
cyklisk - cykliczny, cyklicznie
cyklisme - kolarstwo
cyklist - rowerzysta
cylindrisk - cylindryczny
Cypern - Cypr
da - wtedy, gdy, ależ, przecież, ponieważ, gdyż
dadaist - dadaista
dadaistisk - dadaistyczny
dæk - pokład, opona
dække - pokryć, pokrywać, pokrywać koszty (= płacić), kryć (kogoś, podając nieprawdziwe informacje)
dag - dzień, deg = dekagram
dal - dolina
dame - kobieta, pani, dama (kobieta wytworna), dama, królowa, dziewczyna (z którą się chodzi)
Danmark - Dania
danne - tworzyć, kształtować, nadawać formę
danse - tańczyć
dansk - duński, duński (język)
dansker - Duńczyk, Dunka
dårlig - zły, słaby, o niskiej jakości, chory, wyglądający na chorego
darmstadtium - darmsztadt
dåse - puszka, pizda, mały samochód
datid - czas przeszły
dativ - celownik
datter - córka
de - oni, one
De - Pan, Pani, państwo
debitor - dłużnik
december - grudzień
de er ikke alle venner, som smile - nie wszyscy, którzy się uśmiechają, są przyjaciółmi, nie wszystko złoto, co się świeci • pozory mylą
defekt - defekt, wada, usterka, wadliwy
definition - definicja
De Forenede Stater - Stany Zjednoczone, USA
dekalog - dekalog (10 przykazań)
del - część
delfin - delfin
deltage - uczestniczyć, brać udział
deltagelse - uczestnictwo, współczucie
demografi - demografia
demokrati - demokracja
demonstrant - demonstrant
den - to ( on, ona, ono)
den, der graver en grav for andre, falder tit selv i den - kto pod kim dołki kopie, sam w nie wpada
den ene hånd vasker den anden - ręka rękę myje
denne - ten, ta
den rene barnemad - bułka z masłem
dens - tego / jego
deodorant - dezodorant
depression - depresja
der - tam, który
deres - ich, Pana, Pani, Państwa
derfor - dlatego
dessert - deser
desværre - niestety
det - den, to
det er ikke alt guld, som skinner - nie wszystko złoto, co się świeci, pozory mylą
det stille vand har den dybe grund - cicha woda brzegi rwie
dette - ten, ta
devon - dewon
diabetes - cukrzyca
dialekt - dialekt
diameter - średnica
digter - poeta
dild - koper, koperek
din - twój
diplomat - dyplomata
dirre - trząść się
diskette - dyskietka
dit - twój (din)
djævel - diabeł
djævelens advokat - adwokat diabła
dø - umierać
dobbeltgænger - sobowtór
død - śmierć, martwy
dødeligt - śmiertelnie
dødningehoved - trupia czaszka, zmierzchnica trupia główka
dødningeur - kornik
dog - acz, ależ, przecież, jednak
døgn - doba
dokument - dokument
donation - donacja, dotacja, dar
dør - drzwi
dø som fluer - padać jak muchy
doven - leniwy, zwietrzały (już bez gazu i smaku)
dr. - dr, doktor (lekarz), doktor (osoba z doktoratem), królowa
dråbe - kropla, kropla (mała ilość), krople (forma leku)
dræbe - zabić, zabijać
drage - latawiec, smok, lekka sportowa żaglówka, żądna władzy, budząca strach kobieta, ciągnąć, targać, pociągać seksualnie
drastisk - drastyczny
dreje - obracać się, obracać, skręcać, wykręcać
dreng - chłopiec, chłopak
drik - napój, trunek
drikke - pić
drøm - sen (marzenia senne), marzenie
drømme - śnić, marzyć
dronning - królowa (monarchini), królowa, hetman
drukne - tonąć, utonąć, topić, utopić
DSB - Duńskie Koleje Państwowe
du - ty, nadawać się
dubnium - dubn
dug - rosa, obrus
dum - głupi
dum som et bræt - głupi jak but
dusin - tuzin (dwanaście, dwunastka, 12)
dværg - karzeł
dvs. - tj., tzn., to znaczy (= det vil sige)
dykke - nurkować
dyr - zwierzę, drogi, kosztowny
dyrlæge - weterynarz
dyrs rettigheder - prawa zwierząt
dysenteri - czerwonka, dyzenteria
dysprosium - dysproz
edder - jad
edderkop - pająk
eddike - ocet
eddikesyre - kwas octowy
één voor allen, allen voor één - jeden za wszystkich, wszyscy za jednego
effektivitet - efektywność, skuteczność, sprawność, wydajność
efter - po, potem, za, ku, do, według
efterår - jesień
eftermiddag - popołudnie
efternavn - nazwisko
eg - dąb (drzewo), drewno dębu
egern - wiewiórka, banknot tysiąckoronowy
Egypten - Egipt
einsteinium - einstein
ej - nie
ejefald - dopełniacz
eks. - np. (na przykład)
eksempel - przykład
eksistere - istnieć
eksplodere - wybuchać, eksplodować
eksplosion - wybuch
ekstase - ekstaza
ekstatisk - ekstatyczny
el. - lub)
elefant - słoń
elektricitet - elektryczność
elektrisk - elektryczny
elev - uczeń
elevator - winda
eller - albo, lub
elleve - jedenaście, 11
ellevte - jedenasty, 11.
El Salvador - Salwador
elske - kochać, uwielbiać
elsker - kochanek, miłośnik
elskerinde - kochanka
elve - jedenaście, 11
elvte - jedenasty, 11.
Emilie - Emilia
Emily - Emilia
Emmy - Emily  Emilie, Emma
empirisk - empiryczny
empiristisk - empirystyczny
en - jeden, 1
en blind høne finder også et korn - trafiło się ślepej kurze ziarno
encyklopædi - encyklopedia
end - niż, oprócz, jak tylko
ende - koniec, pupa, kończyć, kończyć się
endelig - końcowy, ostateczny, skończony, ograniczony, ostatecznie, wreszcie, nareszcie, w końcu
endelse - przyrostek, końcówka, sufiks
enebær - jałowiec
energi - energia
eneste - jedyny
en fugl i hånden er bedre end ti på taget - lepszy wróbel w garści niż gołąb na dachu
engel - anioł
engelsk - angielski, angielski (język)
englænder - Anglik
England - Anglia
enhed - jednostka, część, element
enhjørning - jednorożec
enkelt - jedyny, pojedynczy
enogfirs - osiemdziesiąt jeden, 81
enogfyrre - czterdzieści jeden, 41
enoghalvfems - dziewięćdziesiąt jeden, 91
enoghalvfjerds - siedemdziesiąt jeden, 71
enoghalvtreds - pięćdziesiąt jeden, 51
enogtredive - trzydzieści jeden, 31
enogtres - sześćdziesiąt jeden, 61
enogtyve - dwadzieścia jeden, 21
enorm - ogromny
ens - identyczny, niezmienny
ensom - samotny
en storm i et glas vand - burza w szklance wody
ental - liczba pojedyncza
enzym - enzym
EØS - EOG, Europejski Obszar Gospodarczy
epidemi - epidemia
er - być (jestem, jesteś, jest, jesteśmy, jesteście, są)
erbium - erb
erfaring - doświadczenie
Erik - Eryk
erklære - deklarować, oświadczać, ogłaszać
erstatning - odszkodowanie, surogat, produkt zastępczy
Estland - Estonia
et - jeden, 1
etage - piętro
Etiopien - Etiopia
etymologi - etymologia (pochodzenie słowa), etymologia (dział językoznawstwa)
EU - Unia Europejska, UE
euro - euro
euroisere - euroizować
euroisering - euroizacja, euroizowanie
Europa - Europa
europæer - Europejczyk
europæisk - europejski
Europæiske Union - Unia Europejska
europium - europ
eventyr - bajka, przygoda, flirt, krótki romans
evighed - wieczność
få - dostawać, niewiele, mało
fabrik - fabryka, wytwórnia
fader - ojciec, tata, ojciec (zakonnik), ojciec (Bóg)
fadervor - modlitwa „Ojcze nasz”
fædreland - ojczyzna
fælles - wspólny
fælleskøn - rodzaj wspólny
fængsel - więzienie
færge - prom
Færøerne - Wyspy Owcze
fag - zawód, specjalizacja, przedmiot / kierunek w szkole / na uczelni
fakkel - pochodnia
faktisk - faktycznie, w istocie, naprawdę, de facto
fald - upadek, spadek, upadek (utrata władzy lub pozycji), przypadek, w … wypadku, w … razie, fał
falde - spadać (bezwładnie przemieszczać się w dół), padać (ginąć na wojnie), opadać (np. o terenie), upadać (np. o rządzie), padać (np. o propozycji), wypadać, padać (np. na określoną godzinę), przewracać się, zmniejszać się (np. o cenie), obalać
falde i søvn - zasnąć, zasypiać, zapadać w sen
faldskærm - spadochron
falsk - fałszywy
familie - rodzina
far - ojciec
får - owca
fare - niebezpieczeństwo, ryzyko
fåresyge - świnka (parotitis epidemica)
farlig - niebezpieczny
farlig er den, som intet har at miste - niebezpieczny jest ten, kto nic nie ma do stracenia
farve - kolor, kolor w kartach, barwa (dźwięku), farba, kolor skóry człowieka, kolorować, malować
fasan - bażant
fattig - biedny, ubogi, niezamożny
fattigdom - bieda, ubóstwo
fattig som en kirkerotte - biedny jak mysz kościelna
FCK - FC København
feber - gorączka
februar - luty
fedt - tłuszcz
fej - tchórzliwy
fejl - błąd, pomyłka
fem - pięć (5)
feminisme - feminizm
feminist - feministka, feminista
feministisk - feministyczny
femmer - piątka, moneta pięciokoronowa, piątak
femogfirs - osiemdziesiąt pięć, 85
femogfyrre - czterdzieści pięć, 45
femoghalvfems - dziewięćdziesiąt pięć, 95
femoghalvfjerds - siedemdziesiąt pięć, 75
femoghalvtreds - pięćdziesiąt pięć, 55
femogtredive - trzydzieści pięć, 35
femogtres - sześćdziesiąt pięć, 65
femogtyve - dwadzieścia pięć, 25
femte - piąty, 5.
femten - piętnaście, 15
femtende - piętnasty, 15.
fermium - ferm
fersken - brzoskwinia
fest - zabawa, festyn
fil - pilnik, plik
Filippinerne - Filipiny
film - film
filosof - filozof
finde - znaleźć, znajdować
findes - istnieć, występować
finger - palec (u ręki)
fingeraftryk - odcisk palca
fingerbøl - naparstek
Finland - Finlandia
finsk - fiński
firben - jaszczurka
fire - cztery, 4
fireogfirs - osiemdziesiąt cztery, 84
fireogfyrre - czterdzieści cztery, 44
fireoghalvfems - dziewięćdziesiąt cztery, 94
fireoghalvfjerds - siedemdziesiąt cztery, 74
fireoghalvtreds - pięćdziesiąt cztery, 54
fireogtredive - trzydzieści cztery, 34
fireogtres - sześćdziesiąt cztery, 64
fireogtyve - dwadzieścia cztery, 24
firkant - czworokąt
firma - firma
firs - osiemdziesiąt, 80
fisk - ryba, osoba spod znaku Ryb
fisker - rybak, wędkarz
fisse - cipa, cipka, pizda, dupa, jebać, ruchać
fjende - wróg, nieprzyjaciel
fjendtligt - wrogo
fjerde - czwarty
fjerne - usuwać
fjernsyn - telewizor
fjernsynsmodtager - telewizor
fjorten - czternaście, 14
fjortende - czternasty, 14.
flad - płaski, spłukany (bez pieniędzy), bez prądu, bez powietrza
flag - flaga
flagermus - nietoperz
flaske - butelka
flertal - liczba mnoga
flest - będący w większości, najwięcej ( mange), większość
flod - rzeka
fløde - śmietana
flodhest - hipopotam
fløjte - flet
flov - zażenowany, zawstydzony
flue - mucha, przynęta na ryby zakładana na haczyk
fluesvamp - muchomor
fluor - fluor
fly - samolot, uciekać
flytte - przeprowadzać się, przesuwać, przestawiać, zmieniać położenie
flytte ind - wprowadzić się
flyve - latać, lecieć
flyvemaskine - samolot
FN - ONZ, Organizacja Narodów Zjednoczonych
fod - stopa, podstawa, miejsce u dołu
fodbold - piłka nożna
fodboldspiller - piłkarz
føde - rodzić, żywność, pożywienie, karma, strawa
føderation - federacja
fødsel - poród, urodzenie (pochodzenie)
fødselsdag - urodziny
føle - czuć
folk - lud, naród, ludzie
folkeafstemning - referendum
for - podszewka, dla, od, za, pro, zbyt
før - przed, zanim, duży, korpulentny
forælder - rodzic
foran - przed
forår - wiosna
forårsage - powodować
forbedre - ulepszyć, polepszać
forblive - pozostać
forbrydelse - przestępstwo
forbudt - zabroniony  forbyde)
forbyde - zabraniać, zabronić
fordi - bo, ponieważ, albowiem
forebygge - zapobiegać
forene - jednoczyć, łączyć, scalać
foretrække - woleć
forfalske - sfałszować
forfatter - autor, pisarz
forgæves - próżny, daremny, bezcelowy
forgifte - truć, otruć, zatruć, zatruwać
forglemmigej - niezapominajka
forholdsord - przyimek
forkert - zły, niewłaściwy, niepoprawny
forklare - wyjaśniać, objaśniać, tłumaczyć
forkølelse - przeziębienie
forkortelse - skrót, skrócenie
forlade - opuścić (kogoś, coś, miejsce), porzucić, odpuścić (wybaczyć)
form - forma (kształt), forma (rodzaj), forma (kondycja), forma, forma (np. do ciasta)
formål - cel, zamiar
for mange kokke fordærver maden - gdzie kucharek sześć, tam nie ma co jeść
formørkelse - zaćmienie, zaćmienie (chwilowa utrata zdolności jasnego myślenia)
fornærme - obrażać
fornem - elegancki, wytworny, dystyngowany, ważny, znaczący
forretning - sklep, biznes
forsigtigt - ostrożnie
forsikring - ubezpieczenie, zapewnienie
forskel - różnica
forskellig - różny, inny
forsker - naukowiec, badacz
forslag - propozycja
forsøge - próbować
først - najpierw, na początku, z początku
forstå - rozumieć
forstærke - wzmacniać
forstavelse - przedrostek
første - pierwszy, 1.
forstørrelsesglas - szkło powiększające, lupa
forsyne - wyposażać
fortælle - opowiadać
fortov - chodnik
fortovskant - krawężnik
fortryde - żałować, zmienić zdanie, zrezygnować
fortsætte - kontynuować
forurene - zanieczyścić
forveksle - pomylić (dwie osoby lub rzeczy)
forvente - oczekiwać
fosfor - fosfor
fotograf - fotograf
fotografi - fotografia, zdjęcie, fotografia (sztuka)
fotografisk - fotograficzny
fotovoltaik - fotowoltaika
fotovoltaisk - fotowoltaiczny
fra - z, ze, od (kierunek), od (źródło)
francium - frans
Frankrig - Francja
fransk - francuski, francuski (język)
fred - pokój, spokój
fredag - piątek
frem-og-tilbage bevægelse - ruch posuwisto-zwrotny
fremtid - przyszłość, czas przyszły
frimærke - znaczek pocztowy
frisk som en fisk - zdrowy jak ryba
frø - żaba, ziarno, nasiono, nasionko, nasienie
frost - szron
frugt - owoc, efekt, rezultat
frugtarisme - frutarianizm
fruktose - fruktoza
frustration - frustracja
fryse - mrozić, zamrozić, marznąć, zmarznąć, zamarznąć, zamarzać
fugl - ptak
fuglekonge - mysikrólik
fuld - pełen, pełny, całkowity, pijany
fuldmåne - pełnia (księżyca)
fund - znalezisko, odkrycie
fundamental - fundamentalny, podstawowy
fx - np. (na przykład)
Fyn - Fionia
fyrre - czterdzieści, 40
fyrremejse - sikora czarnogłowa, czarnogłówka, sikora czarnogłówka
fyrtårn - latarnia morska
fysik - fizyka
gå - iść, przebiegać, pójść, otwierać się, wychodzić, odchodzić
gade - ulica
gadolinium - gadolin
gæld - dług
gæst - gość
gætte - zgadywać
gaffel - widelec
gå forkert i byen - zwrócić się ( ze swoim problemem) do niewłaściwej osoby
gå i hundene - schodzić/zejść na psy
galakse - galaktyka
galaktisk - galaktyczny
galge - szubienica
gallium - gal
gammel - stary, poprzedni, niebyły
gammel kærlighed ruster ikke - stara miłość nie rdzewieje
gane - podniebienie
gang - raz, chód, przebieg, przedpokój, korytarz
går - gå, i går
garage - garaż
garanti - gwarancja
Gargantua - Gargantua
gås - gęś
gåsehud - gęsia skórka
ged - koza
gedde - szczupak
gemme - zachowywać, zapisać, chować
genetisk - genetyczny
genitiv - dopełniacz
genkende - rozpoznać
gennem - przez
genstandsled - dopełnienie
geografi - geografia
geologisk - geologiczny
Georgien - Gruzja
germanium - german
germansk - germański
gerne - chętnie, z chęcią, z przyjemnością
gift - trucizna, trutka, żonaty, zamężna, żyjący w małżeństwie
gifte sig - wychodzić za mąż, żenić się
giftig - trujący
gil - krzyk
giraf - żyrafa
give - dać
glas - szkło, szklanka
glaskugle - bombka (choinkowa)
glemme - zapominać
global opvarmning - globalne ocieplenie
gnaver - gryzoń
gnist - iskra, radiotelegrafista
gø - szczekać
god - dobry
goddag - dzień dobry
godt - dobrze
Godzilla - Godzilla
gøre - robić, powodować, czynić
gøre ondt - boleć, krzywdzić (gøre nogen ondt)
grå - szary
gradbøjning - stopniowanie
grådig - chciwy, zachłanny
grådighed - chciwość
grådigt - chciwie, zachłannie
gradvis - stopniowy, stopniowo
græde - płakać
Grækenland - Grecja
græker - Grek
grænse - granica, graniczyć
græs - trawa, trawka (marihuana, haszysz)
græsk - grecki, grecki (język)
grammatik - gramatyka
grammatikalsk - gramatyczny (dotyczący gramatyki, związany z gramatyką), gramatyczny (zgodny z regułami gramatyki)
grammatisk - gramatyczny (dotyczący gramatyki, związany z gramatyką), gramatyczny (zgodny z regułami gramatyki)
grammofon - gramofon, adapter
gråspurv - wróbel
gratis - bezpłatny, darmowy
grav - grób
gravid - ciężarna, w ciąży
gregoriansk - gregoriański
grim - brzydki
gris - świnia
grøn - zielony, młody i niedoświadczony, dotyczący natury i środowiska naturalnego
Grønland - Grenlandia
grønlandsk - grenlandzki
grønsag - warzywo
grøn te - zielona herbata
grøntsag - warzywo
grundigt - gruntownie, dokładnie
grundstof - pierwiastek chemiczny
gruppe - grupa
gryde - garnek, zawartość lub pojemność garnka (1.1)
gud - bóg, Bóg
Gud - Bóg, bóg, gud
guitar - gitara
gul - żółty
guld - złoto
guldsmed - złotnik, ważka
gulerod - marchewka
gulsot - żółtaczka
gulv - podłoga
håb - nadzieja
had - nienawiść
hade - nienawidzić
hæl - pięta
hængelås - kłódka
hær - wojsko, armia
hævn - zemsta
hafnium - hafn
hagl - grad, metalowa kulka, pocisk
Haiti - Haiti
haj - rekin, rekin (bezwzględna osoba)
hale - ogon
hallucination - halucynacja
hals - szyja, gardło, szyjka (butelki), przednia dolna część żagla
halskæde - naszyjnik
halvanden - półtora, półtorej
halvfems - dziewięćdziesiąt, 90
halvfjerds - siedemdziesiąt, 70
halvkugle - półkula, półkula Ziemi
halvø - półwysep
halvtreds - pięćdziesiąt, 50
hammer - młotek
hamster - chomik
han - on
hånd - dłoń, ręka
håndbold - piłka ręczna
håndbremse - hamulec ręczny
håndjern - kajdanki
håndklæde - ręcznik
håndled - nadgarstek
handleform - strona czynna
håndtaske - torebka
håndværker - rzemieślnik
håndvask - umywalka, mycie rąk
hane - kogut, kran, cyngiel, kurek strzelby
hankøn - rodzaj męski
Hanne - Hanna
hans - jego
har - have (mieć)
hår - włos, włosy
hård - twardy, trudny, ciężki
harddisk - dysk twardy
hare - zając
harpiks - żywica
hash - haszysz, trawka
hasselnød - orzech laskowy
hassium - has
hastig - bardzo szybki
hastighed - prędkość, szybkość
hav - morze
have - ogród, mieć, zawierać, charakteryzować się, być ubranym w, mieć na sobie
havn - port
hebræisk - hebrajski, hebrajski (język)
hebraisk - hebrajski, język hebrajski
hedde - nazywać się
Heidi - imię żeńskie
hej - hej, cześć (powitanie), hej (zwrócenie uwagi)
hejre - stokłosa
heks - czarownica, wiedźma
hel - cały
helikopter - helikopter
helium - hel
hellig - święty
helt - bohater, bohater literacki / filmowy, sieja pospolita, całkiem, całkowicie, zupełnie
helvede - piekło
hemisfære - półkula Ziemi, hemisfera, półkula mózgowa
hendes - jej
hen hvor peberet gror - gdzie pieprz rośnie
Henrik - Henryk
hensigten helliger midlet - cel uświęca środki
hensynsled - dopełnienie dalsze
her - tu, tutaj
hest - koń, skoczek
hestekraft - koń mechaniczny
hestesko - podkowa
himmel - niebo
hinanden - wzajemnie / nawzajem (się)
hindbær - malina
hindi - hindi
hingst - ogier
historie - historia (nauka), historia (krótka opowieść)
historiker - historyk
historisk - historyczny
hjælp - pomoc
hjælpe - pomagać, pomóc
hjelm - hełm, kask
hjem - dom, do domu
hjemland - ojczyzna
hjemløs - bezdomny
hjerne - mózg
hjerte - serce (centralny narząd układu krwionośnego strunowców i niektórych bezkręgowców), serce (ośrodek uczuć i emocji), serce (centrum)
hjort - jeleń
hjul - koło
hk - hestekraft ( KM = koń mechaniczny)
høg - jastrząb
høj - wysoki, głośny, wzgórze, pagórek
højre - prawy (o kierunku), prawicowy, prawa strona, prawica
højsorbisk - górnołużycki, górnołużycki (język)
højt - wysoko, głośno, na głos
højtaler - głośnik
højttaler - głośnik
holde - trzymać
holde op - przestać, zaprzestać
Holland - Holandia
holmium - holm
høne - kura
Hongkong - Hongkong
honning - miód
hor - zdrada (małżeńska), niewierność seksualna
høre - słyszeć, słuchać
høreapparat - aparat słuchowy
horisont - horyzont
Horus - Horus
hos - u
hospital - szpital
hotel - hotel
hoved - głowa, przedmiot kulisty, ta dolna lub górna część przedmiotu, która jest szersza od reszty, główny
hovedpine - ból głowy, ból głowy (problem)
hovedstad - stolica
hud - skóra
huj - i huj og hast (w wielkim pośpiechu)
hukommelse - pamięć
hukommelseskort - karta pamięci
hul - dziura, otwór, dziura (w zębie), dziura (miejscowość biedna, położona z dala od cywilizacji), wagina, pusty w środku, głuchy (o dźwięku)
hun - ona, samica
hund - pies, banknot o nominale 100 koron
hundefanger - rakarz, hycel
hundegalskab - wścieklizna
hunderakker - rakarz, hycel
hundesyge - nosówka
hundrede - sto, 100, setny, 100.
hunkøn - rodzaj żeński
hurtig - szybki
hurtigt - szybko
hus - dom (budynek)
huskat - kot domowy
huske - pamiętać
hustru - żona
hvad - co
hvæse - syczeć
hval - wieloryb
hvalp - szczenię, szczeniak
hvalros - mors
hvem - kto
hveps - osa
hver - każdy
hvid - biały, blady, waluta używana w średniowiecznej Danii
hvide - białko (w jaju)
Hviderusland - Białoruś
hviderussisk - białoruski, język białoruski
hvidløg - czosnek
hvilken - który, jaki
hvis - jeśli, czyj
hviske - szeptać
hvor - gdzie, jak, ależ, -ż
hvordan - jak
hvorfor - dlaczego
hvor mange - ile
hvor meget - ile
hvornår - kiedy
hyæne - hiena, drażliwa, histeryczna kobieta
hydraulik - hydraulika
hydraulisk - hydrauliczny
hydrogen - wodór
hygge - miła atmosfera, doświadczać miłej atmosfery i tworzyć ją
hyle - wyć
hypoplastisk venstre hjerte syndrom - zespół hipoplazji lewego serca
hypotese - hipoteza
hysteri - histeria
i - w, na
I - wy
i dag - dzisiaj, dziś
idealisme - idealizm
ifølge - według
i forgårs - przedwczoraj
i går - wczoraj
igen - znowu, od nowa, jeszcze raz, z powrotem, już, jeszcze
ikke - nie
ild - ogień, ogień (strzelanie z broni palnej lub armat)
ile - biec, gnać, spieszyć
ilt - tlen
immigrant - imigrant
immigrere - imigrować
imod - przeciw, przeciwko
i morgen - jutro
i morges - dziś rano
imperativ - tryb rozkazujący
ind - do środka
indbyde - zapraszać
indbygger - mieszkaniec
indeholde - zawierać
indenfor - wewnątrz, w środku, do wewnątrz, do środka
indflydelse - wpływ
Indien - Indie
indignation - oburzenie
indium - ind
indkøb - zakup, zakupy, kupowanie
indoeuropæisk - indoeuropejski
Indonesien - Indonezja
indvolde - wnętrzności, wątpia
infektion - infekcja, zakażenie
infinitiv - bezokolicznik
influenza - grypa, influenca
information - informacja
ing. - inż. (inżynier)
Inge - Inga
ingen - nikt, żaden
ingeniør - inżynier
ingen roser uden torne - nie ma róży bez kolców
ingenting - nic
inkvisitorisk - inkwizytorski
insekt - owad, insekt
insistere - nalegać
intelligent - inteligentny
interessant - interesujący
interjektion - wykrzyknik
international - międzynarodowy
intet - nic, nicość
intetkøn - rodzaj nijaki
i overmorgen - pojutrze
Irak - Irak
Iran - Iran
iridium - iryd
Irland - Irlandia
ironi - ironia
is - lód, lody
især - szczególnie, głównie
isbjørn - niedźwiedź polarny
Isis - Izyda
Island - Islandia
islandsk - islandzki
isolere - izolować
Israel - Izrael
isse - ciemię
i stand til - w stanie (być)
Italien - Włochy
italiensk - włoski, włoski (język)
itu - uszkodzony, nieczynny, zepsuty
iver - zapał, entuzjazm
ja - tak
jævndøgn - równonoc
Jan - Jan
januar - styczeń
Japan - Japonia
japaner - Japończyk
japansk - japoński
jeg - ja, ego, jestestwo
jer - wam
jeres - wasz
jern - żelazo
Jesus - Jezus
jiddisch - jidysz
jihad - dżihad
jo - przecież, wszak, im, ależ tak, owszem
jod - jod
jordbær - truskawka
Jorden - Ziemia
jordskælv - trzęsienie ziemi
jordskorpe - skorupa ziemska, odpowiednik skorupy (1.1) na innych planetach
Jørgen - Jerzy
journalistisk - dziennikarski
jul - święta Bożego Narodzenia
juletræ - choinka bożonarodzeniowa
juli - lipiec
juni - czerwiec
jurist - prawnik
Jylland - Jutlandia
kadmium - kadm
kæbe - szczęka
kæde - łańcuch
kælder - piwnica
kæmpe mod vejrmøller - walczyć z wiatrakami
kænguru - kangur
kær - drogi, ukochany
kærlighed - miłość
kaffe - kawa
kage - ciasto, ciastko
kaj - molo
kakerlak - karaluch
kalcium - wapń
kalejdoskop - kalejdoskop
kalender - kalendarz
kalium - potas
kalkun - indyk
kalligrafi - kaligrafia
kalorie - kaloria ( kilokaloria)
kalv - cielę, cielak, cielęca skóra
kam - grzebień
kamæleon - kameleon
kamel - wielbłąd
kampagne - kampania
kan - kunne
kanel - cynamon
kanin - królik
kannibal - kanibal
Kapernaum - Kafarnaum
kapitalisme - kapitalizm
karbon - węgiel, karbon
Karen - Karina
karma - karma
kartoffel - ziemniak, kartofel
Kasakhstan - Kazachstan
kasjubisk - kaszubski, język kaszubski
kassettebånd - kaseta magnetofonowa
kaste - rzucać, poronić
kaste op - wymiotować
kaste penge ud ad vinduet - wyrzucać pieniądze przez okno
kasus - przypadek
kat - kot (zwierzę domowe), zwierzę drapieżne z rodziny, o smukłym ciele, miękkiej sierści i długim ogonie, bicz, pejcz o rozwidlonej końcówce, nihalet kat
katalog - katalog (spis zawartości biblioteki), katalog (folder lub księga zawierająca spis towarów wraz z ich cenami)
katolik - katolik
kattemad - karma (pożywienie) dla kotów
kejser - cesarz
kejsersnit - cesarskie cięcie
kelner - kelner
kemi - chemia
kemisk - chemiczny
kende - znać, uznać, poznać, rozpoznać, współżyć seksualnie
kendeord - przedimek, rodzajnik
Kenya - Kenia
kigge - patrzeć
killing - młody kot, kocię, kotek, kiciuś, młody zając, zajączek
kilometer - kilometr
Kina - Chiny
kind - policzek
kineser - Chińczyk, rodzaj fajerwerków
kinesisk - chiński, chiński (język)
Kirgisistan - Kirgistan
kirke - kościół
kirkegård - cmentarz
kirsebær - wiśnia
kit - kit (masa używana w budownictwie do montażu szyb)
kjole - sukienka, suknia
kl. - godz., godzina), kl., klasa)
klappe hesten - spokojnie poczekać z reakcją, zdać się na upływ czasu
klasse - klasa (w szkole), klasa (warstwa społeczna), klasa (jakość), klasa (grupa elementów o wspólnych cechach)
klaviatur - klawiatura (instrumentu muzycznego)
klint - klif
klit - wydma
klo - pazur, bazgroł, niewyraźny i niechlujny charakter pisma, pisać jak kura pazurem
klog - mądry
klokke - zegar, dzwon, dzwonek
klor - chlor
kloster - klasztor
knæ - kolano
knap - guzik, przycisk, przełącznik, gałka, pokrętło, zaledwie, prawie nie
kniv - nóż
knogle - kość
ko - krowa
ko- - ko- (razem, wspólnie)
kobber - miedź
købe - kupować, kupić, zgadzać się z argumentem, akceptować wyjaśnienie, przekupywać, korumpować
købe katten i sakken - kupić kota w worku
København - Kopenhaga
københavner - kopenhażanin, kopenhażanka
kobling - sprzęgło, sprzęganie
kød - mięso
kofanger - zderzak
koge - gotować, gotować się
kogle - szyszka
køkken - kuchnia (pomieszczenie), kuchnia (zbiór charakterystycznych dań)
kold - zimny, chłodny, obojętny
køleskab - lodówka
kollision - kolizja, stłuczka, zderzenie
koma - śpiączka
kombination - połączenie, kombinacja
komme - przychodzić, przyjeżdżać, dochodzić, osiągać orgazm, szczytować, przyjście, przybycie
komme ind - wchodzić, wejść
kommen - kminek (przyprawa), kminek zwyczajny
kommunikation - komunikacja
kommunisme - komunizm
kommunistisk - komunistyczny
kompas - kompas
komplikation - komplikacja
komposition - kompozycja
køn - płeć, organy płciowe, rodzaj, ładny, niezbyt przyjemny
koncert - koncert
kondensator - kondensator
kondition - kondycja, warunek
kone - żona, starsza, zniszczona życiem kobieta
konfiskere - konfiskować
konge - król
konkret - konkretny
konkurrence - konkurs, konkurencja
konsonant - spółgłoska
konspirationsteori - teoria spiskowa
konstatere - stwierdzić, ustalić
konstruere - konstruować
kontakt - kontakt (zetknięcie się), kontakt (informator, często tajny), kontakt (możliwość przekazywania i odbierania informacji), kontakt (gniazdo sieci elektrycznej), kontakt (przełącznik światła elektrycznego), kontakt (stały katalizator w układach ciekłych lub gazowych)
kontakte - kontaktować / skontaktować się
kontant - w gotówce, konkretny
kontinent - kontynent
kontrol - kontrola (panowanie nad czymś), miejsce, w którym coś się sprawdza
konvolut - koperta
kor - chór
Koranen - Koran
køre - jechać, jeździć, prowadzić (pojazd), wieźć, wozić, działać, pracować, kierować, sterować, zarządzać, uruchamiać
kørekort - prawo jazdy (dokument)
kører - kierowca
køretøj - pojazd
korruption - zepsucie, korupcja
kors - krzyż, krzyż (symbol chrześcijański), krzyż (utrapienie, cierpienie)
korsfæste - krzyżować (dokonywać egzekucji przez przybicie do krzyża)
kort - mapa, karta, kartka, kartka pocztowa, pocztówka, widokówka, karta kredytowa, karta do gry, krótki, krótko
kortslutning - zwarcie
koste - kosztować, wykosztować się, opłacić
køter - kundel
kr. - korona
kræ - zwierzak, małe stworzenie
kræft - nowotwór
kræve - wymagać, żądać
kraft - moc, siła
krage - wrona
kran - żuraw budowlany, dźwig
kranie - czaszka
kranium - czaszka
krebs - rak, osoba spod znaku zodiaku Raka
krig - wojna
kriminalitet - przestępczość
kristen - chrześcijański
kristendom - chrześcijaństwo
kroat - Chorwat
Kroatien - Chorwacja
krokodille - krokodyl
krom - chrom
krone - korona (atrybut królewski), korona (100 øre), korona, koronować
krop - ciało
kry - dumny, śmiały
krypton - krypton
kugle - kula, gałka (porcja lodów), gałka (kulka używana w głosowaniach), jaja
kujon - tchórz
kul - węgiel
kulstof - węgiel
kultiden - karbon
kun - tylko
kunde - klient
kunne - móc, potrafić
kunst - sztuka
kunstig - sztuczny
kurere - leczyć, wyleczyć
kurv - kosz, koszyk
kusine - kuzynka
kusse - cipa, cipka, pizda
kuvert - koperta
kvadrat - kwadrat
kvadratisk - kwadratowy
kvæle i fødslen - dusić w zarodku
kvælstof - azot
kviksølv - rtęć, żywe srebro
kvinde - kobieta
kylling - kurczak
kys - pocałunek
kysse - całować
kyst - wybrzeże
lade - szopa, stodoła, nabijać, ładować, pozwalać, lad os, wyglądać
læbe - warga
læge - lekarz, leczyć się, zarastać
lægge - kłaść, położyć, znosić (jaja)
længde - długość
længe - długo
længsel - tęsknota
lære - uczyć, uczyć się
lærer - nauczyciel
lærerinde - nauczycielka
læse - czytać, studiować
lagkage - tort
lakere - lakierować
laks - łosoś
lam - jagnię
lampe - lampa
land - kraj, ląd, wieś, tereny pozamiejskie
landmand - rolnik, farmer
landsby - wieś, wioska
låne - pożyczać, wypożyczać
lang - długi, bardzo, o wiele
langsom - wolny, powolny
langsomt - powoli
langt - daleko
langvarig - długotrwały
lanthan - lantan
larm - hałas
larme - hałasować
las - szmata, ścierka
laser - laser, las
latinsk - łaciński
lave - robić
lavsorbisk - dolnołużycki, dolnołużycki (język)
lawrencium - lorens
le - śmiać się, kosa
legeme - ciało
lege med ilden - igrać z ogniem
lejlighed - mieszkanie, okazja
lejlighed gør tyve - okazja czyni złodzieja
leksikon - leksykon, encyklopedia, słownik
ler - glina
Letland - Łotwa
leve - żyć, żywić się
lever - wątroba
leve som hund og kat - żyć jak pies z kotem
Libanon - Liban
licens - licencja, podatek od posiadania odbiornika radiowego lub telewizyjnego
lide - cierpieć
lideform - strona bierna
lidt - trochę, niewiele, mało
Liechtenstein - Liechtenstein
lig - trup, równy, jednakowy
lige - równy, odpowiednik, taki sam, identyczny, prosty, poziomy, od razu, bezpośrednio, właśnie, dokładnie, równać, wyrównywać
ligestilling - równouprawnienie
ligge - leżeć, stać
ligne - przypominać (np. z wyglądu), być podobnym, pasować (do schematu zachowania)
lille - mały, młody
lim - klej
lingvistik - lingwistyka, językoznawstwo
Litauen - Litwa
liter - litr
lithium - lit
litium - lit
litteratur - literatura
liv - życie
løb - bieg, prąd (rzeki), ciąg, przeciąg, lufa
løbe - biec, przemieszczać się
løber - biegacz, podłużny dywanik, goniec
lobotomi - lobotomia
lod - odważnik, ciężarek, miara wagi, 1/32 funta
løfte - obietnica
løg - cebula
logge ind - logować (się)
løgn - kłamstwo
løgner - kłamca, łgarz
lokal - lokalny, miejscowy, numer wewnętrzny, wewnętrzny
lokomotiv - lokomotywa
lokum - kibel, sracz
lomme - kieszeń
lommelærke - piersiówka
lommeregner - kalkulator
løn - pensja, klon
London - Londyn
loppe - pchła
lørdag - sobota
lort - gówno (odchody), gówno
løsning - rozwiązanie, rozluźnienie, poluźnienie
lov - prawo, ustawa, pozwolenie
love - obiecywać, przyrzekać
løve - lew
ludder - (dziwka)
luder - dziwka, kurwa, prostytutka
luft - powietrze, przestrzeń między
lufthavn - port lotniczy, lotnisko
lugte - pachnąć, pachnieć, wąchać
lunge - płuco
lup - lupa
lutetium - lutet
Luxembourg - Luksemburg
lyd - dźwięk, głoska
lygte - latarka
lykke - sukces, szczęście
lykkelig - szczęśliwy (odczuwający szczęście)
lykkeligvis - szczęśliwie
lyn - błyskawica, piorun
lynlås - zamek błyskawiczny
lys - świeczka, świeca, światło, jasny
lyse - świecić
lyserød - różowy
lyst - chęć, ochota
lytte - słuchać
lyve - kłamać
mad - jedzenie, kanapka
måde - sposób, umiar, tryb
Madeira - Madera
mælk - mleko
Mælkevejen - Droga Mleczna
måge - mewa
magnesium - magnez
maj - maj
majuskel - majuskuła
makaber - makabryczny
Makedonien - Macedonia
mål - cel, gol, pomiar, język (mowa)
malaria - malaria, zimnica
male - malować (obrazy), malować (powierzchnie, np. ściany)
måle - mierzyć
male byen rød - imprezować na mieście, odwiedzać bary
maling - farba, malowanie
malke - doić
malm - ruda, brąz, mosiądz
målmand - bramkarz
Malta - Malta
måltid - posiłek
mand - mężczyzna, mąż
mandag - poniedziałek
måne - księżyc, Księżyc, Månen
måned - miesiąc
mangan - mangan
mange - wiele
mangel - brak, wada, defekt, usterka
manometer - manometr, ciśnieniomierz
man skal ikke sælge skindet før bjørnen er skudt - nie dziel skóry na niedźwiedziu
man skal smede mens jernet er varmt - kuj żelazo, póki gorące
mareridt - koszmar (zły sen), koszmar (złe doświadczenie)
Maria - Maria (imię żeńskie)
Marianne - Marianna
mariehøne - biedronka
markant - znaczny, zauważalny, znacznie, zauważalnie
marsvin - świnka morska, morświn
Martin - Marcin
marts - marzec
marxisme - marksizm
måske - być może, może, prawdopodobnie
maskine - maszyna, urządzenie
masse - masa, masa (duża ilość lub liczba), masa (gęsta substancja)
matematik - matematyka
materialisme - materializm
måtte - móc (mieć pozwolenie), musieć
mave - brzuch
med - z, medicin, medicinsk, medicinae
medalje - medal
med det samme - natychmiast, niezwłocznie
medfødt - wrodzony
medicin - medycyna, lekarstwo
med koldt blod - z zimną krwią
medlem - członek (np. organizacji)
medlemsland - kraj członkowski
medlyd - spółgłoska
medmindre - jeśli nie, o ile nie, chyba że
med vilje - umyślnie, specjalnie, rozmyślnie
meget - bardzo, dużo, wiele
meitnerium - meitner
mekanisk - mechaniczny, maszynowy, automatyczny, związany z mechaniką
mekanisme - mechanizm
mel - mąka
mellem - między, pomiędzy
melon - melon, melony (kobiece piersi)
men - ale, lecz, uszczerbek, wynik przemocy lub choroby
mendelevium - mendelew
menneske - człowiek
mens - podczas gdy
mere - bardziej, więcej
mest - najbardziej, najwięcej
meter - metr
metro - metro
Michael - Michał
middag - południe (pora dnia), obiad
Middelhavet - Morze Śródziemne
midt - na środku, centralnie
mig - mi, mnie, mną, ja
migræne - ból głowy
Mikael - Michał
mikrofon - mikrofon
milion - milion, 1.000.000
miljø - środowisko
million - milion, 1000000
min - mój
minaret - minaret
mindst - lille, co najmniej
minut - minuta (fragment czasu), minuta
mis - kot, kicia
miste - gubić, tracić
mit - mój (min)
mjave - miauczeć
møbel - mebel
mobiltelefon - telefon komórkowy
mod - odwaga, przeciw, naprzeciw, w kierunku
mod- - przeciw-, anty-, od-
modalverbum - czasownik modalny
model - model, modelka
moder - matka
modgift - odtrutka, antidotum
modig - odważny
modtage - otrzymywać, przyjmować, odbierać
møl - mól
Moldavien - Mołdawia
molybdæn - molibden
moment - ważny czynnik, moment
moms - podatek od wartości dodanej (VAT)
momse - nakładać podatek od wartości dodanej (VAT)
monark - monarcha
monarki - monarchia
Mongoliet - Mongolia
monofonisk - monofoniczny
monoteisme - monoteizm
mønt - moneta
Montenegro - Czarnogóra
mor - mama, matka
mord - morderstwo
morgen - jutro, rano, poranek
morgenmad - śniadanie
mørk - ciemny, mroczny
mørke - ciemność, mrok, ciemnota
mørkt - ciemno
mos - mech, purée
Moskva - Moskwa
motor - silnik
motorbåd - motorówka
motorvej - autostrada
mulig - możliwy
mulighed - możliwość
mund - usta
mur - mur
mursten - cegła, cegła (o grubej książce)
mus - mysz
museum - muzeum
musik - muzyka
muskat - muszkat (sproszkowana gałka muszkatołowa), gałka muszkatołowa
muskatnød - gałka muszkatołowa
muskel - mięsień, muskuł
muslim - muzułmanin
m.v.h. - med venlig hilsen (serdecznie pozdrawiam)
myg - komar
myrde - mordować
myre - mrówka
myreløve - mrówkolew
nabo - sąsiad, sąsiadka
næb - dziób (u ptaków)
næse - nos, nos (zmysł węchu)
næsehorn - nosorożec
næste - następny, bliźni, gnieździć, zagnieżdżać
næsten - prawie
nævner - mianownik
Nairobi - Nairobi
når - kiedy, gdy
narkoman - narkoman
nat - noc
national - narodowy, państwowy
natrium - sód
nattergal - słowik
natugle - puszczyk
navle - pępek
navn - imię, nazwa
navneform - bezokolicznik
navnemåde - bezokolicznik
navneord - rzeczownik
ned - w dół, na papierze
nedbør - opad atmosferyczny
Nederlandene - Holandia
nederlandsk - holenderski
nedresorbisk - dolnołużycki, dolnołużycki (język)
negl - paznokieć
nej - nie, ach, och, ojej
nem - łatwy
nemt - prosto, łatwo
neodym - neodym
neon - neon, neon (reklama, szyld)
Nepal - Nepal
neptunium - neptun
neutron - neutron
ng - nogen (ktoś)
ngt - noget (coś)
ni - dziewięć (9)
niende - dziewiąty, 9.
nihalet kat - pejcz o końcówce rozwidlonej na dziewięć zakończeń, "kot o dziewięciu ogonach"
nikkel - nikiel
niobium - niob
niogfirs - osiemdziesiąt dziewięć, 89
niogfyrre - czterdzieści dziewięć, 49
nioghalvfems - dziewięćdziesiąt dziewięć, 99
nioghalvfjerds - siedemdziesiąt dziewięć, 79
nioghalvtreds - pięćdziesiąt dziewięć, 59
niogtredive - trzydzieści dziewięć, 39
niogtres - sześćdziesiąt dziewięć, 69
niogtyve - dwadzieścia dziewięć, 29
nitrogen - azot
nitten - dziewiętnaście, 19
nittende - dziewiętnasty, 19.
Nix - Nix
NØ - północny wschód
nobelium - nobel
nød - orzech, głowa, łepetyna, potrzeba, nyde
nødvendig - konieczny
nogen - ktoś, ktokolwiek, coś, cokolwiek
nøgen - nagi, pozbawiony dodatków i ozdób
noget - coś
nøgle - klucz, klucz (podpowiedź), klucz (sposób), klucz (narzędzie)
nok - dość, dosyć, wystarczająco, z pewnością, na pewno
nominativ - mianownik
nord - północ, na północ, północny-, północno-
Nordeuropa - Europa Północna
nordisk - nordycki
nordlig - północny
nordlys - zorza polarna na półkuli północnej
nordmand - Norweg
Norge - Norwegia
norm - norma
normal - normalny
norsk - norweski, norweski (język)
november - listopad
nu - teraz
nudist - nudysta
nul - zero, 0
nummer - numer, numer (żart, przekręt, oszustwo)
nummerisk - numeryczny
nummerplade - tablica rejestracyjna
nutid - czas teraźniejszy
NV - północny zachód
ny - nowy
nynazist - neonazista
nyre - nerka
ø - wyspa
Ø - Ø = øst ( wschód), Ø =  Enhedslisten
obelisk - obelisk
occitansk - język prowansalski
ødelægge - zniszczyć, zepsuć
odør - odór, smród
øf - chrum!
ofte - często
og - i, a
også - również
o.h. - over havet / over havets overflade (n.p.m. = nad poziomem morza)
øje - oko
øjeæble - gałka oczna
øjeblik - mgnienie oka, moment
øjeblikkelig - natychmiastowy
øjeblikkeligt - natychmiast
øje for øje, tand for tand - oko za oko, ząb za ząb
økologi - ekologia
økologisk - ekologiczny
økonomi - ekonomia
økonomisk - ekonomiczny, oszczędny, tani
økse - siekiera, topór
oktober - październik
øl - piwo, butelka lub kufel piwa
oldnordisk - język staronordyjski, staronordyjski
Olympia - Olimpia (miasto w Grecji)
olympisk - olimpijski
om - o, za, w ciągu, w okresie
omfatte - zawierać, składać się z, obejmować
omkring - około (o wartościach), dookoła (w przestrzeni)
område - obszar, teren, dziedzina
ond - zły
onde - zło
ondt - źle
onkel - wujek, wuj
onkolog - onkolog
onkologi - onkologia
onkologisk - onkologiczny
ønologi - enologia
onsdag - środa
ønske - życzenie, życzyć, chcieć, pragnąć
op - w górę, do góry
operation - operacja, szereg zaplanowanych działań
operativsystem - system operacyjny
operatør - operator
opfinde - wynaleźć
opgave - zadanie
opium - opium
opleve - doświadczać
oplyse - oświetlać, oświecać, informować
oprindelse - pochodzenie
opsætte - ułożyć, odłożyć, przełożyć (w czasie)
opstandelse - zamieszanie, panika, zmartwychwstanie
optage - przyjmować, nagrywać, zajmować, okupować
optimist - optymista
orange - pomarańczowy (kolor), pomarańcza
ord - słowo, wyraz
ordbog - słownik
orden - porządek, zakon, rząd
ordinær - zwykły, zwyczajny, powszechny
ordstilling - szyk wyrazów
øre - ucho, jednostka walutowa (1/100 korony duńskiej lub norweskiej), odpowiednik polskiego grosza
ørebetændelse - zapalenie ucha
ørering - kolczyk
organisk - organiczny
orgie - orgia
orkan - huragan, cyklon, trąba powietrzna
orkanens øje - oko cyklonu
ørken - pustynia
ørkenagtig - pustynny
ørkennatugle - puszczyk arabski
ørn - orzeł
os - nas, vi
Osaka - Osaka
osmium - osm
OSS - często zadawane pytania, FAQ
ost - ser
øst - wschód, Wschód (Rosja i kraje postkomunistyczne w Europie), ku wschodowi, w kierunku wschodnim
ostehøvl - krajacz do sera
Østersøen - Morze Bałtyckie, Bałtyk
osteskærer - krajacz do sera
Østeuropa - Europa Wschodnia
Ostia - Ostia
østlig - wschodni
Østrig - Austria
osv. - itd., i tak dalej
otte - osiem, 8
ottende - ósmy, 8.
otteogfirs - osiemdziesiąt osiem, 88
otteogfyrre - czterdzieści osiem, 48
otteoghalvfems - dziewięćdziesiąt osiem, 98
otteoghalvfjerds - siedemdziesiąt osiem, 78
otteoghalvtreds - pięćdziesiąt osiem, 58
otteogtredive - trzydzieści osiem, 38
otteogtres - sześćdziesiąt osiem, 68
otteogtyve - dwadzieścia osiem, 28
otter - ósemka (
oval - owal, owalny
øvelse - ćwiczenie
øvelse gør mester - praktyka czyni mistrza
over - nad, podczas, ponad, z powodu, zawierający, omawiający
overflade - powierzchnia
overhovedet - w ogóle
oversætte - tłumaczyć (przenosić znaczenie informacji w jednym języku na drugi)
oversættelse - tłumaczenie
oversætter - tłumacz tekstów pisanych
oversvømmelse - powódź, potop
overvægt - otyłość
overvægtig - otyły
overvinde - przezwyciężyć
ovn - piec, piekarnik, kuchenka
øvresorbisk - górnołużycki, górnołużycki (język)
på - na, po, w
pæn - ładny
pære - gruszka, żarówka, głowa, łeb, łepetyna
på godt og ondt - na dobre i na złe, z dobrych i złych stron
på hovedet - do góry nogami
Pakistan - Pakistan
pakke - paczka, pakować
palæstinensisk - palestyński
palladium - pallad
pande - patelnia, czoło, uderzyć w twarz
panik - panika
papegøje - papuga
papir - papier, papier (dokument), papier (wartościowy)
papiret rødmer ikke - papier się nie rumieni, papier jest cierpliwy
parasit - pasożyt
Paris - Paryż
parkere - parkować
parlamentariker - parlamentarzysta
parlamentarisk - parlamentarny
paryk - peruka
pas - paszport
påske - Wielkanoc
passager - pasażer
passer - cyrkiel
påstå - twierdzić
patient - pacjent
pattedyr - ssak
pave - papież
peber - pieprz (roślina), pieprz (przyprawa)
pedal - pedał
pege - wskazywać
pelikan - pelikan
peloton - pluton
pels - futro, futerko
penge - pieniądze
penis - penis
periode - okres
periodiske system - układ okresowy
perm - perm
perron - peron
person - osoba, osobowy
personlig - osobisty, prywatny
pest - dżuma, zaraza
PET - Policyjna Służba Wywiadowcza
Peter - Piotr
pga. - z powodu
piano nobile - piano nobile
pig - kolec (na skórze zwierzęcia)
pige - dziewczyna, dziewczynka
pik - penis (kutas, chuj), chuj
pil - strzała, strzałka (symbol), wierzba
pille - pigułka, tabletka, obierać, łuskać, zdzierać, dłubać, obmacywać, badać palcami
pindsvin - jeż
pingvin - pingwin
pisk - pejcz, bat, bicz, uderzenie pejczem (1.1)
Pittsburgh - Pittsburgh (stolica Allegheny)
plade - płyta, płyta (tj. płyta gramofonowa lub CD/DVD), płyta (w piecu), tablica (tj. tablica rejestracyjna)
pladespiller - adapter, gramofon
plakat - plakat
planet - planeta
planetarium - planetarium (obiekt)
plante - roślina, zasadzić (roślinę (1.1))
plastik - plastik (tworzywo sztuczne)
platin - platyna
pligt - obowiązek
pludselig - nagle, nagły
plutonium - pluton
plyndre - plądrować
plys - plusz
pneumatisk - pneumatyczny
poetisk - poetycki
pokal - kufel, pokal, puchar (trofeum sportowe)
polak - Polak
polarlys - zorza polarna
Polen - Polska
politi - policja
politibetjent - policjant
politiker - polityk
politikvinde - policjantka
politisk - polityczny
polonium - polon
polsk - polski (odnoszący się do państwa Polska), polski (język)
polyteisme - politeizm
populær - popularny
Portugal - Portugalia
portugisisk - portugalski
postbud - listonosz
postkasse - skrzynka pocztowa
pote - łapa (własc. dolna część łapy, "stopa"), łapa (dłoń), stopa
præfiks - prefiks
præposition - przyimek
præsident - prezydent
præst - kapłan, ksiądz
Praia - Praia
praseodym - prazeodym
Prindsesse - księżniczka)
prins - książę, królewicz
prinsesse - księżniczka
prior - przeor, opat
priorinde - przeorysza
pris - cena, nagroda, porcja, którą można utrzymać między trzema palcami
privat - prywatny
privatskole - szkoła prywatna
problem - problem
procent - procent
producere - produkować
produkt - produkt, iloczyn (wynik mnożenia)
produktion - produkcja
produktionsmidler - środki produkcji
professor - profesor
profit - zysk, różnica między zyskiem a wydatkami przedsiębiorstwa
promethium - promet
pronomen - zaimek
prostitution - prostytucja
protactinium - protaktyn
protestere - protestować
proton - proton
prøve - próbować, spróbować, próba, egzamin
provokere - prowokować
psykisk - psychiczny
Ptah - Ptah
publikum - publiczność
pude - poduszka
pukkel - garb
pukle - harować
pukle røven ud af bukserne - dwoić się i troić, harować jak wół
purpur - purpura
quizze - brać udział w kwizie
råb - krzyk, wrzask
rabat - rabat, zniżka, wąski pas terenu między torami a peronem
råbe - krzyczeć, wyczytywać (nazwiska, punkty)
rabies - wścieklizna
råd - rada, porada, rozkład (gnicie)
radio - radio (urządzenie), radio (instytucja)
radiotelegrafist - radiotelegrafista
radise - rzodkiewka
radium - rad
radius - promień
radon - radon
række - szereg, rząd, szereg (pewna liczba elementów), typ, kolejka, podać, podawać, sięgnąć, sięgać
ræv - lis
ramme - rama, ramka, obramowanie, ograniczenie, zakres, ramy, obramowywać, uderzać, wbijać
raseri - wściekłość, szał
rat - kierownica
rav - bursztyn, awantura, burda, scysja
ravn - kruk
realisation - realizacja, wykonanie
realistisk - realistyczny
redde - ratować, ocalić
redigere - edytować, redagować
redskab - narzędzie
reducere - zmniejszać
regelmæssigt - regularnie
regent - regent
regering - rząd
regn - deszcz
regnbue - tęcza
regning - rachunek
regnorm - dżdżownica
reinkarnation - reinkarnacja
reje - krewetka
rejse - podróż, jechać, podróżować
rejse sig - wstawać
reklamere - reklamować (informować o towarach lub usługach, zachwalać je i sugerować ich kupno), reklamować (żądać naprawy, wymiany lub refundacji wadliwego towaru lub źle wykonanej usługi, często w ramach gwarancji lub rękojmi)
rektangulær - prostokątny
relativt - relatywnie, względnie
religion - religia
ren - czysty
rent - czysto
rente - oprocentowanie, odsetki
repetere - powtarzać, powtarzać (materiał ucząc się)
reporter - reporter
reservat - rezerwat
rest - reszta
retning - kierunek
retsina - retsina
retstavning - ortografia
rettighed - prawo
ret vinkel - kąt prosty
revir - rewir
revolution - rewolucja
revolver - rewolwer
rhenium - ren
rhodium - rod
ri - fastrygować
ribben - żebro
ridder - rycerz
rig - bogaty (mający dużo pieniędzy), bogaty, zasobny (obfitujący w coś)
rige - państwo, kraj, rzesza, królestwo
rim - szron, rym
ris - ryż
ro - spokój, wiosłować
rød - czerwony (kolor)
Røde Kors - Czerwony Krzyż
rodeo - rodeo
rød fluesvamp - muchomor czerwony
rødtoppet fuglekonge - zniczek
rødvin - czerwone wino
roer - wioślarz
røg - dym
røge - wędzić
rolle - rola
rom - rum (
Rom - Rzym
roman - powieść
Rom blev ikke bygget på en dag - nie od razu Kraków zbudowano
rør - rura, słuchawka telefonu, przewód w ciele, np. pokarmowy, moczowy, itp.
rosenkrans - różaniec
rotte - szczur
rottegift - trutka na szczury
røv - dupa, dupek
røvhul - dupek, odbyt
rubidium - rubid
Rumænien - Rumunia
rund - okrągły
rundkørsel - rondo
Rusland - Rosja
russisk - rosyjski, język rosyjski
ruthenium - ruten
rutherfordium - rutherford
ryg - plecy, grzbiet
ryge - dymić, palić (papierosy), gwałtownie przemieszczać się (wpadać, spadać, wlatywać itp.), wędzić
ryger - palacz (wyrobów tytoniowych)
rygning - palenie (tytoniu), kalenica, grzbiet dachu
rygsæk - plecak
s. - s., str., strona, sekunda
så - tak, w ten sposób, tyle, taki, wtedy, potem, więc, siać
Sabina - Sabina
Sabine - Sabina
sæbe - mydło, mydlić, namydlać
sæl - foka
sælge - sprzedać, sprzedawać, sprzedawać się
sætning - zdanie, składanie tekstu (DTP)
sætte - umieszczać
saftig - soczysty
saks - nożyce, nożyczki
sal - sala, piętro
salg - sprzedaż
salt - sól, słony, solny
samarium - samar
samfund - społeczeństwo
samle - zbierać, kolekcjonować
samling - zbiór, kolekcja, spotkanie, zebranie
samme - identyczny, taki sam
samovar - samowar
samt - wraz z, dodatkowo z
samtykke - zezwolenie, zgoda, przyzwolenie
samvittighed - sumienie
sand - piasek
sandhed - prawda
sang - pieśń, piosenka
sangerinde - piosenkarka, pieśniarka
Sao Tome og Principe - Wyspy Świętego Tomasza i Książęca
sår - rana
såret - ranny, zraniony
sarkofag - sarkofag
satanist - satanista, satanistka
sauce - sos
Saudi-Arabien - Arabia Saudyjska
sav - piła
save - piłować
Schlesien - Śląsk
Schweiz - Szwajcaria
se - widzieć, patrzeć, spotkać lub odwiedzić kogoś, woleć, rozumieć
seaborgium - seaborg
seddel - banknot, karteczka
sejl - żagiel
sejlbåd - żaglówka
sejle - żeglować
sejr - zwycięstwo
seks - sześć, 6
seksogfirs - osiemdziesiąt sześć, 86
seksogfyrre - czterdzieści sześć, 46
seksoghalvfems - dziewięćdziesiąt sześć, 96
seksoghalvfjerds - siedemdziesiąt sześć, 76
seksoghalvtreds - pięćdziesiąt sześć, 56
seksogtredive - trzydzieści sześć, 36
seksogtres - sześćdziesiąt sześć, 66
seksogtyve - dwadzieścia sześć, 26
seksten - szesnaście, 16
sekstende - szesnasty, 16.
sekund - sekunda, chwila
selen - selen
selleri - seler
selv - się, sobie, sam, samodzielnie, nawet, jestestwo, ego, własne ja
selvangivelse - zeznanie podatkowe
selvhypnotisk - autohipnotyczny
selvlyd - samogłoska
selvmord - samobójstwo
selvom - chociaż, pomimo tego, że
selv om - selvom (chociaż)
semikolon - średnik (;)
sende - słać, wysyłać
sene - ścięgno
seng - łóżko
sent - późno
separation - separacja
separatisme - separatyzm
separatistisk - separatystyczny
september - wrzesień
servostyring - wspomaganie kierownicy
se ud - wyglądać
sex - seks
SF - Ludowa Partia Socjalistyczna
si - sito
sidde - siedzieć, siedzieć (w więzieniu, zarządzie, itd.), leżeć
siden - od, temu, skoro, że
sidst - ostatnio, ostatnim razem
sidste - ostatni
sig - się
sige - mówić, powiedzieć
signal - sygnał
sikkerhed - bezpieczeństwo, pewność, zabezpieczenie
sikkerhedsnål - agrafka
sikkert - pewnie, zapewne, z pewnością
sikring - bezpiecznik, zabezpieczenie, ubezpieczenie
sild - śledź, laska, ładna dziewczyna
silicium - krzem
silke - jedwab (tkanina)
sin - swój
Singapore - Singapur
sit - sin (swój)
situation - sytuacja
sjæl - dusza
sjælden - rzadki (o częstotliwości)
sjældent - rzadko
sjette - szósty, 6.
skade - szkoda, strata
skadedyr - szkodnik
skæg - broda (zarost)
skak - szachy, szach w (1.1)
skandale - skandal
Skandinavien - Skandynawia
skandinavisk - skandynawski
skarp - ostry
skat - skarb
ske - łyżka, dziać się, zdarzać się, stać się
skelet - szkielet
skelne - odróżniać
skib - statek
skide - srać, srać (na coś)
skildpadde - żółw
skilsmisse - rozwód
skinne - szyna, świecić
skjorte - koszula
skjule - ukrywać, chować
sko - but
skole - szkoła, szkolić, trenować
skønhed - piękno, piękność
skorsten - komin, fajka
skorstensfejer - kominiarz
Skotland - Szkocja
skov - las
skovbrug - leśnictwo
skrækkelig - okropny, straszliwy
skrige - krzyczeć
skrive - pisać
skrivemaskine - maszyna do pisania
skruetrækker - śrubokręt
skudår - rok przestępny
skuespiller - aktor
skuffelse - rozczarowanie
skulle - powinienem, powinien, należy, niech
sky - chmura, nieśmiały
skyde - strzelać, strzelać (gola)
skydelære - suwmiarka
skytsengel - Anioł Stróż
slange - wąż, dętka
slangebøsse - proca
slave - niewolnik, ciężko pracować, harować
slavinde - niewolnica
slavisk - niewolniczy, słowiański
slippe - puścić, zwolnić, wyślizgnąć się, wywinąć się, wymknąć się, wyjść obronną ręką
slot - zamek (budynek)
Slovakiet - Słowacja
Slovenien - Słowenia
slukke - wyłączyć
smag - smak, gust
smage - smakować (mieć smak), kosztować, smakować (badać smak)
smal - wąski
smed - kowal
smerte - ból, boleć
smertefrit - bezboleśnie
smide penge ud ad vinduet - wyrzucać pieniądze przez okno
smil - uśmiech
smile - uśmiechać się
smøg - papieros
smør - masło
smøre - smarować, nasmarować, wysmarować
smugler - przemytnik
smuk - piękny, ładny
snæver - wąski, ciasny
snakke - rozmawiać
snart - wkrótce, niedługo, prawie
snavs - brud
snavset - brudny
sne - śnieg, padać, śnieżyć
snes - 20 sztuk
sø - jezioro, morze
SØ - południowy wschód
socialisme - socjalizm
socialistisk - socjalistyczny
sød - słodki
sofistikeret - wyrafinowany
søge - szukać, próbować, usiłować, wnioskować, wnosić o coś, składać podanie
sok - skarpeta, skarpetka
sol - słońce (gwiazda)
soldat - żołnierz
Solen - Słońce (gwiazda w centrum naszego układu planetarnego)
solsort - kos
solsystem - układ planetarny
sølv - srebro, srebra (zastawa, sztućce), srebrny medal
som - który, jako, jak
søm - gwóźdź
som en fisk i vandet - jak ryba w wodzie
sommer - lato
sommerfugl - motyl
som regel - z reguły
søn - syn
søndag - niedziela
søndagsbilist - niedzielny kierowca
sorbisk - łużycki, łużycki (język)
sort - czarny, nielegalny, pesymistyczny, czarnoskóry, sort (rodzaj, klasa)
søster - siostra, zakonnica, pielęgniarka
søstjerne - rozgwiazda
sove - spać
sovepose - śpiwór
sove som en sten - spać jak kamień
soveværelse - sypialnia
søvn - sen
søvnløshed - bezsenność
spætte - dzięcioł
spåkone - wróżka, kobieta zajmująca się przepowiadaniem przyszłości
spand - wiadro, grat
Spanien - Hiszpania
spansk - hiszpański, hiszpański (język)
sparke - kopać
spejl - lustro
spilde - rozlać, rozlewać, marnować
spille - grać
spinat - szpinak
spinde - prząść, mruczeć (o kocie, motorze, itd.)
spirulina - spirulina
spise - jeść, jadać, jedzenie
spøgelse - duch, upiór, widmo
spolebåndoptager - magnetofon szpulowy
spor - ślad
spørge - pytać, spytać, zapytać
spørgsmål - pytanie
spørgsmålstegn - znak zapytania, pytajnik (znak ?)
sport - sport
sporvogn - tramwaj
sprog - język (zbiór słów, reguł gramatycznych, alfabetu)
sprogvidenskab - językoznawstwo, lingwistyka
sprøjte - strzykawka, zastrzyk, strzykać, wstrzykiwać
spurv - wróbel
spytte - pluć, spluwać
Sri Lanka - Sri Lanka
stå - stać, znajdować się w określonym miejscu, znajdować się w określonym stanie, być napisanym
stærk - silny
stål - stal
stald - stajnia, obora
stamme - rdzeń, pień, ród, pochodzić, jąkać się
stang - laska (jako jednostka), drzewce
stank - smród
stå op - wstawać (po śnie), wschodzić (o ciałach niebieskich), zmartwychwstawać
star - gwiazda (osobistość), gatunek trawy
statistik - statystyka
statsminister - premier
stavelse - sylaba
sted - miejsce, dom, posiadłość, działka budowlana
stedord - zaimek
stege - smażyć
stemme - głos (dźwięk wydawany przez człowieka lub zwierzę), głos (opinia wyrażona podczas głosowania), głosować, stroić (instrument), nastrajać (kogoś), pchać, naciskać
stempel - tłok, pieczątka
sten - kamień
stereofonisk - stereofoniczny
Stettin - Szczecin
sti - ścieżka, chlew
stil - styl, wypracowanie
stilk - łodyga
stille - cichy, cicho, nieporuszający się, nieruchomy, nieruchomo, bez zakłóceń, położyć, postawić, ustawić, ustawiać, regulować
stinke - śmierdzieć, śmierdzieć (o podejrzanych sprawach), ssać (być niemodnym, niefunkcjonalnym, brzydkim itd.)
stiv - sztywny, pijany, uwalony
stjæle - kraść, ukraść
stjerne - gwiazda
stjerneskruetrækker - śrubokręt krzyżowy
stjernetåge - mgławica
stk. - stykke (szt. = sztuka, egzemplarz), stykke (art. = artykuł)
stockholmer - sztokholmczyk
stockholmsk - sztokholmski
stol - krzesło
stor - duży, wielki
Storbritannien - Wielka Brytania
storby - metropolia, duże miasto
stork - bocian
størrelse - wielkość, rozmiar
støv - pył, kurz
støvsuge - odkurzać
støvsuger - odkurzacz
straf - kara
straffe - karać
stråling - promieniowanie
strand - plaża
stregspiller - obrotowy, kołowy
strøm - prąd
strontium - stront
struds - struś
struktur - struktura
strukturel - strukturalny
strygejern - żelazko
stubmark - rżysko
studere - studiować
stykke - sztuka (pojedynczy przedmiot, egzemplarz), sztuka, kawałek, fragment (element zbioru), kanapka, zadanie z matematyki, równanie, sztuka (utwór sceniczny, przedstawienie), obraz, artykuł (podjednostka paragrafu), sztukować, dzielić
styresystem - system operacyjny
subjekt - podmiot
substans - substancja
substantiv - rzeczownik
succes - sukces
suk - wzdech, westchnięcie, tchnienie
sukker - cukier
sukkersyge - cukrzyca
sult - głód
sulte - głodować
sulten - głodny
sulten som en ulv - głodny jak wilk
sumpmejse - sikora uboga, szarytka
sund - cieśnina, zdrowy
suppe - zupa
sur - kwaśny, zły
Susanne - Zuzanna
SV - południowy zachód
svær - trudny, ciężki
sværd - miecz
sværm - rój, chmara
svært - trudno, ciężko
svæve i skyerne - bujać w obłokach
svag - słaby
svagt - słabo
svale - jaskółka
svamp - grzyb, gąbka
svane - łabędź
svar - odpowiedź, rozwiązanie, olbrzymi i groźny
sved - pot
svede - pocić się
Svejts - Szwajcaria
svensk - szwedzki, szwedzki (język)
svensker - Szwed, Szwedka
Sverige - Szwecja
svin - świnia, osoba niechlujna
svindel - oszustwo, szwindel
svineri - świństwo, bałagan, niechlujność
svømme - pływać
svovl - siarka
sy - szyć
syd - południe (strona świata)
Sydafrika - Republika Południowej Afryki, RPA
Sydeuropa - Europa Południowa
sydlig - południowy
sydlys - zorza polarna na półkuli południowej
syfilis - syfilis, kiła
syg - chory
sygdom - choroba
sygehus - szpital
symptom - objaw, symptom
syn - wzrok, pogląd, opinia, widok
synd - grzech
synde - grzeszyć
synes - wydawać się, sądzić, uważać (mieć opinię)
synge - śpiewać, śpiewać (zdradzać wspólników podczas przesłuchania)
synke - tonąć (o statkach), obniżać się, połykać, przełykać
synonym - synonim, synonimiczny
syre - kwas, LSD
system - system, układ
sytten - siedemnaście, 17
syttende - siedemnasty, 17.
syv - siedem, 7
syvende - siódmy, 7.
syver - siódemka (
syvogfirs - osiemdziesiąt siedem, 87
syvogfyrre - czterdzieści siedem, 47
syvoghalvfems - dziewięćdziesiąt siedem, 97
syvoghalvfjerds - siedemdziesiąt siedem, 77
syvoghalvtreds - pięćdziesiąt siedem, 57
syvogtredive - trzydzieści siedem, 37
syvogtres - sześćdziesiąt siedem, 67
syvogtyve - dwadzieścia siedem, 27
tå - palec u nogi
tab - utrata, strata
tabe - stracić, upuścić, przegrać, spóźniać się
Tadsjikistan - Tadżykistan
tæller - licznik
tændstik - zapałka
tænke - myśleć
tæppe - dywan
tæve - suka, kobieta, bić, mocno uderzać
tag - dach
tage - brać, wziąć, zrobić, wykonać działanie, jechać, iść, podróżować
tåge - mgła
tage på - tyć
taiga - tajga
tajga - tajga
Taj Mahal - Tadź Mahal
tak - dziękuję
tal - liczba, cyfra, ilość
tale - mowa, przemowa, dubbing, mówić, mówić (znać dany język)
tale er sølv, men tavshed er guld - mowa jest srebrem, a milczenie złotem
tale er sølv, tavshed er guld - mowa jest srebrem, a milczenie złotem
talent - talent
tallerken - talerz
tallium - tal
tålmodig - cierpliwy
tålmodighed - cierpliwość
talord - liczebnik
talteori - teoria liczb
tand - ząb
tandbørste - szczoteczka do zębów
tandhjul - koło zębate
tandlæge - dentysta, stomatolog
tanke - myśl
tantal - tantal
tante - ciotka
tapet - tapeta
tåre - łza
tarm - jelito
tårn - wieża
tast - klawisz, przycisk
tastatur - klawiatura
taxa - taksówka
taxichauffør - taksówkarz, kierowca taksówki
Tchad - Czad
te - herbata
technetium - technet
tegn - znak, oznaka
tegnefilm - film rysunkowy, film animowany, kreskówka
tegnestift - pinezka
tegnsprog - język migowy
Tekla - Tekla
teknisk - techniczny
tektonik - tektonika
tektonisk - tektoniczny
telefon - telefon
telefonbog - książka telefoniczna
telefonisk - telefoniczny
tellur - tellur
telt - namiot
temperatur - temperatura
terapi - terapia
terbium - terb
termometer - termometr
Thailand - Tajlandia
Thekla - Tekla
Thermopylæ - Termopile
Thomas - Tomasz
thorium - tor
thulium - tul
ti - dziesięć, 10
tid - czas
tid er penge - czas to pieniądz
tidskrævende - czasochłonny
tiende - dziesiąty, 10.
tier - dziesiątka, dziesiątak, dycha, moneta dziesięciokoronowa
tiger - tygrys
tigge - żebrać
tigger - żebrak
til - do (kierunek), do (czas), dla, na
tilbage - z powrotem, w kierunku punktu wyjścia, już, jeszcze
tilbringe - spędzać (czas)
tilbyde - oferować
til fods - pieszo
tillade - pozwalać, zezwalać
tillægsord - przymiotnik
tillid - zaufanie
tilstand - stan
time - godzina, lekcja (godzina lekcyjna)
timeglas - klepsydra
tin - cyna
tirsdag - wtorek
tisse - sikać, siusiać
tit - często
titan - tytan
titanium - tytan
Tjekkiet - Czechy
tjekkisk - czeski, język czeski
tjene - zarabiać, służyć
tjener - kelner, sługa, służący
to - dwa, 2
toer - dwójka
tøf - brum
tog - pociąg
tøjklemme - klamerka (do przypinania prania do sznurka)
told - cło
tolder - celnik
tolv - dwanaście, 12
tolvfingertarm - dwunastnica
tolvte - dwunasty, 12.
tom - pusty
Tom - Tomasz
Tomas - Tomasz
tomat - pomidor
tømme - opróżniać, opróżnić
tommelfinger - kciuk
ton - tona
toogfirs - osiemdziesiąt dwa, 82
toogfyrre - czterdzieści dwa, 42
tooghalvfems - dziewięćdziesiąt dwa, 92
tooghalvfjerds - siedemdziesiąt dwa, 72
tooghalvtreds - pięćdziesiąt dwa, 52
toogtredive - trzydzieści dwa, 32
toogtres - sześćdziesiąt dwa, 62
toogtyve - dwadzieścia dwa, 22
topmejse - sikora czubatka, czubatka, sikora czubata
tør - suchy
tørke - susza
tornado - tornado, trąba powietrzna
torsdag - czwartek
torsk - dorsz
tørst - pragnienie
traditionel - tradycyjny
trådløs - bezprzewodowy
træ - drzewo, drewno
trække - ciągnąć, losować (ciągnąć los), szarpać, targać, przeciągać, wyciągać, naciągać, nakręcać, przyciągać, namawiać na swoje usługi, wciągać, wchłaniać
trække ud - wycofać się, wyrwać (ząb), przeciągać
træt - zmęczony
transistor - tranzystor, tranzystor (radio)
translitteration - transliteracja
trappe - schody
tre - trzy, 3
tredive - trzydzieści, 30
tredje - trzeci
treer - trójka
treogfirs - osiemdziesiąt trzy, 83
treogfyrre - czterdzieści trzy, 43
treoghalvfems - dziewięćdziesiąt trzy, 93
treoghalvfjerds - siedemdziesiąt trzy, 73
treoghalvtreds - pięćdziesiąt trzy, 53
treogtredive - trzydzieści trzy, 33
treogtres - sześćdziesiąt trzy, 63
treogtyve - dwadzieścia trzy, 23
tres - sześćdziesiąt, 60
tretten - trzynaście, 13
trettende - trzynasty, 13.
trias - trias
trillebør - taczka
trist - smutny
tro - wiara, wierzyć, myśleć, sądzić, uważać, wierny
troen kan flytte bjerge - wiara góry przenosi
trold - troll, małe dziecko, "słodki dzidziuś"
true - grozić, zagrażać
tryk - ciśnienie, nacisk, druk, akcent (zdaniowy lub wyrazowy)
trykke - wciskać, naciskać, drukować w dużych ilościach (publikować)
tsar - car
tung - ciężki
tunge - język
tungsten - wolfram
turde - odważyć się, ośmielić się
turist - turysta, turystka
Turkmenistan - Turkmenistan
tusind - tysiąc, 1000
tusindben - stonoga
tusinde - tysiąc, 1000, tysięczny, 1000.
tusse - tysiak, banknot tysiąckoronowy
tv - telewizor, telewizja, TV
tvilling - bliźniak, bliźnię, Bliźniak
tvinge - zmuszać
tvivl - wątpliwość, niepewność
tvivle - wątpić
typisk - typowy, typowo, zwykle
tyr - byk
tyrker - Turek
Tyrkiet - Turcja
tysk - niemiecki, niemiecki (język)
tysker - Niemiec
Tyskland - Niemcy
tyv - złodziej
tyve - dwadzieścia, 20
tyvende - dwudziesty
tyveri - kradzież
tyv tror hver mand stjæler - złodziej myśli, że każdy kradnie
u- - nie-
u. - bez), pod)
uafhængighed - niezależność, niepodległość
uanset - niezależnie od, abstrahując od
ubehagelig - nieprzyjemny
ud - z, na zewnątrz, do miasta, z wizytą
udelukkende - wyłącznie
uden - bez
udenlandsk - zagraniczny
uden mad og drikke duer helten ikke - bez jedzenia i picia nikt nie będzie bohaterem
udfordring - wyzwanie
udlænding - cudzoziemiec
udland - zagranica
udråbsord - wykrzyknik, wykrzyknienie
udråbstegn - wykrzyknik (znak !)
udsagnsord - czasownik
udseende - wygląd, wyglądający, o wyglądzie
udtale - wymowa, przemawiać, wygłaszać mowę, wyrażać, wymawiać
udveksling - wymiana, wymienianie
udvikling - rozwój
uf - ble, fuj
Uganda - Uganda
uge - tydzień
ugle - sowa
uhyre - potwór
Ukraine - Ukraina
ukrainsk - ukraiński
ulv - wilk
ulvetime - wilcza godzina, czas między ustaniem nocy a wzejściem słońca
ulykkelig - nieszczęśliwy
under - cud, pod, poniżej, podczas, w czasie
underskud - deficyt
undersøgelse - badanie, dochodzenie
undskyld - przepraszam!
ung - młody
Ungarn - Węgry
ungarsk - węgierski
ungdom - młodość
uniform - mundur, uniform
universitet - uniwersytet
uorganisk - nieorganiczny
ur - zegar
uran - uran
uren - nieczysty
urin - mocz
Uruguay - Urugwaj
Usbekistan - Uzbekistan
utro - niewierny
utrolig - niewiarygodny
V - zachód
våben - broń
vaccine - szczepionka
våd - mokry
væg - ściana
vælge - wybierać
være - być
være en torn i øjet på én - być solą w oku
værelse - pokój
være til - istnieć
værft - stocznia
væsel - łasica
væske - ciecz, płyn
valg - wybór, wybory
valgkamp - kampania wyborcza, walka wyborcza
valuta - waluta
vampyr - wampir, wampir (gatunek nietoperza żywiącego się krwią ssaków)
vanadin - wanad
vanadium - wanad
vand - woda
vandalisere - wandalizować
vandalisme - wandalizm
vanddamp - para wodna
vandmelon - arbuz
vare - towar, trwać
varm - ciepły
vase - wazon, flakon
vask - umywalka, pranie (to, co jest prane)
vaske - myć, prać
vaskekone - praczka
vaskemaskine - pralka
ved - przy, obok, przez, w taki sposób, z powodu
vedligeholdelse - konserwacja, bieżące utrzymanie
vedr. - dot. (= vedrørende)
veganer - weganin
veganisme - weganizm
vegetarianisme - wegetarianizm
vegetarisme - wegetarianizm
vej - droga
veje - ważyć (= określać ciężar), ważyć (= mieć ciężar)
vejr - pogoda, oddech
vejrmølle - wiatrak
veksle - wymieniać
ven - przyjaciel
veninde - przyjaciółka
venlig - przyjazny
venstre - lewy
vente - czekać, spodziewać się, oczekiwać
ventekjole - sukienka ciążowa
vente sig - być w ciąży
verden - świat
verdens ældste erhverv - najstarszy zawód świata
Veronica - Weronika (duńskie imię żeńskie)
Veronika - Weronika
vest - kamizelka, zachód, ku zachodowi, w kierunku zachodnim
Vesteuropa - Europa Zachodnia
vesteuropæisk - zachodnioeuropejski
vestlig - zachodni
veterinær - weterynarz, weterynaryjny
vi - my
vibration - drganie, wibracja
vide - wiedzieć
viden - wiedza
videnskab - nauka
vifte - wachlarz, wachlarz (skala, rozpiętość, różnorodność), wachlować, odpędzać ruchem dłoni lub ramienia
vigtig - ważny
ville - chcieć
vin - wino
Vincent - Wincenty
Vincents - Wincenty
Vincentz - Wincenty
vind - wiatr
vinde - wygrywać, wygrać (konkurs, konkurencję), wygrać (aukcję, losowanie), spieszyć się
vinder - zwycięzca
vindmølle - wiatrak
vindue - okno
vinge - skrzydło
vinkel - kąt
vinter - zima
virkelig - prawdziwy, naprawdę
virkelighed - rzeczywistość
vise - pokazywać, opowieść (ludowa), piosenka, ballada
vise sig - pokazać się, okazać się
viskelæder - gumka (do zmazywania śladów ołówka)
vismut - bizmut
visum - wiza
vits - żart, kawał, dowcip
vognbane - pas ruchu
vokal - samogłoska, wokalny
voks - wosk
vokse - rosnąć, rozrastać się (zwiększać rozmiar/zasięg), rosnąć (rozwijać się), woskować
voksen - dorosły
vor - nasz
vores - nasz
vrede - gniew
vulgær - wulgarny
vulkan - wulkan
vulkanisering - wulkanizacja
W - Watt
Wales - Walia
Warszawa - Warszawa (stolica Polski)
wigwam - wigwam
Wikipedia - Wikipedia
wolfram - wolfram
xenon - ksenon
xylofon - ksylofon
ynkelig - żałosny
ytterbium - iterb
yttrium - itr
zebra - zebra
zebrafinke - zeberka timorska, zeberka, amadyna zebrowata
zink - cynk
zirkon - cyrkon
zoo - zoo, ogród zoologiczny
