Aafje - imię żeńskie
aaien - głaskać, gładzić, pieścić
aal - węgorz
aalbes - porzeczka
aalmoes - jałmużna, datek
aalscholver - kormoran, kormoran zwyczajny, kormoran czarny
Aalten - miasto i gmina w Holandii
aam - aam
aan - do, przy, nad, u
aanbevelen - polecać, rekomendować
aanbeveling - rekomendacja
aanbidden - uwielbiać, czcić, ubóstwiać, adorować
aanbieden - proponować
aanbouw - budynek
aandacht - uwaga
aandeel - udział, akcja, udział w spółce
aandeelhouder - udziałowiec
aandienen - ogłosić
aandoening - choroba, emocja
aandringen - nalegać
aaneen - razem, bezustannie, ciągle, stale
aangenaam - przyjemny
aangeschoten - podchmielony, podpity
aangezien - z powodu, z uwagi na, biorąc coś pod uwagę, zważywszy na, aanzien
aankomen - dojeżdżać, docierać, przybywać
aankomst - przybycie
aankondigen - ogłosić
aanleveren - dostarczyć
aanmatiging - arogancja
aanmerking - komentarz, krytyka
aanpasbaar - regulowalny, nastawny
aanprijzen - zalecać
aanraken - dotykać
aanroeren - dotykać
aanschaffen - kupić, nabyć
aansprakelijk - odpowiedzialny
aantal - ilość, liczba
aantrekkelijk - atrakcyjny, piękny
aanvaardbaar - do przyjęcia, zadowalający
aanval - atak, napaść, napad, agresja
aanvankelijk - początkowy, początkowo
aanzien - oglądać, patrzeć na coś, znosić coś, tolerować, prestiż, reputacja, wizerunek
aap - małpa
aardappel - ziemniak
aardbei - truskawka
aardbeving - trzęsienie ziemi
aarde - ziemia
Aarde - Ziemia
aardig - miły, grzeczny, ładny, niezły, znaczący, zauważalny, dziwny, miło, bardzo
aardkunde - geologia
aardnoot - orzech ziemny
aardrijk - ziemia
aardrijkskunde - geografia
aardvarken - mrównik
aarzelen - wahać się
aarzeling - wahanie, niepewność
abattoir - rzeźnia
abc - alfabet
abces - ropień, wrzód
abdicatie - abdykacja
abdiceren - abdykować
abdij - opactwo
Abel - Abel
abrikoos - morela
absorberen - absorbować
academie - akademia
academisch - akademicki
accuraat - dokładny, punktualny
acht - osiem, 8
achtendertig - trzydzieści osiem, 38
achtennegentig - dziewięćdziesiąt osiem, 98
achtentachtig - osiemdziesiąt osiem, 88
achtentwintig - dwadzieścia osiem, 28
achtenveertig - czterdzieści osiem, 48
achtenvijftig - pięćdziesiąt osiem, 58
achtenzestig - sześćdziesiąt osiem, 68
achtenzeventig - siedemdziesiąt osiem, 78
achter - za
achterklap - plotka
achternaam - nazwisko
achteruit - do tyłu
achtste - ósmy
achttien - osiemnaście, 18
achttiende - osiemnasty
acne - trądzik
acryl - akryl
actinium - aktyn
activisme - aktywizm
activiteit - aktywność
actrice - aktorka
actueel - obecny
addictie - nałóg
adelaar - orzeł
adellijk - szlachetny
ademen - oddychać
ademhalen - oddychać
adequaat - adekwatny
adjectief - przymiotnik
adolescentie - dojrzewanie
adopteren - adoptować
adviseren - zalecać
advocaat - adwokat, adwokat (alkohol)
af - gotowy, skończony, z
afbreekteken - dywiz
afdrukken - drukować
afgelegen - zdalny
Afghaans - afgański
Afghanistan - Afganistan
afgod - idol
afgunst - zazdrość
afmeten - mierzyć
aforisme - aforyzm
Afrika - Afryka
Afrikaans - afrikaans, język afrykanerski, afrykanerski
afstammeling - potomek
afstand - odległość
afstraffen - karać
afwachting - oczekiwanie
afwasmiddel - płyn do mycia naczyń
afwerpen - przynosić, powodować korzyść
afzonderen - izolować
afzonderlijk - oddzielny
afzweren - wyrzekać się, stracić część ciała z powodu infekcji
agentschap - agencja
agglomeratie - aglomeracja
agressief - agresywny
Aisopos - Ezop
akker - pole
al - wszystko, już
Albanees - albański
Albanië - Albania
albatros - albatros
alchemie - alchemia
alchemist - alchemik
alert - czujny, uważny
alfabet - alfabet
alg - alga, glon
algebraïsch - algebraiczny
algeheel - kompletny
Algerije - Algieria
Algerijn - Algierczyk
alleen - samotny
alleen maar - tylko, jedynie
allengs - stopniowo
allergisch - alergiczny
aller tijden - wszech czasów
alligator - aligator
alom - wszędzie
alreeds - już
als - jeśli
als alle gekken konden vliegen hadden we een permanente zonsverduistering - gdyby wszyscy głupcy potrafili latać, mielibyśmy nieustanne zaćmienie słońca
alsjeblieft - proszę
altaar - ołtarz
alternatief - alternatywny, alternatywa
althans - przynajmniej
altijd - zawsze
altoos - zawsze
aluminium - glin
amandel - migdał (orzech), migdałek
ambiguïteit - niejednoznaczność
ambitie - ambicja
ambitieus - ambitny
americium - ameryk
Amerika - Ameryka
Amerikaans - amerykański
Amerikaans Samoa - Samoa Amerykańskie
Amhaars - język amharski
amnesie - amnezja
ampère - amper
ampèremeter - amperomierz
Amsterdam - Amsterdam
amulet - amulet, talizman
analfabetisme - analfabetyzm
ananas - ananas
anarchist - anarchista
anatomie - anatomia
ander - inny, drugi
anders - inaczej
anderszins - inaczej, w przeciwnym razie
Andes - Andy
Andorra - Andora
anekdote - anegdota
Angola - Angola
angst - strach, lęk
Anneke - Anne
anomalie - anomalia
antagonisme - antagonizm
Antarctica - Antarktyka
antilope - antylopa
antimonium - antymon
antizionisme - antysyjonizm
antropoloog - antropolog
antwoord - odpowiedź
antwoorden - odpowiadać, antwoord
apart - oddzielny
apathie - apatia
apotheek - apteka
apotheker - farmaceuta, aptekarz
appel - jabłko
appelboom - jabłoń
appelsien - pomarańcza (owoc)
april - kwiecień
aquatisch - wodny
Arabisch - arabski, język arabski, arabszczyzna, pismo arabskie
arbeider - pracownik
archaïsch - archaiczny
archipel - archipelag
architect - architekt
architectuur - architektura
arend - orzeł
Argentinië - Argentyna
argon - argon
aristocratisch - arystokratyczny
Aristoteles - Arystoteles
aritmetica - arytmetyka
arm - ramię, gałąź, łapa, biedny, ubogi, niebogaty
armband - bransoletka
Armenië - Armenia
armoe - bieda
armoede - bieda
arresteren - aresztować
arriveren - przybyć
arrogant - arogancki
arseen - arsen
arsenicum - arsen
artillerie - artyleria
artillerist - artylerzysta
artisjok - karczoch
arts - lekarz
as - oś, popiół, proch
asbak - popielniczka
aseksualiteit - aseksualność
asociaal - aspołeczny
asperge - szparag
astaat - astat
astatium - astat
astrologie - astrologia
astroloog - astrolog
astronaut - astronauta
atheïsme - ateizm
atheïst - ateista
Atlantische Oceaan - Ocean Atlantycki
atmosfeer - atmosfera
atmosferisch - atmosferyczny
atol - atol
atoom - atom
atoomnummer - liczba atomowa
attribuut - atrybut
augurk - ogórek
augustus - sierpień
aura - aura
Australië - Australia
auteur - autor
authentiek - autentyczny
auto - auto
automatisch - automatyczny
autonomie - autonomia
autonoom - niezależny
autopsie - autopsja
autopsies - autopsie
avegaar - świder
avocado - awokado
avond - wieczór
avondeten - kolacja
avondklok - godzina policyjna
avonturier - poszukiwacz przygód
axon - akson
Azerbeidzjan - Azerbejdżan
Azië - Azja
azijn - ocet
baan - droga, tor, stanowisko, pozycja, praca
baanbrekend - rewolucyjny
baard - broda
baby - niemowlę
bacove - banan
bacteriologie - bakteriologia
bad - kąpiel, łazienka
Baden-Württemberg - Badenia-Wirtembergia
badkamer - łazienka
badkuip - wanna
badpak - kostium kąpielowy
bahaïsme - bahaizm
Bahama's - Bahamy
bakken - piec
baksteen - cegła
bal - kula, bal
balkon - balkon
ballon - balon
Baltica - Bałtyka
bamboe - bambus
banaan - banan
bang - niespokojący, lękliwy, niespokojąco, lękliwie
Bangladesh - Bangladesz
bank - sofa, kanapa, bank
bankbiljet - banknot
bankroet - zbankrutowany, niewypłacalny, bankructwo
barbaar - barbarzyńca
Barbados - Barbados
barium - bar
baron - baron
barrière - bariera
basilicum - bazylia
Baskisch - język baskijski, baskijski
bazuin - trąbka
beantwoorden - odpowiadać na pytanie, sprostać oczekiwaniom
bebaard - brodaty
bed - łóżko
bedanken - dziękować
bedekken - pokryć
bedevaart - pielgrzymka
bediende - służący, sługa
bedreigen - grozić
bedriegen - oszukiwać
bedrijf - spółka, firma, korporacja, bedrijven
bedrijven - uprawiać, poświęcać się, popełniać, od bedrijf
bedrukken - drukować
beek - strumyk
beeldhouwer - rzeźbiarz
been - noga, kość
beer - niedźwiedź
beest - bestia, zwierzę
beetje - trochę
begaafdheid - talent
begin - początek
beginnen - rozpocząć, zacząć
beginsel - zasada, reguła
begrijpen - rozumieć, zrozumieć ( pojmować coś)
begroting - budżet
beha - biustonosz
behalve - oprócz, z wyjątkiem
behoeven - potrzebować
behulp - pomoc
beide - obaj, obie, oboje
bejaard - starszy
bekend - znany
bekennen - przyznać, uznać, przyjąć do wiadomości
beker - kubek
beknopt - zwięzły
bekoorlijk - atrakcyjny
bekorten - skrócić
bel - dzwon, dzwonek
belangrijk - znaczny, ważny, znacznie
belasting - podatek, obciążenie
beleefdheid - grzeczność
belegeren - oblegać
belemmering - przeszkoda
België - Belgia
Belize - Belize
bellen - dzwonić, zadzwonić
beloven - obiecać
bemerken - zauważyć
beminnen - kochać
bemoeienis - interwencja
ben - zijn
beneden - na dole, na dół, z dołu, pod, poniżej
Benin - Benin
bent - zijn
benzine - benzyna
bepaaldelijk - szczególnie
bereiding - przygotowanie
berg - góra
bergachtig - górzysty
berispen - ganić
berk - brzoza
berkelium - berkel
beroemd - sławny
beroep - zawód, odwołanie
beroeren - dotykać
berokkenen - powodować
berooid - nędzny
beryllium - beryl
beschaamd - zawstydzony
beschaving - cywilizacja
beschermen - chronić
beschermengel - Anioł Stróż
beschikbaar - dostępny
beschikbaarheid - dostępność
beschrijving - opis
beschuldiging - oskarżenie
beslissen - decydować
beslissend - zadecydowany
beslissing - decyzja
besluiten - zdecydować
besnijden - obrzezać
besnijdenis - obrzezanie
bespreking - dyskusja
best - najlepszy, dobrze, całkiem, dość
bestaan - być, istnieć
bestellen - zamawiać, dowozić (zamówienie)
besterven - być w początkowej fazie procesu rozkładu po śmierci, zniknąć jakby z powodu własnej śmierci, zblednąć ze strachu, być skonsternowanym
bestraffen - karać
betalen - płacić, zapłacić
betekenen - znaczyć, oznaczać
betuiging - deklaracja
beuk - buk
beveiligen - chronić
bever - bóbr
bevriend - przyjazny
bewegen - poruszać, wzruszać, namawiać, poruszać się, ruszać się
bewerkelijk - pracowity
bewijzen - udowodnić
bewolkt - pochmurny
bewusteloos - nieprzytomny
bewustheid - świadomość
bewustzijn - świadomość
bezem - miotła
bezitten - posiadać
bezoek - wizyta, gościna
bezoeken - odwiedzić
bezoeker - gość
bezwaarlijk - trudny
bezweren - czarować, oczarowywać, fascynować, urzekać, olśniewać, rzucać zaklęcie, opanowywać, poskramiać, przytłumiać, zażegnywać
Bhutan - Bhutan
bibliotheek - biblioteka
bieden - proponować
bier - piwo
bieslook - szczypiorek
biet - burak
bij - z
bijeen - razem
bijeenkomst - spotkanie
bijenhuif - ul
bijenkorf - ul
bijennest - ul
bijenwas - wosk pszczeli
bijgelovig - przesądny
bijgevolg - w rezultacie
bijklank - konotacja, skojarzenie
bijkomend - dodatkowy
bijl - topór
bijna - prawie, niemal
bijnaam - przydomek
bijten - gryźć
bijvoeglijk naamwoord - przymiotnik
bijvoorbeeld - na przykład
bijwoord - przysłówek
bijziendheid - krótkowzroczność
bijzonder - specjalny, nietypowy
binnen - w ciągu, w środku, do, do środka
binnengaan - wchodzić
biograaf - biograf
biografie - biografia
biografisch - biograficzny
biologie - biologia
biologisch - biologiczny
bioloog - biolog
bioscoop - kino
biosynthese - biosynteza
biseksualiteit - biseksualizm
bismut - bizmut
bisschop - biskup
bizar - dziwaczny
bizon - bizon
blaam - wina
blad - liść, czasopismo, gazeta
bladgroen - chlorofil
bladwijzer - zakładka
blasfemie - bluźnierstwo
blauw - niebieski, błękitny
blauwe gaai - modrosójka błękitna
blazen - dmuchać, dąć, chuchać
blein - pęcherz, bąbel
blessure - uszkodzenie, szkoda, uraz
blij - szczęśliwy
blindelings - ślepo
bloed - krew
bloem - kwiat (kwitnącej rośliny)
bloemkool - kalafior
bloemlezing - antologia
bloes - bluzka
Boedapest - Budapeszt
boeddhisme - buddyzm
boeddhistisch - buddyjski
boek - książka
Boekarest - Bukareszt
boeken - zaksięgować
boekenkast - regał na książki
boekhandel - księgarnia
boemerang - bumerang
boerderij - farma
bohrium - bohr
Bolivia - Boliwia
Boliviaans - boliwijski
Bolivië - Boliwia, Bolivia
bom - bomba
bondgenoot - sojusznik
bonenkruid - cząber
boom - drzewo
boomgaard - sad
boon - fasola
boor - bor
boosheid - gniew
boot - łódź
bord - talerz, tablica
borst - pierś, klatka piersiowa
bos - gaj, las, bukiet
Bosnië - Bośnia
Bosnië en Herzegovina - Bośnia i Hercegowina
bot - kość, flądra, tępy, stępiony
botanie - botanika
boter - masło
Botswana - Botswana
bouwen - budować
bouwer - budowniczy
bouwmeester - architekt
braadpan - patelnia
braaksel - wymiociny
Brabants - język brabancki
braken - wymiotować
branden - palić, płonąć
brandkast - sejf
brandstof - paliwo
Braziliaans - brazylijski
Brazilië - Brazylia
breed - szeroki
breken - łamać, złamać
brengen - przynosić
Bretagne - Bretania
brief - list
brilslang - kobra
Brits - brytyjski
Brits-Columbia - Kolumbia Brytyjska
broccoli - brokuł
broek - spodnie
broer - brat
brons - brąz
brood - chleb
broom - brom
bros - kruchy
brug - most
Brugge - Brugia
bruidegom - pan młody
bruidsschat - posag
bruikbaarheid - użyteczność
bruin - brązowy, heroina
Brussel - Bruksela
budget - budżet
buik - brzuch
buiten bewustzijn - nieprzytomny
buitenspel - spalony
buitenspelregel - zasada spalonego
buizerd - myszołów
buldog - buldog
Bulgarije - Bułgaria
bulgur - bulgur
bult - stłuczka
burgerlijk - cywilny
burgerschap - obywatelstwo
Burkina Faso - Burkina Faso
Burundi - Burundi
buskruit - proch strzelniczy
bustehouder - biustonosz
buur - sąsiad
cacao - kakao
cadeau - prezent
cadmium - kadm
calcium - wapń
Californië - Kalifornia
californium - kaliforn
Cambodja - Kambodża
campagne - kampania
Canada - Kanada
cantharel - kurka (grzyb)
capecitabine - kapecytabina
capibara - kapibara
carona - cygaro
catalogus - katalog
catastrofe - katastrofa
censuur - cenzura
Centraal-Afrikaanse Republiek - Republika Środkowoafrykańska
centrifuge - wirówka
cerium - cer
cesium - cez
chador - czador
chaos - chaos
chaotisch - chaotyczny
checken - sprawdzać
cheeta - gepard
chemie - chemia
Chileens - chilijski
Chili - Chile
chimpansee - szympans
China - Chiny
Chinees - chiński
chirurg - chirurg
chitosan - chitozan
chloor - chlor
chocola - czekolada
chocolade - czekolada
christendom - chrześcijaństwo
chronologisch - chronologiczny
chroom - chrom
cijfer - cyfra
cipres - cyprys
cirkel - okrąg, koło
citroen - cytryna
citruspers - wyciskarka do cytrusów
cobra - kobra
cocktail - koktail
code - kod
collectief - zbiorowy
Colombia - Kolumbia
colonoscopie - kolonoskopia
comité - komitet
commentaar - komentarz
commercial - reklama
commissaris - komisarz
communicatie - komunikacja
compliment - komplement
complot - konspiracja
componeren - komponować
compromis - kompromis
computer - komputer
conclusie - wniosek
concurreren - rywalizować
condoom - prezerwatywa
confirmeren - potwierdzać
confisqueren - konfiskować
connotatie - konotacja, skojarzenie
consensus - konsensus, zgoda
constipatie - zaparcie, zatwardzenie, obstrukcja
contact - kontakt
contactlens - soczewka kontaktowa
continent - kontynent
contrabandier - przemytnik
contract - umowa
controleren - sprawdzać, kontrolować
controversieel - kontrowersyjny
conversatie - rozmowa
coördinaat - współrzędna
correct - poprawny, prawidłowy
correctheid - poprawność
correlatie - korelacja
Costa Rica - Kostaryka
coyote - kojot
creatief - kreatywny
creativiteit - kreatywność
criticus - krytyk
crucifix - krucyfiks
cultuur - kultura
curium - kiur
cyber- - cyber-, cyber- (internetowy)
cynisch - cyniczny
Cyprus - Cypr
daar - tam
daarover - o tamtym, o tamtej (w miejsce "over dat" i "over die")
dag - dzień
dag-en-nachtevening - równonoc
dageraad - świt
dak - dach
dakloos - bezdomny
dan - niż, od, stopień sprawności w japońskich sportach walki
danken - dziękować
dansen - tańczyć
dapper - odważny
darmstadtium - darmsztadt
das - borsuk
dat - tamto, to, oto, które, że
database - baza danych
datzelfde - dokładnie to samo (mocniejsza forma hetzelfde, używane do rzeczowników rodzaju nijakiego i do rzeczy abstrakcyjnych, takie jak myśli, czyjeś zdanie, poglądy.)
debuut - debiut
december - grudzień
deeg - ciasto
deel - część, tom
deelbaar - podzielny
deelstaat - stan
deelwoord - imiesłów
deemster - zmierzch
defensief - obronny
deïsme - deizm
deksel - pokrywka, wieko, przykrywka
delfstof - minerał
delfstofkunde - mineralogia
delier - delirium
demagogie - demagogia
demagoog - demagog
demiurg - demiurg
democratie - demokracja
democratisch - demokratyczny
demografie - demografia
demon - demon
Denemarken - Dania
denkbeeldig - urojony
denken - myśleć
denker - myśliciel
deplorabel - żałosny
derhalve - dlatego
dermatologie - dermatologia
dertien - trzynaście, 13
dertiende - trzynasty
dertig - trzydzieści, 30
designer - projektant
dessert - deser
detail - szczegół
detector - detektor
deur - drzwi
dewijl - ponieważ
deze - ten
dezelfde - ten sam (używany do rzeczowników rodzaju męsko-żeńskiego)
diabetes - cukrzyca
diaken - diakon
dialect - dialekt, slang
diarree - biegunka
dichtbij - bliski, niedaleki
dichtdoen - zamykać
dichter - poeta
dichtheid - gęstość
dictatuur - dyktatura
die - który, która, tamten, tamta
diefstal - kradzież
dienstig - przydatny
diepvrieskast - zamrażarka
diepvriezer - zamrażarka
dier - zwierzę
dierentuin - zoo
dierkunde - zoologia
digitaal - cyfrowy
dille - koper, koperek
dinosauriër - dinozaur
dinosaurus - dinozaur
dinsdag - wtorek
diphallia - difalia
diploma - dyplom
diplomatie - dyplomacja
diplomatiek - dyplomatyczny
direct - bezpośredni, natychmiast
distel - oset
dit - to
ditzelfde - dokładnie to samo (mocniejsza forma hetzelfde, używane do rzeczowników rodzaju nijakiego i do rzeczy abstrakcyjnych, takie jak myśli, czyjeś zdanie, poglądy)
diva - diwa, gwiazda opery
dochter - córka
doctoraat - doktorat
doctorsgraad - doktorat
doctrine - doktryna
document - dokument
doden - zabijać
doeg - na razie
doejong - diugoń, piersiopławka
doelman - bramkarz
doen - robić
dogma - dogmat
doktersrecept - recepta
dolfijn - delfin
dollar - dolar
domheid - głupota
dominatie - dominacja
Dominicaanse Republiek - Dominikana
domoor - idiota
donder - grom, piorun, grzmot
donderdag - czwartek
Donetsk - Donieck
donker - ciemny
dood - martwy
doodgaan - umrzeć
doodskist - trumna
doofheid - głuchota
dooier - żółtko
doorn - cierń
doorzichtig - przeźroczysty
doorzichtigheid - przezroczystość
doos - pudełko, pudło
dorp - miejscowość, wieś
dorstig - spragniony
download - ściąganie, pobieranie, plik do pobrania, forma pierwszej osoby liczby pojedynczej czasu teraźniejszego czasownika
downloaden - ściągać, pobierać
draadloos - bezprzewodowy
draaierigheid - zawroty głowy
draaiing - obrót
dragen - nosić, przenosić, mieć na sobie jakieś ubranie
drank - napój, trunek
drastisch - drastyczny
dreigen - grozić
dreiging - groźba
drie - trzy, 3
driedimensionaal - trójwymiarowy
drieëndertig - trzydzieści trzy, 33
drieënnegentig - dziewięćdziesiąt trzy, 93
drieëntachtig - osiemdziesiąt trzy, 83
drieëntwintig - dwadzieścia trzy, 23
drieënveertig - czterdzieści trzy, 43
drieënvijftig - pięćdziesiąt trzy, 53
drieënzestig - sześćdziesiąt trzy, 63
drieënzeventig - siedemdziesiąt trzy, 73
driehoek - trójkąt
driehoekig - trójkątny
driewieler - pojazd na trzech kołach, trójkołowiec
drijfveer - motyw
drink - drinken
drinken - pić
drogen - suszyć
dromedaris - dromader
dronkaard - pijak
dronkenschap - pijaństwo
droog - suchy
droogte - susza
droom - marzenie, sen
druif - winogrono
druk - forma pierwszej osoby liczby pojedynczej czasu teraźniejszego czasownika drukken, ciśnienie, zajęty
druppel - kropla
dubbel - podwójny
dubbelzinnigheid - niejednoznaczność
dubnium - dubn
duel - pojedynek
duidelijk - dokładny, jasny, wyraźny, jasno, wyraźnie
duikboot - łódź podwodna, okręt podwodny
duiken - pływać, nurkować (poruszać się głęboko pod wodą), nurkować (skakać do wody), zanurkować, szybko poruszać się w dół, rzucać się, duik
duikkopbal - strzał szczupakiem
duim - kciuk
duin - wydma (pojedynczy obiekt), wydma (skupisko wydm)
duisternis - ciemność
Duits - niemiecki
Duitser - Niemiec
Duitsland - Niemcy
duivel - diabeł
duizeligheid - zawroty głowy
duizend - tysiąc
dun - chudy, wiotki, cienki, wąski
dusdanig - taki
duur - drogi, kosztowny
duwen - pchnąć, pchać
dynamiet - dynamit
dynamisch - dynamiczny
dynastie - dynastia
dysenterie - dyzenteria, czerwonka
dysprosium - dysproz
echtgenoot - mąż
echtgenote - żona
echtscheiding - rozwód
Ecuador - Ekwador
edel - szlachetny
eekhoorn - wiewiórka
één - 1, liczba jeden
eend - kaczka
eenendertig - trzydzieści jeden, 31
eenennegentig - dziewięćdziesiąt jeden, 91
eenentachtig - osiemdziesiąt jeden, 81
eenentwintig - dwadzieścia jeden, 21
eenenveertig - czterdzieści jeden, 41
eenenvijftig - pięćdziesiąt jeden, 51
eenenzestig - sześćdziesiąt jeden, 61
eenenzeventig - siedemdziesiąt jeden, 71
een gegeven paard moet men niet in de bek kijken - darowanemu koniowi w zęby się nie zagląda
eenhoorn - jednorożec
eenvormig - jednolity
eerste - pierwszy
eerzuchtig - ambitny
eetbaar - jadalny
eeuw - wiek, stulecie, wieczność, bardzo długi czas
eeuwigheid - wieczność
efficiënt - efektywny
egel - jeż
egoïsme - egoizm
Egypte - Egipt
ei - jajko
eigenaar - właściciel
eigentijds - współczesny
eik - dąb
eiland - wyspa
eind - koniec
einde - koniec
eind goed al goed - wszystko dobre, co się dobrze kończy
einsteinium - einstein
ekster - sroka
elastisch - elastyczny
elders - gdzie indziej
elegant - elegancki
elektriciteit - elektryczność
elektrische spanning - napięcie elektryczne
elektromagnetisch - elektromagnetyczny
elektronisch - elektroniczny
element - pierwiastek chemiczny
elf - jedenaście, elf
elfde - jedenasty
elfmeterschot - rzut karny, dosłownie
elleboog - łokieć
els - olcha
El Salvador - Salwador
emancipatie - emancypacja
embryo - embrion
emmer - wiadro
Emmy - Emilia
emoe - emu
emotie - emocja
en - i
encyclopedie - encyklopedia
energie - energia
engelachtig - anielski
Engeland - Anglia
Engels - angielski
Engelsman - Anglik
enkelvoud - liczba pojedyncza
Enschede - Enschede
enthousiast - entuzjastyczny
entomologie - entomologia
entropie - entropia
epidemie - epidemia
epistemologie - epistemologia
Equatoriaal-Guinea - Gwinea Równikowa
equivalent - równoważny
erbarmelijk - żałosny
erbium - erb
erepenning - medal
erfelijk - dziedziczny
ergens - gdzieś
Eritrea - Erytrea
erkennen - rozpoznawać
ernst - powaga
ernstig - poważny
erotisch - erotyczny
erover - o tym (w miejsce "over het")
erven - dziedziczyć
erwt - groch, groch zielony
erythrosine - erytrozyna
es - jesion
esdoorn - klon
Esperanto - esperanto
esthetica - estetyka
Estland - Estonia
etage - piętro
eten - jedzenie, posiłek, jeść
Ethiopië - Etiopia
ethisch - etyczny
etmaal - doba
etnologie - etnologia
etruscologie - etruskologia
etymologie - etymologia
eufemisme - eufemizm
Europa - Europa
Europese Unie - Unia Europejska
europium - europ
euthanasie - eutanazja
euvel - zły, zło
evenaar - równik
eveneens - także
evenredig - proporcjonalny
eventueel - możliwy, sporadyczny, prawdopodobnie, sporadycznie
evenwel - ale, jednakże
evenwoordig - bliskoznaczny
evolutie - ewolucja
excentriek - ekscentryczny
excentrisch - ekscentryczny
exemplaar - kopia
exotisch - egzotyczny
experiment - eksperyment
expert - ekspert
exploitatie - eksploatacja, wykorzystywanie
explosie - wybuch, eksplozja
explosief - wybuchowy, materiał wybuchowy
exporteren - eksportować
exporteur - eksporter
ezel - osioł
faam - reputacja
fabriek - fabryka
fabrikant - producent
Faeröer - Wyspy Owcze
failliet - zbankrutowany, niewypłacalny, bankructwo
fakkel - pochodnia
familie - rodzina
fanaticus - fanatyk
fantasie - wyobraźnia
fantastisch - fantastyczny
farmaceutisch - farmaceutyczny
farmacie - farmacja, nauki farmaceutyczne
farmacologie - farmakologia
fascistisch - faszystowski
fatsoenlijk - przyzwoity
fatwa - fatwa
fauteuil - fotel
fazant - bażant
februari - luty
feit - fakt
felicitatie - gratulacje
feliciteren - gratulować
feminisme - feminizm
fermium - ferm
fier - dumny
fiets - rower, fietsen
Fiji - Fidżi
file - korek (uliczny), plik
Filipijnen - Filipiny
filoloog - filolog
filosofie - filozofia
filosofisch - filozoficzny
filosoof - filozof
financieel - finansowy
Finland - Finlandia
flat - mieszkanie
flauwvallen - zemdleć
fles - butelka
fleurig - radosny
flexibiliteit - elastyczność
flirten - flirtować
fluisteren - szeptać
fluor - fluor
fniezen - kichnąć
foetus - płód
fok - jeden z żagli pierwszego masztu, rozmnażanie, okulary
fort - zamek
fortuinlijk - szczęśliwy, mający szczęście
fosfor - fosfor
foto - zdjęcie, fotografia
fotograaf - fotograf
fotografie - fotografia
fout - błąd, pomyłka, błędny, zły
fragiel - delikatny
francium - frans
Frankrijk - Francja
Frans - francuski
Frans-Guyana - Gujana Francuska
fraude - oszustwo
fresco - fresk
Fries - język fryzyjski, fryzyjski
Friesland - Fryzja
fruit - owoc
fruitarisme - frutarianizm
frustratie - frustracja
functie - funkcja
fundamenteel - podstawowy, zasadniczy
funderen - ustanowić, ufundować
fysica - fizyka
fysiologie - fizjologia
ga - gaan
gaai - sójka
gaan - pójść, wyjeżdżać, prowadzić, działać, zadziałać, zaczynać, mieć zamiar
gaandeweg - stopniowo
Gabon - Gabon
gading - satysfakcja
gadolinium - gadolin
galant - grzeczny, uprzejmy, szarmancki
Galilea - Galilea (kraina)
gallicisme - galicyzm
gallium - gal
gang - korytarz
gans - gęś
garanderen - gwarantować
Gargantua - Gargantua
garnaal - krewetka
gasthuis - szpital
gastvrijheid - gościnność
gazelle - gazela
gazet - gazeta
gebed - modlitwa
gebeente - szkielet
gebeuren - stać się, wydarzyć się
gebladerte - listowie
gebouw - budynek
gebrek - brak, niedostatek, niedobór
gebruikelijk - zwyczajny
gebruiken - używać, użyć
gebruiker - użytkownik
gebruikster - użytkownik
gedetailleerd - szczegółowy
geduld - cierpliwość
geduldig - cierpliwy
geel - żółty
geelachtig - żółtawy
geelzucht - żółtaczka
geer - włócznia
geestdriftig - entuzjastyczny
geest van salmiak - amoniak
geheel - cały, całkowicie, kompletnie
geheim - sekretny, w sekrecie, tajemnica
geheimzinnig - tajemniczy
gehoorzaamheid - posłuszeństwo
gehucht - wioska, sioło
geiser - gejzer
geit - koza
geld - pieniądze
geleidelijk - stopniowy
gelig - żółtawy
gelijkwaardig - równoważny
geloven - wierzyć
gelovig - religijny
geluid - dźwięk
geluk - szczęście
gelukkig - szczęśliwy
gember - imbir
gemeente - gmina
gemiddeld - przeciętny
gen - gen
generaal - generalny, generał
genetica - genetyka
genoegen - satysfakcja, zadowolenie, przyjemność
genot - przyjemność
geografie - geografia
geologie - geologia
Georgië - Gruzja
georiënteerdheid - orientacja
geraamte - szkielet
gerecht - potrawa, sąd
gerechtigheid - sprawiedliwość
gereed - gotowy, przygotowany
germanium - german
gerst - jęczmień
gerucht - pogłoska
geschenk - prezent
geschiedenis - historia
geschiedkunde - historia
geschrift - pismo
geslachtsgemeenschap - stosunek seksualny
gesprek - rozmowa
getal - ilość, liczba
getrouw - wierny
geur - zapach
gevaarlijk - niebezpieczny
gevang - więzienie
gevangene - więzień
gevangenis - więzienie
gevangenschap - uwięzienie, niewola
geven - dawać
gevleugeld - skrzydlaty
gevoelig - wrażliwy
gewestelijk - regionalny
geweten - sumienie
gewetensvol - sumienny
gewis - pewny, na pewno
gewoon - zwykły
gezegde - powiedzenie, przysłowie
gezicht - twarz
gezondheid - zdrowie
gids - przewodnik
gigantisch - gigantyczny
gijzelaar - zakładnik
giraf - żyrafa
gisteren - wczoraj
gisting - fermentacja
gitaar - gitara
glas - szkło, szklanka
gletsjer - lodowiec
glimworm - świetlik
gloeilamp - żarówka
gnoom - gnom
gnosticisme - gnostycyzm
god - bóg
God - Bóg
godin - bogini
godsdienst - religia
godsdienstig - religijny
godse - bardzo
godslastering - bluźnierstwo
Godzilla - Godzilla
goed - dobry
goedemorgen - dzień dobry
goedheid - dobroć
goedkeuring - akceptacja
goedkoop - tani
goeiemorgen - dzień dobry
golflengte - długość fali
goochelaar - magik
gooien - rzucać
goor - brudny
gordeldier - pancernik
gorilla - goryl
gort - kasza
gotisch - gocki
goud - złoto, złoty medal, złoty kolor
goudvink - gil
grammatica - gramatyka
grammaticaal - gramatyczny
grammaticus - gramatyk
grap - żart
grappig - śmieszny
gras - trawa
gravitatie - grawitacja
gravitationeel - grawitacyjny
gretig - chętny, gorliwy, zapalony
Griekenland - Grecja
Grieks - język grecki, grecki
Griekse - grecki
groen - zielony
groenachtig - zielonkawy
groente - warzywo
groep - grupa
grondgebied - obszar, terytorium
Gronings - dialekt groningski, Gronings
groot - duży
Groot Brittannië - Wielka Brytania
grootheid - wielkość, ilość
grootmoeder - babcia
grootte - rozmiar
grootvader - dziadek
grot - jaskinia
Grote Oceaan - Ocean Spokojny
grotesk - groteskowy
gruwelijkheid - okrucieństwo
Guatemala - Gwatemala
gulzigheid - obżarstwo
Guyana - Gujana
gymnastiek - gimnastyka
haai - rekin
haan - kogut
haar - jej
haast - niebawem, nieomal, niemal
haat - nienawiść
hachelijk - niepewny, wątpliwy
had - hebben
hafnium - hafn
hagedis - jaszczurka
hallucinatie - halucynacja
halsketting - naszyjnik
halssnoer - naszyjnik
halsstarrig - uparty
hamer - młot, młotek
hand - ręka, dłoń
handdoek - ręcznik
handschoen - rękawiczka
hangmat - hamak
hangslot - kłódka
hardheid - twardość
hardnekkig - uparty
harer - jej
harmonie - harmonia
harp - harfa
hars - żywica
hart - serce
hassium - has
haten - nienawidzić
hatsjie - apsik!, a psik!
haven - port
havermout - płatki owsiane
havik - jastrząb
hazelnoot - orzech laskowy
hé - hej
hebben - mieć, posiadać
hectare - hektar
heelal - wszechświat
heester - krzew
hegemonie - hegemonia
heilbot - halibut
heks - wiedźma
helaas - niestety
held - bohater
helemaal - kompletnie
helft - połowa
helikopter - helikopter
helium - hel
helpen - pomagać
hemolyse - hemoliza
hendel - dźwignia
hennep - konopie
her - tutaj
heraldiek - heraldyka
herbergzaam - gościnny
herder - pasterz
herfst - jesień
herfstmaand - wrzesień
herhaaldelijk - wielokrotnie
herhalen - powtarzać
herkennen - rozpoznawać
heroïne - heroina
hersenen - mózg
hert - jeleń
hervorming - reforma
het - to
heterogeen - niejednorodny
heteroseksualiteit - heteroseksualizm
hetzelfde - ten sam (używany do rzeczowników rodzaju nijakiego)
heuvel - pagórek
hier - tutaj
hierover - o tym, o tej (w miejsce "over dit" i "over deze")
hij - on
hik - czkawka
hinderlaag - zasadzka
hirsutisme - hirsutyzm
historisch - historyczny
hoe - jak?, jak
hoed - czapka
hoek - kąt, róg
hoekschop - rzut rożny
hoffelijk - miły, uprzejmy
Hollands - holenderski
holmium - holm
hommer - homar
homogeen - jednolity
homoniem - homonim
homoseksualiteit - homoseksualizm
hond - pies
honderd - sto, 100
Honduras - Honduras
Hongarije - Węgry
honger - głód
hongerig - głodny
Hongkong - Hongkong
honing - miód
hoofd - głowa
hoofdpijn - ból głowy
hoofdstad - stolica
hoog - wysoki
hoogleraar - profesor
hooi - siano
hoorn - róg
hopen - mieć nadzieję, spodziewać się
horen - słyszeć
Horus - Horus
horzel - szerszeń
hospitaal - szpital
hotel - hotel
houden - trzymać
huichelaar - hipokryta
huid - skóra
huidig - obecny
huilen - płakać, wyć, skowyczeć
huis - dom
huishouden - zostawiać po sobie duże zniszczenia, gospodarstwo domowe, sprzątanie domu
huistaak - praca domowa
huiswerk - praca domowa
huiveringwekkend - straszny
hulp - pomoc
hulpeloos - bezradny
Hun - Hun
huwelijk - małżeństwo
hyena - hiena
hygiëne - higiena
hypnose - hipnoza
hypotheek - hipoteka
identificatie - identyfikacja
ie - on
iedereen - każdy
iemand een kool stoven - nawarzyć komuś piwa
iep - wiąz
Ierland - Irlandia (państwo), Irlandia (wyspa)
ijdelheid - próżność
ijs - lód
ijskast - lodówka
IJsland - Islandia
ijsvogel - zimorodek
ijzer - żelazo
ik - ja
illusie - iluzja
illustratie - ilustracja
immenhuif - ul
immenkorf - ul
immigrant - imigrant
immigratie - imigracja
immuniteit - odporność
importeren - importować
in - w, do, do środka, Forma pierwszej osoby liczby pojedynczej czasu teraźniejszego czasownika innen, Tryb rozkazujący liczby pojedynczej czasownika innen, Forma pytająca drugiej osoby liczby pojedynczej czasu teraźniejszego czasownika innen
inbreker - włamywacz
indiscreet - niedyskretny
indium - ind
Indonesië - Indonezja
Indonesisch - indonezyjski, język indonezyjski
ineen - razem
ineffectief - nieskuteczny
infectie - zakażenie, infekcja
infinitief - bezokolicznik
informatie - informacja
infrarood - podczerwony
infrastructuur - infrastruktura
ingenieur - inżynier
ingetogen - skromny
ingrediënt - składnik
inhoud - treść, zawartość, fabuła
initieel - początkowy
inlassen - włożyć
innovatie - innowacja
inschrijving - rejestracja
insect - owad
in slaap - śpiący
inspuiten - wstrzyknąć
inspuiting - zastrzyk
instabiliteit - niestabilność
instemmen - zgadzać się
instituut - instytut
instrument - instrument
integratie - integracja
intensiteit - intensywność
interieur - wnętrze
internet - internet
interrumperen - przerwać
intuïtie - intuicja
investeerder - inwestor
investering - inwestycja
invloed - wpływ
invloedrijk - wpływowy
inwendig - wewnętrzny
inwijking - imigracja
Irak - Irak
Iran - Iran
iridium - iryd
ironie - ironia
is - zijn
islam - islam
islamitisch - islamski
Israël - Izrael
Istanboel - Stambuł
Italiaan - Włoch
Italiaans - włoski
Italië - Włochy
ja - tak
jaar - rok
jaartelling - era
jachtluipaard - gepard
jager - myśliwy
jaguar - jaguar
jakhals - szakal
Jamaica - Jamajka
januari - styczeń
Japan - Japonia
jazz - jazz, dżez
Jemen - Jemen
Jeruzalem - Jerozolima
jeugdig - młody
Jezus - Jezus
jij - ty
jodium - jod
Joegoslavië - Jugosławia
Joegoslavisch - jugosłowiański
jong - młody, nowy
jongen - chłopiec
juistheid - poprawność
juli - lipiec
jullie - wy
juni - czerwiec
Jupiter - Jowisz, Jupiter
justitie - sprawiedliwość
Kaapstad - Kapsztad
Kaapverdië - Republika Zielonego Przylądka
kaars - świeca
kaart - kartka, karta, mapa
kaas - ser
kabeljauw - dorsz
kabouter - gnom
Kafarnaüm - Kafarnaum
kajak - kajak
kakkerlak - karaluch
kalender - kalendarz
kaligrafie - kaligrafia
kalium - potas
kameel - wielbłąd
kameraad - towarzysz
Kameroen - Kamerun
kanarie - kanarek
kandidaat - kandydat
kaneel - cynamon
kangoeroe - kangur
kanneel - cynamon
kansel - ambona
kantoor - biuro
kapel - kaplica
kapitalisme - kapitalizm
kapitein - kapitan
kapmes - maczeta
kapper - fryzjer
kar - wóz
karper - karp
kasteel - zamek
kat - kot (zwierzę domowe), czuwaliczka jadalna
katapult - katapulta
kathedraal - katedra
katoen - bawełna
kauw - kawka
Kazachstan - Kazachstan
keeper - bramkarz
keizer - cesarz
keizerrijk - imperium
kemphaan - batalion
Kenia - Kenia
kennen - znać
kennistheorie - epistemologia
Kenya - Kenia
kerk - kościół
kerker - loch
kerkgebruik - rytuał
kers - czereśnia
kerst - Boże Narodzenie
kerstcadeau - prezent bożonarodzeniowy
kerstgeschenk - prezent bożonarodzeniowy
Kerstmis - Boże Narodzenie
ketchup - keczup
keuken - kuchnia
kever - żuk
kidnappen - porwać
kiespijn - ból zęba
kietelen - łaskotać
kiezen - wybierać
kiezer - wyborca
kijken - patrzeć na
kikker - żaba
kilogram - kilogram
kim - horyzont
kind - dziecko
kindertijd - dzieciństwo
Kirgizië - Kirgistan
Kirgizisch - kirgiski, język kirgiski
Kirgizstan - Kirgistan
kittelaar - łechtaczka
klaaglied - elegia
klagen - narzekać
klankbekken - talerz, czynel
klant - klient
klauteren - wspinać się
klauw - pazur
kleding - odzież
kledingstuk - ciuch, element garderoby
kleermaker - krawiec
klein - mały
kleinkind - wnuk / wnuczka
kleren - odzież
kletsen - plotkować
kleur - kolor
kleuterschool - przedszkole
kleverig - lepki
klif - klif
klimaat - klimat
klimatologie - klimatologia
klimmen - wspinać się
klinken - brzmieć
KLM - Królewskie Towarzystwo Lotnicze
klok - zegar, dzwon
kluis - sejf
kluizenaar - pustelnik
knaagdier - gryzoń
knie - kolano
knoflook - czosnek
knolraap - rzepa
koala - koala
kobalt - kobalt
koe - krowa
koekje - ciasteczko
koelkast - lodówka
Koerdisch - kurdyjski
Koeweit - Kuwejt
koffer - walizka
koffie - kawa
koffiehuis - kawiarnia
koken - gotować
kokosnoot - orzech kokosowy
kolibrie - koliber
komen - iść
komijn - kminek
komkommer - ogórek
komma - przecinek
kompas - kompas, busola
kompel - górnik
komst - przybycie
konijn - królik
koning - król
koningin - królowa
konings - królewski, wspaniały
koninklijk - królewski
koninkrijk - królestwo
konvooi - konwój
kool - węgiel, kapusta
koolstof - węgiel
koolstofdioxide - dwutlenek węgla
koorts - gorączka
kop - filiżanka, kubek
kopen - kupować
koper - miedź
kopie - kopia
kopiëren - kopiować
koppig - uparty
Koreaans - koreański
koren - kukurydza
koriander - kolendra
kort - krótki
kortweg - zwięźle
kosmisch - kosmiczny
kraai - wrona
kraam - stoisko
kracht - siła, moc
krankzinnig - obłąkany
krant - gazeta
krapte - niedobór
kreeft - homar
krent - rodzynek
krijger - wojownik
Kroatië - Chorwacja
Kroatisch - chorwacki, język chorwacki
krokodil - krokodyl
kruidnagel - goździk
kruisbeeld - krucyfiks
kruisboog - kusza
kruisdood - ukrzyżowanie
kruisigen - ukrzyżować
kruisiging - ukrzyżowanie
krypton - krypton
kumpir - kumpir
kunnen - być w stanie, móc
kunst - sztuka
kunstenaar - artysta
kunstig - artystyczny
kunstmatig - sztuczny
kunstzinnig - artystyczny
kussen - całować
kwal - meduza
kwaliteit - jakość
kwik - rtęć
kwikzilver - rtęć
kynologie - kynologia
laadschop - buldożer
laag - niski, warstwa
laars - but
lachen - śmiać się
laf - tchórzliwy
laken - prześcieradło
lamp - lampa
land - kraj
landbouw - rolnictwo
landbouwer - rolnik
landengte - przesmyk
landvoogd - gubernator
lang - długi
langzaam - wolny, powolny
lantaarn - latarnia
lanthaan - lantan
lanthanium - lantan
Laos - Laos
lariks - modrzew
lastig - trudny, uciążliwy
Latijns - łaciński
lawaaierig - hałaśliwy
lawine - lawina
lawrencium - lorens
leeg - pusty
leegte - pustka
leerstelling - dogmat
leeuw - lew
leeuwin - lwica
legendarisch - legendarny
lekker - smaczny, dający dobry uczucie
lelijk - brzydki
lemming - leming
lengte - długość
lening - pożyczka
lente - wiosna
lepel - łyżka
lepra - trąd
leraar - nauczyciel
leren - uczyć
lesbienne - lesbijka
Lesotho - Lesotho
Letland - Łotwa
lettergreep - sylaba
letterkunde - literatura
letterlijk - dosłowny, dosłownie
leugen - kłamstwo
leugenaar - kłamca
leunstoel - fotel
leven - żyć
lever - wątroba
leveren - dostarczyć
lexicon - leksykon
lezen - czytać
Libanon - Liban
liberalisme - liberalizm
Liberia - Liberia
libido - libido, popęd seksualny
Libië - Libia
lichaam - ciało
licht - lekki, jasny
lichtekooi - prostytutka
lichtzinnig - frywolny
Liechtenstein - Liechtenstein
lied - piosenka, pieśń
liefde - miłość
liefhebberij - hobby
lieger - kłamca
lieveheersbeestje - biedronka
lift - winda, podnośnik, dźwig
liggen - kłamać
lijnzaadolie - olej lniany
lijsterbes - jarząb
likken - lizać
Limburgs - język limburski, limburski
links - na lewo
lint - wstążka
linze - soczewica
lip - warga
liter - litr
literair - literacki
literatuur - literatura
lithium - lit
Litouwen - Litwa
litteken - blizna
liturgisch - liturgiczny
logica - logika
logisch - logiczny
logopedie - logopedia
lokaal - lokalny, klasa
Londen - Londyn
lood - ołów
loodgieter - hydraulik
loon - wynagrodzenie, pensja, zapłata
lopen - biec, biegnąć
lork - modrzew
losgeld - okup
loterij - loteria
loven - chwalić
lover - listowie
loyaal - lojalny
lucht - powietrze
luchthaven - lotnisko
luchtvaart - lotnictwo
luchtvaartmaatschappij - linie lotnicze (przedsiębiorstwo)
luiden - brzmieć
luiheid - lenistwo
Luik - Liège (miasto), Liège (prowincja)
luipaard - lampart
luisteren - słuchać
luitenant - porucznik
lul - fiut
lutetium - lutet
lynx - ryś
ma - matka
maag - żołądek
maalsteen - kamień młyński
maaltijd - posiłek
maan - księżyc, manen
maand - miesiąc
maandag - poniedziałek
maanlicht - światło księżyca
maar - jedynie, raptem, tylko, jednak
maart - marzec
Macedonië - Macedonia
Macedonisch - macedoński
machinaal - mechaniczny
machine - maszyna
machtsovernemer - uzurpator
Madeira - Madera
magneet - magnes
magnesium - magnez
magnetisch - magnetyczny
magnetisme - magnetyzm
mais - kukurydza
maïs - kukurydza
maken - robić
makken - jeść
makreel - makrela
malaria - malaria, zimnica
Maleisië - Malezja
malloot - głupi
Malta - Malta
mam - matka
mammoet - mamut
man - mężczyzna, mąż
Man - Wyspa Man
manco - niedobór
mand - kosz
mangaan - mangan
mango - mango
manier - sposób
manipulatie - manipulacja, manipulowanie
mank - kulawy
mankement - defekt, wada
manometer - manometr
markt - rynek
Marokko - Maroko
Marshalleilanden - Wyspy Marshalla
martelaar - męczennik
martelen - torturować
mast - maszt
materiaal - materiał
mathematisch - matematyczny
matroos - marynarz
Mauretanië - Mauretania
mausoleum - mauzoleum
maximum - maksymalny
mayonaise - majonez
me - nieakcentowana forma zaimka "mij" - mnie, mi, się (1. os. l. poj.), sobie (1. os. l. poj.)
medelijden - współczucie
medewerker - pracownik
medicijn - farmaceutyk, lekarstwo
medisch - medyczny
meditatie - medytacja
meedingen - rywalizować
meel - mąka
meer - jezioro
meerderheid - większość
meermin - syrena
meervoud - liczba mnoga
meester - mistrz
meesterwerk - arcydzieło
meetkunde - geometria
meeuw - mewa
meewerken - współpracować
mei - maj
meineed - krzywoprzysięstwo
meisje - dziewczyna
meitnerium - meitner
melk - mleko
melken - doić
Melkweg - Droga Mleczna
meloen - melon
Memel - Niemen
mendelevium - mendelew
meneer - pan
mengen - mieszać
menigmaal - często
mening - opinia
mens - człowiek, o kobiecie, babsko
menselijk - ludzki
mentalist - mentalista
menu - menu
merel - kos
mes - nóż
mest - gnój, łajno, nawóz
met - z
metafysica - metafizyka
meteoor - meteor
meteoriet - meteoryt
meteorologie - meteorologia
methode - metoda
met opzet - celowo
metropolis - metropolia
met twee maten meten - zachowywać się inaczej w takich samych sytuacjach
met wortel en tak uitroeien - wyrwać z korzeniami
meubel - mebel
Mexicaans - meksykański
microfoon - mikrofon
Micronesië - Mikronezja
micro-organisme - mikroorganizm
microscopisch - mikroskopowy
middag - południe, popołudnie
middeleeuws - średniowieczny
Middellandse Zee - Morze Śródziemne
middenklasse - klasa średnia
middernacht - północ
miereneter - mrówkojad
mierikswortel - chrzan
mijden - unikać
mijl - mila
mijlpaal - kamień milowy
mijn - mój
mild - łagodny
militair - wojskowy, militarny, żołnierz
miljoen - milion
millennium - tysiąclecie, millenium
millenniumdenken - millenaryzm, milenaryzm
millivolt - miliwolt
minaret - minaret
minderheid - mniejszość
mineraalwater - woda mineralna
mineralogie - mineralogia
mineraloog - mineralog
minstens - przynajmniej
minuut - minuta
misandrie - mizoandria, mizoandryzm, mizandria
misdaad - przestępstwo
misdadig - przestępczy, kryminalny
misogynie - mizoginia, mizoginizm
misschien - może
missie - misja
modder - błoto
modem - modem
modernisme - modernizm
moeder - matka
moedertaalspreekster - native speakerka
moedertaalspreker - native speaker
moedig - odważny
moeilijk - trudny
moeilijkheid - trudność
moesson - monsun
moeten - musieć
mogelijk - prawdopodobnie
mogelijkheid - możliwość
Moldavië - Mołdawia
molen - młyn
molenaar - młynarz
molensteen - kamień młyński
molybdeen - molibden
monarchie - monarchia
mond - usta, buzia
Mongolië - Mongolia
monnik - mnich
monotheïsme - monoteizm
monster - potwór
Montenegro - Czarnogóra
monteur - mechanik
monument - pomnik
mooi - piękny
morgen - jutro, ranek
mos - mech
moskee - meczet
mossel - małż
mosterd - musztarda
motivatie - motywacja
motto - motto
mout - słód
mouw - rękaw
Mowgli - Mowgli
Mozambique - Mozambik
muis - mysz, mysz komputerowa
munt - mięta
mus - wróbel
museum - muzeum
muskaatnoot - gałka muszkatołowa
mutatie - mutacja
muur - mur
muziek - muzyka
muziekstuk - utwór muzyczny
mycologie - mykologia
mythe - mit
mythologie - mitologia
naaien - szyć, uszyć, pieprzyć się z kimś
naam - imię
na-apen - imitować, naśladować
naar - do (w kierunku), okropny, nieprzyjemny, dokuczliwy
nabijheid - bliskość
nabootsen - imitować, naśladować
nacht - noc
nachtclub - klub nocny
nachtelijk - nocny
nachtevening - równonoc
nachtmerrie - koszmar
nada - nic
naderhand - potem
nadoen - imitować, naśladować
nagalm - echo
nagellak - lakier do paznokci
nagerecht - deser
Nahum - Nahum
Nairobi - Nairobi
najaar - jesień
Namibië - Namibia
namiddag - popołudnie
narwal - narwal
nationalist - nacjonalista
nationaliteit - narodowość
natrium - sód
natuur - natura
natuurkunde - fizyka
natuurlijk - oczywiście, naturalnie, naturalny
nauwelijks - ledwie, ledwo, zaledwie
nauwkeurig - precyzyjny
navel - pępek
navolging - imitacja
nazaat - potomek
nederlaag - porażka
Nederland - Holandia
Nederlands - holenderski (niderlandzki) (język)
Nedersaksisch - dolnosaksoński, język dolnosaksoński
nee - nie
neer - w dole, na dole
Neerlands - holenderski
neerslag - opad (atmosferyczny)
negen - dziewięć 9
negende - dziewiąty
negenendertig - trzydzieści dziewięć, 39
negenennegentig - dziewięćdziesiąt dziewięć, 99
negenentachtig - osiemdziesiąt dziewięć, 89
negenentwintig - dwadzieścia dziewięć, 29
negenenveertig - czterdzieści dziewięć, 49
negenenvijftig - pięćdziesiąt dziewięć, 59
negenenzestig - sześćdziesiąt dziewięć, 69
negenenzeventig - siedemdziesiąt dziewięć, 79
negentien - dziewiętnaście, 19
negentiende - dziewiętnasty
negentig - dziewięćdziesiąt
neodymium - neodym
neon - neon
Nepal - Nepal
neptunium - neptun
nergens - nigdzie
nest - gniazdo, łóżko
netel - pokrzywa
neurologie - neurologia
neus - nos, o Żydzie
neushoorn - nosorożec
neutrino - neutrino
nevel - mgła
Nicaragua - Nikaragua
nier - nerka
niet - nie, nieten
niets - nic
nieuw - nowy
Nieuw-Caledonië - Nowa Kaledonia
Nieuw-Zeeland - Nowa Zelandia
nijlpaard - hipopotam
nijverheid - przemysł
nikkel - nikiel
niks - nic
nimmer - nigdy
niobium - niob
Nix - Nix
nobelium - nobel
nochtans - niemniej jednak
nodig hebben - potrzebować
noen - południe
nomenclatuur - nomenklatura
nominatie - nominacja
noob - noob
noodzaak - potrzeba
nooit - nigdy
Noord-Amerika - Ameryka Północna
noordelijk - północny
noorden - północ
Noord-Korea - Korea Północna
Noordzee - Morze Północne
Noorwegen - Norwegia
noot - orzech, nuta, nota, przypis
noppes - nic
Norbert - Norbert
normaliter - normalnie
november - listopad
nr - nr
nu - teraz
nul - zero, 0
o.a. - (m.in., między innymi)
obelisk - obelisk
obsceen - obsceniczny
observatorium - obserwatorium
obsessie - obsesja
obstakel - przeszkoda
oceaan - ocean
och - niestety
ochtend - ranek
octopus - ośmiornica
Oder - Odra
oefenen - ćwiczyć
oefening - ćwiczenie
Oeganda - Uganda
Oekraïne - Ukraina
oerwoud - dżungla
oester - ostryga
Oezbekistan - Uzbekistan
of - lub, albo
offeren - poświęcić
officieel - oficjalny
oh - och
oktober - październik
olie - olej
olifant - słoń
olijf - oliwka
olijfolie - olej oliwkowy, olej z oliwek, oliwa
olm - wiąz
Olympia - Olimpia (miasto w Grecji)
ombrengen - zabić
omdat - ponieważ
omelet - omlet
omgeven - otaczać, troszczyć się, dbać
omkeerbaar - odwracalny
omkomen - ginąć
omleiding - objazd
omringen - otaczać
omwenteling - rewolucja
onaanvaardbaar - nieakceptowalny
onbekend - nieznany, anonimowy
onder andere - m.in., między innymi
onderbewustzijn - podświadomość
onderdrukking - ucisk
ondergoed - bielizna
onderhandelen - negocjować
onderhandeling - negocjacje
onderwijskundig - edukacyjny
onderwijzen - uczyć
onderwijzer - nauczyciel
onderwijzing - nauczanie
ondiep - płytki
ondoorzichtig - nieprzezroczysty
oneindigheid - nieskończoność
ongebruikelijk - nietypowy
ongeduldig - niecierpliwy
ongehoorzaam - nieposłuszny
ongehoorzaamheid - nieposłuszeństwo
ongeletterd - niepiśmienny
ongelijkheid - nierówność
ongeluk - wypadek, pech, nieszczęście
ongevaarlijk - niegroźny, nieszkodliwy
ongewisse - niepewność
ongewoon - nietypowy
onjuistheid - pomyłka, błąd
onkreukbaar - nieprzekupny
onmisbaar - nieodzowny
onmogelijk - niemożliwy
onomkeerbaar - nieodwracalny
onoverwinnelijk - niezwyciężony
onplezierig - nieprzyjemny
onschadelijk - niegroźny, nieszkodliwy
onscheidbaar - nierozłączny
onsterfelijkheid - nieśmiertelność
ontbijt - śniadanie
ontdekken - odkrywać
ontdekking - odkrycie
ontginnen - rozwijać, rozbudowywać
onthalen - pozdrawiać
ontkomen - uciec
ontmoeten - spotykać
ontploffen - wybuchać, eksplodować
ontploffing - wybuch, eksplozja
ontsnappen - uciec
ontvluchten - uciekać
ontvoogding - emancypacja
ontvreemden - kraść
ontwerper - projektant
ontwikkelen - rozwijać, rozbudowywać
ontzield - martwy
onverhoopt - nieoczekiwany, niespodziewanie
onverschilligheid - obojętność
onverwacht - nieoczekiwany, niespodziewanie
onverwachts - niespodziewanie
onvoltooid deelwoord - imiesłów czasu teraźniejszego
onvoltooid tegenwoordige tijd - czas teraźniejszy niedokonany
onvoltooid tegenwoordig toekomende tijd - czas przyszły prosty
onvoltooid verleden tijd - czas przeszły niedokonany
onvoltooid verleden toekomende tijd - futurum praeteriti
onvoorspelbaar - nieprzewidywalny
onvriendelijk - nieprzyjazny
onwaarheid - fałsz, nieprawda
onzekerheid - niepewność
onzijdig - neutralny, obojętny, nijaki
onzin - nonsens
ooft - owoc
oog - oko
ooglid - powieka
ooievaar - bocian
ook - również, też, także
oom - wujek
oor - ucho
oorbel - kolczyk
oorlog - wojna
oorring - kolczyk
oorzaak - powód, przyczyna
oostelijk - wschodni
oosten - wschód
Oostenrijk - Austria
Oostzee - Morze Bałtyckie
opa - dziadek, dziadziuś
opaal - opal
opeenhoping - nagromadzenie
opendoen - otwierać
openen - otwierać
opera - opera
opinie - opinia
oplosmiddel - rozpuszczalnik
opnieuw - znowu, znów
opperen - sugerować
oppervlak - powierzchnia
oprecht - szczery
oprechtheid - szczerość
oprichter - założyciel
oprotten - spadać, spierdalać, wypierdalać, odpierdalać się, odwalać się
optimisme - optymizm
opvangen - złapać
opvolger - następca
opzettelijk - celowo
opzwellen - puchnąć
oranje - pomarańczowy (kolor)
organisatie - organizacja
organisme - organizm
orgasme - orgazm, szczytowanie
oriëntatie - orientacja
osmium - osm
Ostia - Ostia
otter - wydra
oud - stary
ouderwets - staromodny
oudheid - starożytność
oudheidkunde - archeologia
oud-strijder - weteran
overal - wszędzie, gdziekolwiek
overblijven - pozostać
overdadig - nadmierny
overduidelijk - oczywisty, oczywiście
overgankelijk - przechodni
overgrootvader - pradziadek
overheersing - dominacja
overhemd - koszula
overig - pozostały
overigens - ponadto
overmatig - nadmierny
oversteken - dośrodkowywać, wrzucać
overstroming - powódź
overvloed - obfitość
overvloedig - obfity
overzetting - tłumaczenie
oxide - tlenek
paard - koń
paardmens - centaur
paars - fioletowy
paasfeest - Wielkanoc
pact - pakt, układ
paganisme - pogaństwo
pagina - strona, stronica
paleis - pałac
Palestijns - palestyński
palindroom - palindrom
paling - węgorz
palladianisme - palladianizm
palladium - pallad
palmolie - olej palmowy
pan - garnek, patelnia
Panama - Panama
panda - panda
pandeïsme - pandeizm
paniek - panika
pantheïsme - panteizm
pantoffel - kapeć
papegaai - papuga
papier - papier
paraat - gotowy
paradijs - raj
paradox - paradoks
Paraguay - Paragwaj
parameter - parametr
paranoia - paranoja
paraplu - parasol
parasitair - pasożytniczy
Parijs - Paryż
park - park
parlement - parlament
participeren - brać udział
particulier - prywatny
paspoort - paszport
passagier - pasażer
pastoor - pastor
paswoord - hasło
patriarch - patriarcha
patrijs - kuropatwa
patrouilleren - patrolować
paus - papież
pauw - paw
pedaal - pedał
peen - marchew
peer - gruszka
peetoom - ojciec chrzestny
peetvader - ojciec chrzestny
pelgrim - pielgrzym
pelgrimstocht - pielgrzymka
pelikaan - pelikan
pellen - obierać
penalty - rzut karny
penaltynemer - wykonawca rzutów karnych
penaltystopper - bramkarz wykazujący się wysokimi umiejętnościami obrony rzutów karnych
penningmeester - skarbnik
pepel - motyl
pers - prasa, pers, kot perski, dywan perski, persen
persoon - osoba
persoonlijk - osobisty
persoonlijkheid - osobowość
Peru - Peru
perzik - brzoskwinia
Perzisch - perski, irański
Peter - Piotr
peterselie - pietruszka
pianiste - pianistka
piano - pianino
picknick - piknik
piel - kaczątko
pijn - ból
piloot - pilot
pinda - orzech ziemny
pinguïn - pingwin
pionier - pionier
piraterij - piractwo
pistache - pistacja (owoc), pistacja (drzewo)
Pittsburgh - Pittsburgh (stolica Allegheny)
pixel - piksel
pizza - pizza
plaats - miejsce, pozycja
plaatselijk - lokalny
plafond - sufit
planeet - planeta
planetair - planetarny
planetarium - planetarium (obiekt)
plant - roślina
plantage - plantacja
plantkunde - botanika
platina - platyna
plattegrond - plan, mapa
plechtigheid - ceremonia
pleister - plaster
plezier - przyjemność
plots - nagle
plotseling - nagły, nagle
plutonium - pluton
poëzie - poezja
Polen - Polska
politie - policja
politiek - polityczny, polityka
polonium - polon
polygamie - poligamia
polytheïsme - politeizm
pompoen - dynia
pooier - alfons, sutener
poolbeer - niedźwiedź polarny
Pools - polski
poort - brama
populier - topola
portemonnee - portfel
portier - portier, drzwi
portret - portret
Portugal - Portugalia
Portugees - portugalski
postkantoor - poczta
postmodernisme - postmodernizm
potlood - ołówek
Praag - Praga
pragmatisch - pragmatyczny
pragmatisme - pragmatyzm
Praia - Praia
praktisch - praktyczny
praseodymium - prazeodym
praten - mówić, rozmawiać
precies - dokładny, precyzyjny
predikant - kaznodzieja
prehistorie - prehistoria
prei - por
premier - premier
presentatie - prezentacja
pret - zabawa, ubaw, frajda
prijs - cena
principe - zasada, reguła
prins - książę
Prins Edwardeiland - Wyspa Księcia Edwarda
prinses - księżniczka
printen - drukować
prioriteit - priorytet
privacy - prywatność
privé - prywatny
proberen - próbować
probleem - problem
procedure - procedura
procent - procent
proces - proces
producent - producent
producer - producent
productie - produkcja
profeet - profeta, prorok
professioneel - profesjonalny, zawodowy, związany z danym zawodem
professor - profesor
profijt - zysk
proloog - prolog
promethium - promet
promotie - promocja
prononceren - wymawiać
propaganda - propaganda
prostituee - prostytutka
protactinium - protaktyn
protegeren - chronić
provocatie - prowokacja
proza - proza
pruim - śliwka
Pruisisch - pruski
pseudoniem - pseudonim
psychiatrie - psychiatria
psychologie - psychologia
psychotherapie - psychoterapia
Ptah - Ptah
puist - krosta
Pyreneeën - Pireneje
pyromanie - piromania
Qatar - Katar
quaestor - skarbnik
quorum - kworum
raaf - kruk
raam - okno
rabarber - rabarbar
radijs - rzodkiewka
radioactief - radioaktywny
radioactiviteit - radioaktywność, promieniotwórczość
radium - rad
radon - radon
ramen - ocenić, oszacować
rapport - raport
rat - szczur
ratificatie - ratyfikacja
ravijn - wąwóz
realistisch - realistyczny
realiteit - rzeczywistość
rebellie - bunt
recentelijk - ostatnio
rechtbank - sąd
rechthoek - prostokąt
rechtspraak - jurysdykcja
rechtstreeks - bezpośredni, bezpośrednio
reciteren - recytować
recommandatie - rekomendacja
redden - ocalić, ratować
redekunde - retoryka
redeneerkunde - logika, retoryka
redevoering - mowa
reeds - już
regelbaar - regulowalny, nastawny
regelmaat - regularność
regen - deszcz
regenboog - tęcza
regenscherm - parasol
regent - regent
regenworm - dżdżownica
regionaal - regionalny
reiger - czapla
reïncarnatie - reinkarnacja
reinigen - czyścić
reiziger - podróżny, podróżnik
rekenkunde - arytmetyka
relativiteit - względność
reliek - relikwia
religie - religia
religieus - religijny
relikwie - relikwia
remise - remis
rendier - renifer
renium - ren
renovatie - renowacja
repareren - naprawiać
reptiel - gad
republiek - republika
reputatie - reputacja
restaurant - restauracja
resteren - pozostać
retorica - retoryka
retoriek - retoryka
retsina - retsina
revolver - rewolwer
rhodium - rod
richtlijn - dyrektywa
ridder - rycerz
riem - pas, pasek
riet - trzcina
rijbewijs - prawo jazdy
rijkdom - bogactwo, pomyślność, dobrobyt
rijp - dojrzały
Rijsel - Lille
rijst - ryż
rijwiel - rower
rioolrat - szczur
risico - ryzyko
ritus - rytuał
rivaliteit - rywalizacja
rivier - rzeka
robot - robot
roekeloos - lekkomyślny
Roemeens - rumuński
Roemenië - Rumunia
roemruchtig - wspaniały
roentgenium - rutherford
roepen - krzyczeć, wołać, zawołać
rog - płaszczka
rogge - żyto
rok - spódnica
rolstoel - wózek inwalidzki
roltrap - schody ruchome
romantisch - romantyczny
Rome - Rzym
Romeins - rzymski
rood - czerwony
roodachtig - czerwonawy
roomijs - lody
Rooms - rzymski
rover - rabuś
roze - różowy
rozemarijn - rozmaryn
rozijn - rodzynek
rubidium - rubid
rugby - rugby
ruiken - czuć
ruime sop - morze, ocean
ruimteschip - statek kosmiczny
ruimtevaarder - astronauta
ruiter - jeździec
ruiterij - kawaleria, konnica
rundvlees - wołowina
rups - gąsienica
Rusland - Rosja
Russisch - język rosyjski
ruthenium - ruten
rutherfordium - rutherford
ruziën - kłócić się
sacraal - święty
safe - sejf
saffiaantje - papieros
salamander - salamandra
salaris - pensja
salie - szałwia
samarium - samar
samen - razem
samenvatting - streszczenie
samenwerken - współpracować
samenwerking - współpraca
samenzwering - konspiracja
sanctie - sankcja
sandaal - sandał
sandwich - kanapka
Saoedi-Arabië - Arabia Saudyjska
Sao Tomé en Principe - Wyspy Świętego Tomasza i Książęca
sappig - soczysty
sarcasme - sarkazm
sarcastisch - sarkastyczny
sarcofaag - sarkofag
sardien - sardynka
satijn - satyna
satirisch - satyryczny
saus - sos
Scandinavië - Skandynawia
scandium - skand
schaal - skala
schaap - owca
schaar - nożyce
schaarste - rzadkość
schaken - szachy
schandaal - skandal
schandalig - skandaliczny
schande - wstyd
schap - półka
schapen met bokken verdelen - Mieć podwójny (potrójny, etc.) standard moralny
schatbewaarder - skarbnik
schatmeester - skarbnik
schede - pochwa
scheepswrak - wrak
scheiden - oddzielić, rozwodzić się
scheikunde - chemia
scheikundig - chemiczny
schemerdonker - zmierzch
schemerlicht - zmierzch
scheppen - stwarzać, tworzyć, stworzyć
scherpen - ostrzyć
schiereiland - półwysep
schieten - strzelać, wystrzelić
schijnheiligheid - hipokryzja
schijterig - tchórzliwy
schild - tarcza
schilderen - malować
schilderkunst - malarstwo
schildpad - żółw
schip - statek
schipbreuk - wrak
schizofrenie - schizofrenia
schoen - but
schoenlepel - łyżka do butów
schoenmaker - szewc
school - szkoła
schoolbord - tablica
schoonbroer - szwagier
schoonmaken - czyścić
schoonvader - teść
Schotland - Szkocja
schouwburg - teatr
schrijfmachine - maszyna do pisania
schrijven - pisać
schrijver - pisarz
schuim - piana
schuldig - winny
sculptuur - rzeźba
seaborgium - seaborg
secretaresse - sekretarka
seculier - świecki
sedert - od
sedimentologie - sedymentologia
seismologie - sejsmologia
seizoen - pora roku, sezon
sekse - płeć
seksualiteit - seksualność
sekte - sekta
selecteren - wybierać
seleen - selen
selenium - selen
selfie - selfie
semantisch - semantyczny
senaat - senat
senator - senator
september - wrzesień
serieus - poważny, poważnie
Servië - Serbia
sesam - sezam
shatranj - szatrandż
sierlijk - elegancki
Sierra Leone - Sierra Leone
sigaar - cygaro
sigaret - papieros
signaal - sygnał
sikhisme - sikhizm
sikkel - sierp
Silezisch - śląski
silicium - krzem
simulatie - symulacja
sinaasappel - pomarańcza (owoc)
sinds - od
Singapore - Singapur
siroop - syrop
sjabloon - szablon
sjoemelen - oszukiwać
sjorren - ciągnąć
sla - sałata
slaaf - niewolnik
slaan - bić, uderzać
slaapkamer - sypialnia
slachtoffer - ofiara
slager - rzeźnik
slagveld - pole bitwy
slang - wąż, wąż gumowy, slang
slapen - spać
slavernij - niewolnictwo
slecht - zły
slechts - tylko, jedynie
sleutel - klucz, klucz muzyczny
slijk - błoto
slikken - połykać
Slovenië - Słowenia
Slowakije - Słowacja
sluipschutter - snajper
sluiten - zamykać
smal - wąski
smaragd - szmaragd
smeermiddel - smar
smering - smarowanie
smid - kowal
's morgens - rano
sneeuw - śnieg
Sneeuwbalaarde - ziemia-śnieżka
sneeuwen - śnieżyć
sneeuwklokje - przebiśnieg
sneeuwvlok - śnieżynka, płatek śniegu
snel - szybki
snelheid - prędkość
snellen - spieszyć się
snijden - ciąć
snoekbaars - sandacz
snuffelen - wąchać
snufferd - nos
snuiven - wąchać
snurken - chrapać
socialisme - socjalizm
sociologie - socjologia
socioloog - socjolog
Soedan - Sudan
soep - zupa
soevereiniteit - suwerenność
sojamelk - mleko sojowe
sojasaus - sos sojowy
sok - skarpeta, skarpetka
soldaat - żołnierz
Somalië - Somalia
soortgelijk - podobny
Sovjet-Unie - Związek Radziecki
Spaans - hiszpański
Spanje - Hiszpania
spar - świerk
specerij - przyprawa
specht - dzięcioł
speciaal - wyjątkowy, specjalny
spectaculair - spektakularny
speech - mowa
speer - włócznia
spelen - grać (w grę), grać (na instrumencie)
speler - gracz
sperzieboon - fasolka szparagowa
speurder - detektyw
spiegel - lustro
spijs - potrawa, posiłek
spin - pająk
spinazie - szpinak
spiritueel - duchowy
spirulina - spirulina
spons - gąbka
spoorweg - kolej
sport - sport, sporten
spouwen - pluć, wymiotować
spreeuw - szpak
spreken - mówić, używać języka, rozmawiać
sprinkhaan - szarańcza
sproet - pieg
spruitjes - brukselka
spruitkool - kapusta brukselska, brukselka
spugen - pluć
spuwen - pluć
Sri Lanka - Sri Lanka
staakt-het-vuren - zawieszenie broni
staal - stal, próbka
staan - stać, stawać
staart - ogon
staartster - kometa
stad - miasto
stagnatie - stagnacja
standbeeld - posąg, statua
star - sztywny, zamarznięty, nieelastyczny
station - stacja
steen - kamień
steenkool - węgiel
Stefan - Stefan
stelkunde - algebra
stellen - stawiać, umieszczać, twierdzić, czuć coś do czegoś/kogoś, czuć ważność czegoś, zajmować stanowisko w jakiejś sprawie, ustosunkowywać się
stellig - pewien
stelsel - system
stengel - łodyga
steppe - step
ster - gwiazda
sterrenkunde - astronomia
sterrenkundige - astronom
sterrenwacht - obserwatorium
sterrenwichelaar - astrolog
sterrenwichelarij - astrologia
sterven - umrzeć
stibium - antymon
stichter - założyciel
stiefdochter - pasierbica
stiefmoeder - macocha
stiefzoon - pasierb
stiekem - sekretny
stier - byk
stikstof - azot
stilte - cisza
stoel - krzesło
stof - kurz, pył
stoffig - zakurzony
stofzuiger - odkurzacz
stoom - para
stoornis - nieporządek
stoplicht - światło sygnalizacyjne
stormachtig - burzliwy
stormloop - popłoch, panika
straat - ulica
strafbaar - nielegalny
strafschop - rzut karny
strafschopnemer - wykonawca rzutów karnych
strafschopstopper - bramkarz wykazujący się wysokimi umiejętnościami obrony rzutów karnych
strand - plaża
strategie - strategia
strategisch - strategiczny
streektaal - dialekt
strijdlied - hymn
strijdwagen - rydwan
strijkijzer - żelazko
stro - słoma
strontium - stront
stroop - syrop
stropdas - krawat
structuur - struktura
struik - krzew
struisvogel - struś
stuk - część, kawałek, piękność, atrakcyjna kobieta
stuurwiel - kierownica
substantie - substancja
substantief - rzeczownik
succes - sukces
sufferd - idiota
suggereren - sugerować
suiker - cukier
suikerziekte - cukrzyca
supermarkt - supermarket
Suriname - Surinam
symbool - symbol
symfonie - symfonia
symmetrie - symetria
sympathiek - współczujący
synagoge - synagoga
synaps - synapsa
syntaxis - składnia
synthese - synteza
synthetisch - syntetyczny
Syrië - Syria
systeem - system
taak - zadanie
taal - język, mowa
taalkunde - językoznawstwo
tablet - tabletka, pigułka, tablet
tachtig - osiemdziesiąt
tactiek - taktyka
Tadzjikistan - Tadżykistan
tafel - stół, tafelen
tafelkleed - obrus
taifoen - tajfun
taigagaai - sójka syberyjska, sójka złowroga
Taiwan - Tajwan
tak - gałąź
talent - talent
talrijk - liczny
tand - ząb
tandarts - dentysta
tandenborstel - szczoteczka do zębów
tandpijn - ból zęba
tantaal - tantal
tantalium - tantal
tante - ciotka
tape - taśma
tarwe - pszenica
tatoeage - tatuaż
tatoeëring - tatuaż
tautologie - tautologia
taxi - taksówka
taxonomie - taksonomia
te - zbyt, za, do, w, zlokalizowane w
technetium - technet
technisch - techniczny
technologie - technika
tederheid - czułość
teen - palec u nogi
tegengesteld - przeciwny
tegenovergesteld - przeciwny
tegenwoordige tijd - czas teraźniejszy
tekening - rysunek
telefoon - telefon
telegram - telegram
teleurstellen - rozczarować
teleurstelling - rozczarowanie
televisie - telewizja
telg - potomek
tellen - liczyć, obliczać
tellurium - tellur
telluur - tellur
ten - w, na, za pomocą, po
tenminste - przynajmniej
ten minste - przynajmniej
ten opzichte van - odnośnie do
tent - namiot
ten zeerste - mocno, silnie
ter - w, na, za pomocą, po
terbium - terb
terminologie - terminologia
territorium - terytorium
terrorisme - terroryzm
teruguit - do tyłu
terzijde - na bok
test - test
testosteron - testosteron
tetrapylon - tetrapylon
tevergeefs - na próżno
te voet - pieszo
Thailand - Tajlandia
thalassemie - talasemia
thallium - tal
thee - herbata
theoretisch - teoretyczny
theorie - teoria
therapie - terapia
thermometer - termometr
Thermopylae - Termopile
thesaurier - skarbnik
thorium - tor
thuisland - ojczyzna
thulium - tul
tien - dziesięć, 10
tiende - dziesiąty
tij - pływ
tijd - czas
tijdelijk - tymczasowy, tymczasowo
tijdschrift - magazyn
tijdsduur - czas trwania
tijger - tygrys
tijm - tymianek
timmerman - cieśla, stolarz
tin - cyna
titanium - tytan
titel - tytuł
toegankelijkheid - dostępność
toekan - tukan
toekomend - przyszły
toekomende tijd - czas przyszły
toekomst - przyszłość
toelichting - wyjaśnienie
toerisme - turystyka
toernooi - turniej
toespeling - aluzja
toespraak - mowa
toetsenbord - klawiatura
toezeggen - obiecać
toezegging - obietnica
tolerantie - tolerancja
toleratie - tolerancja
tomaat - pomidor
tomatenketchup - keczup
tombe - grób
tong - język
tonijn - tuńczyk
toponiem - toponim
tor - żuk
toren - wieża
tot kijk - do widzenia
t.o.v. - odnośnie do
toxicologie - toksykologia
traag - powolny, powoli
trachten - próbować
traditie - tradycja
tragedie - tragedia
tragisch - tragiczny
transitief - przechodni
trechter - lejek
trefzeker - dokładny
trein - pociąg
treksprinkhaan - szarańcza
tribunaal - trybunał
triest - żałosny, smutny
Trinidad en Tobago - Trynidad i Tobago
triomf - triumf
trom - bęben
troonsafstand - abdykacja
trots - dumny, duma
Tsjechië - Czechy
Tsjechisch - czeski
tsunami - tsunami
tuin - ogród
tuinboon - bób
tulband - turban
Tunesië - Tunezja
tunnel - tunel
Turkije - Turcja
Turkmenistan - Turkmenia
tussen - między
tussendoortje - przekąska
tussenkomst - interwencja
twaalf - dwanaście, 12
twaalfde - dwunasty
twee - dwa, 2
tweedonker - zmierzch
tweeëndertig - trzydzieści dwa, 32
tweeënnegentig - dziewięćdziesiąt dwa, 92
tweeëntachtig - osiemdziesiąt dwa, 82
tweeëntwintig - dwadzieścia dwa, 22
tweeënveertig - czterdzieści dwa, 42
tweeënvijftig - pięćdziesiąt dwa, 52
tweeënzestig - sześćdziesiąt dwa, 62
tweeënzeventig - siedemdziesiąt dwa, 72
tweelicht - zmierzch
tweetal - para
tweetalig - dwujęzyczny
twijg - gałązka
twintig - dwadzieścia, 20
twintigste - dwudziesty
tyfoon - tajfun
typisch - typowy
typmachine - maszyna do pisania
Tyrtaeus - Tyrtajos, Tyrteusz
Uganda - Uganda
ui - cebula
uier - wymię
uil - sowa
uitbraaksel - wymiociny
uitbuiting - eksploatacja, wykorzystywanie
uitdaging - wyzwanie
uiteraard - oczywiście
uitgever - wydawca
uitkiezen - wybierać
uitkomst - rezultat, wygoda
uitloven - proponować
uitnodigen - zaprosić
uitputting - wyczerpanie
uitspraak - wymowa, werdykt
uitvaart - pogrzeb
uitvinden - wynaleźć
uitvinder - wynalazca
uitvloeisel - wynik
uitvoeren - wykonać, przeprowadzić, wyprowadzić, eksportować
uitwendig - zewnętrzny
uitwerpsel - kał, wydalina
uitwijking - emigracja
uitzondering - wyjątek
uitzonderlijk - wyjątkowy
ultimatum - ultimatum
unaniem - jednomyślny
universiteit - uniwersytet
universum - wszechświat
ununhexium - ununhexium
ununoctium - ununoctium
ununpentium - ununpentium
ununquadium - ununquadium
upload - wgrywanie (kopiowanie) na serwer, forma pierwszej osoby liczby pojedynczej czasu teraźniejszego czasownika uploaden
uploaden - wgrać na serwer
uranium - uran
Uruguay - Urugwaj
usurpator - uzurpator
uur - godzina
uurglas - klepsydra
vaas - wazon
vaccin - szczepionka
vadem - sążeń
vader - ojciec, tata
vaderlijk - ojcowski
vagevuur - czyściec
vallei - dolina
vallen - paść, upadać, spadać
valsspelen - oszukiwać
vampier - wampir
van - z, od
vanadium - wanad
vandaag - dziś
vangen - złapać
vanille - wanilia
van wanten weten - być zdolnym do ciężkiej pracy, móc ciężko pracować
vanzelf - automatycznie
variabel - zmienny
variant - wariant
varken - świnia
varkensvlees - wieprzowina
Vaticaan - Watykan (państwo)
Vaticaanstad - Państwo Watykańskie
vazal - wasal
vechtersbaas - huligan
veder - pióro
veegte - wrogość
veel - dużo, wiele
veelheid - obfitość
veelvuldig - częsty
veertien - czternaście, 14
veertiende - czternasty
veertig - czterdzieści
veertigste - czterdziesty
veganisme - weganizm
veganist - weganin
veganistisch - wegański
vegetariër - wegetarianin
vegetarisch - wegetariański
vegetarisme - wegetarianizm
veilig - bezpieczny, bezpiecznie
veiligheid - bezpieczeństwo
veld - pole
veldslag - bitwa
veldtocht - kampania
Venetië - Wenecja
Venezuela - Wenezuela
vennoot - partner
venster - okno
ver - daleki
verantwoordelijk - odpowiedzialny
verantwoordelijkheid - odpowiedzialność
verbeteren - udoskonalić, poprawiać
verbinden - wiązać, powiązać, łączyć
verbinding - powiązanie, połączenie, związek
verdedigen - bronić
verdenking - podejrzenie
verdieping - piętro, kondygnacja
verdraagzaamheid - tolerancja
verdrag - pakt, traktat
verdrieten - irytować, złościć, zasmucać, martwić
verdrietig - smutny
verdrukking - ucisk
verduidelijken - wyjaśniać
verdwijning - zniknięcie
vereenvoudigen - uprościć
Verenigde Arabische Emiraten - Zjednoczone Emiraty Arabskie
Verenigde Staten - Stany Zjednoczone, USA
Verenigde Staten van Amerika - Stany Zjednoczone Ameryki
Verenigd Koninkrijk - Zjednoczone Królestwo
vergeetachtig - zapominalski
vergelding - odwet
vergelijkbaar - porównywalny
vergelijken - porównać
vergelijking - porównanie, równanie
vergeten - zapomnieć
vergeving - przebaczenie
vergif - trucizna
vergiffenis - przebaczenie
vergift - trucizna
vergissing - pomyłka
vergisting - fermentacja
vergrootglas - lupa
verhitten - ogrzewać
verhuren - wynająć
verifiëren - sprawdzać, weryfikować
verjaardag - urodziny
verjaardagscadeau - prezent urodzinowy
verjaardagsgeschenk - prezent urodzinowy
verkeerslicht - światło sygnalizacyjne
verkiezen - woleć, wybierać
verkiezing - wybory
verkondiger - kaznodzieja
verkoudheid - przeziębienie
verleden tijd - czas przeszły
verliefdheid - zakochanie
verliezen - gubić, stracić, przegrać
vermelding - wzmianka
vermijden - unikać
vernielen - zniszczyć
vernieling - zniszczenie
vernietigen - zniszczyć
vernietiging - zniszczenie
vernieuwing - innowacja
veronderstelling - założenie, przypuszczenie
veroorzaken - powodować
verschijnsel - zjawisko
versie - wersja
versieren - dekorować, uwodzić
versiering - dekoracja
versimpelen - uprościć
verslag - raport
verslaving - nałóg
verstandelijk - intelektualny
versterker - wzmacniacz
vertaalster - tłumacz
vertakking - gałąź
vertalen - tłumaczyć
vertaler - tłumacz
vertaling - tłumaczenie, przekład
verte - odległość
vertegenwoordiger - reprezentant
vertraging - opóźnienie
vertroosting - pocieszenie
verveling - nuda
verven - malować
vervolging - prześladowanie
verwachten - spodziewać się
verwerking - proces
verwerpen - odrzucać
verwijderen - usunąć
verwijten - obwiniać
verwonden - ranić, kaleczyć
verworvenheid - osiągnięcie
vesting - fortyfikacja
videobewijs - telewizyjna powtórka
vier - cztery, 4
vierendertig - trzydzieści cztery, 34
vierennegentig - dziewięćdziesiąt cztery, 94
vierentachtig - osiemdziesiąt cztery, 84
vierentwintig - dwadzieścia cztery, 24
vierenveertig - czterdzieści cztery, 44
vierenvijftig - pięćdziesiąt cztery, 54
vierenzestig - sześćdziesiąt cztery, 64
vierenzeventig - siedemdziesiąt cztery, 74
Vietnamees - wietnamski, Wietnamczyk
vijand - wróg
vijf - pięć, 5
vijfde - piąty
vijfendertig - trzydzieści pięć, 35
vijfennegentig - dziewięćdziesiąt pięć, 95
vijfentachtig - osiemdziesiąt pięć, 85
vijfentwintig - dwadzieścia pięć, 25
vijfenveertig - czterdzieści pięć, 45
vijfenvijftig - pięćdziesiąt pięć, 55
vijfenzestig - sześćdziesiąt pięć, 65
vijfenzeventig - siedemdziesiąt pięć, 75
vijftien - piętnaście, 15
vijftiende - piętnasty
vijftig - pięćdziesiąt, 50
vijg - figa
vijver - staw, sadzawka
vinden - znaleźć
vindingrijk - kreatywny
vinger - palec
viool - skrzypce
vis - ryba
visarend - rybołów
viscositeit - lepkość
viskeus - lepki
visser - rybak
visueel - wizualny
visum - wiza
vlag - flaga
vlas - len
vleermuis - nietoperz
vlees - mięso
vleierij - pochlebstwo
vlieg - mucha
vliegdekschip - lotniskowiec
vliegen - latać
vlieghaven - lotnisko
vliegtuig - samolot
vliegveld - lotnisko
vlijt - pracowitość
vlinder - motyl
vlo - pchła
vloed - powódź
vloeistof - ciecz, płyn
vlok - płatek
vluchteling - uchodźca
vluchten - uciekać
vlug - szybki
vochtig - wilgotny
vochtigheid - wilgoć
voeding - jedzenie, żywność
voedsel - jedzenie
voer - pokarm, pasza
voertuig - wehikuł, środek transportu
voet - stopa
voetafdruk - ślad stopy
voetbal - piłka nożna, Forma pierwszej osoby liczby pojedynczej czasu teraźniejszego czasownika voetballen, Tryb rozkazujący liczby pojedynczej czasownika voetballen, Forma pytająca drugiej osoby liczby pojedynczej czasu teraźniejszego czasownika voetballen, piłka do gry w piłkę nożną
vogel - ptak
vogelbekdier - dziobak
vogelverschrikker - strach na wróble
vol - pełny
voldoening - satysfakcja
volgeling - zwolennik
volgens - według
volkomen - całkowicie
volksfeest - festiwal
volksmenner - demagog
volledig - kompletny, całkowicie
volledigheid - kompletność
voltooid deelwoord - imiesłów czasu przeszłego
voltooid tegenwoordige tijd - czas teraźniejszy dokonany
voltooid tegenwoordig toekomende tijd - czas zaprzyszły
voltooid verleden tijd - czas przeszły dokonany
voltooid verleden toekomende tijd - futurum exactum praeteriti
voor - dla
voorbeeld - przykład
voorbereiding - przygotowanie
voord - bród
voordat - zanim
voordelig - korzystny, tani
voordracht - mowa, prezentacja
voorgeschiedenis - prehistoria
voorgoed - na dobre, na stałe, na zawsze
voorhamer - młot oburęczny
voorhistorisch - prehistoryczny
voorhoofd - czoło
voorjaar - wiosna
voorkeur - preferencja
voorkomend - miły, uprzejmy
voornaamwoord - zaimek
voorouder - przodek
voorrecht - przywilej
voorspelbaar - przewidywalny
voorspoed - pomyślność, dobrobyt
voortgang - postęp
voortreffelijkheid - doskonałość
voortzetten - kontynuować
voortzetting - kontynuacja
vooruitgang - postęp
voorwaardelijk - warunkowy
voorzetsel - przyimek
voorzorg - środek ostrożności
vorig - poprzedni
vork - widelec
vos - lis
vraag - pytanie, zapotrzebowanie na dobra materialne, vragen
vraat - żarłok
vragen - pytać, prosić
vragenlijst - kwestionariusz
vrede - pokój, spokój
vreedzaam - pokojowy
vreselijk - straszny, strasznie, bardzo, znacznie, mocno
vreugde - radość
vriend - przyjaciel
vriendschap - przyjaźń
vriezer - zamrażarka
vrijdag - piątek
vrijen - kochać się, współżyć
vrije trap - rzut wolny
vrije trap nemer - wykonawca rzutów wolnych
vrijgevigheid - hojność, szczodrość
vrijheid - wolność
vrijwel - prawie
vrijzinnig - liberalny
vroegtijdig - przedwczesny
vrolijk - wesoły, radosny
vrouw - kobieta
vrouwelijk - żeński, kobiecy, żeński (rodzaj)
vrucht - owoc
vulkaan - wulkan
vulkanisch - wulkaniczny
vuur - ogień
vuurvlieg - świetlik
vuurwapen - broń palna
vz - przewodniczący
waar - gdzie
waardeloos - bezwartościowy
waardering - uznanie
waardevol - cenny
waargebeurd - prawdziwy
waarheid - prawda
waarlijk - naprawdę
waarnemer - obserwator, reprezentant
waarning - ostrzeżenie
waarom - dlaczego, czemu
waarover - o czym? o którym? (w miejsce "over wat?" i "over welk?"), o czym, o którym (w miejsce "over wat", "over hetwelk" i "over dewelke")
waarschijnlijk - prawdopodobny, prawdopodobnie
waarschuwing - ostrzeżenie
wachtwoord - hasło
wagen - wóz, fura, furmanka, ośmielić się, odważyć się, śmieć, ryzykować, zaryzykować
Wales - Walia
walnoot - orzech włoski
walrus - mors
walvis - wieloryb
wandelen - spacerować
wanhoop - rozpacz
wanneer - gdy
want - rękawiczka z jednym palcem, wanta, bo, ponieważ
wapen - broń
wapenkunde - heraldyka
wapenstilstand - rozejm
Warschau - Warszawa
wasbak - umywalka
wasbeer - szop
wassen - myć, czyścić
wastafel - umywalka
wat - co
water - woda
waterkers - rzeżucha
watermeloen - arbuz
watersnood - powódź
waterstof - wodór
waterval - wodospad
watt - wat
we - nieakcentowana forma zaimka "wij" - my
wederom - ponownie, znowu
wedijveren - rywalizować
weduwe - wdowa
week - tydzień
weekend - weekend
weer - znowu, jeszcze raz, pogoda
weerkunde - meteorologia
weerwolf - wilkołak
weg - droga, trasa
wegen - ważyć, od weg
weigering - odmowa
weit - pszenica
wekker - budzik
welbehagen - przyjemność
welbemind - ukochany
wel degelijk - na pewno
weldoener - dobroczyńca
wel eens - sporadycznie
welgang - sukces
wellevendheid - uprzejmość
wenen - płakać, łkać
Wenen - Wiedeń
wenkbrauw - brew
wenselijk - pożądany
wereld - świat
werelddeel - kontynent
wereldzee - ocean
werk - praca
werkelijk - prawdziwy, rzeczywiście
werkelijkheid - rzeczywistość
werken - pracować, werk
werker - pracownik
werkloos - bezrobotny
werkplaats - warsztat
werktuig - narzędzie
werkwoord - czasownik
werpen - rzucać, ciskać, miotać
wers - gorzej
Westelijke Sahara - Sahara Zachodnia
westen - zachód
weten - wiedzieć
wetenschap - nauka, wiedza
wetgeving - ustawodawstwo
wettelijk - prawny
wezel - łasica
wiel - koło
wierook - kadzidło
wij - my
wijn - wino
wijsbegeerte - filozofia
wijsgeer - filozof
wijsgerig - filozoficzny
wijsvinger - palec wskazujący
wijten - obwiniać
Wikipedia - Wikipedia
wilg - wierzba
willekeurig - arbitralny, przypadkowy
willen - chcieć
wimper - rzęsa
wind - wiatr, wiatry, wzdęcia
windmolen - wiatrak
winkel - sklep
winnen - wygrać, zwyciężyć
winstgevend - korzystny
winter - zima
wiskunde - matematyka
wiskundig - matematyczny
wisselen - wymienić
wit - biały, legalny
Wit-Rusland - Białoruś
wodka - wódka
woensdag - środa
woestijn - pustynia
wol - wełna
wolf - wilk
wolfraam - wolfram
wolk - chmura
wolkenkrabber - wieżowiec
wonder - cud
wondervol - cudowny
woonkamer - pokój gościnny, duży pokój
woord - słowo, wyraz
woordenboek - słownik
worgen - dusić
worm - robak
worst - kiełbasa
worstelaar - zapaśnik
wortel - korzeń (rośliny;  ), marchew, pierwiastek
wortelstok - kłącze
woud - las, dżungla
wraak - zemsta, wraken
wreed - okrutny
wreker - mściciel
wrijven - trzeć, rozcierać
xenon - ksenon
ytterbium - iterb
yttrium - itr
zacht - miękki, delikatny
zachtmoedig - łagodny
zakkenroller - kieszonkowiec, złodziej kieszonkowy
zaklamp - latarka
zalm - łosoś
zand - piasek
zang - śpiew
zaterdag - sobota
zedelijk - moralny
zee - morze
zeegras - wodorost
zeep - mydło
zeeschelp - muszla
zegenen - błogosławić
zeggen - mówić, powiedzieć
zeis - kosa
zelden - rzadko
zeldzaamheid - rzadkość
zelfmoord - samobójstwo
zelfs - nawet
zelfstandig naamwoord - rzeczownik
zenden - wysyłać
zending - misja
zenit - zenit
zes - sześć, 6
zesde - szósty
zesendertig - trzydzieści sześć, 36
zesennegentig - dziewięćdziesiąt sześć, 96
zesentachtig - osiemdziesiąt sześć, 86
zesentwintig - dwadzieścia sześć, 26
zesenveertig - czterdzieści sześć, 46
zesenvijftig - pięćdziesiąt sześć, 56
zesenzestig - sześćdziesiąt sześć, 66
zesenzeventig - siedemdziesiąt sześć, 76
zestien - szesnaście
zestiende - szesnasty
zestig - sześćdziesiąt, 60
zestigste - szesnasty
zeven - siedem, 7
zevende - siódmy
zevenendertig - trzydzieści siedem, 37
zevenennegentig - dziewięćdziesiąt siedem, 97
zevenentachtig - osiemdziesiąt siedem, 87
zevenentwintig - dwadzieścia siedem, 27
zevenenveertig - czterdzieści siedem, 47
zevenenvijftig - pięćdziesiąt siedem, 57
zevenenzestig - sześćdziesiąt siedem, 67
zevenenzeventig - siedemdziesiąt siedem, 77
zeventien - siedemnaście
zeventiende - siedemnasty
zeventig - siedemdziesiąt
zichtbaar - widoczny
zichtbaarheid - widoczność
ziekenhuis - szpital
ziekte - choroba
ziel - dusza
zielkunde - psychologia
zien - widzieć
ziener - prorok
ziften - przesiewać
zij - jedwab
zijn - być, iść gdzieś z zamiarem szybkiego powrotu, równać się (tylko w 3. os. l. poj.), być następnym w kolejce do czegoś, jego
zijner - jego
zilver - srebro
Zimbabwe - Zimbabwe
zingen - śpiewać
zink - cynk
zinnelijk - zmysłowy
zinspreuk - motto
zirkonium - cyrkon
zitten - siedzieć
zitting - spotkanie
z'n - nieakcentowana forma zaimka "zijn" - jego
zoeken - szukać, poszukiwać
zoenen - całować
zoet - słodki
zomer - lato, zomeren
zomp - bagno
zon - słońce
Zon - Słońce
zondaar - grzesznik
zondag - niedziela
zondebok - kozioł ofiarny
zonder - bez
zone - strefa
zonneschijn - światło słoneczne
zonnewende - przesilenie
zonnig - słoneczny
zonsondergang - zachód słońca
zonsopgang - wschód Słońca
zonsopkomst - wschód Słońca
zoö- - zoo-
zoogdier - ssak
zoon - syn
zoöplankton - zooplankton
zout - sól
zouten - solić
zuid - na południe
Zuid-Afrika - Afryka Południowa
Zuid-Amerika - Ameryka Południowa
zuidelijk - południowy
Zuid-Korea - Korea Południowa
Zuid-Soedan - Sudan Południowy
zuigeling - niemowlę, noworodek
zuring - szczaw
zus - siostra
zuster - siostra
zuur - kwaśny, kwas
zuurstof - tlen
zwaan - łabędź
zwaar - ciężki, mocny
zwaard - miecz
zwager - szwagier
zwakte - słabość
zwaluw - jaskółka
zwam - grzyb
zwanger - w ciąży
zwangerschap - ciąża
zwart - czarny
zwavel - siarka
Zweden - Szwecja
Zweeds - szwedzki
zwellen - puchnąć
zwembad - basen
zwemmen - pływać
zwendelen - oszukiwać
zwenken - obracać
zweten - pocić się
zweven - szybować, unosić się
zwijn - świnia
zwinden - zniknąć
Zwitserland - Szwajcaria
ZZW - SSW, pd.-pd.-zach., południowy południowy zachód
