aabestik - alfabet
aabits - elementarz
Aada - Aada | estońskie imię żeńskie
Aadam - Adam | imię męskie
aadlik - szlachcic
aadress - adres
aafrika - afrykański
Aafrika - Afryka
aafriklane - Afrykańczyk | Afrykanka
aamen - amen
aare - skarb
Aare - Aare | estońskie imię męskie
Aarne - Aarne | estońskie imię męskie
aasia - azjatycki
Aasia - Azja
aasialane - Azjata
aasta - rok
aastaaeg - pora roku
aastapäev - rocznica
aatom - atom
aažio - ażio
abduktsioon - abdukcja
Abhaasia - Abchazja
abi - pomoc
abielluma - poślubić
abielu - małżeństwo
abielumees - mąż
abielupaar - para małżeńska
abikaasa - mąż | małżonek | żona | małżonka
abiogenees - abiogeneza | samorództwo
abistama - pomagać
abort - aborcja
abrasioon - abrazja
absint - absynt
absoluutne - absolutny
absoluutne kuulmine - słuch absolutny
abstraktne - abstrakcyjny
absurdne - absurdalny
absurdselt - absurdalnie
adapteerima - przystosować | przystosowywać
ader - pług
adjektiiv - przymiotnik
administraator - administrator
administratsioon - administracja
advokaat - adwokat
aed - ogród
aeg - czas
aeglane - powolny | wolny
aerograaf - aerograf
aevastama - kichać
afaasia - afazja
Afganistan - Afganistan
aga - ale
agressiivne - agresywny
agressioon - agresja
agrobioloogia - agrobiologia
agronoom - agronom
agu - zmierzch
ahel - łańcuch
ahi - piec | piecyk
ahm - rosomak
ahne - zachłanny | łapczywy
ahnus - chciwość | zachłanność
ahv - małpa
ahven - okoń
äi - teść
aiamaa - ogród
aiandus - ogrodnictwo
äike - piorun
Aili - Aili | estońskie imię żeńskie
aim - pojęcie | idea
aimama - przewidywać
aine - materia
Aino - Aino | estońskie imię żeńskie
ainult - tylko
ainus - jedyny
ait - stodoła
aitama - pomagać
ajaarvamine - era | chronologia
ajajärk - epoka
ajakiri - magazyn | czasopismo
ajakirjandus - dziennikarstwo
ajakirjanik - dziennikarz
ajal - podczas
ajaleht - gazeta | dziennik
ajaloolane - historyk
ajalooline - historyczny
ajalugu - historia
ajama - prowadzić
ajatolla - ajatollah
ajaviide - przeszłość
aju - mózg
ajutine - tymczasowy
akadeemia - akademia
akadeemik - akademik
akadeemiline - akademicki
aken - okno
akrüülvärv - akryl | farba akrylowa
aktiinium - aktyn
aktiivne - aktywny | zajęty | energiczny
aktiivsus - aktywność
aktsent - akcent
akustika - akustyka
akustiline - akustyczny
akvaarium - akwarium
akvarell - akwarela
ala - obszar
alaline - stały | ciągły
alandama - poniżać | upokarzać
alasti - nagi
alastus - nagość
alati - zawsze
alatiseks - na zawsze
albaania - albański
Albaania - Albania
albaanlane - Albańczyk | Albanka
albumiin - albumina
Aleuudid - Aleuty | Wyspy Aleuckie
algaine - element
algaja - początkujący
algama - zaczynać
algus - początek
alistama - opanowywać | ujarzmiać
Alje - estońskie imię żeńskie
alkohol - alkohol
alkohoolik - alkoholik
alkohoolne - alkoholowy
allahindamine - redukcja | zmniejszenie
alla kirjutama - śpiewać
allee - aleja
allegooria - alegoria
allergia - alergia | uczulenie
allergiline - alergiczny
allikas - źródło
allkiri - podpis
allveearheoloogia - archeologia podwodna
allveelaev - łódź podwodna | okręt podwodny
alpinism - alpinizm
alternatiiv - alternatywa
altkäemaks - łapówka
alumiinium - glin
aluspesu - bielizna
alustama - zacząć | rozpocząć
alustass - spodek
Alžeeria - Algeria
ämber - wiadro
ämblik - pająk
ameerika - amerykański
Ameerika - Ameryka
Ameerika Ühendriigid - Stany Zjednoczone
ameeriklane - Amerykanin | Amerykanka
ameriitsium - ameryk
amet - praca
ametlik - oficjalny | formalny
ämm - teściowa
ammu - dawno temu
amüloidoos - amyloidoza | skrobiawica | betafibryloza
anabolism - anabolizm
ananass - ananas
anastroof - anastrofa
anatoomia - anatomia
Andaluusia - Andaluzja
andekas - utalentowany | obdarzony
andestama - wybaczyć
andestamatu - niewybaczalny
Andorra - Andora
android - android
angerjas - węgorz
Angola - Angola
ankeet - ankieta
ankur - kotwica
Annika - Annika | Anika | estońskie imię żeńskie
Antarktika - Antarktyka
antibiootikum - antybiotyk
Antigua ja Barbuda - Antigua i Barbuda
antimon - antymon
antonüüm - antonim
aparaat - aparat
apelsin - pomarańcza
apenditsiit - zapalenie wyrostka robaczkowego
aplikaator - aplikator
apopleksia - apopleksja | udar mózgu
appi - pomocy!
aprikoos - morela
aprill - kwiecień
apteek - apteka
apteeker - aptekarz
araabia - arabski
Araabia emiraadid - Zjednoczone Emiraty Arabskie
Araabia meri - Morze Arabskie
araablane - Arab
arabesk - arabeska
arahnofoobia - arachnofobia
araukaaria - araukaria
arbuus - arbuz
arendama - rozwijać | rozbudowywać
arg - nieśmiały | bojaźliwy
argentiina - argentyński
Argentiina - Argentyna | Argentina
argentiinlane - Argentyńczyk | Argentynka
Argentina - Argentyna
arglikkus - nieśmiałość
argoon - argon
argpüks - tchórz
arheoloog - archeolog
arheoloogia - archeologia
arheoloogiline - archeologiczny
arhipelaag - archipelag
arhitekt - architekt
arhitektuur - architektura
arhivaar - archiwariusz
ärimees - biznesmen
aristokraat - arystokrata
Aristoteles - Arystoteles
arm - rana
armas - drogi | kochany
armastaja - kochany | ukochany
armastama - kochać
armastus - miłość
armee - armia
armeenia - ormiański
Armeenia - Armenia
armeenlane - Ormianin | Ormianka
armetu - nędzny
armukade - zazdrosny
armukadedus - zazdrość
armulugu - romans
armuma - zakochać się
Arno - Arno | estońskie imię męskie
aromaatne - aromatyczny
arseen - arsen
arst - doktor | lekarz
artikkel - artykuł
artistlik - artystyczny
aru - rozum | umysł
arusaamatus - nieporozumienie
arutama - dyskutować
arutelu - dyskusja
arütmia - arytmia
arvatavasti - prawdopodobnie | być może
arve - rachunek | konto
arvuti - komputer
ase - łóżko
aseksuaalne - aseksualny
aseksuaalsus - aseksualność
Aserbaidžaan - Azerbejdżan
aserbaidžaani - azerski | azerbejdżański
asjatundja - ekspert
askees - asceza
aspiriin - aspiryna
astaat - astat
asteroid - asteroida
astrobioloog - astrobiolog
astrobioloogia - astrobiologia
astrofüüsika - astrofizyka
astronoomia - astronomia
atakk - atak
ateism - ateizm
ateist - ateista
Atlandi ookean - Ocean Atlantycki
atmosfäär - atmosfera
august - sierpień
auk - dziura
aur - para
ausammas - monument | pomnik
Austraalia - Australia
Austria - Austria
autentne - autentyczny
auto - auto | samochód
autobiograafia - autobiografia
automaatne - automatyczny
autonoomia - autonomia
autopsia - autopsja
autor - autor
autosugestioon - autosugestia
avalik - publiczny | powszechny
avama - otwierać
baar - bar
baarium - bar
Baffini saar - Ziemia Baffina
Bahama - Bahamy
Bahama saared - Bahamy
baklažaan - bakłażan
Baleaarid - Baleary
balett - balet
balti - bałtycki
Baltica - Bałtyka
banaalne - banalny | pospolity
banaan - banan
Bangladesh - Bangladesz
bankett - bankiet
Barbados - Barbados
bassein - basen
beduiin - Beduin
beebi - dziecko | bobas
Beirut - Bejrut
Belgia - Belgia
Belize - Belize
Benin - Benin
benseen - benzen
bensiin - benzyna
berkeelium - berkel
Berliin - Berlin
berüllium - beryl
Bhutan - Bhutan
biofüüsika - biofizyka
biogenees - biogeneza
biograaf - biograf
biograafia - biografia
biokeemia - biochemia
bioloog - biolog
bioloogia - biologia
biosüntees - biosynteza
biotiin - biotyna
biseksuaalne - biseksualny
biseksuaalsus - biseksualizm
biskviit - herbatnik | ciasteczko
blond - blond
bohrium - bohr
boikott - bojkot
Boliivia - Boliwia
Bosnia ja Hertsegoviina - Bośnia i Hercegowina
botaanika - botanika
Botswana - Botswana
brändi - brandy | winiak
brasiilia - brazylijski
Brasiilia - Brazylia
brasiillane - Brazylijczyk
bretooni - bretoński | bretoński (język)
briljant - brylant
britlane - Brytyjczyk
broom - brom
buldooser - buldożer
bulgaaria - bułgarski | bułgarski (język)
Bulgaaria - Bułgaria
bulgaarlane - Bułgar
buliimia - bulimia
Burjaatia - Buriacja
bürokraatia - biurokracja
büroo - biuro
buss - autobus
bussijaam - dworzec autobusowy
bussijuht - kierowca autobusu
daam - dama
Damaskus - Damaszek
darmstadtium - darmsztadt
debatt - debata
deduktiivne - dedukcyjny
deemonlik - demoniczny
defekt - defekt | wada
defineerima - definiować
definitsioon - definicja
deism - deizm
dekoloniseerima - dekolonizować
delegatsioon - delegacja
delfiin - delfin
demarkatsioon - wytyczenie granic | demarkacja | rozgraniczenie | odgraniczenie
demograafia - demografia
demokraat - demokrata
demokraatia - demokracja
demokraatlik - demokratyczny
depressioon - depresja
desinfektsioon - dezynfekcja
dessert - deser
detsember - grudzień
diagnoos - diagnoza
diagramm - diagram
diameeter - średnica
dieet - dieta
difraktsioon - dyfrakcja
diivan - sofa | kanapa
dimorfism - dymorfizm
dinosaurus - dinozaur
direktiiv - dyrektywa
direktor - dyrektor
diskreetsus - dyskrecja
diskrimineerima - dyskryminować
diskussioon - dyskusja
dispuut - dysputa
distants - dystans
dokument - dokument
dolmen - dolmen
draakon - smok
draama - dramat
dramaatiline - dramatyczny
dublikaat - duplikat
dubnium - dubn
dünamo - prądnica
düsproosium - dysproz
dušš - prysznic
džäss - jazz
džässbänd - grupa jazzowa | zespół jazzowy
džässmuusik - muzyka jazzowa
džaul - dżul
džemm - dżem
džihaad - dżihad
džiip - dżip | jeep
ebaaus - nieuczciwy
ebainimlik - nieludzki
ebaloomulik - nienaturalny
ebaloomulikult - nienaturalnie
ebamäärane - nieokreślony | niejasny
ebameeldiv - nieprzyjemny
ebameeldivalt - nieprzyjemnie
ebamugav - niewygodny
ebamugavalt - niewygodnie
ebanormaalne - anormalny
ebanormaalsus - anormalność
ebapraktiline - niepraktyczny
ebaseaduslik - nielegalny
ebasõbralik - nieprzyjazny
ebaviisakas - niemiły | niegrzeczny
edasi - naprzód | do przodu
edel - południowy zachód
edu - sukces
eelkõige - przede wszystkim
eelmine - poprzedni
eesel - osioł
eeskiri - instrukcja | regulacja
eesmärk - cel
eesnimi - imię z chrztu
eesriie - zasłona
eesti - estoński
Eesti - Estonia
eestlane - Estończyk
eetika - etyka
efektne - spektakularny
ega - ani
egiptlane - Egipcjanin
Egiptus - Egipt
egiptuse - egipski
Egiptuse Araabia Vabariik - Arabska Republika Egiptu
egüptoloog - egiptolog
egüptoloogia - egiptologia
ehitaja - budowniczy
ehitama - budować
ehitis - budynek
ehitus - budynek
ehituskunst - architektura
ehk - lub | albo
ehmatus - strach | przerażenie | bojaźń
ehtne - prawdziwy
ei - nie - zaprzeczenie
ei keegi - nikt
eile - wczoraj
Eili - Eili | estońskie imię żeńskie
eilne päev - wczoraj
ei midagi - nic
eine - posiłek | przekąska
einsteinium - einstein
eksima - być w błędzie
eksistentsialism - egzystencjalizm
ekskursioon - wycieczka
eksobioloogia - astrobiologia
ekvaator - równik
elama - żyć
elanikkond - populacja
elastne - elastyczny
elavhõbe - rtęć
elekter - elektryczność
elektrienergia - energia elektryczna
elektrik - elektryk
elektriline - elektryczny
elektripliit - kuchenka elektryczna
elektriväli - pole elektryczne
elektromagnetism - elektromagnetyzm
Elevandiluurannik - Wybrzeże Kości Słoniowej
elevant - słoń
elu - życie
elukindlustus - ubezpieczenie na życie
elukoht - miejsce zamieszkania
elukutse - zawód | profesja
elulooline - biograficzny
elulugu - biografia
elutu - nieżywy | martwy | nieożywiony
elutuba - pokój gościnny | duży pokój
ema - matka
emakeel - język ojczysty
emalik - matczyny
emalõvi - lwica
embrüo - embrion
embrüoloogia - embriologia
embus - uścisk | objęcie
emfaas - emfaza
emiir - emir
emiraat - emirat
emotsionaalne - emocjonalny
emotsioon - emocja
empirism - empiryzm
enam - więcej
energeetika - energetyka
energia - energia
energiline - energetyczny
enesekaitse - samoobrona
enesekindel - pewny siebie
enesetapp - samobójstwo
enesetunne - uczucie | odczucie
enne - przed | zanim | wcześniej | omen | znak | zwiastun
enneaegne - przedwczesny
entsüklopeedia - encyklopedia
epideemia - epidemia
epideemiline - epidemiczny
epohh - epoka
eraldama - oddzielać | odseparowywać
eraldi - oddzielnie
erapooletu - bezstronny
erbium - erb
eriala - specjalność
erinev - inny | różny
eriti - szczególnie
erootiline - erotyczny
erootiliselt - erotycznie
erootilisus - erotyzm | erotyka
ese - obiekt | przedmiot | rzecz
esialgne - wstępny | próbny
esimene - pierwszy
eskimo - Eskimos
esmaspäev - poniedziałek
et - że
etanool - etanol
eteen - eten | etylen
etioloogia - etiologia
Etioopia - Etiopia
etniline - etniczny
etoloogia - etologia
ettekandja - kelner | kelnerka
ette nägema - przewidzieć
ettevaatlik - ostrożny
etüleen - etylen | eten
etümoloogia - etymologia
Euroopa - Europa
Euroopa Liit - Unia Europejska
euroopium - europ
eutanaasia - eutanazja
evakueerima - ewakuować
evolutsioon - ewolucja
Fääri saared - Wyspy Owcze
faasan - bażant
fakiir - fakir
fakt - fakt
Falklandi saared - Falklandy
fallos - penis
fanaatik - fanatyk
fanaatiline - fanatyczny
fantaasia - fantazja
fantastiline - fantastyczny
farmaatsia - farmacja
farmakoloogia - farmakologia
farmatseut - farmaceuta
fassaad - fasada
fermium - ferm
filiaal - filia
Filipiinid - Filipiny
film - film
filoloog - filolog
filoloogia - filologia
filosoof - filozof
filosoofia - filozofia
filosoofiline - filozoficzny
filosoofiliselt - filozoficznie
floora - flora
fluor - fluor
föderatsioon - federacja
följeton - felieton
foneetika - fonetyka
foneetiline - fonetyczny
foobia - fobia
foorum - forum
formaalsus - formalność
fosfor - fosfor
fotoaparaat - aparat fotograficzny
fotograaf - fotograf
fotograafia - fotografia
fotorealism - fotorealizm
frantsium - frans
fruktoos - fruktoza
funktsioon - funkcja
furunkul - czyrak
füsioloogia - fizjologia
fütobioloogia - fitobiologia
futuroloogia - futurologia
füüsik - fizyk
füüsika - fizyka
füüsiline - fizyczny
gaas - gaz
gaasipliit - kuchenka gazowa
gadoliinium - gadolin
galaktika - galaktyka
Galaktika - Droga Mleczna
galerii - galeria
Galilea - Galilea (kraina)
gallium - gal
garaaž - garaż
garantii - gwarancja
garderoob - garderoba
Gargantua - Gargantua
gastriit - zapalenie błony śluzowej żołądka | zapalenie żołądka | nieżyt żołądka
geenius - geniusz
geiser - gejzer
geneetika - genetyka
geofüüsika - geofizyka
geograafia - geografia
geoloog - geolog
geoloogia - geologia
germaani - niemiecki
germaanium - german
glatsioloogia - glacjologia
glükoos - glukoza
graafik - grafik | harmonogram
graafika - grafika
grammatika - gramatyka
graniit - granit
gravitatsioon - grawitacja
greif - gryf | gryfon
gripp - grypa
Gröönimaa - Grenlandia
grupp - grupa
Gruusia - Gruzja
günekoloogia - ginekologia
haak - hak
hääl - głos
hääldama - wypowiadać
hääletama - głosować
haamer - młot | młotek
haarama - chwycić | złapać
haav - rana
haavaside - bandaż
habe - broda
häbematu - bezwstydny
häbi - wstyd
häda - kłopot
hafnium - hafn
hahk - edredon
hai - rekin
haige - chory
haigla - szpital
haiglavoodi - łóżko szpitalne
haigutama - ziewać
hais - smród | odór
haisema - śmierdzieć | cuchnąć
Haiti - Haiti
hakk - kawka
hakkama - zaczynać
halb - zły
hale - żałosny | nędzny | smutny
hall - szary
halleluuja - alleluja
halvatus - paraliż
hambaarst - dentysta
hambahari - szczoteczka do zębów
hambapasta - pasta do zębów
hammas - ząb
hammustama - gryźć
hangelind - śnieguła
hani - gęś
hape - kwas
haplotüüp - haplotyp
hapnik - tlen
hapu - kwaśny
harakas - sroka
härg - byk
hari - szczotka
haridus - edukacja
harilik - zwyczajny
harjumus - zwyczaj
harrastus - hobby | zainteresowanie
haruldane - nietypowy
harva - rzadko
hassium - has
haud - grób
haug - szczupak
hävitaja - niszczyciel | kontrtorpedowiec | myśliwiec
hävitama - niszczyć
hävituslennuk - myśliwiec
hea - dobry
head aega - do widzenia | do zobaczenia
heasüdamlik - życzliwy | dobrotliwy
hedonism - hedonizm
heebrea - hebrajski (język)
heelium - hel
hein - siano
heinakuu - lipiec
hele - jasny | rozświetlony
helge - jasny
heli - dźwięk
helilooja - kompozytor
helio- - helio-
heliplaat - płyta | nagranie
helmekuu - styczeń
heraldika - heraldyka
herilane - osa
heroiin - heroina
heteroseksuaalne - heteroseksualny
heteroseksuaalsus - heteroseksualizm
hetk - moment
higi - pot
higine - spocony
hiiglane - gigant
Hiina - Chiny
hiir - mysz
hilinema - spóźniać się
hiljuti - ostatnio | niedawno
hind - cena
hinduism - hinduizm
hing - dusza
hingama - oddychać
hinnaline - wartościowy | cenny | kosztowny
hirsutism - hirsutyzm
hirv - jeleń
hispaania - hiszpański | hiszpański (język)
Hispaania - Hiszpania
hõbe - srebro
hobujõud - koń mechaniczny
hobune - koń
hoiatus - ostrzeżenie
hoidma - trzymać
hollandi - holenderski | holenderski (język)
holmium - holm
hõlmkuu - wtorek
homme - jutro
hommik - rano | poranek
hommikueine - śniadanie
hommikusöök - śniadanie
homonüüm - homonim
homoseksuaalsus - homoseksualizm
Hongkong - Hongkong
hooaeg - sezon | pora roku
hooletu - beztroski
hoor - dziwka | kurwa
hõõrumine - tarcie
Horvaatia - Chorwacja
hotell - hotel
hüdrobioloogia - hydrobiologia
hüdroloogia - hydrologia
huligaan - huligan
hüljes - foka
hulk - ilość
hull - szalony
hümn - hymn
hunt - wilk
hüpe - skok
hüpersomnia - hipersomnia
hüppama - skakać
hüüatus - okrzyk | krzyk | wykrzyknienie
hüüdma - krzyczeć | wołać
huul - warga
huulepulk - szminka
huumor - humor
hüüp - bąk
hüüumärk - wykrzyknik | znak wykrzyknienia
huvitav - ciekawy | interesujący
huvi tundma - interesować się | być zainteresowanym
ida - wschód
Ida-Aasia - Azja Wschodnia
Ida-Timor - Timor Wschodni
ideaalne - idealny
idealistlikult - idealistycznie
idee - idea
idioot - idiota
idiootlik - idiotyczny
iga päev - codziennie | każdego dnia
igatsus - tęsknota
igaüks - każdy | wszyscy
igav - nudny
igaveseks - na zawsze
ige - dziąsło
ihu - ciało
iialgi - nigdy
Iisrael - Izrael
ike - jarzmo
ikka - zawsze
ilm - pogoda
ilma - bez
ilmselt - ewidentnie | najwyraźniej
ilukirjandus - fikcja
ilus - ładny | piękny | uroczy
ilves - ryś
imaam - imam
ime - cud
imelik - dziwny
imetaja - ssak
immuunsüsteem - układ odpornościowy | układ immunologiczny
impressionism - impresjonizm
improvisatsioon - improwizacja
indiaani - indiański
India ookean - Ocean Indyjski
indium - ind
Indoneesia - Indonezja
Indrek - Indrek | estońskie imię męskie
inetu - brzydki
infektsioon - infekcja
informatsioon - informacja
informeerima - informować
infrastruktuur - infrastruktura
ingel - anioł
ingellik - anielski
inglane - Anglik
inglise - angielski
Inglismaa - Anglia
ingver - imbir
inimene - człowiek
inimlik - ludzki
institutsioon - instytucja
instrument - instrument
interjektsioon - wykrzyknienie
Iraak - Irak
Iraan - Iran
iriidium - iryd
Irja - Irja | estońskie imię żeńskie
irratsionaalne - irracjonalny
isa - ojciec
isamaa - ojczyzna
isamaaline - patriotyczny
isamaalisus - patriotyzm
iseäralik - wyjątkowy | specjalny | szczególny
iseloom - charakter
iseseisvus - niepodległość
isik - osoba
isiklik - osobisty | personalny | indywidualny
isiklikult - osobiście
islam - islam
islandi - islandzki
islandlane - Islandczyk
isoleerima - izolować
istuma - siedzieć
isu - apetyt
isuri - ingryjski | iżorski
itaalia - włoski | język włoski
Itaalia - Włochy
ja - i
jaa - tak
jää - lód (zamarznięta woda)
jääaegne - lodowcowy
Jaagup - Jaagup | estońskie imię męskie | wariant imion Jakob i Jaakob
jäälind - zimorodek
jaam - stacja | dworzec
jäämägi - góra lodowa
jäämurdja - lodołamacz
jaanuar - styczeń
Jaapan - Japonia
jaapani - japoński | japoński (język)
jaapanlane - Japończyk
jääpurikas - sopel
jäätis - lody
jagama - dzielić
jah - tak
jahe - chłodny
jahu - mąka
jakk - kurtka | marynarka
jalg - stopa
jälg - ślad
jalgpall - piłka nożna
jalgratas - rower
jälle - znów | znowu
jalutaja - piechur | spacerowicz
jalutama - spacerować
Janek - Janek | estońskie imię męskie | wariant imion Jaan i Johannes
jänes - zając
janu - pragnienie
järgmine - następny
järjehoidja - zakładka
järv - jezioro
jasmiin - jaśmin
Jeemen - Jemen
Jeesus - Jezus
Jeesus Kristus - Jezus Chrystus
jõehobu - hipopotam
jõgi - rzeka
jõhvikas - żurawina
jonnakas - uparty | zawzięty
jood - jod
joodik - pijak
jooga - joga
joogi - jogin
jook - napój | picie
jooks - bieg
jooma - pić
joon - linia
jõud - siła
jõuline - dokonany przemocą | gwałtowny | żywiołowy
jõulud - Boże Narodzenie
jõulukuu - grudzień
Jõulusaar - Wyspa Bożego Narodzenia
jube - straszny
juhataja - kierownik | dyrektor | szef
juhend - instrukcja
juhind - dyrektywa
juht - kierowca
juhtuma - stać się | wydarzyć się | nastąpić
juhuslik - przypadkowy
julgus - śmiałość | odwaga
jumal - bóg
jumal tänatud - dzięki Bogu
jumalus - bóstwo
jurist - prawnik
justiits - sprawiedliwość
jutt - rozmowa | konwersacja
juuli - lipiec
juuni - czerwiec
juur - korzeń
juurvili - warzywo
juust - ser
juut - żyd
juveelitooted - biżuteria
juveliir - jubiler
kaabu - kapelusz
kaadmium - kadm
kaal - waga
kaalium - potas
kaaluma - ważyć
kaamel - wielbłąd
kaamera - kamera
kaanon - kanon
kaar - łuk
käärid - nożyczki | nożyce
kaart - mapa
kaasavara - posag
kaasosaline - partner | wspólnik
kabel - kaplica
kabinet - gabinet
kadakas - jałowiec
kade - zazdrosny
Kadi - Kadi | estońskie imię żeńskie
Kadri - Kadri | estońskie imię żeńskie
kaebama - narzekać | skarżyć się
kael - szyja
kaelakee - naszyjnik
kaelkirjak - żyrafa
kaevur - górnik
kafeteeria - kafeteria | kawiarnia
kagu - południowo-wschodni
kägu - kukułka
Kagu-Aasia - Azja Południowo-Wschodnia
kahekordne - podwójny
kaheksa - osiem (8)
kaheksakümmend - osiemdziesiąt
kaheksas - ósmy
kaheksateist - osiemnaście
kaheksateistkümnes - osiemnasty
kahekümnes - dwudziesty
kaheteistkümnes - dwunasty
kahjuks - niestety
kahtlustama - podejrzewać
kahvatu - blady
kahvel - widelec
Kaisa - Kaisa | estońskie imię żeńskie
käituma - zachowywać się
kaja - echo
kajakas - mewa
kaklema - walczyć
kaks - dwa (2)
kaksik - bliźniak
kakskümmend - dwadzieścia
kaksteist - dwanaście | 12
kala - ryba
kalamari - kawior | ikra
kalastama - łowić
käli - szwagierka
kalifornium - kaliforn
kaliiber - kaliber
kalju - głaz | skała
kalkun - indyk
kallaletung - atak | agresja
kallas - brzeg
kallis - drogi | kosztowny
kalliskivi - klejnot | kamień szlachetny
kallistus - uścisk | objęcie
kalmistu - cmentarz
kaltsium - wapń
Kamerun - Kamerun
kana - kurczak | kura
Kanaari saared - Wyspy Kanaryjskie
Kanada - Kanada
kanamuna - jajko
kanarbik - wrzos
kanarbikukuu - wrzesień
kanep - konopie
kangelane - bohater
kangelaslik - bohaterski
kangelaslikkus - bohaterstwo | heroizm
känguru - kangur
kannatus - cierpliwość
kaootiline - chaotyczny
kaos - chaos
kapitalist - kapitalista
kapitalistlik - kapitalistyczny
kapitulatsioon - kapitulacja
kapituleeruma - kapitulować
käpp - łapa
kapsas - kapusta
kapten - kapitan
kära - hałas
karakter - charakter
kardemon - kardamon
karikatuur - karykatura
karistama - karać | ukarać
karjäär - kariera
kärnkonn - ropucha
kartul - ziemniak | kartofel
karu - niedźwiedź
kasahh - kazachski
Kasahstan - Kazachstan
käsi - ręka
kasiino - kasyno
kask - brzoza
käskkiri - dyrektywa
kass - kot
kassikakk - puchacz
kastraat - kastrat
kasulik - przydatny | użyteczny
kasutaja - użytkownik
kasutama - używać
kasvama - rosnąć
kataloog - katalog
katastroof - katastrofa
katastroofiline - katastrofalny
katastroofiliselt - katastrofalnie
katedraal - katedra
kategooria - kategoria
kategooriline - kategoryczny
käterätik - ręcznik
Kätlin - Kätlin | estońskie imię żeńskie
katoliku - katolicki
Katre - Katre | estońskie imię żeńskie
kättemaks - zemsta
kättemaksuhimuline - mściwy
katus - dach
kaubamärk - znak towarowy
kaugus - dystans | odległość | dal
Kaukaasia - Kaukaz
kaukaaslane - mieszkaniec Kaukazu
kaunidus - piękno
kaunilt - pięknie
kaunis - piękny
kaur - nur
kaval - chytry
kee - naszyjnik
keegi - ktoś
keel - język | mowa
keeleteadus - językoznawstwo
keemia - chemia
keemik - chemik | aptekarz | farmaceuta
keemiline - chemiczny
keemiline füüsika - fizyka chemiczna
keeristorm - cyklon
keevitaja - spawacz
kehakultuur - kultura fizyczna
keiser - cesarz
kenasti - ładnie | uroczo | miło
Kenya - Kenia
kerjus - żebrak
Kerli - Kerli | estońskie imię żeńskie
Kersti - Kersti | estońskie imię żeńskie
kesakuu - czerwiec
Kesk-Euroopa - Europa Środkowa
kesköö - północ
kett - łańcuch
kevad - wiosna
kibe - gorzki
kiilaspäine - łysy
kiir - promień
kiiresti - szybko | prędko
kiirgusfüüsika - radiofizyka
kiitma - chwalić
kiivi - kiwi
kiivitaja - czajka
kilpkonn - żółw
kindlasti - pewnie | na pewno
king - but
kinnas - rękawiczka
kino - kino
kirik - kościół
kirjandus - literatura
kirjanik - pisarz
kirjutama - pisać
kirjutusmasin - maszyna do pisania
kirp - pchła
kirurg - chirurg
kirves - siekiera
kitarr - gitara
kits - koza
kitsas - wąski
kivirullija - kamusznik
kivitäks - białorzytka
klass - klasa
klassifikatsioon - klasyfikacja
klaviatuur - klawiatura
kleepima - kleić
kleptomaania - kleptomania
kliima - klimat
kliinik - klinika
kliiniline - kliniczny
kloor - chlor
klooster - opactwo | klasztor
kobras - bóbr
kodakondsus - obywatelstwo
kodu - dom
kodumaa - ojczyzna
kodusõda - wojna domowa
koer - pies
kofeiin - kofeina
kogemata - przypadkowo | przypadkiem
kogunema - zbierać
köha - kaszel
kohalik - lokalny | miejscowy
köhima - kaszleć
koht - miejsce
kõht - brzuch
kohtama - spotykać
kohtunik - sędzia
kohustuslik - obowiązkowy
kohv - kawa
kohvibaar - bar kawowy | kawiarnia
kohvipuu - kawowiec
Koidu - Koidu | estońskie imię żeńskie
kõiv - brzoza
kokaiin - kokaina
kokku - razem | wspólnie
kokkuhoid - oszczędzanie | oszczędność
kokkuhoidlik - oszczędny
kokkupuude - kontakt
kõlblusõpetus - etyka
kole - okropny | wstrętny
kollane - żółty
kollisioon - kolizja
kolm - trzy (3)
kolmapäev - środa
kolmas - trzeci
kolmeteistkümnes - trzynasty
kolmkümmend - trzydzieści
kolmteist - trzynaście
kolmvarvas-rähn - dzięcioł trójpalczasty
kolonialism - kolonializm
kolonn - kolumna
kolp - czaszka
Kolumbus - Kolumb (odkrywca)
komissariaat - komisariat
komöödia - komedia
komparatiiv - porównawczy | komparatywny
kompositsioon - kompozycja
kompuuter - komputer
kõndima - chodzić
kõne - mowa
kõnelema - mówić
konjak - koniak
konn - żaba
konserv - konserwa
konstruktivism - konstruktywizm
kont - kość
kontinent - kontynent
kontinentaalne - kontynentalny
kontroll - kontrola
kontrollima - sprawdzać | kontrolować
kontseptuaalne - konceptualny
kontsert - koncert
koobalt - kobalt
köök - kuchnia
Kookossaared - Wyspy Kokosowe
kool - szkoła
koolera - cholera
kooljakuu - listopad | październik
kõõlus - ścięgno
kõõm - łupież
koopia - kopia
koor - chór | śmietana
koputama - pukać
Koraan - Koran
kõrb - pustynia
kõrge - wysoki
kõrgendama - podwyższać
Kõrgõzstan - Kirgistan
kõri - gardło
korporatsioon - korporacja
korruptsioon - korupcja
korsten - komin
korv - kosz
kõrv - ucho
kõrvits - dynia
korvpall - koszykówka
kosk - wodospad
kosmeetikakabinet - gabinet kosmetyczny
kosmeetine - kosmetyczny
kosmiline - kosmiczny
kosmoselaev - statek kosmiczny
kotkas - orzeł
kõva - twardy
kraad - stopień
kraan - kran
krabi - krab
kreeka - grecki
Kreeka - Grecja
kriitiline - krytyczny
kristall - kryształ
Kristel - Kristel | estońskie imię żeńskie
Kristi - Kristi | estońskie imię żeńskie
Kristiina - Krystyna | estońskie imię żeńskie
kristlus - chrześcijaństwo
kronoloogia - chronologia
kroom - chrom
krüptograafia - kryptografia
krüptograafiline - kryptograficzny
krüptoon - krypton
ksenobioloogia - astrobiologia
ksenoon - ksenon
kube - pachwina
küber- - cyber- (internetowy)
kubism - kubizm
kuiv - suchy
kukk - kogut
kukkuma - spadać
küla - wioska
külaelanik - wieśniak | mieszkaniec wsi | wioski
külaline - gość
külastama - odwiedzić | odwiedzać | gościć u kogoś
kuld - złoto
külgetõmbav - atrakcyjny | pociągający
kulinaaria - kulinaria | sztuka kulinarna
kullassepp - jubiler
kulles - kijanka
külm - zimny
külmik - chłodziarka | lodówka
külmkapp - lodówka
kultuur - kultura
kümme - dziesięć
kümnes - dziesiąty
kunde - klient
kuningriik - królestwo
künnis - próg
kunst - sztuka (twórczość)
kunstiteraapia - arteterapia
kunstlik - sztuczny
kunstnik - artysta
küpress - cyprys
kurat - diabeł
kuratlik - diabelski
kurb - smutny
kurbus - smutek
kurdi - kurdyjski
kuri - zły | wściekły
kurk - gardło | ogórek
kurt - głuchy | głucha osoba
kurtus - głuchota
küsimus - pytanie
kutse - zaproszenie
kütus - paliwo
kuu - księżyc | miesiąc
kuues - szósty
kuueteistkümnes - szesnasty
kuulama - słuchać
küülik - królik
kuulsus - sławny
kuuluma - należeć
kuum - gorący
kuumus - gorąco
küünal - świeca
küünarnukk - łokieć
küünlakuu - wtorek
kuup - sześcian | kostka
kuupäev - data
kuurium - kiur
kuus - sześć (6)
küüs - paznokieć
kuuskümmend - sześćdziesiąt
küüslauk - czosnek
kuusteist - szesnaście
Kuveit - Kuwejt
laama - lama
Lääne - prowincja w zachodniej Estonii
Lääne-Euroopa - Europa Zachodnia
Läänemeri - Morze Bałtyckie
laanenäär - sójka syberyjska | sójka złowroga
lääs - zachód
laatsaret - szpital
labane - banalny | tani | wulgarny | prostacki | pospolity | ordynarny
laen - dług | pożyczka | zapożyczenie
laenama - pożyczać
laev - statek
lagi - sufit
lähedus - bliskość
Lähis-Ida - Bliski Wschód
lai - szeroki
laine - fala
laineline - falisty
laisk - leniwy
lame - płaski
lammas - owca
lämmastik - azot
langema - spadać | upadać
langetõbi - padaczka | epilepsja
lantaan - lantan
laps - dziecko
Lassi - toponim | nazwa dwóch wsi estońskich w gminach Salme i Emmaste
Läti - Łotwa
laud - stół
lauk - czosnek | łyska
laul - piosenka
laulma - śpiewać
laululuik - łabędź krzykliwy
laup - czoło
laupäev - sobota
laut - stajnia
lävi - próg
lavrentsium - lorens
Leedu - Litwa
leer - obóz
leevike - gil
lehis - modrzew
lehm - krowa
leht - liść
leib - chleb
leidma - znaleźć
Leili - Leili | estońskie imię żeńskie
leitnant - porucznik
lend - lot
lendama - latać
Lennart - Lennart | estońskie imię męskie
lennujaam - lotnisko
lennuk - samolot
lepp - olszyna | olcha
lesk - wdowiec
libahunt - wilkołak
Libeeria - Liberia
liblikas - motyl
ligidal - blisko
liha - mięso
lihas - mięsień
lihavõtted - Wielkanoc
lihtne - prosty | łatwy
lihunik - rzeźnik
Liia - Liia | estońskie imię żeńskie
Liibanon - Liban
liibanoni - libański
liibanonlane - Libańczyk
Liibüa - Libia
Liidia - Liidia | estońskie imię żeńskie
liiga - też
liik - rodzaj | gatunek
Liilia - Lilia | estońskie imię żeńskie
liim - klej
Liina - Liina | estońskie imię żeńskie
Liis - Liis | estońskie imię żeńskie
Liisbet - Liisbet | estońskie imię żeńskie
Liisi - Liisi | estońskie imię żeńskie
liiter - litr
liitium - lit
liiv - piasek
liivakell - klepsydra
Liivi - Liivi | estońskie imię żeńskie
liköör - likier
lill - kwiat
lillkapsas - kalafior
limonaad - lemoniada
lind - ptak
linn - miasto
linnus - zamek
Linnutee - Droga Mleczna
lipp - flaga | hetman | królowa | dama
lips - krawat
lisama - dodawać
literatuur - literatura
liustik - lodowiec
lõbu - przyjemność
lõbumaja - burdel
lõbus - wesoły
lõbustus - rozrywka
lohe - smok
lõhn - zapach | woń
lõikuskuu - sierpień
loll - głupi
London - Londyn
loodus - natura
loogika - logika
loom - zwierzę
lööma - uderzyć
loomaarst - weterynarz
loomapsühholoogia - psychologia zwierząt
loomulik - naturalny
lootus - nadzieja
lootusetu - beznadziejny
loov - kreatywny
loovus - kreatywność
lõpetama - kończyć
loss - zamek
lõug - broda
Lõuna-Aafrika - Afryka Południowa
Lõuna-Ameerika - Ameryka Południowa
Lõuna-Korea - Korea Południowa
lõvi - lew
Loviise - estońskie imię żeńskie
luba - zezwolenie | pozwolenie
lühik - krótki
lühike - krótki
lühinägevus - krótkowzroczność
luik - łabędź
lükkama - pchać
lükopeen - likopen
lumepüü - pardwa górska
lumi - śnieg
lusikas - łyżka
luteetsium - lutet
luu - kość
luul - urojenie
luule - poezja
Luule - Luule | estońskie imię żeńskie
luulekunst - ars poetica | sztuka poetycka
luuletaja - poeta
luuletus - wiersz
luuüdi - szpik kostny
Maa - Ziemia
maailm - świat
maailmajagu - kontynent
maal - malarstwo
maalija - malarz
maania - mania
Maarika - Maarika | estońskie imię żeńskie | wariant imienia Marika
Maarja - Maarja | estońskie imię żeńskie
Maarjo - Maarjo | estońskie imię męskie | wariant imienia Mario
maasikas - truskawka
maavärin - trzęsienie ziemi
Madalmaad - Holandia
Madi - Madi | estońskie imię męskie | krótko od Mattias | Matteus
Madis - Madis | estońskie imię męskie | skrócenie imion Mattias i Matteus
madrus - marynarz
madu - wąż
magama - spać
mäger - borsuk
mägi - góra
magneesium - magnez
magus - słodki
mahl - sok
mai - maj
Maimu - estońskie imię żeńskie
mainima - wspominać | wzmiankować
mais - kukurydza
maitse - smak
maitsekas - smaczny
maitsev - smaczny
maja - dom
majakas - latarnia morska
makaron - makaron
Makedoonia - Macedonia
makedoonlane - Macedończyk
makromolekul - makromolekuła | makrocząsteczka
maks - wątroba
maksma - płacić
malaaria - malaria
Malaisia - Malezja
mäletama - pamiętać
mänd - sosna
mäng - gra
mangaan - mangan
mänsak - orzechówka
mära - klucz
mardikas - żuk
Marek - Marek | estońskie imię męskie
märg - mokry | wilgotny
Margit - Małgorzata | estońskie imię żeńskie
Margo - Margo | estońskie imię męskie | wariant imienia Markus
Maria - Maria (imię żeńskie)
marihuaana - marihuana
Marika - Marika
märklaud - cel
marmor - marmur
Märt - Märt | estońskie imię męskie | wariant imienia Martin
märts - marzec
masin - maszyna
maskuliin - męski
massaaž - masaż
masseerima - masować
masturbeerima - masturbować się
mateeria - materia
matemaatik - matematyk
matemaatika - matematyka
matemaatiline - matematyczny
materjal - materiał
matk - wycieczka | wędrówka
matus - pogrzeb
Mauritaania - Mauretania
mausoleum - mauzoleum
me - my
meditsiin - medycyna
meditsiinidoktor - doktor medycyny
meditsiiniline - medyczny
meditsiiniõde - pielęgniarka | pielęgniarz
meeldima - lubić
Meelis - Meelis | estońskie imię męskie
meenutama - przypominać
mees - mężczyzna | mąż
meessoost - męski
Mehhiko - Meksyk
Mehis - Mehis | estońskie imię męskie
meie - my
meisterlik - mistrzowski
meitneerium - meitner
melanhoolia - melancholia
melanhoolne - melancholijny
meloodia - melodia
mendeleevium - mendelew
menu - sukces
menüü - menu
merebioloogia - biologia morza
meremees - marynarz
mererand - plaża
merevaik - bursztyn
meri - morze
merikajakas - mewa
mesitaru - ul
metabolism - metabolizm
metafüüsika - metafizyka
metall - metal
metallurgia - metalurgia
meteoor - meteor
meteoriit - meteoryt
meteoriitika - meteorytyka
mets - las
metsis - głuszec
metskurvits - słonka
metsvint - zięba
mihklikuu - wrzesień
Miikael - Michał | estońskie imię męskie
Miiko - Miiko | estońskie imię męskie
Mikk - Mikk | estońskie imię męskie | krótko od Mihkel
mikrobioloogia - mikrobiologia
mikroorganism - mikroorganizm
miljon - milion
miljonär - milioner
millivolt - miliwolt
mina - ja
minarett - minaret
mineraalõli - olej mineralny
mineraloogia - mineralogia
minia - synowa
minu - mój
mitte - nie
modifitseerima - modyfikować | zmieniać | przekształcać
mõdu - miód pitny
möga - nonsens
mõistma - rozumieć
mõju - wpływ
moldaavlane - Mołdawianin
mölder - młynarz
molekul - cząsteczka
molekulaarbioloogia - biologia molekularna
molekulaarfüüsika - fizyka molekularna
molübdeen - molibden
monarhia - monarchia
Mongoolia - Mongolia
mõnikord - czasami
monogaamia - monogamia
monoteism - monoteizm
Montenegro - Czarnogóra
mõnus - wygodny
mööbel - mebel
mood - moda | styl
mõõk - miecz
moos - dżem
moosekant - muzyk | muzykant
moraalsus - moralność
morfiin - morfina
mõrtsukas - morderca
mõrv - morderstwo
mõrvama - mordować
mõrvar - morderca
Mosambiik - Mozambik
mošee - meczet
mõte - pomysł
mõtlema - myśleć
mugav - wygodny
mugavus - komfort | wygoda
mükoloogia - mykologia
muld - ziemia | gleba
multimiljonär - multimilioner
muna - jajko
münt - moneta
müoopia - krótkowzroczność
mure - żal | zmartwienie
mürgine - trujący
mürgitama - truć | zatruć | otruć
mürk - trucizna
murrak - dialekt
murre - dialekt
musikaalsus - muzykalność
muskel - mięsień
muslim - muzułmanin
must - czarny
mustikas - borówka amerykańska
musträhn - dzięcioł czarny
mütoloogia - mitologia
müüja - sprzedawca
müüma - sprzedawać
muuseum - muzeum
muusik - muzyk
muusika - muzyka
müüt - mit
muutma - zmieniać
naaber - sąsiad
naatrium - sód
naba - pępek
nädal - tydzień
nädalalõpp - weekend
nädalavahetus - weekend
naer - śmiech
naerma - śmiać się
nägemist - do widzenia
nägus - przystojny | ładny
nahk - skóra
nahkhiir - nietoperz
näide - przykład
näiline - iluzja
naine - kobieta | żona
naispolitseinik - policjantka
näitleja - aktor
näitlejanna - aktorka
näitlejatar - aktorka
nakkus - infekcja
nälg - głód
nali - żart
näljane - głodny
Namiibia - Namibia
närima - żuć
narkolepsia - narkolepsja
närv - nerw
natsionaalbolševism - narodowy bolszewizm
natsionalism - nacjonalizm
natsionalist - nacjonalista
natsioon - naród
naturalisatsioon - naturalizacja
neel - gardło
neelama - połykać | przełykać
Neitsisaared - Wyspy Dziewicze
neli - cztery
nelikümmend - czterdzieści
neliteist - czternaście
neljapäev - czwartek
neljas - czwarty
neljateistkümnes - czternasty
neodüüm - neodym
neoon - neon
neptuunium - neptun
neurobioloogia - neurobiologia
neuroloogia - neurologia
neuropatoloogia - neuropatologia
neuropsühholoogia - neuropsychologia
neuroteadus - neurobiologia
neutraliteet - neutralność
niatsiin - niacyna
nihilism - nihilizm
niikuinii - jakkolwiek
niiske - wilgotny | zwilżony
nikkel - nikiel
nikotiin - nikotyna
nimi - imię | nazwa
ninasarvik - nosorożec
ning - i
nioobium - niob
nisu - pszenica
nobeelium - nobel
nõel - igła
nõges - pokrzywa
nõid - wiedźma
noor - młody
nõrk - słaby
Norra - Norwegia
nostalgia - nostalgia
Nõukogude Liit - Związek Radziecki
nõunik - doradca
november - listopad
nuga - nóż
nukk - lalka
number - liczba
nüüd - teraz
objektiiv - obiektyw
objektiivselt - obiektywnie
observatoorium - obserwatorium
odav - tani
odavalt - tanio
oder - jęczmień
õgard - żarłok
õhk - powietrze
ohtlik - niebezpieczny
õhtu - wieczór
õigesti - właściwie
õigeusklik - ortodoksyjny
õiglane - uczciwy | szczery
õiglus - sprawiedliwość
õigusteadlane - prawoznawca
õilis - szlachetny
õis - kwiat (pączek)
õitsema - prosperować
oivaline - wyśmienity | doskonały | smaczny
Okeaania - Oceania
ökonomeetriline - ekonometryczny
ökonomist - ekonomista
ökonoomika - ekonomia
oks - gałąź
okse - wymiociny
oktoober - październik
okultism - okultyzm
okupatsioon - okupacja
okupeerima - okupować
oled - olema
olema - być
oleme - olema
olen - olema
olenema - zależeć | polegać na
olete - olema
oliivipuu - drzewo oliwne
õlu - piwo
oluline - podstawowy | ważny | znaczący | istotny
oma - własny
omadussõna - przymiotnik
omama - posiadać
omand - własność
omanik - właściciel
omapärane - oryginalny
omlett - omlet
on - i olema
onkoloog - onkolog
onkoloogia - onkologia
õnn - radość | szczęście
õnnelik - szczęśliwy
önoloogia - enologia
onu - wujek
öö - noc
ööbik - słowik
ookean - ocean
ööklubi - klub nocny, nocny klub
öökull - sowa
ooper - opera
oopium - opium
ootama - czekać
ootamatu - nieoczekiwany
ootamatult - nieoczekiwanie
opaal - opal
operaator - operator (kamery)
õpetaja - nauczyciel
õpetama - uczyć
õpetamine - nauczanie
õpik - podręcznik
orav - wiewiórka
orb - sierota
orbiit - orbita
orel - organ
org - dolina
organisatsioon - organizacja
organism - organizm
orgasm - orgazm
orgia - orgia
orhidee - orchidea
ori - niewolnik
orientatsioon - orientacja
origami - origami
originaalne - oryginalny
orjus - niewolnictwo
orkester - orkiestra
ortodoksne - ortodoksyjny
osa - część
osake - cząstka
osakeste füüsika - fizyka cząstek (elementarnych)
osakond - oddział | departament
oskama - wiedzieć
osmium - osm
ost - zakup
ostma - kupować
östrogeen - estrogen
otell - hotel
otsima - szukać
otsing - szukanie | poszukiwanie | wyszukiwanie
otsus - decyzja
õun - jabłko
õunapuu - jabłoń
ovaal - owal
ovulatsioon - owulacja | jajeczkowanie
paabulind - paw
paanika - panika
paar - para
pääsuke - jaskółka
paat - łódka | łódź
paber - papier
padi - poduszka
pael - wstążka
päev - dzień
pagar - piekarz
pagas - bagaż
paha - zły
pähkel - orzech
paik - miejsce
päike - słońce
päikesefüüsika - heliofizyka | fizyka Słońca
päikeseloojang - zachód słońca
painduma - zginać
paise - ropień | wrzód
paistetus - obrzęk | puchlizna
paju - wierzba
pakkuma - oferować
paks - gęsty
palav - gorący
palavik - gorączka | temperatura
palee - pałac
Palestiina - Palestyna
palitu - płaszcz
paljas - nagi | goły
palkon - balkon
pallaadium - pallad
paluma - pytać o | prosić
pandeism - pandeizm
panema - umieszczać
pang - wiadro
pangatäht - banknot
pankur - bankier
panteism - panteizm
papagoi - papuga
paralüüs - paraliż
parameedik - paramedyk
parameeter - parametr
paras - wystarczający | właściwy | pasujący | odpowiedni
Pariis - Paryż
parkima - parkować
pärm - drożdże
pärmseened - drożdże
part - kaczka
parun - baron
pask - gówno
päts - bochenek
patsient - pacjent
pealinn - stolica | miasto stołeczne
pealkiri - tytuł
pealuu - czaszka
peamine - główny | podstawowy | fundamentalny
peaminister - premier
peavalu - ból głowy
peegel - lustro
peenis - penis
pehme - miękki
peitma - chować
pere - rodzina
perekond - rodzina
perkussioon - perkusja
personifikatsioon - personifikacja
Peruu - Peru
pesa - gniazdo
pesema - myć | czyścić | zmywać
petersell - pietruszka
pidutsema - świętować
pidžaama - piżama
pihlakas - jarzębina
Piibel - Biblia
piilpart - cyraneczka
piim - mleko
piiramatu - absolutny | nieograniczony
piiritaja - jerzyk
piirjoon - granica
piiskop - biskup
pikk - długi
pikkamisi - wolno | powoli
pikkus - długość
pildistama - fotografować
pilet - bilet
piloot - pilot
pilt - obrazek | zdjęcie | ilustracja
pilv - chmura
pilvine - pochmurny
pilvitu - bezchmurny
pime - ciemny
pind - powierzchnia
pingviin - pingwin
pink - ławka
pintsak - kurtka
pipar - pieprz
pirn - gruszka
pisike - maleńki
pisut - mało | niewiele
pitsat - pieczęć
Pittsburgh - Pittsburgh (stolica Allegheny)
plaan - plan | projekt
plaat - płyta
plaatina - platyna
plagiaator - plagiator
plakat - plakat
planeet - planeta
plats - plac
plejaad - plejada
plekk - plama
plii - ołów
pliiats - ołówek
ploom - śliwka
ploomipuu - śliwa
plutoonium - pluton
pluus - bluza | bluzka
põder - łoś
podiaatria - podologia
poeesia - poezja
poeet - poeta
poeg - chłopak | syn
põgenema - uciekać | uciec
Põhja-Aafrika - Afryka Północna
Põhja-Ameerika - Ameryka Północna
Põhja-Korea - Korea Północna
põhjavint - jer
põhjus - przyczyna | powód
pöial - kciuk
poiss - chłopak | chłopiec
põld - pole
põldpüü - kuropatwa
põlemine - spalanie
põletik - zapalenie
poliitik - polityk
poliitika - polityka
poliitiline - polityczny
põlismets - las
politsei - policja
politseinik - policjant
põllumajandus - rolnictwo
poloonium - polon
polügaamia - poligamia
Polüneesia - Polinezja
põlv - kolano
poni - kucyk
pood - sklep
pöök - buk
poola - polski
Poola - Polska
pooljuhtide füüsika - fizyka półprzewodników
populaarne - popularny
populaarsus - popularność
populariseerima - popularyzować
põrand - podłoga
porgand - marchew
põrgu - piekło
pori - błoto
pornograafia - pornografia
pornograafiline - pornograficzny
portree - portret
portselan - porcelana
põsk - policzek
postimees - listonosz
praegu - teraz
praegune - aktualny
praktiline - praktyczny
prantslane - Francuz
prantslanna - Francuzka
prantsuse - francuski
Prantsusmaa - Francja
praseodüüm - prazeodym
preemia - premia
preester - ksiądz
preili - panna | młoda dama
presbüter - prezbiter
prillid - okulary
printsiip - zasada | reguła
privileeg - przywilej
probleem - problem | kwestia
prohvet - prorok
proklamatsioon - proklamacja
promeetium - promet
pronks - brąz
proosa - proza
proovima - próbować
protaktiinium - protaktyn
protestantism - protestantyzm
protestantlik - protestancki
protsent - procent
Provansi - język prowansalski
provisoorne - prowizoryczny
provitamiin - prowitamina
prügi - śmieci | odpady
pruut - narzeczona | panna młoda
psühhiaater - psychiatra
psühholoog - psycholog
psühholoogia - psychologia
psüühe - psyche
psüühika - psychika
publikatsioon - publikacja
pudel - butelka
puder - owsianka
püha - święty
pühapäev - niedziela
puhas - czysty
puhastama - czyścić | oczyszczać
puhkama - odpoczywać
puhkus - wakacje
puhmas - krzak
püksid - spodnie
pull - byk | wół
pulmad - ślub | wesele
punane - czerwony
punarind - rudzik
pung - pąk
purjus - pijany
püss - pistolet
püssirohi - proch | proch strzelniczy
putukas - owad | robak
puu - drzewo
püü - kuropatwa
puudel - pudel
puuder - puder
püüdma - łapać
puudutama - dotykać
puus - biodro
puusepp - cieśla
puuvili - owoc
puuvill - bawełna
puuvillane - bawełniany
raadio - radio
raadium - rad
raal - komputer
raam - rama | ramka
raamat - książka
raamatukogu - biblioteka
raamatukoguhoidja - bibliotekarz
raamatupidaja - księgowy
raamatupood - księgarnia
rabapüü - pardwa mszarna
rada - ścieżka
radiobioloogia - radiobiologia
radoon - radon
raha - pieniądz | pieniądze
rahakott - portmonetka
rähn - dzięcioł
rahvas - ludzie
rahvastikuteadus - demografia
rahvushümn - hymn narodowy
rahvuslus - nacjonalizm
rajoon - dystrykt | rejon | okolica
rakendusfüüsika - fizyka stosowana
rand - plaża | wybrzeże
rändaja - podróżnik
rändama - podróżować
räni - krzem
ranne - nadgarstek
rase - w ciąży
rasedus - ciąża
raske - trudny | ciężki
rass - rasa
rassism - rasizm
rästas - drozd
rasv - tłuszcz
rasvaimu - liposukcja
rasvatihane - bogatka | sikora bogatka
ratas - rower | koło
ratastool - wózek inwalidzki
ratsavägi - kawaleria
rätsep - krawiec
raud - żelazo
raudtee - kolej (środek transportu) | linia kolejowa
raudteejaam - stacja kolejowa
ravi - leczenie | terapia
ravim - lek
ravima - leczyć
realism - realizm | realism
realistlik - realistyczny
rebane - lis
redis - rzodkiewka
reduktsioon - redukcja
reede - piątek
reenium - ren
reetma - zdradzić
regioon - region
registreerima - rejestrować
regulaarne - regularny
rehekuu - październik
reinkarnatsioon - reinkarnacja
reis - podróż
reisija - pasażer | podróżnik
reisima - podróżować
reklaam - reklama
religioon - religia
religioosne - religijny
relv - broń
remont - remont
remontima - remontować
rentima - oddać w najem
reserveerima - rezerwować
restoran - restauracja
retoorika - retoryka
revolutsionäär - rewolucjonista
revolutsioon - rewolucja
revolutsiooniline - rewolucyjny
režissöör - reżyser
riboflaviin - ryboflawina
riietumine - odzież
riik - kraj | państwo
riim - rym
riis - ryż
riist - narzędzie
rikas - bogaty
rike - defekt | wada | szkoda | uszkodzenie
rind - pierś
ring - kółko
risk - ryzyko
riskeerima - ryzykować
ristisõda - wyprawa krzyżowa
ristiusk - chrześcijaństwo
ristleja - krążownik
rõdu - balkon
roheline - zielony
Roheneemesaared - Republika Zielonego Przylądka
roherähn - dzięcioł zielony
rohevint - dzwoniec
rohi - trawa
roimar - przestępca
rong - pociąg
rõngas - pierścień
rongijaam - dworzec kolejowy
ronk - kruk
röntgeenium - rutherford
roodium - rod
roojama - wypróżniać się
rool - kierownica
rõõm - radość
roos - róża
roosa - różowy
Rootsi - Szwecja
röövel - rabuś | złodziej
rott - szczur
rubiidium - rubid
rukis - żyto
rumal - głupi
rumeenia - rumuński
Rumeenia - Rumunia
rumeenlane - Rumun
rumm - rum
ruteenium - ruten
rutherfordium - roentgen
rüütel - rycerz
saabas - but | kamasz
saabuma - przybyć | przybywać | przyjeżdżać
šaakal - szakal
saal - sala
saar - wyspa
Saara - Sara | estońskie imię żeńskie
saarestik - archipelag
saastumine - zanieczyszczenie
saatan - szatan
saatanlik - demoniczny | sataniczny
saatürlik - satyryczny
saatus - przeznaczenie | los
saba - ogon
sada - liczba 100
sadam - port | przystań
sadama - upaść
sadamalinn - port morski
sadu - opad
sage - częsty
sageli - często
sahharoos - sacharoza
sajand - wiek | stulecie
sajas - setny
saksa - język niemiecki
Saksamaa - Niemcy
Saksamaa Liitvabariik - Republika Federalna Niemiec | Niemcy
saladus - tajemnica | sekret
salapärane - tajemniczy
salat - sałatka
sall - szalik
salv - maść
sama - taki sam
šamaan - szaman
samaarium - samar
šamanism - szamanizm
samet - aksamit
samm - krok
sammal - mech
šampanja - szampan
šampoon - szampon
šampus - szampan
samuti - także | również
sandaal - sandał
säng - łóżko
šantažeerija - szantażysta
São Tomé ja Príncipe - Wyspy Świętego Tomasza i Książęca
sapp - żółć
särk - koszula
Saudi Araabia - Arabia Saudyjska
saun - sauna
savi - glina
seaborgium - seaborg
seadus - prawo
seedima - trawić
seelik - spódnica
seemnevedelik - sperma
seen - grzyb
seeneteadus - mykologia
seep - mydło
segregatsioon - segregacja
sein - ściana
Seišellid - Seszele
seitse - siedem (7)
seitsekümmend - siedemdziesiąt
seitseteist - siedemnaście
seitsmes - siódmy
seitsmeteistkümnes - siedemnasty
seksapiil - sex appeal | seksapil
seksism - seksizm
seksist - seksista
seksuaalne - seksualny
seksuaalne orientatsioon - orientacja seksualna
seksuaalne suundumus - orientacja seksualna
seksuoloogia - seksuologia
seleen - selen
seller - seler
seminar - seminarium
sepp - kowal
september - wrzesień
sfäär - sfera
sfääriline - sferyczny
sibul - cebula
sidrun - cytryna
siga - świnia
sigar - cygaro
sigaret - papieros
siid - jedwab
siidisaba - jemiołuszka
siidiuss - jedwabnik
siil - jeż
Siiri - Siiri | estońskie imię żeńskie
siirup - syrop
sild - most
silm - oko
sina - ty
Singapur - Singapur
sinikael-part - krzyżówka
sinine - niebieski
sinirind - podróżniczek
sinitihane - modraszka | sikora modra
sipelgas - mrówka
sirge - prosty
sisemajanduse kogutoodang - produkt krajowy brutto
skandium - skand
skorbuut - szkorbut
skorpion - skorpion
Skorpion - Skorpion
skulptuur - rzeźba
slovaki - słowacki | słowacki (język)
Slovakkia - Słowacja
Sloveenia - Słowenia
sõber - przyjaciel
sõbralik - przyjazny | życzliwy
sõda - wojna
sõdur - żołnierz
soe - ciepły
soekuu - wtorek
šogun - szogun
sohva - sofa | kanapa
sokk - skarpeta
šokolaad - czekolada
Solon - Solon
sõltumatus - niepodległość
Sõltumatute Riikide Ühendus - Wspólnota Niepodległych Państw
sõltuvus - nałóg
solvama - urazić | obrazić | znieważyć
Somaalia - Somalia
sõna - słowo
sõnaraamat - słownik
sõnastik - słownik
soo - bagno
soolane - słony
sööma - jeść
soome - fiński
Soome - Finlandia
soon - ścięgno
soov - życzenie | pragnienie | chęć
sõprus - przyjaźń
sõrm - palec
šoti - szkocki
Šotimaa - Szkocja
sõtkas - gągoł
sotsialism - socjalizm
sotsiobioloogia - socjobiologia
sperma - sperma
spetsialiteet - specjalność
spinat - szpinak
spioneerima - szpiegować
sport - sport
Sri Lanka - Sri Lanka
statistika - statystyka
Stefanos - Stefan
strontsium - stront
süda - serce
sudenkuu - wtorek
sügis - jesień
suhkur - cukier
suits - dym
sülg - ślina
sulgema - zamykać
sümbioos - symbioza
sümbol - symbol
sümbolism - symbolizm
sünnipäev - urodziny
sünonüüm - synonim
sünonüümne - bliskoznaczny
süntees - synteza
supp - zupa
surm - śmierć
surmama - zabić
surnud - martwy
süsinik - węgiel
süstal - strzykawka
süsteem - system | układ
süstemaatika - systematyka
suu - usta
suudlus - pocałunek
suur - duży
suura - sura
Suurbritannia - Wielka Brytania
süüria - syryjski
Süüria - Syria
suurusluul - mania wielkości | megalomania
suvi - lato
Šveits - Szwajcaria
taani - duński
Taani - Dania
taevas - niebo
Taga-Kaukaasia - Kaukaz Południowy | Zakaukazja | Zakaukazie | Transkaukazja
tähestik - alfabet
tahhükardia - tachykardia | częstoskurcz
tahke keha füüsika - fizyka ciała stałego
tahkisefüüsika - fizyka ciała stałego
täht - gwiazda
tähtis - ważny
tähtkuju - konstelacja
tahtma - chcieć
tahvel - tablica
Tai - Tajlandia
täielik - absolutny | całkowity
täiesti - całkowicie
taim - roślina
taimebioloogia - fitobiologia
taimefüsioloogia - fizjologia roślin | fitofizjologia
taimetoit - wegetariańskie danie | wegetariańskie jedzenie
taimetoitlane - wegetarianin | weganin
taimetoitlus - wegetarianizm
täiuslik - perfekcyjny | doskonały | ukończony | skończony
täiuslikkus - perfekcja | doskonałość
taksiauto - taksówka
takso - taksówka
taksojuht - taksówkarz
tall - jagnię
Tallinn - Tallinn
tallium - tal
talv - zima
tammetõru - żołądź
täna - dziś | dzisiaj
tänama - dziękować
tänamatu - niewdzięczny
tänav - ulica
tantaal - tantal
tänulik - wdzięczny
tapeet - tapeta
täpne - dokładny
taristu - infrastruktura
tärklis - skrobia
tarkvara - oprogramowanie
tätoveerija - tatuażysta
tätoveerima - tatuować
tätoveering - tatuaż
tautoloogia - tautologia
teadlane - naukowiec
teadus - nauka
teadusharu - nauka
teadustama - ogłaszać
teadvus - świadomość
teave - informacja
teder - cietrzew
tee - herbata | droga (trasa)
tegusõna - czasownik
teha sääsest elevant - robić z igły widły
tehissaar - sztuczna wyspa
tehneetsium - technet
teisipäev - wtorek
tekst - tekst
telefon - telefon
telefonikabiin - kabina telefoniczna | budka telefoniczna
telefoninumber - numer telefoniczny
televisioon - telewizja
telluur - tellur
tema - on
temake - ona
temperatuur - temperatura
tennis - tenis
teooria - teoria
teraapia - terapia
teras - stal
terbium - terb
tere - cześć | witaj (powitanie) | halo ( przez telefon)
tere hommikust - dzień dobry (powitanie w godzinach porannych)
tere õhtust - dobry wieczór
termomeeter - termometr
Termopüülid - Termopile
tiamiin - tiamina
tigu - ślimak
tihane - sikora
Tiibet - Tybet
tiiger - tygrys
Tiina - Tiina | estońskie imię żeńskie
tina - cyna
titaan - tytan
tõeline - prawdziwy | właściwy
toit - jedzenie
tõlk - tłumacz
tõlkija - tłumacz
tõlkima - tłumaczyć
tomat - pomidor
tõmmu - brązowy | śniady | smagły
töö - praca
toonekurg - bocian
toorium - tor
töötama - pracować
topograafia - topografia
tõrv - smoła
traagiliselt - tragicznie
traditsioon - tradycja
tragikomöödia - tragikomedia
traktor - traktor
tramm - tramwaj
Transnistria - Naddniestrze
trofee - trofeum
troon - tron
Tšaad - Czad
tseerium - cer
Tšehhi - Czechy
Tšiili - Chile
tsink - cynk
tsirkoonium - cyrkon
tsirkus - cyrk
tsiviilisik - cywil
tsiviliseerima - cywilizować
tsoon - zona | strefa
tuba - pokój
tüdruk - dziewczyna
tugevus - siła
tuhandes - tysięczny
tuhat - tysiąc (1000)
tuhk - popiół
tulekahju - ogień
tuletõrjuja - strażak
tuletorn - latarnia morska
tund - godzina
Tuneesia - Tunezja
türanlik - tyrański
türannia - tyrania
türanniseerima - tyranizować
türgi - turecki
Türgi - Turcja
Turks ja Caicos - Turks i Caicos
tütar - córka
tütarlaps - dziewczyna
tutkas - batalion | bojownik
tuttpütt - perkoz dwuczuby
tuul - wiatr
Tuulepealsed saared - Wyspy Na Wietrze
Tuuli - Tuuli | estońskie imię żeńskie
tuulium - tul
tuumafüüsika - fizyka jądrowa
tuvi - gołąb
uba - fasola
udu - mgła
üheksa - dziewięć (9)
üheksakümmend - dziewięćdziesiąt
üheksas - dziewiąty
üheksateist - dziewiętnaście
üheksateistkümnes - dziewiętnasty
Ühendkuningriik - Zjednoczone Królestwo
ühik - jednostka
ujuma - pływać
Ukraina - Ukraina
uks - drzwi
üks - jeden
üks kõigi ja kõik ühe eest - jeden za wszystkich, wszyscy za jednego
ükssarvik - jednorożec
üksteist - jedenaście | 11
ülekohus - niesprawiedliwość
ülikool - uniwersytet
üliõpilane - student | studentka
ümberlõikamine - obrzezanie
Ungari - Węgry
unikaalne - unikalny | unikatowy
universaalne - uniwersalny
unts - uncja
unustama - zapomnieć
uraan - uran
üritama - próbować
urvalind - czeczotka
uskuma - wierzyć
uskumatu - niewiarygodny | niemożliwy
uss - robak
usund - wiara
üterbium - iterb
ütlema - powiedzieć
ütrium - itr
uurija - badacz
uus - nowy
Uus-Meremaa - Nowa Zelandia
vaas - wazon
vaatama - widzieć | zobaczyć
väävel - siarka
vabadus - wolność
vabariik - republika
vaenulikkus - wrogość
vaesus - bieda
väga - bardzo
Vahemeri - Morze Śródziemne
vaher - klon
vaht - piana
vahvel - wafel
vaik - żywica
väike - mały
väikekoskel - bielaczek | tracz bielaczek
väikepütt - perkozek
Vaikne ookean - Ocean Spokojny
vaikus - cisza
väimees - zięć
valetaja - kłamca
valge - biały | osoba biała
valgevene - białoruski
Valgevene - Białoruś
valgus - światło
välismaalane - cudzoziemiec | obcokrajowiec
välismaine - obcy | zagraniczny
väljaanne - edycja | wydanie | wydawnictwo
valuuta - waluta
valve - straż
vana - stary
vanaadium - wanad
vanamoodne - staromodny
vanasõna - przysłowie
vandenõu - konspiracja
vanne - przysięga
vannituba - łazienka
varblane - wróbel
vares - wrona
vari - cień
varjatud - ukryty | skryty | tajemny
varrukas - rękaw
värske - świeży
vart - grążyca | kaczka nurkująca
värv - farba
vasar - młot | młotek
vasektoomia - wazektomia
väsinud - zmęczony
vask - miedź
vastama - odpowiedzieć
vastlakuu - wtorek
vastuvõetav - do przyjęcia | zadowalający
Vatikan - Państwo Watykańskie | Watykan
vatt - wat
veebruar - luty
veegan - weganin
veen - żyła
veer - krawędź
veetulv - powódź
vegetaarlane - wegetarianin
vein - wino
veksilloloogia - weksylologia
vend - brat
vene - rosyjski
Veneetsia - Wenecja
vene keel - język rosyjski
Venemaa - Rosja
venestamine - rusyfikacja
veoauto - ciężarówka
veregrupp - grupa krwi
veri - krew
vermut - wermut
vesi - woda
vesinik - wodór
vesipapp - pluszcz
vestlema - rozmawiać
veterinaaria - weterynaria
veterinaarkliinik - klinika weterynaryjna
veterinaarne - weterynaryjny
Victoria saar - Wyspa Wiktorii
vietnami - wietnamski
viha - gniew | wrogość
vihane - zły | rozgniewany
vihik - zeszyt
vihkama - nienawidzić
vihkamine - nienawiść
vihkamisväärne - nienawistny
vihm - deszcz
vihmakuub - płaszcz przeciwdeszczowy
viies - piąty
viieteistkümnes - piętnasty
viin - wódka
viinakuu - październik
viinamari - winogrono
viis - pięć
viiskümmend - pięćdziesiąt
viisteist - piętnaście
viiul - skrzypce
vikat - kosa
vikerkaar - tęcza
Vikipeedia - Wikipedia
vile - gwizdek
vintpüss - karabin
vismut - bizmut
vitamiin - witamina
viupart - świstun
või - masło | lub
võileib - kanapka
võim - moc
võimalik - możliwy
võimetu - niezdolny
võitja - zwycięzca
volfram - wolfram
võlts - sztuczny | fałszywy
võlur - czarodziej
voodi - łóżko
võrkkiik - hamak
vulgaarne - wulgarny
vulgaarsus - wulgarność
vulgarism - wulgaryzm
vulkaan - wulkan
vürts - przyprawa
Wales - Walia
Yulia - Julia | estońskie imię żeńskie
žalusii - żaluzja
žanr - gatunek | rodzaj
žargoon - żargon
želatiin - żelatyna
ženšenn - żeńszeń
žest - gest
žestikuleerima - gestykulować
žetoon - żeton
žilett - żyletka
zombi - zombi
zoo- - zoo-
zooloogia - zoologia
zoopark - zoo
zooplankton - zooplankton
žürii - jury
