aakkonen - litera
aakkosellinen - alfabetyczny
aakkoset - alfabet, abecadło, podstawy, ABC, aakkonen
aakkosjärjestys - porządek alfabetyczny
aakkosto - alfabet
ääliömäisyys - głupota
aallonharja - grzbiet fali
aallonmurtaja - falochron
aallonpituus - długość fali
aalto - fala
aaltoinen - falisty
aaltoviiva - linia falista
aamen - amen
aamiainen - śniadanie
aamu - rano, poranek
aamupäivä - poranek, rano
aamupala - śniadanie
aamuruoka - śniadanie
aamurusko - wschód słońca
aamutakki - podomka, szlafrok
aamutossu - kapeć
äänestäjä - wyborca
äänestys - głosowanie
äänettömyys - cisza
ääni - dźwięk, odgłos, głos
Ääninen - Jezioro Onega
äänneoppi - fonologia
ääntämys - wymowa
ääntö - wymowa
aapinen - elementarz (książka)
äärellinen - skończony
äärettömyys - nieskończoność
aari - ar
aaria - aria
aarnikotka - gryf
aarre - skarb
aasi - osioł, półgłówek
Aasia - Azja
aasialainen - azjatycki
aate - idea, pomysł, myśl
aatelismies - szlachcic
aatto - przeddzień, wigilia
aave - duch, zjawa
aavikko - pustynia
aavikkohaukka - raróg
aavikkokettu - fenek
aavistaa - przeczuwać, mieć przeczucie
abdikaatio - abdykacja
abdominaalinen - brzuszny
abessiivi - ? ?  abessivus
abiturientti - abiturient
ablatiivi - ? ? ?  ablativus
abnormi - nienormalny
abnormiteetti - nienormalność
abnormius - nienormalność
abortti - aborcja
absintti - absynt
absolutisti - absolutysta, abstynent
absoluutti - absolut
absorbointi - absorpcja
abstinenssi - abstynencja
abstrahointi - abstrakcja
abstrakti - abstrakcyjny
abstraktinen - abstrakcyjny
abstraktio - abstrakcja
absurdi - absurdalny
absurditeetti - absurd
absurdius - absurd
adessiivi - ? ?  adessivus
adjektiivi - przymiotnik
adjektiivinen - przymiotnikowy
administraatio - administracja
adoptointi - adopcja
adrenaliini - adrenalina
adressaatti - adresat
adverbi - przysłówek
adverbinen - przysłówkowy
aerodynamiikka - aerodynamika
aerosoli - aerozol
äes - brona
Afganistan - Afganistan
aforismi - aforyzm
afrikaans - afrykanerski
Afrikka - Afryka
afrikkalainen - Afrykanin, Afrykanka, afrykański
agaatti - agat
agentuuri - agencja
agglomeraatio - aglomeracja
aggregaatti - agregat
aggressiivinen - agresywny
aggressiivisuus - agresywność, wojowniczość, napastliwość, ofensywność
aggressio - agresja
agitoija - agitator
agnostisismi - agnostycyzm
agraarinen - rolny
agronomia - agronomia
ahdas - ciasny, wąski
ahdistelu - molestowanie
ahjo - kuźnia
ahkera - pilny, gorliwy, pracowity
ahma - rosomak
ahmia - żreć, pochłaniać
ahnas - chciwy, łapczywy, zachłanny
ahomansikka - poziomka
ahtaasti - ciasno, wąsko
ahtaus - tłok, ciasnota, brak miejsca
ahven - okoń
Ahvenanmaa - Wyspy Alandzkie
aidas - drewniana podpórka tradycyjnego płotu tyczkowego z Finlandii
aidata - ogradzać, ogrodzić
äidinkieli - język ojczysty ( język matczyny)
aihe - powód, przyczyna, przedmiot, temat
aiheeton - niepotrzebny
aiheuttaja - powód, przyczyna
äijä - stary mężczyzna, stary (znajomy, kolega, przyjaciel), dziadek (lub inna najstarsza osoba w gospodarstwie)
aika - czas, całkiem, stosunkowo, dość
aikaan - czas
aikaansaannos - dokonanie, osiągnięcie
aikainen - wczesny
aikainen lintu madon nappaa - kto rano wstaje, temu Pan Bóg daje, wczesny ptak łapie robaka
aikaisin - wcześnie
aikakauslehti - magazyn, czasopismo
aikamuoto - czas
aikavyöhyke - strefa czasowa
aikomus - intencja, zamiar, plan
aikuinen - dorosły, pełnoletni
aina - zawsze
aine - materia, materiał, przedmiot nauczania, wypracowanie, esej
ainesosa - składnik
ainoa - jedyny
ainoastaan - tylko, wyłącznie, jedynie
airo - wiosło
Aisopos - Ezop
aistiharha - halucynacja
aistillinen - zmysłowy
aistimus - percepcja
aita - płot, ogrodzenie, płotek
äiti - matka
aitio - loża
äitipuoli - macocha
aito - autentyczny, prawdziwy, oryginalny
aitous - autentyczność
aivastaa - kichnąć
aivastus - kichnięcie
aivot - mózg
ajaa - jechać, jeździć, iść
ajaja - kierowca, szofer
ajankohtainen - aktualny
ajankuluke - hobby
ajanviete - hobby
ajanvietto - rekreacja
ajatella - myśleć, zastanawiać się
ajatelma - aforyzm
ajattelija - myśliciel
ajatus - myśl
ajo - jazda, nagonka
ajokoira - pies myśliwski
ajokortti - prawo jazdy
ajos - wrzód, ropień
akaatti - agat
akateeminen - akademicki
akatemia - akademia
akka - stara kobieta, babsztyl
äkkinäinen - nagły
akku - bateria (akumulator)
akkumulaatio - nagromadzenie
akkumulaattori - akumulator
akkusatiivi - biernik
akseli - oś
äksy - gniewny, wściekły
aktiivinen - aktywny
aktinium - aktyn
aktivismi - aktywizm
aktivointi - aktywacja
akupunktio - akupunktura
akupunktuuri - akupunktura
akustinen - akustyczny
akusto - bateria
akuutti - przenikliwy, ostry
akuuttinen - przenikliwy, ostry
akvaario - akwarium
akvaattinen - wodny
akvedukti - akwedukt
ala - terytorium, obszar, dziedzina
alalaji - podgatunek
alanko - nizina
Alankomaat - Niderlandy, Holandia
alaraaja - kończyna dolna, kończyna tylna
alasin - kowadło, kowadełko
alasinluu - kowadełko
alaston - nagi, goły
albania - język albański
Albania - Albania
albanialainen - Albańczyk, Albanka, albański
albatrossi - albatros
albiino - albinos
Aleksandra - Aleksandra
alfa - alfa (nazwa greckiej litery α)
algebra - algebra
algebrallinen - algebraiczny
Algeria - Algieria
algoritmi - algorytm
alijäämä - deficyt
alinomaa - ciągle
alituisesti - ciągle
alkaa - zacząć, rozpocząć, zaczynać się
alkemia - alchemia
alkemisti - alchemik
alkoholi - alkohol, napój alkoholowy
alkoholijuoma - napój alkoholowy
alkoholismi - alkoholizm
alkoholiton - bezalkoholowy
alku - początek
alkuaine - pierwiastek
alkuluku - liczba pierwsza
alkusointu - aliteracja
alkusoitto - preludium, uwertura
allakka - almanach
allas - basen
allatiivi - ? ? ?  allativus
allegoria - alegoria
allekirjoitus - podpis, autograf
allergia - alergia, uczulenie
alli - lodówka
alligaattori - aligator
allihaahka - birginiak, pstrokaczka, kaczka srokata
allitteraatio - aliteracja
almanakka - kalendarz, almanach
almu - jałmużna
aloittaa - zaczynać, rozpoczynać
aloittelija - początkujący
alokas - rekrut
Alpi - Alpi, fińskie imię męskie
Alpit - Alpy
alppihiihto - narciarstwo alpejskie
altimetri - wysokościomierz
altitudi - wysokość
altruismi - altruizm
alttari - ołtarz
alue - obszar, teren, strefa, terytorium, rejon
alueellinen - regionalny
alueittainen - regionalny
aluepiiri - kraj (jednostka administracyjno-terytorialna w Federacji Rosyjskiej)
alumiini - glin, aluminium
alushousut - majtki
alusvaate - bielizna
älykäs - inteligentny
älyttömyys - głupota
amatööri - amator
ambitio - ambicja
ambulanssi - ambulans
amerikanjääkuikka - nur lodowiec
Amerikan Yhdysvallat - Stany Zjednoczone Ameryki, USA
amerikium - ameryk
Amerikka - Ameryka, USA, Stany Zjednoczone Ameryki
amerikkalainen - Amerykanin, Amerykanka, amerykański
ametisti - ametyst
amfetamiini - amfetamina
amfora - amfora
amiraali - admirał
ämmä - stara baba, stara kobieta
ammatti - zawód, profesja
ammattikoulu - szkoła zawodowa
ammattikoulutus - kształcenie zawodowe, nauczanie zawodu
ammattiliitto - związek zawodowy
amme - wanna
amnesia - amnezja
amnestia - amnestia
ämpäri - wiadro
ampeeri - amper
ampeerimittari - amperomierz
ampiainen - osa
ampua - strzelać, zastrzelić
ampuhaukka - drzemlik
ampuma-ase - broń palna
amputaatio - amputacja
amputointi - amputacja
amuletti - amulet
amurinkoskelo - tracz chiński
amyloidoosi - amyloidoza, skrobiawica, betafibryloza
ämyri - głośnik
anakonda - anakonda
analogia - analogia
analyysi - analiza
ananas - ananas
ananasmehu - sok ananasowy
anarkia - anarchia
anarkismi - anarchizm
anarkisti - anarchista
Anatolia - Anatolia
anatomia - anatomia
anatominen - anatomiczny
Andalusia - Andaluzja
Andorra - Andora
andorralainen - andorski
anekdootti - anegdota
Angola - Angola
animaalinen - zwierzęcy
animaatio - animacja
ankanpoikanen - kaczątko
ankea - przygnębiony, smutny, ciężki, trudny
ankerias - węgorz, węgorz europejski
ankka - kaczka, kaczka dziennikarska
ankkuri - kotwica
annihilaatio - anihilacja
anodi - anoda
anomalia - anomalia
anonyymi - anonimowy
anoppi - teściowa
antaa - dawać, darować, dać, pozwolić
antagonisti - antagonista, przeciwnik
Antarktis - Antarktyda, Antarktyka
antenni - antena
antibiootti - antybiotyk
antibioottinen - antybiotykowy
antidootti - antidotum
Antigua ja Barbuda - Antigua i Barbuda
antiikki - antyk
antilooppi - antylopa
antimoni - antymon
antipatia - antypatia, niechęć
antisosiaalinen - aspołeczny
antiteesi - antyteza
antologia - antologia
antonyymi - antonim
antropofagia - kanibalizm, ludożerstwo
antropologi - antropolog
antropologia - antropologia
apaattinen - apatyczny
apatia - apatia
apea - przygnębiony
apila - koniczyna
apina - małpa
apokalypsi - apokalipsa
apokryfinen - apokryficzny
apollinarismi - apolinaryzm
apostoli - apostoł
apotti - opat
apottiluostari - opactwo
appelsiini - pomarańcza
appelsiinimehu - sok pomarańczowy
appi - teść
approksimaatio - aproksymacja
aprikoosi - morela
apteekki - apteka
apu - pomoc
apuraha - stypendium, zapomoga, zasiłek
apuverbi - czasownik posiłkowy
arabi - Arab
arabia - język arabski
arabialainen - arabski, Arab, Arabka
Arabian niemimaa - Półwysep Arabski
Arabiemiirikunnat - Zjednoczone Emiraty Arabskie
araknofobia - arachnofobia
arastelu - wahanie, niepewność
arbuusi - arbuz
areena - arena
Argentiina - Argentyna
argon - argon
aristokraattinen - arystokratyczny
aristokraattisuus - arystokracja
aristokratia - arystokracja
Aristoteles - Arystoteles
aritmetiikka - arytmetyka
arka - bojaźliwy, lękliwy, czuły, wrażliwy
arkaainen - archaiczny
arkaistinen - archaiczny
Arkangeli - Archangielsk
arkikielinen - kolokwialny, potoczny
arkki - arkusz, arka
arkkipiispa - arcybiskup
arkkitehti - architekt
arkkitehtuuri - architektura
armahtavainen - miłosierny
armeija - armia
armelias - miłosierny
armenia - język ormiański
Armenia - Armenia
armoinen - miłosierny
armokuolema - eutanazja
armollinen - miłosierny
aro - step
arpa - los (kupon)
arpeuma - blizna
arpi - blizna
arroganssi - arogancja
arrogantti - arogancki
arseeni - arsen
artikkeli - artykuł
artikulaatio - artykulacja
artikulointi - artykulacja
artisokka - karczoch
artistinen - artystyczny
arvelu - przypuszczenie
arvioija - krytyk
arviolta - około
arvo - wartość, cena
arvonta - loteria
arvostella - oceniać, krytykować
arvostelma - osąd
arvostelu - recenzja, krytyka, sąd, osąd, mniemanie
arvoton - bezwartościowy
asbesti - azbest
ase - broń, oręż
aseksuaalisuus - aseksualność
asema - stacja, dworzec, pozycja, położenie, status
asfaltti - asfalt
asia - rzecz, sprawa, kwestia
asiakas - klient
asianajaja - adwokat, obrońca
asiantuntija - ekspert
asiapaperi - dokument, akt
asiayhteys - kontekst
askeesi - asceza
askel - schód, schodek, stopień, krok
aspiriini - aspiryna
ässä - as
assimilaatio - asymilacja
assimilointi - asymilacja
assistentti - asystent
astaatti - astat
astatiini - astat
aste - stopień, stopień wielomianu
asteittain - stopniowo
asteittainen - stopniowy
asteittaisesti - stopniowo
asti - do, aż do, od
astia - naczynie
astianpesukone - zmywarka
astrofysiikka - astrofizyka
astrologia - astrologia
astronautti - astronauta
astronomi - astronom
astronomia - astronomia
astronominen - astronomiczny
astua - wejść, wchodzić
asua - mieszkać
asukas - mieszkaniec, mieszkanka, lokator, lokatorka
asumaton - bezludny, niezaludniony
asunto - mieszkanie, apartament, miejsce zamieszkania
asuntola - akademik
Ateena - Ateny
ateismi - ateizm
ateisti - ateista
Atlantin valtameri - Ocean Atlantycki
Atlantti - Atlantyk
atmosfääri - atmosfera
atolli - atol
atomaarinen - atomowy
atomi - atom
ätsii - apsik!, a psik!
ätsiih - apsik!, a psik!
atsimuutti - azymut
attraktiivinen - atrakcyjny
aukean paikan kammo - agorafobia
aukiokammo - agorafobia
aukko - otwór, szpara
aukkokohta - dziura
aura - pług
auringonkilo - światło słoneczne
auringonkukka - słonecznik
auringonlasku - zachód słońca
auringonnousu - wschód Słońca
auringonpaiste - światło słoneczne
auringonpimennys - zaćmienie słońca
auringonpistos - udar słoneczny
aurinko - słońce
Aurinko - Słońce (ciało niebieskie)
aurinkoinen - słoneczny
aurinkokurki - słonecznica
aurinkolasit - okulary słoneczne
Australia - Australia
autenttinen - autentyczny
autenttisuus - autentyczność
autio - bezludny, pusty
autiomaa - pustynia
auto - samochód
autolautta - prom
automaatti - automat
automaattinen - automatyczny
automaattisesti - automatycznie
autonomia - autonomia
autonominen - autonomiczny
auttaa - pomagać
avain - klucz (narzędzie do otwierania zamków), klucz (w kryptografii), klucz (w muzyce)
avanto - przerębel
avaruus - przestrzeń kosmiczna, kosmos
avaruuslaiva - statek kosmiczny
avata - otwierać, otworzyć
avioero - rozwód
avioliitto - małżeństwo, związek małżeński
aviomies - mąż
avokado - awokado
avosetti - szablodziób
avustaja - asystent
avuton - bezradny
äyriäinen - skorupiak
äyriäishuuhkaja - sowa japońska, puchacz japoński
Azerbaidžan - Azerbejdżan
baari - bar
Bahrain - Bahrajn
bakteeri - bakteria
bakteriologia - bakteriologia
baletti - balet
balttilainen - bałtycki, nadbałtycki
bambu - bambus
banaani - banan
bandiitti - bandyta
Bangladesh - Bangladesz
banketti - bankiet
baptismi - baptyzm
barbaari - barbarzyńca
Barbados - Barbados
barista - barista
barium - bar
barrikadi - barykada
basaari - bazar
basaltti - bazalt
baseball - baseball
basilika - bazylika, bazylia
baskeri - beret
baski - baskijski
baskilainen - baskijski
basso - bas, gitara basowa
bastioni - bastion
bataatti - wilec ziemniaczany, batat, patat, słodki ziemniak
beatifikaatio - beatyfikacja
Belgia - Belgia
belgialainen - Belg, Belgijka, belgijski
Belize - Belize
bengali - bengalski (język)
Benin - Benin
bensiini - benzyna
bensiiniasema - stacja benzynowa
berkelium - berkel
Berliini - Berlin
berliiniläinen - berlińczyk, berliński
berylli - beryl
beryllium - beryl
betoni - beton
Bhutan - Bhutan
bibliografi - bibliograf
bibliografia - bibliografia
biisi - bis
biisoni - bizon
bilateraalinen - dwustronny
biografi - biograf
biografia - biografia
biografinen - biograficzny
biokemia - biochemia
biologi - biolog
biologia - biologia
biologinen - biologiczny
biosynteesi - biosynteza
bisarri - dziwaczny
biseksuaalinen - biseksualny
biseksuaalisuus - biseksualizm
bohrium - bohr
boikotti - bojkot
Bolivia - Boliwia
Böömi - Czechy (kraina geograficzna)
boori - bor
bordyyri - haft
Bosnia ja Hertsegovina - Bośnia i Hercegowina
botaniikka - botanika
Botswana - Botswana
brandy - brandy, winiak
Brasilia - Brazylia
brasilialainen - brazylijski, Brazylijczyk
briljantti - brylant
brittiläinen - Brytyjczyk, Brytyjka, brytyjski
brodeeraus - haft
brodyyri - haft
brodyyrikangas - haft
brokkoli - brokuł
bromi - brom
Brunei - Brunei
brutaali - brutalny
brutto - brutto
Bryssel - Bruksela
brysselinkaali - brukselka
buddhalaisuus - buddyzm
buddhismi - buddyzm
budjetti - budżet
bulevardi - bulwar
bulgaria - bułgarski
Bulgaria - Bułgaria
bulgarialainen - bułgarski, Bułgar, Bułgarka
bulgarian kieli - język bułgarski
bulgur - bulgur
Burkina Faso - Burkina Faso
Burma - Birma
Burundi - Burundi
bussi - autobus
bussilippu - bilet autobusowy
byrokraatti - biurokrata
byrokratia - biurokracja
cerium - cer
charmantti - uroczy
charmikas - uroczy
Chile - Chile
Costa Rica - Kostaryka
cowboy - kowboj
croissant - rogalik
curium - kiur
darmstadtium - darmsztadt
debatti - debata
deduktio - dedukcja
defekti - defekt, wada
defektiivinen - uszkodzony
defensiivinen - obronny
definitio - definicja
deismi - deizm
dekaani - dziekan
dekoraatio - dekoracja
delfiini - delfin
demografia - demografia
demokraatti - demokrata
demokraattinen - demokratyczny
demokratia - demokracja
derivaatta - pochodna
dermatologia - dermatologia
designer - projektant
desilitra - decylitr
deskriptiivinen - opisowy
deskriptio - opis
destruktiivinen - destrukcyjny
detalji - szczegół
detaljoitu - szczegółowy
devalvaatio - dewaluacja
devalvoida - dewaluować
diagnoosi - diagnoza
diagrammi - diagram
diakoni - diakon
diakuva - przezrocze
diatriba - diatryba
dieetti - dieta
difallia - difalia
digitaalinen - cyfrowy
diktaattori - dyktator
diktatuuri - dyktatura
dimensio - wymiar
dinosaurus - dinozaur
diplomaatti - dyplomata
diplomaattinen - dyplomatyczny
diplomatia - dyplomacja
diplomi - dyplom
direktiivi - dyrektywa
disponibiliteetti - dostępność
diversiteetti - różnorodność
Djibouti - Dżibuti
dogmi - dogmat
doktriini - doktryna
dokumentaatio - dokumentacja
dokumentointi - dokumentacja
dollari - dolar
dolmen - dolmen
Dominica - Dominika
Dominikaaninen tasavalta - Dominikana, Republika Dominikańska
dominointi - dominacja
dosentti - docent
draama - dramat
dramaattinen - dramatyczny
drastinen - drastyczny
dubnium - dubn
duetto - duet
duraatio - czas trwania
dynaaminen - dynamiczny
dynamiitti - dynamit
dynastia - dynastia
dysfagia - dysfagia
dysleksia - dysleksja
dysprosium - dysproz
dyyni - diuna
eaa - przed naszą erą
Ecuador - Ekwador
edellinen - poprzedni
edellytys - warunek, przesłanka, założenie
edesvastuu - odpowiedzialność
edistyksellinen - postępowy
edistys - postęp
edullinen - tani, niedrogi, korzystny
eduskunta - sejm, parlament
eduskuntavaalit - wybory do parlamentu
edustaja - przedstawiciel, agent, pełnomocnik
edustus - przedstawicielstwo, reprezentacja
eeben - heban
eebenholtsi - heban
eebenpuu - heban
eestiläinen - estoński, Estończyk, Estonka
eettinen - etyczny
eeva - kobieta
efektiivisyys - skuteczność, efektywność
egoismi - egoizm
egoistisuus - egoizm
Egypti - Egipt
egyptiläinen - egipski, Egipcjanin
ehdokas - kandydat, nominowany
ehdollinen - warunkowy
ehdottaa - proponować
ehdotus - propozycja, wniosek
ehei - nie
ehkä - może, być może
ehto - warunek, zastrzeżenie, klauzula, egzamin poprawkowy
ehtotapa - tryb warunkowy
ehtyä - wysychać, wyczerpać się, przestać dawać mleko
ei - nie - zaprzeczenie, nie - zaprzeczenie czasownika
eilen - wczoraj
eilinen - wczoraj, wczorajszy
eilispäivä - dzień wczorajszy, wczoraj
ei mikään - nic
ei milloinkaan - nigdy
einsteinium - einstein
ei yksi pääsky kesää tee - jedna jaskółka wiosny nie czyni, jedna jaskółka nie czyni lata
ekologia - ekologia
ekologinen - ekologiczny
ekonomia - ekonomia
eksaktisti - dokładnie
eksellenssi - doskonałość
eksellentti - wspaniały
eksentrinen - ekscentryczny
eksessiivinen - nadmierny
eksistenssi - egzystencja
eksklusiivisesti - wyłącznie
eksoottinen - egzotyczny
eksperimentaalinen - eksperymentalny
ekspertti - ekspert
ekspressiivinen - ekspresyjny
eksterni - zewnętrzny
ekstrapolaatio - ekstrapolacja
ekvaattori - równik
ekvivalentti - równoważny
ekvivalenttinen - równoważny
elää - żyć, mieszkać
eläin - zwierzę
eläinlääkäri - weterynarz
eläinopillinen - zoologiczny
eläinoppi - zoologia
eläinsatu - bajka
eläintarha - zoo
eläintiede - zoologia
eläintieteellinen - zoologiczny
eläintieteilijä - zoolog
elämä - życie
elämäkerrallinen - biograficzny
elämäkerta - biografia
elämäkerturi - biograf
elastinen - elastyczny
elatiivi - ? ?  elativus
ele - gest
elefantti - słoń
eleganssi - elegancja
elegantti - elegancki
elegia - elegia
elektrodi - elektroda
elektrolyysi - elektroliza
elektrolyytti - elektrolit
elektroni - elektron
elektroniikka - elektronika
elektroninen - elektroniczny
eliksiiri - eliksir
eliminaatio - eliminacja
eliminointi - eliminacja
elinpaikka - habitat, środowisko
elintarvike - artykuł spożywczy
elinympäristö - habitat, środowisko
eliö - organizm
elohopea - rtęć
elokuu - sierpień
elokuva - film
elokuvateatteri - kino
El Salvador - Salwador
elukka - zwierzę
emakko - maciora, locha
emansipaatio - emancypacja
emäs - zasada
emätin - pochwa
emigrantti - emigrant
Emilia - Emilia
emittointi - emisja
Emmi - Milja, Milla, Emilia
emootio - emocja, uczucie
emotionaalinen - emocjonalny
empatia - empatia
empiirinen - empiryczny, doświadczalny
empiristinen - empiryczny, doświadczalny
en - nie - używany przy chęci zaprzeczenia czasownika, w pierwszej osobie .
endeeminen - endemiczny
endiivi - endywia
enemmistö - większość
energia - energia
eŋgelasgiella - język angielski
englanti - język angielski
Englanti - Anglia
englantilainen - angielski, Anglik
eniten - najwięcej, najbardziej
enkeli - anioł
enkelimäinen - anielski
ennakko - zaliczka, zadatek
ennakkoluulo - przesąd, uprzedzenie
ennakkomyynti - przedsprzedaż
ennakkotapaus - precedens
ennätys - rekord
ennen - przedtem, dawniej, przed
ennenkuin - zanim
eno - wuj, wujek
enologia - enologia
Enontekiö - Enontekiö (gmina w Laponii)
ensiapu - pierwsza pomoc
ensiapuasema - stacja pogotowia ratunkowego
ensimmäinen - pierwszy
entomologia - entomologia
entsyymi - enzym
entusiasmi - entuzjazm
entusiastinen - entuzjastyczny
entuudestaan - już
epähuomiossa - przypadkowo
epäilys - podejrzenie
epäjärjestys - nieporządek
epäjohdonmukainen - niespójny
epäjumalankuva - idol
epäkypsä - niedojrzały
epälojaali - nielojalny
epäluulo - podejrzenie
epäluuloisuus - podejrzenie
epänormaali - nienormalny
epänormaalisuus - nienormalność
epänormaalius - nienormalność
epäorgaaninen - nieorganiczny
epärehellinen - nieuczciwy
epäröidä - wahać się
epäröinti - wahanie, niepewność
epäsäännöllinen - nieregularny
epäsikiö - potwór
epäsuora - pośredni
epäsuorasti - pośrednio
epätasa-arvo - nierówność
epätavallinen - nietypowy
epätäydellinen - niekompletny
epäterve - niezdrowy
epäterveellinen - niezdrowy
epätodellinen - nierealny
epävakaisuus - niestabilność
epävakaus - niestabilność
epäystävällinen - nieprzyjazny
epideeminen - epidemiczny
epilepsia - padaczka, epilepsja
epilogi - epilog, zakończenie
epistemologia - epistemologia
epitafi - epitafium
epiteetti - epitet
epuu - odmowa
erä - część, udział, racja, ilość, połów, zdobycz, runda, tura, partia, raz
erämaa - położona bardzo daleko od osiedli ludzkich strefa lasu (w Laponii), ostępy leśne
eräs - jeden, pewien
erbium - erb
erhe - pomyłka, błąd
eriarvoinen - nierówny
erikoinen - specjalny, osobliwy, szczególny
erikseen - osobno, oddzielnie
erilainen - różny, odmienny
erilaisesti - inaczej
erinomainen - wybitny, świetny, znakomity
eriskummallinen - dziwaczny
erisnimi - nazwa własna
eritelmä - specyfikacja
Eritrea - Erytrea
erittäin - bardzo
erityisesti - zwłaszcza
erityisosaaja - ekspert
eronnut - rozwiedziony
eroottinen - erotyczny
erotus - różnica
esihistoria - prehistoria
esihistoriallinen - prehistoryczny
esikäsittely - przygotowanie
esikaupunki - przedmieście
esiliina - fartuch
esim. - np., na przykład
esimerkiksi - na przykład, przykładowo
esimerkki - przykład
esine - przedmiot, rzecz
esipuhe - przedmowa
esitelmöijä - wykładowca
esitelmöitsijä - wykładowca
esivanhempi - przodek
espanja - hiszpański
Espanja - Hiszpania
espanjalainen - Hiszpan, Hiszpanka, hiszpański
esperanto - esperanto
Espoo - Espoo
essiivi - ? ? ? ?
esso - ecstasy, metylenodioksymetamfetamina
este - przeszkoda
estetiikka - estetyka
estuaari - ujście
etäisyys - odległość
etana - ślimak
eteinen - przedpokój, przedsionek serca, przedsionek
eteiskäytävä - korytarz
etelä - południe (kierunek)
Etelä-Afrikka - Republika Południowej Afryki
Etelä-Amerikka - Ameryka Południowa
eteläinen - południowy
Etelä-Korea - Korea Południowa
eteläkorealainen - południowokoreański, mieszkaniec/mieszkanka Korei Południowej
Etelämanner - Antarktyka
Etelänapamanner - Antarktyka
etenkin - zwłaszcza, szczególnie, przede wszystkim
etiikka - etyka
etikka - ocet
etnisyys - narodowość
etnologia - etnologia
etruskilainen - etruski
etsiä - szukać
että - że
etunimi - imię
etusivu - strona główna
etusormi - palec wskazujący
etuus - korzyść
etymologia - etymologia
eufemismi - eufemizm
euforia - euforia
eunukki - eunuch
euro - euro
Euroopan unioni - Unia Europejska
Eurooppa - Europa
eurooppalainen - Europejczyk, Europejka, europejski
europium - europ
eutanasia - eutanazja
evä - płetwa
evakuointi - ewakuacja
evankeliumi - ewangelia
evaporaatio - parowanie
eväsretki - piknik
evidentti - ewidentny
evoluutio - ewolucja
faabeli - bajka
fagotti - fagot
fajanssi - fajans
fakta - fakt
faktori - czynnik
Falklandinsaaret - Falklandy
fallos - penis
fanaatikko - fanatyk
fantastinen - fantastyczny
farmakologia - farmakologia
farmasia - farmacja
farmi - farma
Färsaaret - Wyspy Owcze
farssi - farsa
fasaani - bażant
fasistinen - faszystowski
federaalinen - federalny
federaatio - federacja
feeniks - feniks
feeniks-lintu - feniks
feminismi - feminizm
feodalismi - feudalizm
fermentointi - fermentacja
fermium - ferm
festivaali - festiwal
Fidži - Fidżi
filantrooppinen - dobroczynny
filantropia - filantropia
filee - filet, polędwica
Filippiinit - Filipiny
filmata - filmować
filmi - film
filologi - filolog
filologia - filologia
filosofi - filozof
filosofia - filozofia
filosofinen - filozoficzny
finni - pryszcz
flaamilainen - flamandzki, Flamandczyk, Flamandka
floora - flora
flunssa - grypa
fluori - fluor
flyygeli - fortepian
fondue - fondue
foneettinen - fonetyczny
fonetiikka - fonetyka
fonologia - fonologia
fontti - czcionka
foorumi - forum
forelli - pstrąg
fosfori - fosfor
foto - zdjęcie
fotoni - foton
frankium - frans
fregatti - fregata
fregattilintu - fregata
frekvenssi - częstotliwość
frekventti - częsty
fresko - fresk
frontaalinen - przedni
fruitarismi - frutarianizm
frustraatio - frustracja
fundamentaalinen - podstawowy, zasadniczy
funktio - funkcja
furunkuloosi - czyrak
futurologia - futurologia
fysiikka - fizyka
fysikaalisesti - fizycznie
fysiologia - fizjologia
fyysikko - fizyk
fyysillisesti - fizycznie
fyysinen - fizyczny, cielesny
fyysisesti - fizycznie
Gabon - Gabon
gadolinium - gadolin
galaksi - galaktyka
Galilea - Galilea (kraina)
galleria - galeria
gallium - gal
Gambia - Gambia
Gargantua - Gargantua
gaselli - gazela
geeni - gen
genealogia - genealogia
geneettinen - genetyczny
genetiivi - dopełniacz
genre - gatunek, rodzaj
gentlemanni - dżentelmen
geografia - geografia
geologia - geologia
geometria - geometria
geometrinen - geometryczny
georgia - język gruziński
geotiede - geografia
gepardi - gepard
germanium - german
Ghana - Ghana
giganttinen - gigantyczny
gini - dżin
gladiaattori - gladiator
globaalinen - globalny
glossaario - glosariusz
gnoseologia - epistemologia
gnostilaisuus - gnostycyzm
gnostisismi - gnostycyzm
Godzilla - Godzilla
golf - golf
goottilainen - gocki
gorilla - goryl
grafiikka - grafika
gramma - gram
grammaattinen - gramatyczny
grammaattisesti - gramatycznie
granaatti - granat
granaattiomena - granat
graniitti - granit
greippi - grejpfrut
greippimehu - sok grejpfrutowy
Grenada - Grenada
Grönlanti - Grenlandia
Guatemala - Gwatemala
Guinea - Gwinea
Guinea-Bissau - Gwinea Bissau
gynekologi - ginekolog
Haag - Haga
haahka - edredon
haalea - ciepławy, letni
haamu - duch, upiór, zjawa
haapa - osika
haapana - świstun
haarahaukka - kania
haarake - gałąź
haarapääsky - jaskółka dymówka, dymówka
haarukka - widelec
haaska - padlina, ścierwo
haastattelu - wywiad
häät - wesele, ślub
haava - rana
haavautuma - wrzód
haave - marzenie
haaveilla - marzyć
Habarovsk - Chabarowsk
habitaatti - habitat, środowisko
hädässä ystävä tunnetaan - prawdziwych przyjaciół poznaje się w biedzie
hädin tuskin - ledwie, ledwo, zaledwie
hafnium - hafn
hahmo - postać, kształt, figura
hahmotus - percepcja
hahtuva - puch
hai - rekin
haihdunta - parowanie
haihduttaminen - parowanie
haihdutus - parowanie
haihtua - parować, wyparować, ulotnić się, rozproszyć się, zniknąć
häikäilemätön - pozbawiony skrupułów
haikala - rekin
haikara - bocian
haikea - smutny, smętny, gorzki, bolesny
haikeus - nostalgia
hailea - blady
haima - trzustka
haistaa - wąchać, powąchać, węszyć
haisunäätä - skunks
haitari - harmonia
Haiti - Haiti
häivä - ślad
hajamielinen - roztargniony
haje - entropia
hajottaa - rozbić, rozwalić, rozproszyć, rozebrać na części, rozmontować, rozpuścić
haju - zapach, woń, smród, odór
hajuaisti - zmysł powonienie, węch
hajuste - perfumy
hajuvesi - perfumy
häkä - tlenek węgla, czad
hakaneula - agrafka
hakaristi - swastyka
hakemus - podanie, prośba na piśmie
hakkailla - flirtować
hakku - kilof
haksahdus - gafa
hakusana - hasło
halaus - uścisk, objęcie
halkaisija - średnica
halla - nocny przymrozek
halli - hala, foka szara
hallinto - administracja, rząd, zarząd
hallitus - rząd, rada ministrów
hallusinaatio - halucynacja
halpa - tani
haltia - elf
halu - ochota, chęć
haluta - chcieć
halveksia - gardzić, pogardzać, lekceważyć, poniżać
hämähäkki - pająk
hämärä - zmrok, zmierzch, ciemny, mroczny, niewyraźny
hame - spódnica
hammas - ząb
hammasharja - szczoteczka do zębów
hammaskipu - ból zęba
hammaslääkäri - dentysta
hammaspuikko - wykałaczka
hammassärky - ból zęba
hammastahna - pasta do zębów
hammastikku - wykałaczka
hampaankolotus - ból zęba
Hampuri - Hamburg
hän - on, ona
hanakka - chętny
hänen - jego, jej
hanhi - gęś
hankala - trudny, ciężki, żmudny
hanke - projekt
hanki - zmrożony wiosenny śnieg, szreń
hanko - widły
hansikas - rękawiczka
häntä - ogon
Hanti-Mansijsk - Chanty-Mansyjsk
hapan - kwaśny
hapankaali - kapusta kiszona
hapankerma - kwaśna śmietana
hapankirsikka - wiśnia pospolita
hapera - kruchy
happi - tlen
happo - kwas, pijak
hapsukiislanen - nurniczek wąsaty
häpy - srom
häpyhuuli - warga sromowa
häpykieli - łechtaczka
hara - brona
harakka - sroka
häränliha - wołowina
harava - grabie
harha-aistimus - halucynacja
harhakuva - iluzja
harhaoppi - herezja
harja - szczotka, grzywa, grzebień
harjakoskelo - kapturnik
harjalintu - dudek
harjas - szczecina
harjoite - ćwiczenie
harjoittelu - ćwiczenie
harju - wzgórze
härkä - byk
Härkä - Byk
härkälintu - perkoz rdzawoszyi
härkäpapu - bób
harmaa - szary, bezbarwny, przygnębiający, szary kolor
harmaahaikara - czapla siwa
harmaakuukkeli - sójka kanadyjska
harmaalokki - mewa srebrzysta
harmaapäätikka - dzięcioł zielonosiwy
harmaasieppo - muchołówka szara
harmaasirkku - potrzeszcz
harmaasorsa - krakwa
harmiton - niegroźny, nieszkodliwy
harmonia - harmonia
harmonikka - akordeon
harppi - cyrkiel
harppu - harfa
harrastaa - interesować się, mieć hobby
harrastaja - hobbysta, amator, entuzjasta, fan
harraste - hobby
harrastus - hobby, zainteresowanie
härski - zjełczały, bezczelny, śmiały
hartia - ramię, bark
hartiahuivi - szal
harvainvalta - oligarchia
harvinainen - rzadki (nie spotykany często)
harvoin - rzadko
hasis - haszysz
hasselpähkinä - orzech laskowy
hassium - has
hätiköinti - pośpiech
hattara - wata cukrowa, chmurka, obłoczek
hattu - kapelusz
hauki - szczupak
haukka - jastrząb, dzienny ptak drapieżny
haukkua - szczekać
haukotella - ziewać
haukotus - ziewnięcie
haupitsi - haubica
hauras - kruchy, łamliwy, słaby
hauska - sympatyczny, przyjemny, miły
hauta - grób
hautajaiset - pogrzeb
hautakirjoitus - epitafium
hautakivi - nagrobek
hautausmaa - cmentarz
hautuumaa - cmentarz
havainnoida - obserwować
havainnoija - obserwator
havainnoitsija - obserwator
havainto - obserwacja
havaintokyky - percepcja
havaitsija - obserwator
häviö - porażka
hävittäjä - niszczyciel, kontrtorpedowiec, myśliwiec
hävitys - zniszczenie
havu - igliwie
havupuu - drzewo iglaste
he - oni, one
hede - pręcik
hedelmä - owoc
hedelmämehu - sok owocowy
hedonismi - hedonizm
heeros - bohater
hegemonia - hegemonia
hehku - żar, żarzenie
hehkulamppu - żarówka
heidän - ich
Heidi - imię żeńskie
heikko - słaby
heiluri - wahadło
heimo - rodzina, szczep, ród, plemię
heinä - siano, trawa
heinäkurppa - dubelt
heinäkuu - lipiec
heinäsirkka - konik polny
heinätavi - cyranka
heittää - rzucać
heittiö - łajdak
heitto - rzut
heiveröinen - słaby
heksagoninen - sześciokątny
helikopteri - helikopter, śmigłowiec
helium - hel
hellä - wrażliwy, czuły, delikatny, tkliwy
hellävarainen - delikatny
hellävaraisesti - delikatnie
hellävaroen - delikatnie
helle - upał, upalna pogoda
helma - łono
helmi - perła
helmikana - perliczka
helmikuu - luty
helmipöllö - włochatka
helmitaulu - abakus
helposti - prosto, łatwo, lekko, bez trudu
helppo - łatwy
Helsinki - Helsinki
heltta - korale, blaszki
helvetillinen - piekielny
helvetti - piekło
hemisfääri - półkula
hemppo - makolągwa
hengellinen - duchowy
hengellisesti - duchowo
hengenvaara - zagrożenie życia
hengittää - oddychać
hengitys - oddech
henki - oddech, duch, umysł, osoba, życie, wiaterek, powiew wiatru
henkilö - osoba, postać (np. w sztuce, filmie)
henkilöitymä - personifikacja
henkilökohtainen - osobisty, prywatny
henkivartija - ochroniarz
henkselit - szelki
Henrik - Henryk
hepokatti - pasikonik, konik polny
heprea - hebrajski
hera - serwatka
heraldiikka - heraldyka
herätä - budzić się, obudzić się
heräte - bodziec
herättää - budzić, obudzić (kogoś), wzbudzić, wzbudzać, wywoływać, wywołać (coś)
hereä - obfity
herhiläinen - szerszeń
herkkä - wrażliwy, czuły, tkliwy, uczuciowy, sentymentalny
herkullinen - pyszny
hermo - nerw
hermotautioppi - neurologia
herne - groch
hernekerttu - pokrzewka piegża, piegża
heroiini - heroina
heroismi - bohaterstwo
herooinen - bohaterski
herra - pan
herrasmies - dżentelmen
herttainen - czarujący, miły, uprzejmy
herttuatar - księżna
herukka - porzeczka
hete - trzęsawisko, bagno, moczar
heterogeeninen - niejednorodny
heteroseksuaalisuus - heteroseksualizm
heterous - heteroseksualizm
hetki - chwila, moment
hevonen - koń, skoczek
hevosenkenkä - podkowa
hevosvoima - koń mechaniczny
hidas - wolny, powolny
hieho - jałówka
hiekka - piasek
hiekkakello - klepsydra
hiekkakivi - piaskowiec
hiekkalaatikko - piaskownica
hiekkaranta - plaża
hieman - trochę
hienovarainen - subtelny
hierarkia - hierarchia
hietakurki - żuraw kanadyjski
hiha - rękaw
hihna - rzemyk, pasek
hiihtää - jeździć na nartach, uprawiać narciarstwo
hiihto - narciarstwo
hiili - węgiel
hiiri - mysz
hiirihaukka - myszołów
hiiripöllö - sowa jarzębata
hiiro - czepiga
hiiva - drożdże
hiki - pot
hikka - czkawka
hila - kratownica
hiljainen - cichy
hiljaisesti - cicho
hiljaisuus - cisza
hilla - malina moroszka
hilleri - tchórz
hillo - dżem, konfitury
hilpeä - radosny
hilse - łupież
hinnakas - drogi
hinta - cena
hinttari - pedał
hioa - szlifować, ostrzyć
hippiäinen - mysikrólik
hirmuhallitsija - tyran
hirmulisko - dinozaur
hirmuvaltias - tyran
hirssi - proso
hirsutismi - hirsutyzm
hirvi - łoś, mięso łosia
hirviö - potwór, stwór, bestia
hissi - winda
historia - historia
historiallinen - historyczny
hitaasti - powoli, wolno
hitsaaja - spawacz
hiukset - włosy
hiukseton - bezwłosy
hius - włos
hiusharja - szczotka do włosów
hiustenpesuaine - szampon
hiutale - płatek
hivellä - gładzić, głaskać
hockey - hokej
hohkainen - porowaty, gąbczasty
hohkakivi - pumeks
hoito - pielęgnowanie, opieka, leczenie, kuracja, nadzór, pilnowanie, czuwanie, manipulownie, obsługiwanie, troska, dbanie, zawiadywanie, administrowanie
hollanti - holenderski
Hollanti - Holandia
holmium - holm
holtiton - lekkomyślny
home - pleśń
homogeeninen - jednolity
homonymia - homonim
homonyymi - homonim
homoseksuaalisuus - homoseksualizm
hömötiainen - sikora czarnogłowa, czarnogłówka
homous - homoseksualizm
Hongkong - Hongkong
honka - sosna
höntti - prostak
hopea - srebro
hopeainen - srebrny
hopeinen - srebrny
horisontaalinen - poziomy
horisontti - horyzont
horna - piekło
Horus - Horus
hostelli - hostel
hotelli - hotel
housut - spodnie
höyhen - pióro
höyry - para, opar
höyrylaiva - statek parowy, parowiec
höytäle - płatek
huhtikuu - kwiecień
huhu - pogłoska
huilu - flet
huippu - szczyt, wierzchołek, wierzch
Huippuvuoret - Spitsbergen, Svalbard
huivi - szalik
hukka - wilk
huligaani - huligan
hulinoitsija - huligan
hullu - głupiec, wariat, dureń, chory psychicznie, obłąkany
humaani - ludzki
humaaninen - ludzki
humala - chmiel
humanitaarinen - humanitarny
hummeri - homar
hunaja - miód
hunajaopas - miodowód
huoli - zmartwienie, troska, opieka, obawa, trwoga
huomautus - komentarz, uwaga
huomen - poranek, jutro
huomenna - jutro
huomenta - dzień dobry
huomio - uwaga
huomioija - obserwator
huone - pokój, pomieszczenie, dom, ród, dynastia
huonekalu - mebel
huono - zły, biedny
huono-onninen - nieszczęśliwy, pechowy
huora - kurwa, dziwka
huotra - pochwa
hupaisa - śmieszny
hupi - zabawa, ubaw, frajda
hurja - gwałtowny
hurraaisänmaallisuus - patriotyzm
hurrikaani - huragan
huuhkaja - puchacz
huuli - warga
huulipuna - szminka
huumori - humor
huumorintaju - poczucie humoru
huutaa - krzyczeć
huuto - krzyk
huutokauppa - aukcja, licytacja
hydraulinen - hydrauliczny
hydrostatiikka - hydrostatyka
hyeena - hiena
hygienia - higiena
hyinen - lodowaty, zimny jak lód
hylje - foka
hylky - wrak
hylly - półka
hyllykkö - regał
hylsy - łuska
hymni - hymn
hymy - uśmiech
hymyillä - uśmiechać się
hyödyllisyys - użyteczność
hyödytön - bezużyteczny
hyökätä - napadać, atakować
hyökkäys - atak, napad
hyökyaalto - fala przypływu, fala przyboju, fala błądząca, tsunami
hyönteinen - owad
hyönteishävite - środek owadobójczy
hyönteismyrkky - środek owadobójczy
hyönteistiede - entomologia
hyönteistutkimus - entomologia
hyötyisä - korzystny
hypätä - skakać, przeskakiwać
hypnoosi - hipnoza
hypoteekki - hipoteka
hypoteesi - hipoteza
hyppääjä - skoczek
hyppiä - skakać
hyppy - skok
hysteria - histeria
hytti - kabina, kajuta
hyttynen - komar
hyvä - dobry
hyvää huomenta - dzień dobry
hyvää iltaa - dobry wieczór
hyvää joulua - Wesołych Świąt (Bożego Narodzenia)
hyvää yötä - dobranoc
hyvänmakuinen - smaczny
hyväntekijä - dobroczyńca
Hyväntoivonniemi - Przylądek Dobrej Nadzieji
hyveellinen - cnotliwy
hyvin - dobrze, bardzo
iäkäs - starszy
iankaiken - na zawsze
iankaikkisuus - wieczność
idänuunilintu - wójcik, wójcik zielony
idea - pomysł, idea, myśl przewodnia
ideaalinen - idealny
idealismi - idealizm
identifikaatio - identyfikacja
identifiointi - identyfikacja
ideologia - ideologia
idiomaattinen - idiomatyczny
idiomi - idiom
idiootti - idiota
idioottimainen - idiotyczny
idoli - idol
ien - dziąsło
ihan - całkiem, całkowicie
ihanteellinen - idealny
ihme - cud, cudo, dziwo, zdziwienie, zdumienie
ihminen - człowiek
ihmiset - ludzie
ihmisrakas - dobroczynny
ihmissusi - wilkołak
ihmistiede - antropologia
iho - skóra (ludzka)
iibis - ibis
iilimato - pijawka
ikä - wiek (ilość lat)
ikävöidä - tęsknić
ikiajoiksi - na zawsze
ikkuna - okno
ikkunalauta - parapet
iktyologi - ichtiolog
ikuinen - wieczny
ikuisuus - wieczność
iljetys - wstręt, odraza
ilkeämielinen - złośliwy
illallinen - kolacja
illatiivi - ? ?  illativus
illegaali - nielegalny
illustraatio - ilustracja
illuusio - iluzja
ilma - powietrze, pogoda
ilmailu - lotnictwo
ilmailuyhtiö - linie lotnicze (przedsiębiorstwo)
ilmainen - bezpłatny
ilmakehä - atmosfera
ilman - bez, bezpłatnie, darmowo, gratis
ilmanpaine - ciśnienie atmosferyczne
ilmanpainemittari - barometr
ilmapallo - balon
ilmapuntari - barometr
ilmasto - klimat
ilmasto-oppi - klimatologia
ilmastotiede - klimatologia
ilmatiede - meteorologia
ilmeikäs - ekspresyjny
ilmeisemmin - oczywiście
ilmiö - zjawisko
ilmiselvä - oczywisty
iloinen - szczęśliwy, zadowolony
Ilomantsi - Ilomantsi
ilotalo - burdel, dom publiczny
iloton - ponury
ilta - wieczór
iltapäivä - popołudnie
iltti - język buta
ilves - ryś
imaginaatio - wyobraźnia
imartelu - pochlebstwo
imitaatio - imitacja
imitoida - imitować
imitointi - imitacja
immateriaalinen - niematerialny
immigrantti - imigrant
immuniteetti - odporność
immuunius - odporność
imperfekti - czas przeszły prosty
imperialismi - imperializm
impeys - dziewictwo
inarinsaame - język inari
indiisi - poszlaka
indium - ind
indonesia - język indonezyjski
Indonesia - Indonezja
indonesialainen - Indonezyjczyk, Indonezyjka, indonezyjski
inertia - bezwładność
inessiivi - ? ?   inessivus
inflaatio - inflacja
influenssa - grypa
influenssi - wpływ
informaatio - informacja
infrapuna - podczerwień
infrapunainen - podczerwony
infrastruktuuri - infrastruktura
inhimillinen - ludzki
inkarnaatio - inkarnacja
innostus - entuzjazm
innovaatio - innowacja
insektisidi - środek owadobójczy
insinööri - inżynier
inspehtori - inspektor
instituutio - instytucja
instituutti - instytut
instruktiivi - ? ?   instructivus
instrumentti - instrument, narzędzie
integraali - całka
intensiivinen - intensywny
intensiteetti - intensywność
intentio - zamiar
interaktio - interakcja
interiööri - wnętrze
interventio - interwencja
Intia - Indie
Intian valtameri - Ocean Indyjski
intimiteetti - prywatność
into - entuzjazm, zapał
intomielinen - entuzjastyczny
intomielisyys - entuzjazm
intuitio - intuicja
invaasio - inwazja
Irak - Irak
Iran - Iran
iridium - iryd
Irlanti - Irlandia
ironia - ironia
irtolainen - włóczęga, wagabunda
irvokas - groteskowy
isä - ojciec
isänmaa - ojczyzna
isänmaallinen - patriotyczny
isänmaallisuus - patriotyzm
isänmaanrakkaus - patriotyzm
isänpuoleinen - ojcowski
isäpuoli - ojczym
iskeä - uderzyć, uderzać, bić
isku - uderzenie, cios
islamilainen - islamski
islaminusko - islam
islanti - język islandzki
Islanti - Islandia
islantilainen - islandzki
iso - duży, wielki
isoäiti - babcia
Iso-Britannia - Wielka Brytania
isoisä - dziadek
isoisoisä - pradziadek
isojalkakana - nogal
isokäpylintu - krzyżodziób sosnowy
isokihu - wydrzyk wielki, skua
isokoskelo - tracz nurogęś
isolaatio - izolacja
isolepinkäinen - dzierzba srokosz, srokosz
isolokki - mewa blada
isolunni - maskonur pacyficzny
isorokko - ospa
isosirri - biegus rdzawy
isotooppi - izotop
Iso valtameri - Ocean Spokojny
Israel - Izrael
istua - siedzieć
isuri - ingryjski, iżorski
itä - wschód
itäinen - wschodni
italia - włoski
Italia - Włochy
italialainen - włoski
Itämeri - Morze Bałtyckie
Itä-Timor - Timor Wschodni
Itävalta - Austria
itävaltalainen - Austriak, austriacki
Itävalta-Unkari - Austro-Węgry
itiö - zarodnik
itkeä - płakać
itku - płacz
itsehallinto - autonomia
itsekäs - samolubny
itsemurha - samobójstwo
itsemurhaaja - samobójca
itsenäisesti - niezależnie
itsenäisyys - niepodległość
itsepäinen - uparty
itsetoiminen - automatyczny
itsetyydytys - samogwałt, masturbacja
itsevalta - autokracja
ja - i
jää - lód, jäädä
jäädä - pozostawać, zostawać, trwać, pozostać, zostać
jäähdytin - chłodnica
jääkaappi - lodówka
jääkahvi - kawa mrożona
jääkarhu - niedźwiedź polarny
jääkausi - epoka lodowcowa
jääkiekko - hokej na lodzie
jääkuikka - nur białodzioby
jäälautta - kra
jäämä - pozostałość, reszta
jäänmurtaja - lodołamacz
jääpuikko - sopel
jäätee - mrożona herbata
jäätelö - lód
jäätikkö - lodowiec
jäävuori - góra lodowa
jaguaari - jaguar
jakaa - dzielić, rozdzielać
jakaja - dzielnik
jäkälä - porost
jakautua - dzielić się
jako - podział, dzielenie
jakolasku - dzielenie
jakso - etap, okres, period
jaksollinen - okresowy
jakuutti - język jakucki
jalanjälki - ślad stopy
jalava - wiąz
jäljenne - kopia
jäljitellä - naśladować
jalka - stopa, noga, trzon grzyba
jalkajousi - kusza
jalkapallo - piłka nożna
jalkapalloilija - piłkarz
jalkapallojoukkue - drużyna piłkarska
jalkaterä - stopa
jalkavaimo - konkubina
jälki - ślad, trop
jälkikäteen - potem
jalkine - obuwie
jalkineet - obuwie
jälkiruoka - deser
jälkisanat - epilog, zakończenie
jälleen - znowu, znów
jalo - szlachetny
jalohaukka - sokół
jalokivi - kamień szlachetny
jalopähkinä - orzech włoski
Jamaika - Jamajka
jamssi - pochrzyn
jänis - zając
jänkä - moczar, bagno, mokradło
jänkäkurppa - bekasik
jänkäsirriäinen - biegus płaskodzioby
jänne - ścięgno
jännite - napięcie
jano - pragnienie
jänö - zając
janoinen - spragniony
japani - japoński
Japani - Japonia
japanilainen - japoński
jargon - żargon
järin - bardzo
järjestelmä - system
järjestelmällinen - systematyczny
järjestö - organizacja
järkäle - głaz
järripeippo - jer, zięba jer
jarru - hamulec
järvi - jezioro
jäsen - członek
jäsenistö - zgromadzenie członków, ogół członków, kolegium
jasmiini - jaśmin
jatkuminen - kontynuacja
jatsi - jazz
jättää - wychodzić, opuszczać
jättiläismäinen - gigantyczny
jättimäinen - gigantyczny
jauhaa - mleć, mielić
jauho - mąka
jäykkä - sztywny, zdrętwiały, uparty, nieugięty
Jeesus - Jezus
Jeesus Kristus - Jezus Chrystus
jekku - żart, żarcik, figiel
Jemen - Jemen
jo - już
jodi - jod
jo ennestään - już
joensuu - ujście rzeki
Joensuu - Joensuu
jogurtti - jogurt
johde - przewodnik
johdinauto - trolejbus
johtopäätös - wniosek
joka - który
jokainen - każdy
joki - rzeka
jokin - coś
joku - ktoś
jonglööri - żongler
jonne - gdzie
jonnekin - gdzieś
jordanialainen - Jordańczyk, Jordanka, jordański
Jordanjoki - Jordan
jos - jeśli
joskus - czasami, czasem, niekiedy
jouhisorsa - rożeniec
joukkue - drużyna
joulu - święta Bożego Narodzenia
joulukuu - grudzień
joululahja - świąteczny prezent (na święta Bożego Narodzenia)
joulupukki - święty mikołaj
Joulusaari - Wyspa Bożego Narodzenia
journalismi - dziennikarstwo
journalistiikka - dziennikarstwo
jousi - łuk, smyczek
jousiammunta - łucznictwo
jousiampuja - łucznik
Jousimies - Strzelec
joustamaton - sztywny
joutsen - łabędź
joutsenhanhi - gęś łabędzionosa, suchonos
joutuin - szybko
joutuisa - szybki
judo - judo, dżudo
juhla - przyjęcie, święto, ceremonia
juhla-ateria - bankiet
juhlia - imprezować, świętować
julkaisija - wydawca
julkaisu - publikacja
julki - znany, wiadomy
julkisesti - publicznie
julkisuus - rozgłos, reklama
julma - okrutny, groźny
julmasti - okrutnie
jumala - bóg, bóstwo
Jumala - Bóg
jumalainen - boski
jumalankieltäjä - ateista
jumalanpilkka - bluźnierstwo
jumalatar - bogini
jumalolento - bóstwo
jumalusko - deizm
jumaluus - bóstwo
juna - pociąg
junanrata - kolej
juoda - pić
juoksija - biegacz
juoksujalkainen - stonoga
juolukka - borówka bagienna, łochynia
juoma - napój
juomalasi - szklanka
juoppo - pijak
juosta - biegać, biec
juotikas - pijawka
juuri - właśnie, akurat, dokładnie, niedawno, korzeń
juusto - ser
juutalaisuus - judaizm
jyrähdellä - grzmieć
jyrkänne - stromy brzeg, urwisko
jyrkkä - stromy, urwisty
jyrsijä - gryzoń
jyvä - ziarno, zboże, muszka (karabinu)
Jyväskylä - Jyväskylä
kaakao - kakao
kaakko - południowy wschód
kaakkuri - nur rdzawoszyi
kaali - kapusta, łeb, głowa
kaamos - noc polarna
käännös - tłumaczenie, przekład
kääntää - tłumaczyć, odwrócić, kompilować
kääntäjä - tłumacz
kaaoksellinen - chaotyczny
kaaos - chaos
kaaosmainen - chaotyczny
kaapata - porwać, uprowadzić
kaapeli - kabel
kääpiö - karzeł
kaappi - szafka
Kaarina - Katarzyna
käärme - wąż
käärmekaula - wężówka
käärmekotka - krótkoszpon, gadożer
käärmetähti - wężowidło
kaarna - kora
kaasu - gaz
kaasukehä - atmosfera
kaavakuva - diagram
kädenliike - gest
kadetti - kadet
kadmium - kadm
kahdeksan - osiem (8)
kahdeksankymmentä - osiemdziesiąt
kahdeksankymmentäkahdeksan - osiemdziesiąt osiem, 88
kahdeksankymmentäkaksi - osiemdziesiąt dwa, 82
kahdeksankymmentäkolme - osiemdziesiąt trzy, 83
kahdeksankymmentäkuusi - osiemdziesiąt sześć, 86
kahdeksankymmentäneljä - osiemdziesiąt cztery, 84
kahdeksankymmentäseitsemän - osiemdziesiąt siedem, 87
kahdeksankymmentäviisi - osiemdziesiąt pięć, 85
kahdeksankymmentäyhdeksän - osiemdziesiąt dziewięć, 89
kahdeksankymmentäyksi - osiemdziesiąt jeden, 81
kahdeksantoista - osiemnaście (18)
kahdeksas - ósmy
kahdeksikko - ósemka
kahdesti - dwa razy
käheä - ochrypły
kahvi - kawa
kahvila - kawiarnia
kahvinpapu - ziarenko kawy
kahvipapu - ziarenko kawy
kai - prawdopodobnie, może
kaikkeus - wszechświat
kaikki - wszystek, wszystko, każdy
kaikki tiet vievät Roomaan - wszystkie drogi prowadzą do Rzymu
kaiku - echo
kaima - imiennik
kaimaani - kajman
kainalo - pacha
kainalokuoppa - pacha
kaino - wstydliwy, nieśmiały
kaipuu - tęsknota
Kairo - Kair
kaisla - sitowie
kaivaa - kopać
kaivinkone - koparka
kaivo - studnia
kaivos - kopalnia
kaivosmies - górnik
kaivostyöläinen - górnik
Kajaani - Kajaani
käki - kukułka
kakiluumu - persymona
kakkonen - dwójka
kakku - ciasto
kakofonia - kakofonia
kaksi - dwa (2)
kaksikielinen - dwujęzyczny
kaksikylkinen - dwustronny
kaksikymmentä - dwadzieścia (20)
kaksikymmentäkahdeksan - dwadzieścia osiem, 28
kaksikymmentäkaksi - dwadzieścia dwa, 22
kaksikymmentäkolme - dwadzieścia trzy, 23
kaksikymmentäkuusi - dwadzieścia sześć, 26
kaksikymmentäneljä - dwadzieścia cztery, 24
kaksikymmentäseitsemän - dwadzieścia siedem, 27
kaksikymmentäviisi - dwadzieścia pięć, 25
kaksikymmentäyhdeksän - dwadzieścia dziewięć, 29
kaksikymmentäyksi - dwadzieścia jeden (21)
kaksisataa - dwieście (200)
kaksitoista - dwanaście (liczba)
kaksituhatta - dwa tysiące (2000)
kaksoispiste - dwukropek
Kaksoset - Bliźnięta
kaktus - kaktus
kala - ryba
kalalokki - mewa pospolita
kalastaa - łowić ryby
kalastaja - rybak
kalastajakissa - taraj
Kalastajasaarento - Półwysep Rybacki
kalastus - rybołówstwo, łowienie ryb
kalatiira - rybitwa rzeczna
kaleidoskooppi - kalejdoskop
kalenteri - kalendarz
kalibrointi - kalibracja
kalifaatti - kalifat
kalifi - kalif
kalifornium - kaliforn
kalium - potas
kalja - piwo
kalju - łysy
kalkkarokäärme - grzechotnik
kalkkikivi - wapień
kalkkuna - indyk
kallio - skała
kallionjärkäle - głaz
kallis - drogi, kosztowny
kallisarvoinen - cenny
kallo - czaszka
kalmari - kalmar
kalmisto - cmentarz, cmentarzysko
kalpea - blady
kalsium - wapń
kaltainen - podobny
kalvakka - blady
kalvas - blady
kalvo - błona
käly - szwagierka
Kambodža - Kambodża
kameleontti - kameleon
kameli - wielbłąd
Kamerun - Kamerun
kamferi - kamfora
kämmen - dłoń
kamomilla - rumianek
kampela - stornia, flądra
Kamtšatka - Kamczatka (półwysep)
kana - kurczak, kura
Kanada - Kanada
kanadanhanhi - bernikla kanadyjska
kanahaukka - jastrząb, jastrząb gołębiarz
kanalja - łajdak
kananmuna - kurze jajko
kanarialintu - kanarek
kanarianhemppo - kanarek
Kanariansaaret - Wyspy Kanaryjskie
kaneli - cynamon
kanerva - wrzos
kangas - tkanina, sukno, wrzosowisko, suche miejsce w lesie
kangaskiuru - skowronek borowy, lerka
kangaspuut - krosno
kani - królik, lombard
kaniini - królik
kanjoni - kanion
kankku - pośladek
kannabis - konopie
kannas - przesmyk
kannattaja - zwolennik, stronnik
kannibaali - kanibal
kannibalismi - kanibalizm
kannuste - zachęta
kännykkä - telefon komórkowy
kanonisointi - kanonizacja
kansa - naród
kansainvälinen - międzynarodowy
kansakunta - nacja
kansalainen - obywatel
kansalaisuus - obywatelstwo
kansallinen - narodowy
kansallismielinen - nacjonalistyczny
kansallismielisyys - nacjonalizm
kansallispuisto - park narodowy, rezerwat przyrody
kansallisuus - narodowość
kansanperinne - folklor
kansanvalta - demokracja
kansanvaltainen - demokratyczny
kansatiede - etnologia
kansi - pokrywka, okładka, pokład
kanssa - wraz, ze, z, też, również
kanssakäyminen - interakcja
kantaa - nieść, dźwigać
kantapää - pięta
kanuuna - działo
kaoottinen - chaotyczny
käpälä - łapa
kapalo - pielucha
kapea - wąski
kapeasti - wąsko, ciasno
kapeikko - cieśnina, przesmyk
Kapernaum - Kafarnaum
kapina - powstanie, bunt, rebelia
kapitalismi - kapitalizm
kapitalisti - kapitalista
kappale - sztuka, egzemplarz, ciało, kawałek
kappeli - kaplica
kapustahaikara - warzęcha
kapustarinta - siewka złota
Kap Verde - Republika Zielonego Przylądka
käpy - szyszka
käpylintu - krzyżodziób ( Loxia sp.)
käpytikka - dzięcioł duży, dzięcioł pstry duży
karamelli - cukierek
karanteeni - kwarantanna
kardemumma - kardamon
kardinaali - kardynał
kardiologia - kardiologia
kargo - towar
kärhämöidä - kłócić się
karhi - brona
karhu - niedźwiedź
karikatyyri - karykatura
karikukko - kamusznik
karimetso - kormoran czubaty
karitsa - jagnię
karjala - język karelski
Karjala - Karelia
karjalainen - karelski, Karelczyk
Karjalan tasavalta - Republika Karelia
karjapaimen - kowboj
kärkäs - chętny
karkausvuosi - rok przestępny
kärki - szpic, czubek, szczyt
karnevaali - karnawał
karpalo - żurawina
kärpänen - mucha
kärpässieni - muchomor
kärppä - gronostaj
karppi - karp
karriääri - kariera
karrieeri - kariera
kärsivällinen - cierpliwy
kärsivällisyys - cierpliwość
karski - szorstki, opryskliwy
kartasto - atlas
kartio - stożek
kartonki - karton
kartta - mapa
karttapallo - globus
kartuttaa - gromadzić
karu - surowy, niegościnny, nieurodzajny
karviainen - agrest
käry - swąd, woń spalenizny
kasari - rondel
käsi - dłoń, ręka
käsikärryt - taczka
käsivarsi - ramię
käskeä - kazać, rozkazywać
käsky - rozkaz, nakaz, przykazanie
Kassiopeia - Kasjopeja
kaste - rosa, chrzest
kastemato - dżdżownica
kasti - kasta
kastike - sos
kastraatio - kastracja
kastraatti - kastrat
kasuaari - kazuar
kasvaa - rosnąć
kasvi - roślina
kasvillisuus - roślinność
kasvinsyöjä - roślinożerca
kasvioppi - botanika
kasvis - warzywo
kasvissyönti - wegetarianizm
kasvisto - flora
kasvitiede - botanika
kasvot - twarz
kataja - jałowiec
katalogi - katalog
katapultti - katapulta
katastrofi - katastrofa
katedraali - katedra
kateellinen - zazdrosny
kategoria - kategoria
katekismus - katechizm
kateus - zazdrość
kätilö - położna
kätkä - rosomak
katkarapu - krewetka
katkeruus - gorycz
kätkyt - kołyska
katodi - katoda
katolinen - katolicki
katsastaja - inspektor
katsoa - patrzeć
katto - sklepienie, sufit, dach
kattohaikara - bocian biały
katu - ulica
kauan - długo
kauas - daleko
kauhu - paniczny strach
Kaukasia - Kaukaz
kaula - szyja
kaulaketju - naszyjnik
kaulakoru - naszyjnik
kaulaliina - szalik
kaulus - kołnierz
kauneus - piękno
kaunis - piękny, ładny, śliczny
kauniste - dekoracja
kaunistus - dekoracja
kaunopuheisuus - elokwencja
kauppa - handel, wymiana handlowa, sklep
kauppatori - targ
kauppias - kupiec, handlarz
kaupunki - miasto
kaupunkimainen - miejski
kaura - owies
kausi - epoka, sezon, period
kauttaaltaan - dokładnie, gruntownie
kävellä - chodzić, spacerować
kävely - spacer, chód
kaveri - kolega, facet, koleś
kaviaari - kawior
kavio - kopyto
käymälä - toaleta
käyrä - krzywy, krzywa
käytännöllinen - praktyczny
käyttää - używać, użytkować, korzystać
käyttäjä - użytkownik
käyttäytyminen - zachowanie
Kazakstan - Kazachstan
Kefeus - Cefeusz
kefiiri - kefir
kehäriutta - atol
keho - ciało człowieka
kehto - kołyska
kehtolaulu - kołysanka
kehunta - pochwała
keidas - oaza
keihäänheitto - rzut oszczepem
keihäs - włócznia, oszczep
keimailla - flirtować
keisari - cesarz
keisaripingviini - pingwin cesarski
keitinliemi - rosół
keittää - gotować
keittiö - kuchnia
keitto - zupa
keittokirja - książka kucharska
keksijä - wynalazca
kelju - nieprzyjemny
kellari - piwnica
kellertävä - żółtawy
kellervä - żółtawy
kello - zegar, zegarek, godzina, dzwonek
keltahemppo - kulczyk
keltainen - żółty, kolor żółty
keltamo - jaskółcze ziele
keltasirkku - trznadel, trznadel zwyczajny
keltuainen - żółtko
kemia - chemia
kemiallinen - chemiczny
kemisti - chemik
kenguru - kangur
Kenia - Kenia
kenkä - but
kenkänokka - trzewikodziób
kentauri - centaur
kenties - prawdopodobnie
kenttä - pole, teren
kepponen - figiel, żart, psikus
keraaminen - ceramiczny
keräkaali - kapusta
keräkurmitsa - mornel
kerettiläisyys - herezja
kerjuri - żebrak
kerma - śmietanka
kernaasti - chętnie
kerros - kondygnacja, piętro, warstwa
kersantti - sierżant
kerta - raz
kertoa - opowiadać, mówić, mnożyć
kertolasku - mnożenie
kertosäe - refren
kertotaulu - tabliczka mnożenia
kerttu - pokrzewka
kerttunen - ptak z rodzaju
kesä - lato
kesäinen - letni, związany z latem
kesakko - pieg
kesäkurpitsa - cukinia, kabaczek
kesäkuu - czerwiec
kesanto - ugór, odłóg
kesken - między, pomiędzy
Keski-Afrikan tasavalta - Republika Środkowoafrykańska
keskiaikainen - średniowieczny
keskimääräinen - przeciętny, mierny
keskinäinen - wzajemny
keskipäivä - południe
keskiviikko - środa
keskiyö - północ, środek nocy, czas około godziny 24:00
keskus - centrum
keskushermosto - ośrodkowy układ nerwowy
keskusta - centrum (miasta), centrum
keskustelu - rozmowa, dyskusja
kestit - uczta
ketale - łajdak
ketju - łańcuch
ketkale - łajdak
ketsuppi - keczup
kettu - lis
keuhko - płuco
keuhkokuume - zapalenie płuc
keväinen - wiosenny
kevät - wiosna
kevyesti - lekko
kevyt - lekki
kide - kryształ
kidutus - tortura
kielenkääntäjä - tłumacz
kieli - język, język (mówiony), struna
kieliopillinen - gramatyczny
kieliopillisesti - gramatycznie
kielioppi - gramatyka
kielitiede - językoznawstwo
kielitieteellinen - językowy
kielitieteilijä - językoznawca
kielo - konwalia
kieltää - zabraniać, zakazywać
kielto - zakaz, odmowa, negacja, przeczenie
kierto - obrót, cyrkulacja, krążenie
kiertotie - objazd
kihu - wydrzyk
kiihkoilija - fanatyk
kiihoke - bodziec, zachęta
kiihtyvyys - przyśpieszenie
kiikari - lornetka
kiina - język chiński, chińszczyzna
Kiina - Chiny
kiinalainen - chiński
kiirastuli - czyściec
kiire - pośpiech, wierzch głowy, ciemię
kiiruna - pardwa górska
kiiski - jazgarz
kiisla - nurzyk
kiislanen - nurniczek
kiistelty - kontrowersyjny
kiitettävä - wspaniały
kiitollinen - wdzięczny
kiitos - dzięki, podziękowanie
kiittää - dziękować
kiivetä - wspinać się
kiivi - kiwi
kikherne - groch
kiljuhanhi - gęś mała
kilogramma - kilogram
kilometri - kilometr
kilpailu - mecz, rozgrywka, zawody
kilpakävely - chód sportowy
kilpi - tarcza
kilpikonna - żółw
kilpirauhanen - tarczyca
kilta - cech
kiltinänsaame - język kildin
kimalainen - trzmiel
kimara - koktail
kinkku - szynka
kinnas - rękawiczka
kino - kino
kinos - zaspa śnieżna
kioski - kiosk
Kiova - Kijów
kipinä - iskra
kipu - ból
kirahvi - żyrafa
Kirgisia - Kirgistan
Kiribati - Kiribati
kirja - książka
kirjailija - pisarz
kirjaimisto - abecadło
kirjain - litera
kirjakaappi - regał na książki
kirjakauppa - księgarnia
kirjakielinen - literacki
kirjallinen - literacki, pisemny
kirjallisuus - literatura
kirjanpitäjä - księgowy
kirjasto - biblioteka
kirjastonhoitaja - bibliotekarz
kirjava - wielobarwny, kolorowy, pstrokaty, pstry, różnorodny, rozmaity
kirje - list
kirjohanhi - bernikla
kirjoittaa - pisać
kirjoittaja - pisarz
kirjoitus - pisanie, pismo, tekst
kirjoituskone - maszyna do pisania
kirjonta - haft
kirjosiipikäpylintu - krzyżodziób modrzewiowy, krzyżodziób dwupręgowy
kirkko - kościół
kirkollinen - kościelny
kirkonkylä - wieś kościelna, wieś w której znajduje się kościół, wieś parafialna, wieś centralna, centrum gminy
kirnupiimä - maślanka
kirppu - pchła
kirsikka - czereśnia
kirurgi - chirurg
kirva - mszyca
kirves - siekiera
kirvesmies - stolarz
kirvinen - świergotek
kisa - gra, zabawa
kisailija - konkurent
kisko - szyna
kissa - kot, atrakcyjna i seksowna młoda kobieta, kociak
kissanpentu - kociątko
kisu - kotek
kitalaki - podniebienie
kitara - gitara
kitka - tarcie
kitti - kit
Kittilä - Kittilä (gmina w Laponii)
kiukku - gniew
kiuru - skowronek
kiusaantuneisuus - zażenowanie
kiusata - dręczyć, nękać, męczyć, przeszkadzać, denerwować
kiva - fajny, super, miły, przyjemny
kivääri - karabin
kivenlohkare - głaz
kivennäistiede - mineralogia
kives - jądro
kivespussi - moszna
kivi - kamień
kivijärkäle - głaz
kivikkorastas - nagórnik, drozd skalny
kivilohkare - głaz
kivilouhos - kamieniołom
kivitasku - białorzytka
kivulias - bolesny
kivulloinen - bolesny
klarinetti - klarnet
klassinen - klasyczny
kleptomania - kleptomania
kliininen - kliniczny
klimatologia - klimatologia
klinikka - klinika
klo - godzina
klooni - klon
kloori - chlor
klorofylli - chlorofil
klovni - klaun
ko - czy, zastanawiać się, zadawać sobie pytanie
-ko - czy
kö - ko
koala - koala
koboltti - kobalt
koditon - bezdomny
koe - próba, doświadczenie, eksperyment, test
kofeiini - kofeina
kohina - szum, szmer, hałas, szum fal
kohtalo - przeznaczenie, los, dola
kohteliaisuus - grzeczność, komplement
kohtio - cel
kohtu - macica
koi - mól
koillinen - północny wschód, północno-wschodni
koipi - noga ptaka, noga
koira - pies
koiras - samiec
koite - świt
koitos - walka
koivikko - lasek brzozowy, brzeziniak
koivu - brzoza
kokaiini - kokaina
kokelas - kandydat, kadet
kokemus - doświadczenie
kokko - ognisko
koko - wielkość, rozmiar, cały, wszystek, całkowicie, całkiem
kokoelma - kolekcja
koksi - koks
koktaili - koktail
kolari - wypadek, kolizja, zderzenie
Kolari - Kolari (gmina w Laponii)
köli - kil
kolibri - koliber
koliikki - kolka
kolikko - moneta
kollapsi - zapaść
kollektiivinen - zbiorowy
kollo - głupi
kolmas - trzeci
kolmastoista - trzynasty
kolme - trzy (3)
kolmekymmentä - trzydzieści
kolmekymmentäkahdeksan - trzydzieści osiem, 38
kolmekymmentäkaksi - trzydzieści dwa, 32
kolmekymmentäkolme - trzydzieści trzy, 33
kolmekymmentäkuusi - trzydzieści sześć, 36
kolmekymmentäneljä - trzydzieści cztery, 34
kolmekymmentäseitsemän - trzydzieści siedem, 37
kolmekymmentäviisi - trzydzieści pięć, 35
kolmekymmentäyhdeksän - trzydzieści dziewięć, 39
kolmekymmentäyksi - trzydzieści jeden, 31
kolmesataa - trzysta
kolmetoista - trzynaście (13)
kolmikulmainen - trójkątny
kolmikulmio - trójkąt
kolmiloikka - trójskok
kolmio - trójkąt
kolmiulotteinen - trójwymiarowy
kolmonen - trójka
kolonia - kolonia
kolonisaatio - kolonizacja
kolonoskopia - kolonoskopia
kolossaalinen - kolosalny
Kolumbia - Kolumbia
Kolumbus - Kolumb (odkrywca)
komea - przystojny, wspaniały, okazały
komedia - komedia
komeetta - kometa
komeus - elegancja, wspaniałość, świetność, okazałość
komissaari - komisarz
komitatiivi - ? ?  comitativus
komitea - komitet
kommentti - komentarz
kommunikaatio - komunikacja
kommunismi - komunizm
komparaatio - porównanie
komparatiivi - stopień wyższy
kompassi - kompas
kömpelö - niezdarny, ociężały
kompleksikas - złożony
kompleksisuus - złożoność
kompositio - kompozycja
kompotti - kompot
kompromissi - kompromis
konditionaali - tryb warunkowy
kondomi - prezerwatywa
kondori - kondor
kone - maszyna
konepaja - warsztat
konferenssi - konferencja
konjakki - koniak
konjektuuri - przypuszczenie
konjunktio - koniunkcja, spójnik
konkreettinen - konkretny
konna - ropucha
konsensus - konsensus, zgoda
konsertti - koncert
konservatiivinen - konserwatywny
konspiraatio - konspiracja
konstikas - szczególny, osobliwy, skomplikowany, zawiły, złożony
konstikkuus - osobliwość, zawiłość
konsulaatti - konsulat
konsuli - konsul
kontakti - kontakt
konteksti - kontekst
kontiainen - kret
kontio - niedźwiedź, niedźwiadek
kontrabasso - kontrabas
konveksi - wypukły
konvergenssi - konwergencja, ewolucja konwergentna
koodi - kod
kookas - okazały, rosły
kookosmaito - mleczko kokosowe
kookospähkinä - kokos
koomikko - komediant, komik
koominen - komiczny
Kööpenhamina - Kopenhaga
kooperaatio - współpraca
kopea - dumny, pyszny, zarozumiały, pyszałkowaty
kopio - kopia
kopioida - kopiować, przerysowywać, przepisywać
kopisti - kopista
kopla - banda, szajka
koppa - kosz
koppelo - samica głuszca
koppi - buda, budka, cela
koputtaa - pukać
Koraani - Koran
koralli - koral
korallieläin - koralowiec
korallisaari - wyspa koralowa
korea - koreański
korealainen - Koreańczyk, Koreanka, koreański
kori - kosz, koszyk
koripallo - koszykówka
koristaa - ozdabiać, dekorować
koriste - ozdoba, dekoracja
koristella - dekorować
koristelu - dekoracja
korjata - naprawić, reperować, remontować
korjaus - naprawa, reperacja, korekta, poprawa, remont, renowacja
korkea - wysoki
korkeapaine - wyż, wyż baryczny
korkeus - wysokość
korkeushyppy - skok wzwyż
korkkiruuvi - korkociąg
korko - obcas, oprocentowanie
koronkiskonta - lichwa
korppi - kruk
korppikotka - sęp
korppu - sucharek
korrektisti - poprawnie
korrelaatio - korelacja
korroosio - korozja
korsetti - gorset
korsi - źdźbło
korskea - wyniosły
kortti - karta
koru - ozdoba, dekoracja, biżuteria
koruompelu - haft
korut - biżuteria, ozdoby
korva - ucho, uszko, rączka, uchwyt, krawędź, skraj
korvakoru - kolczyk
kosia - zalecać się
kosija - konkurent, zalotnik
koska - kiedy, gdy, ponieważ, bo
koskea - dotykać, dotknąć, dotyczyć, urazić, zranić
koskelo - tracz
koski - szybki, wartki nurt w rzece
koskikara - pluszcz
kosminen - kosmiczny
kostea - wilgotny
kosto - zemsta
kostoisku - odwet
koti - dom, miejsce, w którym się żyje/mieszka
kotieläin - zwierzę domowe
kotikalja - piwo
kotilo - ślimak
kotilokurki - bekaśnica
kotimaa - ojczyzna
kotirouva - gospodyni domowa
kotitehtävä - zadanie domowe
kotka - orzeł
Kotka - Kotka, gwiazdozbiór Orła
kotoperäinen - endemiczny
kottarainen - szpak
koulu - szkoła
koululainen - uczeń
kova - twardy
kovakuoriainen - chrząszcz
kovalevy - twardy dysk
kovera - wklęsły
koveruus - wklęsłość
kovin - bardzo
kovuus - twardość
köyhä - biedny
köyhyys - bieda, ubóstwo
köysi - lina, sznur
kpl - sztuka, egzemplarz
kraana - kran
kraatteri - krater
Krakova - Kraków
krapula - kac
kravatti - krawat
kreatiivinen - kreatywny
kreikka - grecki
Kreikka - Grecja
kreikkalainen - grecki, Grek
kreivi - hrabia
kreivitär - hrabina
kriisi - kryzys
kriitikko - krytyk
kriminaalinen - przestępczy, kryminalny
kristalli - kryształ
kristinusko - chrześcijaństwo
kristinuskoinen - chrześcijański
kristitty - chrześcijański, chrześcijanin
kristologia - chrystologia
kriteeri - kryterium
kritiikki - krytyka
kroatia - chorwacki
Kroatia - Chorwacja
kroissantti - rogalik
krokotiili - krokodyl
kromi - chrom
kromosomi - chromosom
kronikka - kronika
kronologinen - chronologiczny
krusifiksi - krucyfiks
kruunajaiset - koronacja
kruunata - koronować
kruunu - korona
kruunusta luopuminen - abdykacja
krypton - krypton
krysanteemi - chryzantema
krysopraasi - chryzopraz
ksenofobia - ksenofobia
ksenon - ksenon
ksylofoni - ksylofon
kubismi - kubizm
kudos - tkanka
kuhankeittäjä - wilga
kuhilas - snop
Kuhmo - Kuhmo (miasto we wschodniej Finlandii)
kuhmura - stłuczka
kuikka - nur czarnoszyi, ptak z rodzaju nurów
kuinka - jak? w jaki sposób?
kuiskaus - szept
kuiskia - szeptać
kuiskina - szept
kuitu - włókno
kuiva - suchy
kuivakas - suchy
kuivuus - suchość, susza
kuja - uliczka, alejka
kujanne - aleja
kuje - żarcik, figiel
kuka - kto?
kukaties - prawdopodobnie
kukinto - kwiatostan
kukka - kwiat, marihuana
kukkakaali - kalafior
kukkanen - kwiat
kukkaruukku - donica, doniczka
kukko - kogut
kukkula - wzgórze, pagórek
kukunta - kukułka
kulho - miska
kuljeksija - wędrowiec, wędrownik
kulkija - wędrowiec, włóczęga
kulkutaudinomainen - epidemiczny
kulma - kąt, zakątek, róg, węgieł
kulmakarva - brew
kulmapotku - rzut rożny
kulmikas - kanciasty
kulorastas - paszkot
kulta - złoto, złoty medal, kochanie, złotko
kultainen - złoty, słodki
kultakala - złota rybka
kultarinta - zaganiacz
kultti - kult
kulttuuri - kultura
kumi - guma, gumka do ścierania, prezerwatywa
kummitäti - matka chrzestna
kumppani - kompan, towarzysz, wspólnik, partner
kumpu - pagórek, wzgórze
kun - gdy
kuningas - król
kuningaskalastaja - zimorodek
kuningaskunta - królestwo
kuningasmerikotka - bielik olbrzymi
kuningaspingviini - pingwin królewski
kuningatar - królowa
kunnas - pagórek
kunniakas - wspaniały
kunnianhimo - ambicja
kunnianhimoinen - ambitny
kunnioittava - pełen szacunku
kunta - gmina
kuntoutus - rehabilitacja
kuoha - piana
kuohita - kastrować
kuohkea - puszysty
kuokka - motyka, oskard
kuolema - śmierć, zgon
kuolematon - nieśmiertelny
kuolla - umrzeć (na)
kuollut - martwy
Kuollutmeri - Morze Martwe
kuono - ryj
kuori - skórka, skorupka
kuoriainen - żuk
kuorma-auto - ciężarówka
kuormata - załadować
kuoro - chór
kuovi - kulik
kuovisirri - biegus krzywodzioby
kupari - miedź
kupera - wypukły
kupoli - kopuła
kuppa - syfilis, kiła
kuppatauti - syfilis, kiła
kuppi - filiżanka
kupula - stłuczka
kura - błoto, biegunka
kurantti - aktualny
kureliivi - gorset
kuriiri - kurier
kurki - żuraw, żuraw zwyczajny, gatunek ptaka lub osobnik należący do rodziny żurawi
kurkku - gardło, ogórek, korniszon
kurmitsa - siewka
kurpitsa - dynia
kurppa - bekas
kurssi - kurs
kuskus - kuskus
kustanne - publikacja
kustantaja - wydawca
kutale - łajdak
kutitella - łaskotać
kutittaa - łaskotać
kutoa - tkać
kutsu - zaproszenie
kutsua - zapraszać
kutsumanimi - przydomek
kutu - tarło
kuu - księżyc, satelita planety, miesiąc, łój, zwierzęcy tłuszcz, litera Q
Kuu - Księżyc
Kuuba - Kuba
kuudes - szósty
kuukausi - miesiąc
kuukkeli - sójka złowroga, sójka syberyjska
kuula - kula, pocisk
kuulakärkikynä - pióro kulkowe, długopis
kuulantyöntö - pchnięcie kulą
kuuliainen - posłuszny
kuulla - słuchać, słyszeć
kuulo - słuch
kuuluisa - słynny
kuuma - gorący
kuumailmapallo - balon na ogrzane powietrze
kuume - gorączka, temperatura
kuunnella - słuchać
kuunvalo - światło księżyca
kuura - szron
kuurous - głuchota
Kuusamo - Kuusamo
kuusi - sześć (6), świerk
kuusikulmainen - sześciokątny
kuusikymmentä - sześćdziesiąt
kuusikymmentäkahdeksan - sześćdziesiąt osiem, 68
kuusikymmentäkaksi - sześćdziesiąt dwa, 62
kuusikymmentäkolme - sześćdziesiąt trzy, 63
kuusikymmentäkuusi - sześćdziesiąt sześć, 66
kuusikymmentäneljä - sześćdziesiąt cztery, 64
kuusikymmentäseitsemän - sześćdziesiąt siedem, 67
kuusikymmentäviisi - sześćdziesiąt pięć, 65
kuusikymmentäyhdeksän - sześćdziesiąt dziewięć, 69
kuusikymmentäyksi - sześćdziesiąt jeden, 61
kuusisataa - sześćset
kuusitiainen - sikora sosnówka, sosnówka
kuusitoista - szesnaście (16)
kuutamo - światło księżyca
kuutio - sześcian, kostka
kuutonen - szóstka
kuva - obrazek, obraz
kuvaannollinen - obrazowy, symboliczny, przenośny, alegoryczny
kuvaannollisesti - obrazowo, symbolicznie, przenośnie, alegorycznie
kuvake - ikona, obrazek
kuvanveistäjä - rzeźbiarz
kuvaruutu - ekran
kuvernööri - gubernator
kuvitella - wyobrażać, wyobrażać sobie
kuvitus - ilustracja
kuvottaa - mdlić, ciągnąć na wymioty
Kuwait - Kuwejt
kvalitatiivinen - jakościowy
kvantitatiivinen - ilościowy
kvartsi - kwarc
kyber- - cyber- (internetowy)
kybernetiikka - cybernetyka
kyhmy - guz, narośl
kyhmyhaahka - edredon okazały, turkan
kyhmyjoutsen - łabędź niemy
kyklooppi - cyklop
kyky - talent, umiejętność, dar
kylä - wieś
kyläläinen - chłop
kyläpöllönen - syczek, syczek zwyczajny
kyljys - kotlet
kyllä - tak
kyllästynyt - nasycony, syty, przesycony, znużony, zmęczony
kylliksi - wystarczająco, dość, dosyć
kyllin - wystarczająco
kylmä - zimny, zimno
kylpyhuone - łazienka
kylvää - siać
kymmenen - dziesięć (10)
kymmenes - dziesiąty
kymmenottelu - dziesięciobój
kymppi - dziesiątka
kynä - długopis, ołówek
kynäilijä - pisarz
kynnys - próg
kynsi - paznokieć, pazur, szpon
kynttilä - świeca
kynttilänjalka - świecznik
kypärä - hełm
Kypros - Cypr
kyrillinen - cyrylicki
kyrpä - chuj, huj
kyssäkurki - gruchacz
kysyä - pytać, prosić
kysymys - pytanie, kwestia, problem
kysymysmerkki - znak zapytania
kytkeä - połączyć, związać, sprzęgać, sprzęgnąć
kyy - żmija
kyyhky - gołąb
kyyhkynen - gołąb
kyyhkyrääkkä - madagaskarnik
kyynärpää - łokieć
kyynel - łza
kyyninen - cyniczny
laadukas - jakościowy
laadullinen - jakościowy
läähättää - dyszeć
laaja - szeroki, obszerny, przestronny, wyczerpujący
laajentaa - rozszerzyć, rozciągnąć, powiększyć
lääkäri - lekarz
lääke - lekarstwo, lek
laakea - płaski
laakeri - łożysko, laur, wawrzyn
lääketiede - medycyna
lääketieteellinen - medyczny
laakso - dolina
laama - lama
laasti - zaprawa murarska
laatikko - pudełko, pudło, skrzynia, szuflada
laatu - jakość, gatunek
laava - lawa
laboratorio - laboratorium
labyrintti - labirynt
laguuni - laguna
lähde - źródło
läheisesti - blisko
lähellä - blisko, w pobliżu
lähettäjä - nadawca
lähiseutu - sąsiedztwo
lahja - prezent, podarunek, dar
lahjoittaja - dawca, dobroczyńca
lahjonta - przekupstwo, korupcja
lahjus - łapówka
lahna - leszcz
lahti - zatoka, rzeź, ubój
lähtien - od
laidun - pastwisko
laiha - chudy, szczupły
laihtua - chudnąć, schudnąć
laillistus - legalizacja
laina - pożyczka, kredyt, słowo zapożyczone
lainata - pożyczać, wypożyczać
laine - fala
lainsäädännöllinen - ustwodawczy
lainsäädäntö - ustawodawstwo
laiska - leniwy
laiskanpulskea - leniwy
laiskiainen - leniwiec
laitos - urząd, instytucja
laituri - pomost, molo
laiva - statek, nawa
laivanhylky - wrak
laivue - flotylla, flota
laji - gatunek
lakana - prześcieradło
lakeija - lokaj
laki - prawo, ustawa, szczyt górski, sufit, strop, powała
lakiasäätävä - ustwodawczy
lakka - moroszka, malina moroszka
lakki - czapka
läkki - blacha
lakko - strajk
lakoninen - lakoniczny
lakritsi - lukrecja
läksy - zadanie domowe
lammas - owca
lammikko - kałuża, sadzawka, bajoro
lämmin - ciepły
lampaanliha - baranina
lampi - staw (zbiornik wodny)
lampiviklo - brodziec pławny
lämpö - ciepło
lämpötila - temperatura
lamppu - żarówka, lampa, lampka
lampunvarjostin - klosz
langaton - bezprzewodowy
lanka - nić, nitka
lanko - szwagier
länsi - zachód
Länsi Berliini - Berlin Zachodni
Länsi-Sahara - Sahara Zachodnia
lanta - gnój
lantaani - lantan
lantio - miednica
lantti - moneta
Laos - Laos
lapaluu - łopatka
lapasorsa - kaczka płaskonos
lapasotka - ogorzałka
läpeensä - dokładnie, gruntownie
läpikotaisesti - dokładnie, gruntownie
läpikuultamaton - nieprzezroczysty
läpinäkymätön - nieprzezroczysty
läpinäkyvyys - przezroczystość
lapinkirvinen - świergotek rdzawogardły
lapinpöllö - puszczyk mszarny
lapinsirkku - poświerka, poświerka szponiasta
lapinsirri - biegus mały
lapintiainen - sikora północna, sikora syberyjska
lapio - łopata
Lappi - Laponia
lapsenlapsi - wnuk
lapsi - dziecko
lapsuus - dzieciństwo
laser - laser
laseri - laser
lasi - szkło, szklanka
lasikaappi - gablota
lasikko - gablota
laskea - liczyć
laskiainen - ostatki, zapusty
laskimo - żyła
laskin - kalkulator
lasku - odpływ, ujście rzeki, odjazd, zachód słońca, konto, rachunek
laskuvarjo - spadochron
Lassi - fińskie imię męskie pochodzenia łacińskiego
lastentarha - przedszkole
lätäkkö - kałuża
lateksi - lateks
latentti - ukryty
lato - stodoła
lattana - płaski
lättänä - płaski
lattia - podłoga
latva - wierzchołek, szczyt, korona, górny bieg rzeki
latvia - język łotewski
Latvia - Łotwa
latvialainen - łotewski, Łotysz
latvusto - baldachim
lauantai - sobota
laukku - teczka, torba, tornister, plecak
laulaa - śpiewać
laulaja - śpiewak
laulu - piosenka, pieśń, śpiewanie
laulujoutsen - łabędź krzykliwy
laulurastas - drozd śpiewak
lauma - stado,trzoda, gromada, tłum
laupias - miłosierny, litościwy
lause - zdanie, twierdzenie
lauta - deska
lautanen - talerz
lautta - tratwa, prom
lavastaja - scenograf, dekorator, altannik
lavea - szeroki
lawrencium - lorens
legenda - legenda
legendaarinen - legendarny
legioona - legion
lehmä - krowa, otyła kobieta
lehmipoika - pastuch bydła, kowboj
lehmus - lipa
lehteri - balkon
lehti - liść, gazeta, czasopismo
lehtikuusi - modrzew
lehtipuu - drzewo liściaste
lehtivihreä - chlorofil
lehto - zagajnik
lehtokerttu - pokrzewka ogrodowa, gajówka
lehtokurppa - słonka
lehtopöllö - puszczyk, puszczyk zwyczajny
lehtori - wykładowca
leija - latawiec
leijona - lew
leikkiä - bawić się
leikkikalu - zabawka
leikkikenttä - plac zabaw
leikkipuisto - plac zabaw
Leila - Leila, fińskie imię żeńskie
leimasin - stempel
leipä - chleb
leipoa - piec
leipomo - piekarnia
leipuri - piekarz
leiri - obóz
leivonen - skowronek
leivos - ciastko
lejeerinki - stop
lelu - zabawka
lempeys - czułość
lempiä - kopulować, kochać się
lempinimi - przydomek
lenko - zgięty
lentää - latać
lento - lot, lento
lentoasema - lotnisko
lentokenttä - lotnisko
lentokone - samolot
lentopallo - siatkówka
lentotukialus - lotniskowiec
leopardi - lampart
lepakko - nietoperz
lepinkäinen - dzierzba
leppä - olcha, olsza
leppäkerttu - biedronka, boża krówka
leppälintu - pleszka
lesbo - lesbijka
leski - wdowiec
leskimies - wdowiec
Lesotho - Lesotho
lesti - kopyto szewski
leuhka - chełpliwy
leuka - podbródek, broda
levä - alga, glon, wodorost
leveä - szeroki
leveäpyrstökihu - wydrzyk tęposterny
leveys - szerokość
leveyspiiri - szerokość geograficzna
levy - płyta, dysk
levyke - dyskietka
Libanon - Liban
liberaali - liberalny
liberaalinen - liberalny
liberalismi - liberalizm
liberalistinen - liberalny
Liberia - Liberia
Libya - Libia
Liechtenstein - Liechtenstein
lieju - błoto, muł, szlam
liekki - płomień
lieko - widłak
liemi - rosół, bulion
lieriö - walec
liesi - kuchenka, piec kuchenny
lieska - płomień
liettua - język litewski
Liettua - Litwa
liettualainen - litewski, Litwin
lievästi - nieco, odrobinę, trochę
lievike - lekarstwo
liha - mięso
lihansyöjä - mięsożerca
lihas - mięsień
lihavuus - otyłość
liiallinen - nadmierny
liiallisesti - nadmiernie
liian - zbyt, nadto
liikalihava - otyły
liikalihavuus - otyłość
liike - ruch
liikennemerkki - znak drogowy
liikkuvuus - mobilność
liikunta - sport
liima - klej
liioin - ani
liioittelu - przesada
liitohaukka - kaniuk
liito-orava - polatucha
liitto - związek
liittolainen - sojusznik
liitutaulu - tablica
lika - brud
likainen - brudny, naganny, niezgodny z normami etycznymi
likiarvoinen - przybliżony
likimääräinen - przybliżony
likinäköisyys - krótkowzroczność
likööri - likier
lilja - lilia
limonadi - lemoniada
limsa - lemoniada
lingvisti - językoznawca
lingvistiikka - lingwistyka
lingvistikko - językoznawca
lingvistinen - językowy
linja-auto - autobus
linjalaiva - okręt liniowy, liniowiec, transatlantyk
linko - proca
linna - zamek
linnoite - fortyfikacja
linnunpelätin - strach na wróble
linnunpelätti - strach na wróble
linnunpoika - pisklę, pisklak
Linnunrata - Droga Mleczna
linssi - soczewka, soczewica
lintu - ptak
lintutiede - ornitologia
lintutieteilijä - ornitolog
lipas - skrzynka, pudełko, kasetka, magazynek (, )
lipasto - komoda
lipoa - lizać
lippu - bilet, flaga
liro - łęczak
lisenssi - licencja
lisko - jaszczurka
Lissabon - Lizbona
lista - lista, listewka
litium - lit
litra - litr
litteä - płaski
liturgia - liturgia
liukas - śliski
liukuportaat - schody ruchome
liuos - roztwór
liuote - rozpuszczalnik
liuotin - rozpuszczalnik
liuske - łupek
logaritmi - logarytm
logiikka - logika
lohduke - pocieszenie
lohi - łosoś, łosoś szlachetny
lohikäärme - smok
lohkare - głaz
loikkari - dezerter
loinen - pasożyt
loistaa - lśnić, błyszczeć
loistava - lśniący, błyszczący
loistelias - wspaniały
lojaali - lojalny
lojaalinen - lojalny
lojaliteetti - lojalność
lokaalinen - lokalny
lokakuu - październik
lokasuoja - błotnik
lokki - mewa
lomake - formularz, blankiet, druk
lompakko - portfel
lonkka - biodro
Lontoo - Londyn
lontoolainen - londyński, londyńczyk
loogikko - logik
lootus - lotos
loppu - koniec
loppusanat - epilog, zakończenie
lotja - barka
lounas - południowy zachód
löytää - znaleźć, odnaleźć
lude - pluskwa
luennoija - wykładowca
luenta - czytanie
luento - wykład, odczyt
luettelo - katalog
luhta - podmokła łąka
luhtahuitti - kropiatka, kureczka nakrapiana
luhtakana - wodnik
luhtakerttunen - łozówka
luiska - stok, skarpa
luistin - łyżwa
luja - mocny, twardy, niezłomny, nieugięty
lujike - wzmocnienie
lujite - wzmocnienie
lukea - czytać
lukko - zamek
lukkoseppä - ślusarz
luksus - luksus
luku - liczba, cyfra, rozdział, czytanie
lukuisa - liczny
lukukausi - półrocze, semestr
lukutaidottomuus - analfabetyzm
lume - iluzja
lumi - śnieg
lumiaura - pług śnieżny
lumihanhi - gęś śnieżna, śnieżyca
lumihiutale - śnieżynka, płatek śniegu
lumikko - łasica
lumikurki - żuraw biały
lumimyrsky - burza śnieżna, zamieć śnieżna
luminen - śnieżny
lumipallo - kula śnieżna
lumipyry - śnieżyca
lumiukko - bałwan śniegowy
lumivarpunen - śnieżka
lunnaat - okup
lunnasraha - okup
lunni - maskonur, maskonur atlantycki
luoda - tworzyć
luode - północny zachód
luokka - klasa, kategoria, klasa społeczna, gromada (taksonomia zwierząt), klasa (taksonomia roślin)
luokkahuone - klasa
luokse - do, ku
luola - jaskinia, pieczara, grota
luomiskyky - kreatywność
luonnollinen - naturalny
luonnollisesti - naturalnie
luonteenomainen - charakterystyczny
luonto - natura, środowisko naturalne, charakter
luostari - klasztor
luoti - kula
luoto - mała skalista wysepka
luotonantaja - wierzyciel
luotsi - pilot portowy
luottokortti - karta kredytowa
luovuus - kreatywność
lupa - zezwolenie, pozwolenie, upoważnienie, pełnomocnictwo, koncesja, licencja
lusikka - łyżka
lutetium - lutet
lutikka - pluskwa
lutka - kurwa, dziwka, prostytutka
luu - kość
luultavasti - prawdopodobnie
luumu - śliwka, śliwa
luuta - miotła
luuydin - szpik kostny
Luxemburg - Luksemburg
lyhde - snop, kopa
lyhenne - skrót
lyhkäinen - krótki
lyhty - latarnia
lyhyt - krótki
lyhytnokkahanhi - gęś krótkodzioba
lyhytsanainen - zwięzły, lakoniczny
lyijy - ołów
lyijykynä - ołówek
lymy - kryjówka, ukrycie
lynkata - linczować, zlinczować
lynkkaus - lincz
lypsää - doić
lypsy - dojenie
lyriikka - liryka
lyseo - liceum
lyyra - lira
lyyrikko - liryk
lyyrinen - liryczny
lyyrypyrstö - lirogon
maa - ziemia, grunt
Maa - Ziemia
maagikko - magik
maaginen - magiczny
maagisuus - magia
maahanhyökkäys - inwazja
maahanmuuttaja - imigrant
maahanmuutto - imigracja
maailma - świat
maailmankaikkeus - wszechświat
maajussi - rolnik
maakunta - region
maalausteline - sztaluga
maaliskuu - marzec
maalivahti - bramkarz
maallikko - laik
maallinen - świecki, ziemski
maallistunut - świecki
maamies - rolnik
maanantai - poniedziałek
maanjäristys - trzęsienie ziemi
maanosa - kontynent
maantie - droga
maantiede - geografia
maantieteilijä - geograf
maantieto - geografia
maanviljelijä - rolnik
maanviljely - rolnictwo
maanviljelys - rolnictwo
maanvyöry - osuwisko
maanvyörymä - osuwisko
maaöljy - ropa naftowa
maaorja - chłop pańszczyźniany
maapähkinä - orzech ziemny
maapallo - kula ziemska
määrä - liczba, ilość
määrällinen - ilościowy
määrite - atrybut
määritelmä - definicja
määrittely - specyfikacja
maastamuuttaja - emigrant
maastamuutto - emigracja
maatalous - rolnictwo
maatila - farma
machete - maczeta
Madagaskar - Madagaskar
madame - pani
made - miętus
Madeira - Madera
magia - magia
magiikka - magia
magneetismi - magnetyzm
magneetti - magnes
magneettinauha - taśma magnetyczna
magneettinen - magnetyczny
magneettisuus - magnetyzm
magnesium - magnez
magnetismi - magnetyzm
maha - brzuch
mahalaukku - żołądek
mahdikas - potężny
mahdollinen - możliwy
mahdollisesti - prawdopodobnie, możliwie
mahdollisuus - możliwość
mahdoton - niemożliwy
mahdottomuus - niemożliwość
mahla - oskoła
maila - rakieta, rakietka, kij
mailanen - lucerna
mainari - górnik
maine - opinia, renoma, reputacja, sława, orzeczenie
maininta - wzmianka
mainita - wspominać, wspomnieć (, )
mainos - reklama
mainostaa - reklamować, ogłaszać
maisema - krajobraz
maissi - kukurydza
maistuvainen - smaczny
maite - lotos
maito - mleko
maitohammas - ząb mleczny
maitokauppa - mleczarnia
maitomainen - mleczny
maitoparta - młodzik, żółtodziób
maja - chata
majakka - latarnia morska
majatalo - gospoda, zajazd
majava - bóbr
majesteettinen - majestatyczny
majoneesi - majonez
majuri - major
makaroni - makaron
makea - słodki
Makedonia - Macedonia
makeinen - cukierek
makeus - słodycz
mäki - wzgórze
mäkihyppääjä - skoczek narciarski
mäkihyppy - skoki narciarskie
makkara - kiełbasa
makoisa - smaczny
maksa - wątroba
maksaa - płacić, zapłacić
maksiimi - maksyma
maksimi - maksimum
maksu - opłata
maksullinen - płatny
maku - smak
makuuhuone - sypialnia
malaria - malaria, zimnica
Malawi - Malawi
Malediivit - Malediwy
Malesia - Malezja
Mali - Mali
maljakko - wazon
mallas - słód
mallasjuoma - piwo
malli - model, wzór, fason, manekin
malline - szablon
malmi - ruda
Malta - Malta
maltiton - niecierpliwy
maltittomuus - niecierpliwość
malttamattomuus - niecierpliwość
mammutti - mamut
mandariinisorsa - mandarynka
mangaani - mangan
manipulaatio - manipulacja
manipulointi - manipulacja
manner - kontynent
Mansaari - Wyspa Man
mansikka - truskawka
mäntä - tłok
manteli - migdał, migdałek
manttelinperijä - następca
mänty - sosna
manuli - manul
manuskripti - rękopis, manuskrypt
märehtijä - przeżuwacz
margariini - margaryna
marhi - ziemnokraska
marihuana - marihuana
Marika - Marika
marja - jagoda
Marja - Maria (imię żeńskie)
märkä - mokry
märkäpaise - ropień, wrzód
märkile - ropień, wrzód
markka - marka
marmori - marmur
marmorimurri - morzyk marmurkowy
Marokko - Maroko
marraskuu - listopad
Marshallinsaaret - Wyspy Marshalla
marsipaani - marcepan
marssi - marsz
marsu - świnka morska
maskuliini - rodzaj męski
masto - maszt
masturboida - masturbować się
matala - niski, płytki
matalapaine - niż, niż baryczny
matelija - gad
matemaatikko - matematyk
matemaattinen - matematyczny
matematiikka - matematyka
materiaali - materiał
mäti - ikra, kawior
matka - droga, podróż
matkailu - turystyka
matkamuisto - pamiątka
matkapuhelin - telefon komórkowy
matkia - naśladować, imitować
matkija - naśladowca, imitator, przedrzeźniacz
matkustaja - podróżny, pasażer, turysta
matkustus - podróż
mato - robak, robak (komputerowy)
matriisi - matryca, macierz
matto - dywan
maukas - smaczny
Mauritania - Mauretania
Mauritius - Mauritius
mausoleumi - mauzoleum
mauste - przyprawa
mäyrä - borsuk
mäyräkoira - jamnik
me - my
medestäjä - nektarnik
meditaatio - medytacja
meditointi - medytacja
meduusa - meduza
meedialainen - Med, Medyjczyk, medyjski
mehiläinen - pszczoła
mehiläiskenno - plaster
mehiläiskuningatar - królowa pszczół
mehiläispesä - ul
mehiläissyöjä - żołna
mehiläisvaha - wosk pszczeli
mehu - sok
mehuisa - soczysty
mehukas - soczysty
meidän - nasz
meirami - majeranek
meitnerium - meitner
mekaanikko - mechanik
mekaaninen - mechaniczny
mekanismi - mechanizm
mekko - sukienka
Meksiko - Meksyk
meksikolainen - Meksykanin, Meksykanka, meksykański
melkein - prawie, blisko
melko - dość, dosyć
mellakka - rozruchy
meloni - melon
melu - hałas
meluisa - hałaśliwy
mendelevium - mendelew
menestyksekkäästi - skutecznie
menestyksellisesti - skutecznie
menestyksetön - nieudany
menetelmä - metoda
menettää - stracić, utracić
menettelytapa - procedura
mennä - iść, chodzić, przechodzić, mijać, jechać, kursować
menneisyys - przeszłość
menstruaatio - miesiączka
merenneito - syrena
meri - morze
merihanhi - gęś gęgawa, gęgawa
meriharakka - ostrygojad, morska sroka
merikihu - wydrzyk ostrosterny, wydrzyk pasożytny
merikotka - bielik
merilokki - mewa siodłata
merimakkara - strzykwa
merimetso - kormoran czarny
meripihka - bursztyn, jantar
merirosvo - pirat
merisiili - jeżowiec
merisirri - biegus morski
merkittävästi - znacząco
merkitys - znaczenie
merkki - znak, symbol
mesi - nektar, miód
mesikko - miodojad
messinki - mosiądz
mestari - mistrz
metabolia - metabolizm, metamorfoza, przeobrażenie
metaetiikka - metaetyka
metafora - metafora, przenośnia
metafysiikka - metafizyka
metalli - metal
metallinen - metaliczny
metalliseos - stop
metallurgia - metalurgia
metamorfoosi - metamorfoza, przeobrażenie
meteori - meteor
meteoriitti - meteoryt
meteorologia - meteorologia
metodi - metoda
metodologia - metodologia
metri - metr
metropoli - metropolia
metsä - las
metsähanhi - gęś zbożowa
metsäkanalintu - głuszec
metsäkauris - sarna
metsäkirvinen - świergotek leśny, świergotek drzewny
metsänhoito - leśnictwo
metsäsika - borsuk
metsästää - polować
metsästäjä - myśliwy
metsästys - polowanie, myślistwo, łowiectwo
metsäviklo - samotnik, brodziec samotny
metso - głuszec
miekka - miecz
mieleenpainuva - niezapomniany
mielellään - chętnie, z przyjemnością
mielenkiintoinen - interesujący
mielenvikainen - obłąkany
mieli - umysł, rozum, intelekt, zmysł, sąd, zdanie, mniemanie, opinia, charakter, natura, usposobienie, chęć, ochota, nastrój, humor, gust, upodobanie
mielikuvituksellinen - fantastyczny
mielipuoli - wariat, szaleniec, obłąkany, szalony, chory umysłowo, chory psychicznie
mielipuolinen - obłąkany, chory psychicznie, umysłowo chory
mielipuolisuus - szaleństwo
mielisairas - chory psychicznie
mielivaltaisesti - dowolnie
miellyttävä - przyjemny
mieluisa - przyjemny
mies - mężczyzna, mąż
mieskuntoinen - męski
miesleski - wdowiec
miespuolinen - męski
mietintö - raport
mieto - łagodny
migraatio - migracja
mihin - dokąd
miinus - minus
mikä - co?
mikrobiologia - mikrobiologia
mikrofoni - mikrofon
Mikronesia - Mikronezja
mikro-organismi - mikroorganizm
mikroskooppi - mikroskop
mikroskooppinen - mikroskopowy
miksi - dlaczego?, czemu?, po co?
Milja - Emilia
miljoona - milion
Milla - Emilia
millainen - jaki, jaka, jakie
millimetri - milimetr
milloin - kiedy
miltei - prawie
minä - ja
minareetti - minaret
mineraali - minerał
mineraalivesi - woda mineralna
mineralogia - mineralogia
miniä - synowa
miniatyyri - miniatura
ministeri - minister
minkki - norka amerykańska
minne - dokąd?
minun - mój
minuutti - minuta
miraakkeli - cud
misantropia - mizantropia
missä - gdzie?
missio - misja
mistä - skąd?
misteli - jemioła
mitään - nic
mitali - medal
mitella - temblak, chusta trójkątna
miten - jak
mitra - mitra
mittari - miernik, licznik
mobiliteetti - mobilność
moderni - nowoczesny
moi - cześć!, na razie
Moldova - Mołdawia
molekyyli - cząsteczka, molekuła
möljä - molo
molybdeeni - molibden
Monaco - Monako
monarkia - monarchia
monetaarinen - pieniężny
Mongolia - Mongolia
mongolilainen - mongolski
monijumalaisuus - politeizm
monijumalisuus - politeizm
monikko - liczba mnoga
monikulttuurinen - wielokulturowy
monikulttuurisuus - wielokulturowość
monimuotoinen - różnorodny
monimuotoisuus - różnorodność
monimutkaisuus - złożoność
moninainen - różnorodny
moninaisuus - różnorodność
monni - sum, rekrut
monogamia - monogamia
monoteismi - monoteizm
monsuuni - monsun
Montenegro - Czarnogóra
monumentti - pomnik
moottori - silnik
moottoripyörä - motocykl
mopsi - mops
moraalisuus - moralność
moraaliton - niemoralny
moraalittomuus - niemoralność
moraliteetti - moralność
moreeni - morena
morfiini - morfina
morfologia - morfologia
mörkö - potwór, straszydło
Mörkö - Buka
morsian - narzeczona, panna młoda
morsiosorsa - karolinka
mörssäri - moździeż
mortaliteetti - śmiertelność
Mosambik - Mozambik
moskeija - meczet
Moskova - Moskwa
motelli - motel
motiivi - motyw
motivaatio - motywacja
moukari - młot
moukarinheitto - rzut młotem
Mowgli - Mowgli
muhkura - stłuczka
muija - kobieta, dziewczyna, żona, pisklę, motyka, suka
muinainen - starożytny
muinaisaika - starożytność
muistaa - pamiętać, przypomnieć
muisti - pamięć
mukava - miły
muki - kubek, garnuszek
multa - ziemia, gleba, ściółka
muna - jajo, jajko
munakas - omlet
munakoiso - bakłażan
munanasetin - pokładełko
munasarja - jajnik
munasolu - komórka jajowa
munkki - mnich, zakonnik, pączek
munkkirinkilä - pączek
munuainen - nerka
muodollisesti - formalnie
muodonvaihdos - metamorfoza, przeobrażenie
Muonio - Muonio (gmina w Laponii)
muoto - kształt, forma
muotoilija - projektant
muotokuva - portret
muovi - plastik, tworzywo sztuczne
mura - żwir, osad
murha - zabójstwo, mord
murhaaja - morderca
murhata - mordować, zamordować
murikka - głaz
Murmansk - Murmańsk
murre - dialekt
mursu - mors
murteellinen - dialekt, gwara
murtoluku - ułamek
murtomies - włamywacz
murtovaras - włamywacz
museo - muzeum
musiikki - muzyka
musiikki-instrumentti - instrument muzyczny
musikantti - muzyk
muskotti - gałka muszkatołowa
musta - czarny, czerń, Murzyn, Czarny
mustahaikara - bocian czarny
mustakaulauikku - perkoz zausznik, zausznik
mustaleppälintu - kopciuszek
mustalintu - markaczka
Mustameri - Morze Czarne
mustankipeä - zazdrosny
mustapääkerttu - pokrzewka czarnogłowa, kapturka
mustarastas - kos
mustasukkainen - zazdrosny
mustasukkaisuus - zazdrość
mustavalkoinen - czarno-biały
mustavaris - gawron
mustaviklo - brodziec śniady
muste - atrament
mustekala - kałamarnica, ośmiornica
mustikka - borówka, czarna jagoda
mutaatio - mutacja
mutka - zakręt
mutta - ale, a
mutteri - mutra, nakrętka
muu - inny
muualla - gdzie indziej
muualle - gdzie indziej
muuli - muł
muuliaasi - osłomuł
muumio - mumia
muumioida - mumifikować
muunnelma - wariant
muurahainen - mrówka
muurahaiskarhu - mrówkojad
muurahaiskeko - mrowisko
muurain - malina moroszka
muurata - murować
muuri - mur
muurinmurtaja - taran
muusa - muza
muusikko - muzyk
muutoin - inaczej, w przeciwnym razie
muuttohaukka - sokół wędrowny
muuttoliike - migracja
mykiö - soczewka
mykkä - niemowa (człowiek niemy), niemy
mykologia - mykologia
mylly - młyn
myllynkivi - kamień młyński
myöhään - późno
myöntyä - zgodzić się, pozwolić
myös - także, również
myötäkäyminen - sukces
myrha - mirra
myrkky - trucizna
myrkyllinen - trujący
myrsky - burza, sztorm
myrskyinen - burzliwy
myrskyisä - burzliwy
myrskylintu - petrel, fulmar
myrskysukeltaja - nurzec
myrtti - mirt
myski - piżmo
myskihärkä - piżmowół
myssy - czepiec, czepek
mytologia - mitologia
myydä - sprzedawać
myyjä - sprzedawca
myymälä - sklep
myytti - mit
naakka - kawka
naali - piesiec, lis polarny, piesak
naama - twarz
naamari - maska
nääntymys - wyczerpanie
naapuri - sąsiad
naaras - samica
naarasleijona - lwica
näätä - kuna leśna, tumak
naevus - znamię, znamię barwnikowe
nähdä - widzieć
nahka - skóra
nahkiainen - minóg
naida - żenić się, jebać, pierdolić
naiivi - naiwny
naikkonen - kobieta
nainen - kobieta
Nairobi - Nairobi
naisellinen - kobiecy
näkyväisyys - widoczność
nälkä - głód
nälkäinen - głodny
nalle - miś, niedźwiadek
nalli - spłonka, kapiszon
Namibia - Namibia
namu - cukierek
namunen - cukierek
napa - pępek, środek, centrum, punkt środkowy, biegun
napakka - energiczny
napapiiri - koło podbiegunowe
napata - porwać, chwycić
näppäimistö - klawiatura
näppy - pryszcz, krosta
näppylä - krosta
näre - drzewo iglaste (, )
närhi - sójka
narkoottinen - narkotyczny
narrimainen - głupi
narrimaisuus - głupota
narsissi - narcyz
narttu - suka (o samicy psa), suka (o kobiecie)
nasakka - energiczny
nasta - pinezka, pluskiewka
nasu - świnia
nationalismi - nacjonalizm
nationalisti - nacjonalista
natrium - sód
naturalismi - naturalizm
nauha - taśma, wstążka
naula - gwóźdź
naulakko - wieszak
nauraa - śmiać się
nauru - śmiech
Nauru - Nauru
naurulokki - mewa śmieszka, śmieszka
nautinto - przyjemność
nautintoaine - używka
navigaatio - nawigacja
navigointi - nawigacja
näyttelijä - aktor
näyttelijätär - aktorka
neekeri - Murzyn, czarnoskóry człowiek
negatiivinen - negatywny
neilikka - goździk
neitokurki - żuraw stepowy
neitsyt - dziewica
neitsyys - dziewictwo
nelikulmainen - kwadratowy
neliö - kwadrat, metr kwadratowy
neliömetri - metr kwadratowy
neljä - cztery (4)
neljäkäs - romb
neljäkymmentä - czterdzieści
neljäkymmentäkahdeksan - czterdzieści osiem, 48
neljäkymmentäkaksi - czterdzieści dwa, 42
neljäkymmentäkolme - czterdzieści trzy, 43
neljäkymmentäkuusi - czterdzieści sześć, 46
neljäkymmentäneljä - czterdzieści cztery, 44
neljäkymmentäseitsemän - czterdzieści siedem, 47
neljäkymmentäviisi - czterdzieści pięć, 45
neljäkymmentäyhdeksän - czterdzieści dziewięć, 49
neljäkymmentäyksi - czterdzieści jeden, 41
neljäs - czwarty
neljätoista - czternaście (14)
nelonen - czwórka
nenä - nos
nenäliina - chusteczka do nosa
neodyymi - neodym
neologismi - neologizm
neon - neon
Nepal - Nepal
nepotismi - nepotyzm
neptunium - neptun
nero - geniusz
nerokkuus - geniusz
nerous - geniusz
neste - ciecz, płyn
nestemäinen - płynny
nestorilainen - nestorianin
neula - igła
neulepuikko - drut do robótek
neuloa - robić na drutach
neutraali - neutralny
neutraalisuus - neutralność
neutraalius - neutralność
neutraliteetti - neutralność
neutri - rodzaj nijaki
neuvo - rada, dorada, wskazówka
neuvoja - doradca
Neuvostoliitto - Związek Radziecki
neuvostoliittolainen - obywatel Związku Radzieckiego, radziecki, sowiecki
neuvotella - negocjować
neuvoton - bezradny
neuvottelija - mediator
neva - bagno, moczary, trzęsawisko
-ni - mój, moja, moje
Nicaragua - Nikaragua
nide - tom, zeszyt
nieleminen - łykanie
niemi - półwysep, cypel
niemimaa - półwysep
Niger - Niger
Nigeria - Nigeria
nihilismi - nihilizm
niini - łyko
niinipuu - lipa drobnolistna
niitty - łąka
niittykirvinen - świergotek polny
niittysuohaukka - błotniak łąkowy
nikkeli - nikiel
nilkka - kostka (u nogi)
nimeke - tytuł
nimekkyys - sława
nimetön - bezimienny
nimi - imię
nimikkeistö - nomenklatura
nimipäivä - imieniny
nimisana - rzeczownik
nimittää - mianować, nazywać, tytułować
niobi - niob
niobium - niob
nirhama - chip, układ scalony
nisä - sutek, brodawka piersiowa
nisäkäs - ssak
niska - kark
nitoja - zszywacz
nituri - zszywacz
niukasti - skąpo
niukka - skąpy, kusy, marny, nikły, ubogi, ciasny, wąski, zwięzły, ścisły, lakoniczny
niveljalkainen - stawonóg
nivuset - pachwina
Nix - Nix
no - …oznaczająca potaknięcie, przyzwolenie
nobelium - nobel
noin - około, w przybliżeniu, mniej więcej
noita - czarownica, wiedźma
nojata - podpierać, opierać się
nojatuoli - fotel
noki - sadza
nokikana - łyska
nokikuukkeli - sójka tybetańska, sójka okopcona
nokka - dziób
nokkavarpunen - grubodziób
nokkonen - pokrzywa
nolla - zero
nolostuminen - zażenowanie
nolous - zażenowanie
nomenklatuuri - nomenklatura
nominatiivi - mianownik
nopea - szybki
nopeasti - szybko
nopeus - szybkość, prędkość
noppa - kostka do gry
nopsa - szybki
nopsaan - szybko
nopsasti - szybko
Norfolkinsaari - Norfolk
norja - język norweski
Norja - Norwegia
norjalainen - norweski
normaalisti - normalnie
norsu - słoń
Norsunluurannikko - Wybrzeże Kości Słoniowej
nostaa - wznieść, podnieść, wznosić, podnosić, wydobywać, podejmować, podjąć, pobierać, pobrać
nostalgia - nostalgia
nostalgisuus - nostalgia
nostin - żuraw, dźwig
nostokanki - dźwignia
nostokurki - żuraw
nousta - podnosić się, wznosić się
nöyhtäinen - puszysty
nöyryytys - upokorzenie
nuha - katar
nuhtelu - reprymenda
nuijapää - kijanka
nukke - lalka, kukiełka
nukkua - spać
numeraali - liczebnik
numero - cyfra, numer
nummikirvinen - świergotek polny
nunna - zakonnica
nuoli - strzała, strzałka
nuolihaukka - kobuz
nuora - sznur, sznurek
nuori - młody, młoda osoba, młodzież
nuoruus - młodość
nuotio - ognisko
nuotta - niewód
nuotti - nuta
nurkka - kąt, róg
nurmikko - trawnik
nussia - jebać, pieprzyć, pierdolić, uprawiać seks
nutritio - odżywianie
nuudeli - makaron
nuuka - skąpy
nuuska - tabaka
nykyinen - obecny
nykytanssi - taniec nowoczesny
nyrkkeilijä - bokser
nyrkkeily - boks
nyt - teraz, obecnie
oas - cierń
obduktio - autopsja
obeliski - obelisk
obseeni - obsceniczny
observaattori - obserwator
observatorio - obserwatorium
observoija - obserwator
odottaa - czekać
odottamatta - niespodziewanie
odottamattomasti - niespodziewanie
ohdake - oset
ohi - obok, mimo, koło
ohimarssi - defilada, przemarsz
ohimo - skroń
ohjauspyörä - kierownica
ohjelma - program telewizyjny, program komputerowy, program, założenia, postulaty, repertuar
ohjenuora - zasada, wytyczna
ohra - jęczmień
ohut - cienki
oieta - wyprostować się
oikea - prawy, z prawej strony, prawidłowy, właściwy, odpowiedni, rzeczywisty, prawdziwy, sprawiedliwy, słuszny
oikeaoppinen - ortodoksyjny
oikeauskoinen - ortodoksyjny
oikein - prawidłowo, poprawnie, bardzo
oikeinkirjoitus - ortografia
oikeus - prawo, sąd, instancja sądowa
oikeustiede - prawoznawstwo
oikku - kaprys
oikoa - prostować, poprawić
oinas - baran, tryk
Oinas - Baran
öinen - nocny
oire - objaw, symptom
oja - rów
oka - cierń
okkultismi - okultyzm
oksa - gałąź
oksennus - wymiociny
oksentaa - wymiotować
oksidi - tlenek
oksitaani - język prowansalski
olen - olla
olennoituma - personifikacja
olento - istota, stworzenie, stwór
olevainen - egzystencja
olevaisuus - egzystencja
Olga - Olga
oligarkia - oligarchia
oliivi - oliwa
oliiviöljy - oliwa
oliivipuu - drzewo oliwne
olio - stworzenie, istota
oljenkorsi - słoma
öljy - olej
öljyinen - oleisty, naoliwiony
öljypuu - drzewo oliwne
olkaa hyvä - proszę
olkapää - ramię
olki - słoma
olla - być, znajdować się, przebywać, mieć, posiadać, musieć, być zobowiązanym, zachowywać się, prawie/niemal coś zrobić (olla vähällä), udawać, sprawiać wrażenie, pretendować, zamierzać coś za chwilę zrobić, już mieć zamiar coś zrobić
olla yllään - nosić
olmi - odmieniec jaskiniowy
olohuone - pokój gościnny, duży pokój
olut - piwo
olutpanimo - browar
Olympia - Olimpia (miasto w Grecji)
oma - własny
oma-aloitteinen - spontaniczny
omaelämäkerta - autobiografia
Oman - Oman
omanto - dopełniacz
omata - posiadać
omatoiminen - samoczynny, samorodny, automatyczny
omatunto - sumienie
omena - jabłko
omenamehu - sok jabłkowy
omenapuu - jabłoń
omistaa - posiadać, przywłaszczać, przywłaszczyć, przejąć, przypisywać, ofiarować, poświęcić, dedykować
omistaja - właściciel
on - olla
ongelma - problem
onki - wędka
onkologia - onkologia
onnekas - szczęśliwy, mający szczęście
onnellinen - szczęśliwy
onnellisesti - szczęśliwie
onnellisuus - szczęście
onneton - nieszczęśliwy
onnettomuus - katastrofa
onni - szczęście, radość, powodzenie
onnistuneesti - skutecznie
onnitella - gratulować
onnittelu - gratulacje
onomatopoeettisuus - onomatopeja
onomatopoesia - onomatopeja
oodi - oda
oopiumi - opium
ooppera - opera
opaakki - nieprzezroczysty
opaali - opal
opastaa - oprowadzać, wskazywać drogę, kierować
opastaja - doradca
operetti - operetka
opettaa - uczyć, nauczać
opettaja - nauczyciel/nauczycielka
opettaminen - nauczanie
opetuksellinen - edukacyjny
opiskelija - student
opisto - instytut
oppia - uczyć się
oppikirja - podręcznik
oppitunti - lekcja
opportunismi - oportunizm
optimismi - optymizm
optimistinen - optymistyczny
optimistisuus - optymizm
ora - kolec, cierń
oranki - orangutan
oranssi - pomarańczowy, kolor pomarańczowy
orapihlaja - głóg
orastaa - kiełkować
orava - wiewiórka
organisaatio - organizacja
organismi - organizm
organogeneesi - organogeneza
orgasmi - orgazm
ori - ogier
orientaatio - orientacja
orientointi - orientacja
orientoituminen - orientacja
originaali - oryginał
orja - niewolnik
orjuus - niewolnictwo
ornamentti - ornament
ornitologi - ornitolog
ornitologia - ornitologia
orpo - sierota
orpolapsi - sierota
orsi - grzęda
ortografia - ortografia
orvokki - fiołek
osa - część
osake - akcja, papier wartościowy
osata - móc, potrafić, umieć, znać, trafić
osinko - dywidenda
osittaa - dzielić, podzielić
osmium - osm
osoite - adres
ostaa - kupować, nabywać
ostaa sika säkissä - kupować kota w worku
ostaja - nabywca, kupiec
osteri - ostryga
Ostia - Ostia
osto - zakup
osua - trafić, trafiać
osviitta - przewodnik
otava - rodzaj pułapki na ryby
otella - rywalizować
otsa - czoło
otsoni - ozon
ottaa - brać, wziąć, przyjmować, zażywać
otus - stworzenie
Oulu - Oulu (miasto w Finlandii)
outo - obcy, nieznany, niezwykły, osobliwy
ovaali - owalny, owal
ovela - chytry, przebiegły
ovenkahva - klamka
ovi - drzwi
ovulaatio - owulacja
pää - głowa, końcówka, czubek
paahde - żar, skwar, upał
pääkallo - czaszka
pääkaupunki - stolica
päällystakki - płaszcz, palto
pääministeri - premier
paanu - gont
päärynä - gruszka
päärynäpuu - grusza (drzewo)
pääsiäinen - Wielkanoc
pääsky - jaskółka
pääskykahlaaja - żwirowiec
pääskynen - jaskółka
paasto - post
paastota - pościć
päätös - koniec, zakończenie, decyzja, orzeczenie, wyrok, postanowienie
päättely - dedukcja
paavi - papież
pagodi - pagoda
paha - zły, trudny, zło
pähkinä - orzech
pähkinähakki - orzechówka
pähkinänakkeli - kowalik
paholainen - diabeł, czart, zły duch, demon
pahuus - zło
pahvi - tektura
paikka - miejsce
paikkansapitävä - dokładny
paimen - pasterz
päin - do, w kierunku
painajainen - koszmar
paine - ciśnienie
painija - zapaśnik
paino - ciężar, nacisk
painovoima - grawitacja
paise - wrzód
paistaa - świecić
paisti - pieczeń
paistinpannu - patelnia
paita - koszula
päivä - dzień, słońce
päiväaika - dzień
päiväkirja - dziennik
päivällinen - obiad
päivämäärä - data
päivänkakkara - stokrotka
päivänpaiste - światło słoneczne
päivänselvästi - oczywiście
päiväntasaaja - równik
Päiväntasaajan Guinea - Gwinea Równikowa
paja - warsztat
paju - wierzba
pajulintu - piecuszek
pajusirkku - potrzos
pakana - poganin
pakara - pośladek
Pakistan - Pakistan
pakkanen - mróz
pakko - przymus
pakokauhu - panika
pakolainen - uciekinier, zbieg, uchodźca, emigrant
pakollinen - przymusowy
pakote - sankcja
pakottaa - zmuszać, przymuszać
paksu - gruby
paksujalka - kulon
pakti - pakt, układ
palaa - płonąć
palaminen - palenie, spalanie
palatsi - pałac
Palau - Palau
paleontologi - paleontolog
palestiinalainen - Palestyńczyk, Palestynka, palestyński
palindromi - palindrom
paljas - goły
paljon - dużo, wiele, ile
paljonko - paljon
palkkasotilas - najemnik
palkkasoturi - najemnik, żołnierz najemny
palko - strąk, strączek
palladium - pallad
pallea - przepona
pallo - piłka, sfera
pallosalama - piorun kulisty
palmu - palma
palo - ogień, pożar
palokärki - dzięcioł czarny
palokunta - straż pożarna
palomies - strażak
paloposti - hydrant
palsami - balsam
palvella - obsługiwać, służyć, obsłużyć, usłużyć
palvelu - obsługa, obsłużenie, służba, służenie, usługiwanie
palvoa - czcić, adorować
Panama - Panama
panda - panda
pandeismi - pandeizm
paniikki - panika
panimo - browar
pankki - bank
pankkiiri - bankier
panna - kłaść, nakładać, położyć, wkładać, włożyć, wykładać
panoraama - panorama
panssarilaiva - pancernik
panteismi - panteizm
pantti - rzecz zastawiona, zastaw, rękojmia, poręka
panttivanki - zakładnik
paperi - papier, dokument
paperiliitin - spinacz
papisto - kler
pappi - ksiądz
papu - fasola, fasolka
Papua-Uusi-Guinea - Papua-Nowa Gwinea
papukaija - papuga
paraabeli - parabola
paradoksi - paradoks
Paraguay - Paragwaj
parakki - barak
parametri - parametr
parasiitti - pasożyt
paratiisi - raj
paratiisilintu - ptak rajski, cudowronka
parempi pyy pivossa kuin kaksi oksalla - lepszy jarząbek w garści niż dwa na gałęzi, lepszy wróbel w garści niż gołąb na dachu
parfyymi - perfumy
pari - para (dwie osoby, dwie rzeczy)
Pariisi - Paryż
pariisilainen - paryski
parkkeeraus - parking
parlamentaarinen - parlamentarny
parlamentti - parlament
paroni - baron
paronitar - baronowa
parrakas - brodaty
parsakaali - brokuł
parta - broda
partainen - brodaty
partakorppikotka - orłosęp, orłosęp brodaty
partneri - partner
parveke - balkon
paska - gówno, gówniany, bardzo zły, popsuty, tandetny, kurwa!, cholera!
paskiainen - dupek, gnojek
passi - paszport
pässi - baran
passiivinen - bierny
pässinpää - idiota
pastori - pastor
pataljoona - batalion
pätevyys - kompetencja
patja - materac
patriarkka - patriarcha
patrioottinen - patriotyczny
patriotismi - patriotyzm
patruuna - nabój, pocisk
patsas - posąg
paula - sznurek, taśma, siec
paviaani - pawian
pedagogia - pedagogika
pedagogiikka - pedagogika
pehmeä - puchaty, miękki
pehmeys - miękkość
pehmoinen - miękki
peikko - trol
peili - lustro, lusterko
peippo - zięba
peitsi - dzida, kopia (broń)
Pekka - Piotr
pelaaja - gracz
pelata - grać
pelätä - bać się
pelätin - strach na wróble
peli - gra
pelikaani - pelikan
pelko - lęk, obawa, strach
pelkuri - tchórz
pellava - len
pelle - klaun
pelokas - bojaźliwy, lękliwy
peltinen - blaszany
pelto - pole
peltopyy - kuropatwa
peltosirkku - ortolan
pendeli - wahadło
penger - grobla, wał, skarpa, taras, miedza, nasyp kolejowy
penikka - szczenię, szczeniak
penkki - ławka, grządka
pensas - krzew, krzak
pensasaita - żywopłot
pensaskerttu - pokrzewka cierniówka, cierniówka
pensastasku - pokląskwa
penseä - obojętny, zobojętniały
penseys - obojętność
pensseli - pędzel
pentu - młode zwierząt, zwłaszcza ssaków
peräaukko - odbyt
peräsin - ster
perästäpäin - potem
pergamentti - pergamin
perhe - rodzina
perhonen - motyl
perhosentoukka - gąsienica
periaate - zasada, reguła
perijä - spadkobierca
perinne - tradycja
perinnöllinen - dziedziczny
perinpohjaisesti - dokładnie, gruntownie
perinteisesti - tradycyjnie
perintö - spadek
perjantai - piątek
perkele - niech to diabli, do diabła, diabeł, szatan, demon
perse - dupa
persikka - brzoskwinia
persilja - pietruszka
persimon - persymona
persimoni - persymona
personifikaatio - personifikacja
personifiointi - personifikacja
personointi - personifikacja
persoonallisuus - osobowość
Peru - Peru
peruna - ziemniak, kartofel
perustaja - założyciel
perustavanlaatuinen - podstawowy
perusteellisesti - dokładnie, gruntownie
peruuttaa - anulować, cofnąć, przerwać, odwołać
perversio - perwersja
pesä - gniazdo
pessimismi - pesymizm
pestä - myć, prać
pesuaine - środek piorący
pesuallas - umywalka
pesukarhu - szop pracz
pesukone - pralka
petkuttaa - oszukiwać
petoeläin - zwierzę drapieżne, drapieżca
Petra - Piotra (imię żeńskie)
Petroskoi - Pietrozawodsk
Petteri - Piotr
petturi - zdrajca
peukalo - kciuk
peukaloinen - strzyżyk
peura - renifer
piaffe - piaff
pian - wkrótce
pianisti - pianista
piano - pianino
piekana - myszołów włochaty
pieli - futryna, framuga
pieneliö - mikroorganizm
pieni - mały
piennar - pobocze, skraj drogi
pieru - gaz jelitowy, pierdnięcie
Pietari - Sankt Petersburg
pigmentti - barwnik
pihka - żywica
Pihkova - Psków
pihlaja - jarzębina
pihvi - befsztyk
pii - krzem, liczba π (pi)
piikki - kolec, cierń
piikkisika - jeżozwierz
piili - strzała
piilolinssi - soczewka kontaktowa
piilottaa - ukryć, schować
piimä - zsiadłe mleko, kwaśne mleko, maślanka
piina - męka, katusze, kaźń, tortura
piippu - fajka, komin
piirakka - pieróg
piiri - koło, krąg, strefa, obszar, region, okręg, rejon, rewir
piirikunta - hrabstwo
piironki - komoda
piirros - rysunek, szkic
piirtää - rysować, szkicować
piirtäjä - rysownik, rysowniczka
piisku - nawłoć
piispa - biskup
pikainen - szybki
pikapikaa - szybko
pikari - kielich
pikku - mały, maleńki
pikku- - mały
pikkuhuitti - zielonka, kureczka zielonka
pikkujoutsen - łabędź mały
pikkukajava - mewa trójpalczasta
pikkukäpylintu - krzyżodziób świerkowy
pikkukiislanen - nurniczek malutki
pikkukiljukotka - orlik krzykliwy
pikkukylä - wioska
pikkulepinkäinen - dierzba gąsiorek, gąsiorek
pikkulokki - mewa mała
pikkuraha - drobne
pikkuruokki - alczyk, traczyk, traczyk lodowy
pikkusieppo - muchołówka mała
pikkusirri - biegus malutki
pikkutelkkä - gągołek
pikkutikka - dzięciołek
pikkutuulihaukka - pustułeczka
pikkutylli - sieweczka rzeczna
pikku-uikku - perkozek
pikkuvarpunen - mazurek
piknikki - piknik
pila - żart
pilkkaniska - uhla pstrodzioba
pilkkasiipi - uhla
pilleri - pigułka
pilli - gwizdek
pillu - pizda, cipa
pilvenpiirtäjä - wieżowiec
pilvi - chmura, marihuana
pilvinen - pochmurny
pimeä - ciemny
pimennys - zaćmienie
pimeys - ciemność
pinaatti - szpinak
pingviini - pingwin
pinta - powierzchnia
pippuri - pieprz
piru - diabeł, pirun
pisama - pieg
pisara - kropla
pistää - kłuć
piste - kropka
pitää - lubić
pitkä - długi, wysoki
pitkäjalka - szczudłak
pitsa - pizza
pittoreski - malowniczy
Pittsburgh - Pittsburgh (stolica Allegheny)
pituus - długość, wzrost, długość geograficzna
pituushyppy - skok w dal
piukka - ciasny
pivo - dłoń, garść
pizza - pizza
planeetta - planeta
plantaasi - plantacja
platina - platyna
pluraali - liczba mnoga
plutonium - pluton
pöheikkö - zarośla, gąszcz
pohjankiisla - nurzyk polarny
Pohjanlahti - Zatoka Botnicka
Pohjanmeri - Morze Północne
pohjansirkku - trznadel czubaty, trznadel trzypręgowy
pohjantikka - dzięcioł trójpalczasty
pohje - łydka
pohjoinen - północ, północny
Pohjoinen jäämeri - Ocean Arktyczny
Pohjois-Amerikka - Ameryka Północna
Pohjois-Korea - Korea Północna
pohjoisnapa - biegun północny
pohjoissaame - język północnolapoński
poiju - boja, pława
poika - chłopiec, chłopak, syn
poikapuoli - pasierb
poikaystävä - chłopak, narzeczony, ukochany
poikia - mieć młode, cielić się, kocić się
poikkeus - wyjątek
poikue - lęg, miot
poissaoleva - nieobecny
pokeri - poker
poliisi - policja
poliisimies - policjant
poliitikko - polityk
poliittinen - polityczny
politiikka - polityka
poljento - rytm
poljin - pedał
polku - ścieżka
polkupyörä - rower
pöllö - sowa
pöllönen - syczek
pöllöpapukaija - kakapo
polonium - polon
polttaa - spalić
polttoaine - paliwo
polvi - kolano
pöly - kurz, pył
polygamia - poligamia
pölyinen - zakurzony
polyteismi - politeizm
polyyppi - polip
pommi - bomba
pommittaa - bombardować
pommittaja - bombowiec, osoba podkładająca bombę
poni - kucyk
poppeli - topola
populariteetti - popularność
pora - wiertło
porkkana - marchew
pornografia - pornografia
poro - renifer
poronhoito - hodowla reniferów, zajmowanie się wypasającymi się swobodnie satadami reniferów hodowlanych, pasterstwo reniferów
poronhoitoalue - strefa wypasu reniferów
porsas - prosię
portaikko - schody
portti - brama
portugali - portugalski
Portugali - Portugalia
portugalilainen - portugalski
poski - policzek
posliini - porcelana
possunliha - wieprzowina
posti - poczta
postikortti - kartka pocztowa, pocztówka
postilla - postylla
postimerkkeilijä - filatelista
postimerkki - znaczek pocztowy
postpositio - poimek, postpozycja
potentiaalinen - potencjalny
potilas - pacjent
potkaisu - kopniak
potku - kopniak
potkuri - śruba napędowa, śmigło
potretti - portret
pötsi - żwacz
pöty - nonsens
pouta - pogoda bez deszczu
povaaja - wróż, wróżka
povi - pierś, biust
pöyheä - puszysty
pöytä - stół
pöytäliina - obrus
PP - polipropylen, celownik kolimatorowy
pragmaattinen - pragmatyczny
praseodyymi - prazeodym
predikaatti - orzeczenie
preeria - preria
prefiksi - przedrostek
presidentti - prezydent
Preussi - Prusy
prinsessa - księżniczka
prioriteetti - priorytet
privilegio - przywilej
probleema - problem
probleemi - problem
profeetta - prorok
professori - profesor
profetia - przepowiednia
projekti - projekt
projektio - projekcja
proletariaatti - proletariat
prologi - prolog
prometium - promet
pronomini - zaimek
pronssi - brąz
proosa - proza
propaganda - propaganda
proportionaalinen - proporcjonalny
prosentti - procent
prostituutio - prostytucja
protaktinium - protaktyn
proteiini - białko
protesti - protest
protokolla - protokół
protoni - proton
provokaatio - prowokacja
provosointi - prowokacja
pseudonyymi - pseudonim
psykologi - psycholog
psykologia - psychologia
psykologinen - psychologiczny
Ptah - Ptah
pudota - upadać, spadać, padać
puhdas - czysty
puhdistaa - czyścić
puhe - mowa, przemowa
puheenparsi - idiom
puhekielinen - kolokwialny, potoczny
puhelias - rozmowny
puhelin - telefon
puhetaito - retoryka
puhjeta - pękać, pęknąć
puhua - mówić
puhuja - mówca, spiker
puida - młócić
puinen - drewniany
puisto - park
pujo - bylica pospolita
pulla - bułka, bułeczka
pullo - butelka
pulma - trudność, problem
pulmunen - śnieguła
pulmussirri - piaskowiec
pulska - pulchny, grubiutki, tęgi, korpulentny, mięsisty (
pultti - trzpień śruby
pulveri - proszek
puna - czerwień, kolor czerwony
punainen - czerwony (kolor)
punajalkaviklo - krwawodziób, brodziec krwawodzioby
punajuuri - burak czerwony
punakaali - czerwona kapusta
punakaulahanhi - bernikla rdzawoszyja
punakottarainen - pasterz, pasterz różowy
punakuiri - szlamnik
punakylkirastas - droździk, drozd rdzawoboczny
punanokkakiislanen - nurniczek krasnodzioby
punapäänarsku - hełmiatka
punarinta - rudzik
punasolu - krwinka czerwona
punasotka - głowienka
punatulkku - gil
punavarpunen - dziwonia
punaviini - czerwone wino
puola - język polski, polszczyzna, szczebel, szpulka, szprycha, borówka
Puola - Polska
puolalainen - Polak, polski
Puolanka - Puolanka
puolanvinttikoira - chart polski
puoli - połowa, stanowiący połowę
puolipiste - średnik
puolisko - połowa, półkula
puoliyö - północ
puoltaa - bronić, wstawiać się, ująć się, orędować
puolue - partia
puolukka - borówka brusznica
puoskari - znachor
pupilli - źrenica
puppu - nonsens
purje - żagiel
purjevene - żaglówka
purkurauta - łom
purnukka - słoik
puro - strumień, strumyk, potok
purra - gryźć, kąsać
pursimies - bosman
purukumi - guma do żucia
pusero - bluza
puskikko - zarośla, gąszcz
puskutraktori - buldożer
pussi - torba, torebka, worek
pussijuoksu - wyścig w workach
pussikarhu - koala
pussitiainen - remiz
pusu - buziak, całus, cmok, dziubek
putkimies - hydraulik
puu - drzewo, drewno
puudeli - pudel
puuhanhi - bezpłetwiec, gęś skąpopłetwa
puuhiili - węgiel drzewny
puukiipijä - pełzacz leśny
puukko - nóż fiński, finka
puuro - owsianka
puuseppä - cieśla, stolarz
puutarha - ogród, sad
puutos - niedobór
puuttua - brakować, ingerować, wtrącać się, przerywać
puuttuminen - brak, niedostatek
puuvilla - bawełna
pyhä - święty
pyhättö - świątynia
pyhiinvaellusmatka - pielgrzymka
pyhiinvaeltaja - pielgrzym
pyhimys - święty
pyjama - piżama
pylväs - filar, kolumna
pyökki - buk
pyörä - koło
pyörätuoli - wózek inwalidzki
pyöreä - okrągły
pyöveli - kat
pyromaani - piroman
pyromania - piromania
pyrstö - ogon, płetwa
pyrstösammakko - salamandra
pyrstötähti - kometa
pyrstötiainen - raniuszek
pysäkki - przystanek
pyssy - strzelba
pysty- - prosty, stojący
pystysuora - pionowy
pyton - pyton
pyy - jarząbek
pyyhe - ręcznik, ścierka
pyyheliina - ręcznik
pyyjuoksija - przepiórnik
pyykki - pranie, brudna bielizna, kamień graniczny
Qatar - Katar
raadollinen - pozbawiony skrupułów
raaja - kończyna
Raamattu - Biblia
raana - kran
raastin - tarka
raatihuone - ratusz, urząd miejski
raavaanliha - wołowina
rabbi - rabin
rabbiini - rabin
radiaatio - promieniowanie
radio - radio
radioaktiivinen - radioaktywny
radioaktiivisuus - radioaktywność, promieniotwórczość
radium - rad
radon - radon
rae - grad
raha - pieniądz
rahallinen - pieniężny
rahanvaihtaja - handlarz walutą
rahtitavara - towar
raikas - świeży
raitiovaunu - tramwaj
raivaustraktori - buldożer
raivo - wściekłość, szał, wściekły
raja - granica, bariera
räjähdys - wybuch, eksplozja
rajaseutu - granica
rajoittaa - ograniczać, ograniczyć
raju - gwałtowny, wściekły, szalony
rajuilma - burza
rakastaa - kochać
räkättirastas - kwiczoł
rakennus - budynek
rakentaa - budować, konstruować, wznosić
raketti - rakieta
rakkaus - miłość
rakko - pęcherz
räme - bagno, moczary
rangaista - karać
rankaisemattomuus - bezkarność
rankaisu - kara
rankka - silny, gwałtowny
ranne - nadgarstek
rannikko - wybrzeże
ranska - francuski
Ranska - Francja
ranskalainen - Francuz, Francuzka, francuski
ranta - plaża, wybrzeże, brzeg rzeki
räntä - deszcz ze śniegiem
rantakurvi - terekia
räntäsade - deszcz ze śniegiem
rantasipi - kuliczek, kuliczek piskliwy
rapakko - kałuża
rapsi - rzepak
rapu - rak
Rapu - Rak
rariteetti - rzadkość
rasismi - rasizm
raskas - ciężki
rastas - drozd
rastaskerttunen - trzciniak
rastuli - klarnetnik
rasva - tłuszcz
rasvaimu - liposukcja
rata - tor
ratifiointi - ratyfikacja
rationalismi - racjonalizm
ratkaista - decydować
ratsuväki - kawaleria, konnica
ratto - przyjemność
rauha - spokój, harmonia
rauhaisa - pokojowy
rauhanen - gruczoł
raukea - zmęczony, wykończony, wycieńczony
raunio - ruina
rausku - płaszczka
rauta - żelazo, żelazny kij golfowy, w   kajdany, pęta, w   kajdanki, w   wnyki, hardware, sprzęt
rautabetoni - żelbeton, żelbet, żelazobeton
rautainen - żelazny, silny, hardy, zahartowany
rautamalmi - ruda żelaza
rautatie - kolej (środek transportu), linia kolejowa
rautatieasema - dworzec kolejowy
rautatiekisko - szyna kolejowa
rautatiesilta - most kolejowy
rautatievaunu - wagon kolejowy
rautatieverkko - sieć kolejowa
rautiainen - płochacz pokrzywnica
rautio - kowal
ravakka - energiczny
raviini - wąwóz
ravinto - pożywienie, pokarm
ravintola - restauracja
ravita - żywić, odżywiać, karmić
räyskä - rybitwa wielkodzioba
räystäspääsky - jaskółka oknówka, oknówka
reaalinen - prawdziwy, realny
reaktio - reakcja
realismi - realizm
realistinen - realistyczny
referee - sędzia
refleksiivipronomini - zaimek zwrotny
refleksiiviverbi - czasownik zwrotny
reformi - reforma
regionaalinen - regionalny
rehabilitaatio - rehabilitacja
rehabilitointi - rehabilitacja
rehu - pasza
reikä - dziura, otwór
reinkarnaatio - reinkarnacja
reipas - energiczny
reisi - udo
rekisteröinti - rejestracja
rekryytti - rekrut
relatiivisuus - względność
remontti - renowacja
renium - ren
rentukka - knieć błotna, kaczeniec
reportaasi - reportaż
reppu - plecak
reproduktio - reprodukcja
resepti - recepta
resitoida - recytować
resonanssi - rezonans
resonointi - rezonans
reti - reda
retiisi - rzodkiewka
retikka - rzodkiew
retoriikka - retoryka
retsina - retsina
reuma - reumatyzm
reuna - brzeg, krawędź
reversiibeli - odwracalny
revoluutio - rewolucja
revolveri - rewolwer
revonhäntä - szarłat, amarant
revontulet - zorza polarna
riekko - pardwa mszarna
riemuvoitto - triumf
rienaus - bluźnierstwo
Riianlahti - Zatoka Ryska
Riika - Ryga
riikinkukko - paw
riippua - wisieć, zależeć
riippulukko - kłódka
riippumattomasti - niezależnie
riisi - ryż
riita - kłótnia
riittää - wystarczyć, starczyć
riittävästi - wystarczająco
rikas - bogaty
rikki - wniwecz, w drzazgi, w proch, na kawałki, na pół, na części, siarka
rikollinen - przestępca, przestępczy, kryminalny
rikos - zbrodnia, przestępstwo
rinkilä - pączek
rinnastus - porównanie
rinne - brzeg, skarpa
rinta - klatka piersiowa, piersi (kobiece)
rintakoru - broszka
rintalasta - mostek
rintaneula - broszka
rippi - spowiedź
riskilä - nurnik
risteilijä - krążownik, jacht wycieczkowy, pojemnik na odpadki w mesie
risti - krzyż
ristiinnaulitunkuva - krucyfiks
risukko - zarośla, gąszcz
ritari - rycerz
rituaali - rytuał
riuska - energiczny
riutta - rafa
rivakka - energiczny
rivi - rząd, szereg, wiersz, linijka
rivistö - kolumna
rivo - sprośny, bezwstydny, frywolny
robotti - robot
rodium - rod
rohkea - odważny, śmiały, zuchwały
roju - śmieć
rokotus - szczepienie
romania - język rumuński
Romania - Rumunia
romanialainen - Rumun, rumuński
romanttinen - romantyczny
romisko - skrzydłoszpon
rommi - rum
röntgenium - rutherford
rontti - łajdak
rooli - rola
Rooma - Rzym
roosa - różowy
roska - śmieć, odpadek
rosmariini - rozmaryn
rosvous - rabunek
rotaatio - obrót
rotko - rozpadlina, szczelina
rotkolaakso - kanion
rotta - szczur
rotu - rasa
rouva - pani
Rovaniemi - Rovaniemi
Ruanda - Rwanda
rubidium - rubid
rubiini - rubin
ruhtinas - książę
ruhtinatar - księżniczka
ruis - żyto
ruisrääkkä - derkacz
rukoushuone - kaplica
rukousnauha - różaniec
rullaportaat - schody ruchome
ruma - brzydki, paskudny, szkaradny, ohydny
rumpu - bęben
rumuus - brzydota
runkata - masturbować się
runko - pień, kadłub
runo - wiersz
runoelma - wiersz
runoilija - poeta
runoilijatar - poetka
runous - poezja
runsas - obfity
runsaslukuinen - liczny
ruoansulatus - trawienie
ruode - żebro
ruohikko - trawa, trawnik
ruoho - trawa
ruohosipuli - szczypiorek
ruoka - jedzenie, posiłek
ruokahalu - apetyt
ruokalaji - danie, potrawa
ruokasali - jadalnia
ruokki - alka
ruokokerttunen - rokitniczka
ruokosirkkalintu - brzęczka
ruori - koło sterowe, ster
ruoska - bicz
ruoste - rdza
ruosteinen - zardzewiały
ruostesorsa - kazarka, kazarka rdzawa
ruostua - rdzewieć
ruoto - ość
ruotsalainen - szwedzki, Szwed, Szwedka
ruotsi - szwedzki
Ruotsi - Szwecja
rupikonna - ropucha
rupla - rubel
rusakko - zając szarak
rusetti - muszka
rusina - rodzynek
ruskea - brązowy, brunatny
rusko - zorza, brązowy koń
ruskuainen - żółtko
rusto - chrząstka
rutenium - ruten
rutherfordium - roentgen
rutjake - łajdak
rutto - epidemia, zaraza, pomór, dżuma
ruudikas - silny, mocny
ruuhka - korek
ruukku - garnek
ruumis - ciało człowieka, ciało, zwłoki
ruumisarkku - trumna
ruusu - róża
ruuti - proch strzelniczy
ruuvi - śruba
ruuvitaltta - śrubokręt
ryhmä - grupa
rynnäs - pierś
ryöstäjä - rabuś
ryöstö - rabunek
ryöväri - rabuś
rytikerttunen - trzcinniczek
rytmi - rytm
sää - pogoda
saada - otrzymać, dostać, móc, uprawiać seks z kimś (łączy się z przypadkiem Ablatiivi)
saaga - saga
sääksi - rybołów
šaali - szal
säännöllisesti - regularnie
säännöllisyys - regularność
säännötön - nieregularny
sääntö - reguła
sääoppi - meteorologia
saapas - but (z cholewą), kozak
saapua - przybyć, przyjechać, nadejść
saari - wyspa
sääri - goleń, podudzie, noga
saaristo - archipelag
saarna - kazanie
saarnaaja - kaznodzieja
saarnamies - kaznodzieja
saarni - jesion
saarto - blokada
saasta - brud
saatana - niech to diabli, do diabła, szatan, diabeł
Saatana - szatan
saatavuus - dostępność
säätiede - meteorologia
säätiö - fundacja
saattue - konwój
sabotaasi - sabotaż
sabotointi - sabotaż
sadas - setny
sade - deszcz
säde - promień
sadetakki - płaszcz nieprzemakalny, deszczowiec
sadismi - sadyzm
säe - wiersz, wers
saha - piła
sahanpuru - trociny
sähke - telegram
sähkö - elektryczność
sähköasentaja - elektryk
sähkömagneettinen - elektromagnetyczny
sähkömies - elektryk
sähköposti - poczta elektroniczna, mail, e-mail, wiadomość wysłana za pomocą poczty elektronicznej
sähkövirta - prąd elektryczny
sahrami - szafran
säihkyjä - sierpodudek
saippua - mydło
saippuaooppera - opera mydlana
saippuasarja - opera mydlana
sairaala - szpital
sairas - chory, pacjent
sairaus - choroba
saita - skąpy
saituri - skąpiec
saivar - gnida
säkä - kłąb
säkene - iskra
sakko - mandat, grzywa
sakramentti - sakrament
saksa - język niemiecki
Saksa - Niemcy
saksalainen - Niemiec, niemiecki
Saksan Demokraattinen Tasavalta - Niemiecka Republika Demokratyczna
saksanhirvi - jeleń, jeleń szlachetny
Saksan Liittotasavalta - Republika Federalna Niemiec, Niemcy
sakset - nożyczki
saksinokka - brzytwodziób
saksofoni - saksofon
sala - tajemnica
sala-ampuja - snajper
salaatti - sałatka
salaisuus - tajemnica
salakuljettaja - przemytnik
salama - piorun
salamoida - błyskać
salamurha - zamach, morderstwo
salaperäinen - tajemniczy
salasana - hasło
salko - słup, maszt
salmi - cieśnina
salo - leśna głusza
Salomonsaaret - Wyspy Salomona
salpietari - saletra
šamaani - szaman
samanarvoinen - równoważny
samanlaisuus - podobieństwo
samantekevä - nieistotny
samarium - samar
sametti - aksamit
sammakko - żaba
sammakonpoikanen - kijanka
sammal - mech
sammutin - gaśnica
sammuttaa - gasić
Samoa - Samoa
samojedinkoira - samojed
samovaari - samowar
sampi - jesiotr
sampoo - szampon
samppanja - szampan
sana - słowo
sanakirja - słownik
sananen - słowo
sananlasku - przysłowie
sananmukainen - dosłowny
sananmukaisesti - dosłownie
sananvapaus - wolność słowa
sandaali - sandał
sangen - bardzo
saniainen - paprotnik
sankari - bohater
sankarillinen - bohaterski
sankka - gęsty
sanko - wiadro
sanktio - sankcja
sänky - łóżko
sannikas - sandał
sanoa - powiedzieć
sanomalehti - gazeta
São Tomé ja Príncipe - Wyspy Świętego Tomasza i Książęca
säpäle - drzazga
sappi - żółc
sappirakko - woreczek żółciowy
sara - turzyca
sarakerttunen - wodniczka
sarana - zawias
sarastus - świt, brzask
sardiini - sardynka
sarja - seria
sarkasmi - sarkazm
sarkastinen - sarkastyczny
särki - płoć, płotka
sarkofagi - sarkofag
särky - ból
sarvi - róg
sarvikiisla - nurek
sarvikuono - nosorożec
sarvinokka - dzioborożec
sarvipöllö - sowa uszata, uszatka
sarvivalas - narwal
sata - sto (liczba), 100
sataa - padać (o deszczu, śniegu itp.)
satakieli - słowik
satama - port
sateenkaari - tęcza
sateenvarjo - parasolka
säteily - promieniowanie
sateinen - deszczowy, dżdżysty, obfitujący w opady deszczu
satelliitti - satelita
satiiri - satyra
satu - bajka
satula - siodło, siodełko
satunnainen - przypadkowy
Saudi-Arabia - Arabia Saudyjska
sauhu - dym
saukko - wydra
sauma - szew
sauna - sauna, łaźnia fińska
saunoa - zażywać kąpieli w saunie
saunominen - zażywanie kąpieli w saunie
sävel - ton
sävelmä - melodia
säveltäjä - kompozytor
savi - glina
savu - dym
savuke - papieros
savustaa - wędzić
säyseä - uległy, posłuszny
se - ono, to
seaborgium - seaborg
sedimentti - osad
seepra - zebra
seerumi - serum, surowica
seikkailija - poszukiwacz przygód
seikkailu - przygoda
seinä - ściana
seinälukki - kosarz pospolity
seiska - siódemka
seisoa - stać
seitsemän - siedem (cyfra)
seitsemänkymmentä - siedemdziesiąt
seitsemänkymmentäkahdeksan - siedemdziesiąt osiem, 78
seitsemänkymmentäkaksi - siedemdziesiąt dwa, 72
seitsemänkymmentäkolme - siedemdziesiąt trzy, 73
seitsemänkymmentäkuusi - siedemdziesiąt sześć, 76
seitsemänkymmentäneljä - siedemdziesiąt cztery, 74
seitsemänkymmentäseitsemän - siedemdziesiąt siedem, 77
seitsemänkymmentäviisi - siedemdziesiąt pięć, 75
seitsemänkymmentäyhdeksän - siedemdziesiąt dziewięć, 79
seitsemänkymmentäyksi - siedemdziesiąt jeden, 71
seitsemäntoista - siedemnaście
seitsemäs - siódmy
seiväshyppy - skok o tyczce
sekä - i, oraz
sekasortoinen - chaotyczny
seksi - seks
seksismi - seksizm
seksuaalinen - seksualny
seksuaalinen suuntautuminen - orientacja seksualna
seksuaalisesti - seksualnie
seksuaalisuus - seksualność
seksualiteetti - seksualność
sektori - sektor
sekunti - sekunda
seleeni - selen
selitys - wyjaśnienie
selkä - plecy
selkäranka - kręgosłup
selkeys - klarowność, przejrzystość
sellainen - taki, tego rodzaju
selleri - seler
sello - wiolonczela
sellofaani - celofan
semanttinen - semantyczny
sementti - cement
sen - tego, jego
senaattori - senator
Senegal - Senegal
seniili - starczy
sensitiivinen - wrażliwy
sensuelli - zmysłowy
sentrifugi - wirówka
sentti - cent
senttimetri - centymetr
sepelhanhi - bernikla obrożna
sepelkyyhky - gołąb grzywacz, grzywacz
sepelrastas - drozd obrożny
seppä - kowal
seppele - wianek
Serbia - Serbia
Serbia ja Montenegro - Serbia i Czarnogóra
seremonia - ceremonia
serkku - kuzyn, kuzynka
setä - wujek
seteli - banknot
seula - sito
seuraaja - zwolennik, następca
seuraava - następny, kolejny
seurailija - zwolennik
Seychellit - Seszele
sfääri - sfera
shakki - szachy
sharon - persymona
sheriffi - szeryf
-si - twój, twoja, twoje
sianliha - wieprzownia
side - bandaż
siellä - tam
sielu - dusza
sielutiede - psychologia
siemen - nasienie, nasiono
sieni - grzyb
sienitiede - mykologia
siepata - chwycić, pochwycić
sieppo - muchołówka
sierain - nozdrze
Sierra Leone - Sierra Leone
signaali - sygnał
sihteeri - sekretarka
siika - sieja
siili - jeż
siinä paha missä mainitaan - o wilku mowa, tam zły gdzie go wspomniano
siipi - skrzydło
siirappi - syrop
siirtää - przesunąć, przestawić, przenieść na inne miejsce
siirtokunta - kolonia
siirtolainen - imigrant
siirtomaa - kolonia
siis - więc, zatem
siitin - penis
siittää - zapładniać
siivekäs - skrzydlaty, ptak
siivetönruokki - alka olbrzymia
siivilä - sito
sika - świnia
sikala - chlew, chlewnia, świniarnia
sikari - cygaro
sikhiläisyys - sikhizm
sikiö - zarodek, embrion, płód
sikotauti - świnka
sikseen - na bok
sikuri - cykoria
silava - słonina
silhuetti - sylwetka
silitysrauta - żelazko
silkki - jedwab
silkkiäistoukka - jedwabnik
silkkinen - jedwabny
silkkitoukka - jedwabnik
silkkiuikku - perkoz dwuczuby
silloin - wtedy, wówczas
silloin kun - kiedy
silmä - oko
silmälasihaahka - edredon okularowy
silmälasikurki - żuraw białoszyi
silmälasit - okulary
silmäluomi - powieka
silmämuna - gałka oczna
silmäripsi - rzęsa
silmäys - spojrzenie, rzut oka
silminnähtävä - ewidentny
silta - most
siluetti - sylwetka
sima - miód pitny
simpanssi - szympans
simulaatio - symulacja
sinä - ty
sinappi - musztarda
sinelmä - siniak
sinetti - pieczęć
sinfonia - symfonia
Singapore - Singapur
sininärhi - kraska
sininen - niebieski (kolor)
sinipunainen - fioletowy
sinipyrstö - modraczek
sinirinta - podróżniczek (Luscinia svecica)
sinisorsa - krzyżówka
sinitiainen - sikora modra, modraszka
sinkki - cynk
sinun - twój
Siperia - Syberia
siperiankurmitsa - siewka złotawa
siperiantavi - cyranka syberyjska
sipinä - szept
sipuli - cebula
sirittäjä - świstunka leśna
sirkku - ptak z rodziny trznadlowatych rodzaju, trznadel
sirkus - cyrk
sirri - biegus
sisäinen - wewnętrzny
sisäinen kitka - lepkość
sisältää - zawierać
sisar - siostra
sisätila - wnętrze
sisilisko - jaszczurka żyworodna
sisko - siostra
sissi - partyzant
sisus - wnętrze
Sisyfos - Syzyf
sitoa - wiązać, związywać
sitruuna - cytryna
sitruunamehu - sok cytrynowy
siunaus - błogosławieństwo
sivakka - narta
siveetön - niemoralny
sivellin - pędzel
sivilisaatio - cywilizacja
sivu - strona
sivujoki - dopływ
skandaali - skandal
Skandinavia - Skandynawia
skandium - skand
skeema - schemat
skorpioni - skorpion
Skotlanti - Szkocja
skunkki - skunks
slangi - slang
Sleesia - Śląsk
Slovakia - Słowacja
slovakki - język słowacki
Slovenia - Słowenia
smaragdi - szmaragd
smetana - śmietana
sohva - sofa, kanapa
soijakastike - sos sojowy
soikea - owalny
soikio - owal
soittaa - grać (na instrumencie), dzwonić (do kogoś)
sokea - ślepy, niewidomy
sokeasti - ślepo
sokeri - cukier
sokeritoukka - rybik cukrowy
sokeus - ślepota
solakka - smukły
solidaarisuus - solidarność
solidariteetti - solidarność
solisti - solista
solmio - krawat
solu - komórka
Somalia - Somalia
sonetti - sonet
sonsari - pchła
soolo - solo
soopeli - soból
sopeutuminen - adaptacja
sopiva - odpowiedni
soppa - zupa
sopuli - leming
sopuratkaisu - kompromis
sopusointu - harmonia
sora - żwir
sorkka - racica
sormi - palec
sormus - pierścień (biżuteria)
sormustin - naparstek
sorsa - kaczka pływająca, kaczka właściwa, kaczka
sosialismi - socjalizm
sosialistinen - socjalistyczny
Sosialististen Neuvostotasavaltojen Liitto - Związek Socjalistycznych Republik Radzieckich
sosiologi - socjolog
sosiologia - socjologia
sota - wojna
sotilaallinen - wojskowy, militarny
sotilas - żołnierz, pionek
sotka - kaczka nurkująca, grążyca
soturi - żołnierz, wojownik
soutaa - wiosłować
spesialisti - specjalista
spesifikaatio - specyfikacja
spiraali - spirala
spitaali - trąd
spitaalinen - trędowaty
sponsori - sponsor
spontaani - spontaniczny
spontaaninen - spontaniczny
sprii - spirytus
Sri Lanka - Sri Lanka
stabiili - stabilny
stagnaatio - stagnacja
statistiikka - statystyka
Stefanos - Stefan
stilus - rylec
strategia - strategia
strateginen - strategiczny
stressi - stres
strontium - stront
strutsi - struś
strykniini - strychnina
substantiivi - rzeczownik
subtrooppinen - subtropikalny, podzwrotnikowy
Sudan - Sudan
sudenkorento - ważka
suhteellisesti - względnie
suhteellisuus - względność
suhteen - ze względu na, odnośnie do
suihkukaivo - fontanna
suihkulähde - fontanna
suippo - szpiczasty, ostry
suippopyrstösirri - biegus ostrosterny
suitsuke - kadzidło
sukellusvene - łódź podwodna
sukeltaja - nurek
sukka - skarpeta, skarpetka
sukki - pagórek
suklaa - czekolada
suksi - narta
suku - rodzaj
sukunimi - nazwisko
sukupuoli - płeć
sukupuolisuus - seksualność
sukupuoliyhteys - stosunek seksualny
sukututkija - genealog
sukututkimus - genealogia
sulka - pióro
sulo - wdzięk
suloinen - słodki, uprzejmy, uroczy, miły
sulttaani - sułtan
sumu - mgła
sunnuntai - niedziela
suo - bagno
suodattaa - filtrować
suohaukka - błotniak
suoja - ochrona, osłona, schron, schronienie, odwilż, ocieplenie
suojasää - odwilż, ocieplenie
suojata - chronić, strzec, bronić, osłaniać
suojelus - ochrona, opieka
suojelusenkeli - Anioł Stróż
suokukko - batalion, bojownik
suola - sól
suolainen - solony
suoli - jelito
suomalainen - Fin
suomen kieli - język fiński
suomenkielinen - fiński, fińskojęzyczny, w języku fińskim, mówiący po fińsku
Suomenlahti - Zatoka Fińska
Suomen tasavalta - Republika Finlandii
suomi - język fiński
Suomi - Finlandia
suomu - łuska
suomuurain - moroszka, malina moroszka
suoni - naczynie krwionośne
suopöllö - sowa błotna, uszatka błotna
suorakulmio - prostokąt
suosio - popularność
suosirri - biegus zmienny
suositella - zalecać
suosittaa - zalecać
suosittelija - sędzia
supattaa - szeptać
supermarket - supermarket
supina - szeptanie, szemranie
suppilo - lejek
Suriname - Surinam
surrealistinen - surrealistyczny
suru - żal, smutek, żałoba
suruaika - żałoba
surullinen - smutny, przygnębiony
surullisenkuuluisa - niesławny
surullisuus - smutek
susi - wilk
susikoira - wilczur
suu - usta
suudella - całować, pocałować
suudelma - pocałunek
suula - głuptak
suulake - dysza
suunnitelma - projekt, plan
suunta - kierunek
suuntaus - trend, orientacja
suura - sura
suurelta osin - głównie
suurenmoinen - wspaniały
suurennella - przesadzać
suurennuslasi - lupa
suuri - duży
suurlähetystö - ambasada
suuseksi - seks oralny
suutari - lin, szewstwo
suvanto - szeroki i głęboki odcinek koryta rzeki, w którym woda płynie bardzo wolnym nurtem
suvereenisuus - suwerenność
suvereniteetti - suwerenność
suvi - lato
Sveitsi - Szwajcaria
sydän - serce
sydänyö - północ
syfilis - syfilis, kiła
syke - puls
sykloni - cyklon
syksy - jesień
syksyinen - jesienny
syleily - uścisk, objęcie
sylki - ślina
symboli - symbol
symbolinen - symboliczny
symbolisesti - symbolicznie
symbolismi - symbolizm
symmetria - symetria
symmetrisyys - symetria
sympaattinen - współczujący
sympatia - sympatia
synonyymi - synonim
syntaksi - składnia
synteesi - synteza
synteettinen - syntetyczny
synti - grzech
syntymäpäivä - urodziny
syödä - jeść
syönti - jedzenie
syöpä - rak
syötti - przynęta, wabik
sysi - węgiel drzewny
systeemi - system
systemaattinen - systematyczny
systematiikka - systematyka
systematisoida - organizować
sytologia - cytologia
syvä - głęboki
syy - przyczyna, powód, wina, motyw, pobudka
syyhy - świerzb, swędzenie
syylä - brodawka
Syyria - Syria
syyskuu - wrzesień
taakka - ciężar, brzemię
täällä - tutaj, tu
taannoin - ostatnio
taas - znowu, znów, od nowa
taateli - daktyl
taatusti - na pewno
tabletti - tabletka, pastylka
tabu - tabu
tadikko - widły
Tadžikistan - Tadżykistan
tahallinen - zamierzony
tahdas - ciasto
tähkä - kłos
tahmainen - lepki
tähti - gwiazda
tähtitiede - astronomia
tähtitieteellinen - astronomiczny
tähtitieteilijä - astronom
tähtitorni - obserwatorium
tahtoa - chcieć, mieć ochotę, życzyć sobie, zamierzać
tai - lub, albo
täi - wesz
taide - sztuka
taifuuni - tajfun
taiga - tajga
taika - magia, czary, zaklęcie
taikausko - przesąd, zabobon, gusło
taikauskoinen - przesądny
taikauskoisuus - przesąd
taikka - lub, albo
taikuri - mag, czarnoksiężnik
taikuus - magia
taimen - troć, pstrąg
taimi - sadzonka
taistella - walczyć
taistelu - walka, bitwa
taistelukärki - głowica
taistelulaiva - pancernik
taivaanvuohi - bekas kszyk, kszyk
taivas - niebo
Taiwan - Tajwan
taju - przytomność, świadomość, zmysł, zrozumienie
tajunta - świadomość
tajuta - zrozumieć, pojąć
tajuton - nieprzytomny
takaisin - z powrotem
takaisinpäin - do tyłu
takamus - tyłek, pupa, siedzenie
takapuoli - tyłek, pupa, siedzenie
takavarikoida - konfiskować
takoa - kuć, wykuwać
takoa silloin kun rauta on kuuma - kuj wtedy gdy żelazo gorące, kuj żelazo, póki gorące
taksa - opłata
taksi - taksówka
taksonomia - taksonomia
takuu - gwarancja
talitiainen - sikora bogatka
Tallinna - Tallinn
tallium - tal
talo - dom (budynek)
talonmies - woźny, odźwierny, dozorca, portier
talous - gospodarka, ekonomia, gospodarstwo
taltta - dłuto
talutushihna - smycz
talvi - zima
talvinen - zimowy
talvitakki - płaszcz zimowy
tämä - ten, ta, to
tamma - klacz, kobyła
tammenterho - żołądź
tammi - dąb
tammikuu - styczeń
tammitikka - dzięcioł średni
Tampere - Tampere
tänään - dzisiaj
tanko - żerdź, tyka, drążek
Tansania - Tanzania
tanska - język duński
Tanska - Dania
tanskalainen - Duńczyk, Dunka, duński
tanssi - taniec
tanssia - tańczyć
tantaali - tantal
tapa - sposób, zwyczaj, obyczaj
tapahtua - zdarzyć się
tapaturmaisesti - przypadkowo
tapetti - tapeta (papier)
tappaa - zabić
tappaa kaksi kärpästä yhdellä iskulla - upiec dwie pieczenie na jednym ogniu, zabić dwie muchy jednym uderzeniem
tarina - opowieść
tarinankertoja - gawędziarz
tarjoilija - kelner
tarjoilijatar - kelnerka
tarjokas - wolontariusz
tärkeä - ważny
tärkeys - istotność, ważność
tarkkailija - obserwator
tarkoittaa - znaczyć, oznaczać, mieć na myśli, rozumieć
tarkoituksellinen - zamierzony
tärpätti - terpentyna
tarpeeksi - dość, dosyć
tarpeellinen - konieczny
tarpeellisuus - konieczność
tarra - naklejka, nalepka, etykieta samoprzylepna
tarve - potrzeba
tarvita - potrzebować
täry - wibracja
tasa-arvo - równość
tasan - dokładnie
tasanko - równina
tasasuhtaisuus - symetria
tasavalta - republika
tasavaltainen - republikański
tasavaltaisuus - republikanizm
tasavaltalainen - republikański
tasku - kieszeń
taskuvaras - kieszonkowiec, złodziej kieszonkowy
täsmälleen - dokładnie
täsmällisyys - precyzja
täti - ciocia
tatuointi - tatuaż
tauko - przerwa, pauza
taulu - tablica, tabela, tabelka
tausta - tło
tauti - choroba
tautologia - tautologia
tavallinen - zwykły, standardowy
tavallisesti - zwykle
tavara - towar
tavata - spotkać się
tavi - cyraneczka
taviokuurna - łuskowiec
tavu - sylaba, zgłoska, bajt
täydellinen - perfekcyjny, kompletny, pełny
täysi - pełny
täysikuu - pełnia księżyca
täysin - pełno, całkiem
te - wy
teatteri - teatr
tee - herbata
teelusikka - łyżeczka do herbaty
teema - temat
teerenpilkku - pieg
teeri - cietrzew
tehdä - robić
tehdas - fabryka
tehoisa - silny, mocny
tehtävä - praca, robota, zadanie do wykonania
teidän - wasz
teknetium - technet
tekniikka - technika
teknillinen - techniczny
tekninen - techniczny
teknologinen - techniczny
tekopyhyys - hipokryzja
tekovika - defekt, wada
teksti - tekst
tekstiviesti - SMS
telakka - stocznia
telefoni - telefon
teleskooppi - teleskop
televisio - telewizja
telkkä - gągoł
telluuri - tellur
teloittaa - dokonać egzekucji, ściąć
teloitus - egzekucja
teltta - namiot
tennis - tenis
tenori - tenor
tentti - egzamin
teollinen - przemysłowy
teollisuus - przemysł
teologi - teolog
teologinen - teologiczny
teoria - teoria
teräksinen - stalowy
terapia - terapia
teräs - stal
terävä - ostry
terbium - terb
terhakas - energiczny
terhakka - energiczny
termi - termin
terminologia - terminologia
termodynamiikka - termodynamika
territorio - terytorium
terrorismi - terroryzm
terska - żołądź ( glans penis)
terva - smoła
tervapääsky - jerzyk
terve - cześć, zdrowy
terveellinen - zdrowy
tervetuloa - witaj!, witajcie
terveys - zdrowie
testi - test
tetraplegia - tetraplegia
tetrapylon - tetrapylon
teuras - zwierzę rzeźne
teurastaja - rzeźnik
teurastamo - rzeźnia
Thaimaa - Tajlandia
Thermopylai - Termopile
tiainen - sikora, sikorka
tie - droga
tiede - nauka
tiedeakatemia - akademia nauk
tiedekunta - wydział, fakultet
tiedemies - uczony, naukowiec
tiedoton - nieprzytomny
tietää - wiedzieć
tieteellinen - naukowy
tieto - wiedza
tietoisuus - świadomość
tietojenkäsittelytiede - informatyka
tietokanta - baza danych
tietokone - komputer
tietosanakirja - encyklopedia
tietotekniikka - informatyka
tietoteoria - epistemologia
tihu - mżawka
Tiibet - Tybet
tiikeri - tygrys
tiili - cegła
tiira - rybitwa
tiistai - wtorek
tiivis - szczelny
tikari - sztylet
tikka - dzięcioł
tikli - szczygieł
tila - miejsce, położenie, stan, sytuacja
tilanne - sytuacja
tilapäisesti - tymczasowo
tilhi - jemiołuszka
tiltaltti - pierwiosnek
timantti - diament
timjami - tymianek
tina - cyna
tinka - kłótnia, niedobór
tippuri - rzeżączka
tipu - kurczę, kurczątko
tislata - destylować
titaani - tytan, potężny człowiek
tiu - 20 sztuk jaj
tms. - itp.
todella - naprawdę, rzeczywiście, faktycznie
todellinen - prawdziwy, faktyczny
todellisuus - rzeczywistość
Togo - Togo
töhkä - brud
tohtori - doktor, lekarz
tohvelieläin - pantofelek
toiletti - toaleta
toimisto - biuro
toimite - publikacja
toinen - drugi
toipilas - rekonwalescent
toisaalla - gdzie indziej
toistaa - powtarzać
toistamiseen - znowu, znów
toistuvasti - wielokrotnie
toiviomatka - pielgrzymka
toiviomatkalainen - pielgrzym
toivioretkeläinen - pielgrzym
toivioretki - pielgrzymka
toivo - nadzieja
toivoa - mieć nadzieję
toksikologia - toksykologia
toksinen - trujący
toleranssi - tolerancja
tomaatti - pomidor
tomu - pył, kurz
tomuinen - zakurzony
tomusokeri - cukier puder
tonnikala - tuńczyk
töpökkä - mrówkożer
tora - kłótnia
torakka - karaluch
torikammo - agorafobia
torikauhu - agorafobia
torium - tor
törmä - stromy urwisty brzeg, klif
törmänne - wał przeciwpowodziowy
törmäpääsky - jaskółka brzegówka, brzegówka
torni - wieża
tornipöllö - płomykówka
torstai - czwartek
torttu - tort
tosiasia - fakt
tosio - fakt
totaalisesti - totalnie
tottelematon - nieposłuszny
tottelemattomuus - nieposłuszeństwo
tottelevaisuus - posłuszeństwo
totunnainen - konwencjonalny
totuus - prawda
toukka - larwa, gąsienica
toukokuu - maj
touvi - cuma
tovi - moment
töyhtö - czubek, czub
töyhtöhyyppä - czajka
töyhtökiislanen - nurniczek czubaty
töyhtökiuru - dzierlatka
töyhtölunni - syn., maskonur złotoczuby
töyhtötiainen - sikora czubata, czubatka
traaginen - tragiczny
traditio - tradycja
traktori - traktor, ciągnik rolniczy
transistori - tranzystor
transkriptio - transkrypcja
translatiivi - ? ?, translativus
translitterointi - transliteracja
Transnistria - Naddniestrze
transparentti - przeźroczysty
trendi - trend
tribunaali - trybunał
trigonometria - trygonometria
trikotillomania - trichotillomania
Trinidad ja Tobago - Trynidad i Tobago
triviaali - trywialny
trogoni - trogon
trooppinen - tropikalny
tropiikkilintu - faeton
troposfääri - troposfera
trumpetti - trąbka
tsaari - car
Tšad - Czad
tšekki - Czech, język czeski
Tšekki - Czechy
tšekkiläinen - czeski
Tšekkoslovakia - Czechosłowacja
Tšekkoslovakian Sosialistinen Tasavalta - Czechosłowacka Republika Socjalistyczna
Tšeljabinsk - Czelabińsk
tsunami - tsunami
tsygootti - zygota
tuhannes - tysięczny
tuhat - tysiąc (1000)
tuhka - popiół
tuhkakuppi - popielniczka
tuhkarokko - odra
tuho - zniszczenie
tuhoaja - niszczyciel
tuhoisa - destrukcyjny
tuhooja - niszczyciel
tuijotella - gapić się, wpatrywać się
tuijottaa - gapić się, wpatrywać się
tuisku - śnieżyca, zamieć śnieżna
tukaani - tukan
Tukholma - Sztokholm
tuki - podpora, opora, oparcie, poparcie, wsparcie
tukka - włosy
tukkakoskelo - szlachar, tracz długodzioby
tukkasotka - czernica
tukko - kępka
tulenlieska - płomień
tulevaisuus - przyszłość
tuli - ogień
tuliase - broń palna
tulipäähippiäinen - zniczek
tulipalo - pożar
tulitauko - zawieszenie broni
tulitikku - zapałka
tulium - tul
tulivuori - wulkan
tulkinta - interpretacja
tulkki - tłumacz
tulla - przyjść
tulli - cło
tulos - rezultat, wynik
tulostin - drukarka
tulva - powódź
tuma - jądro komórkowe
tumma - ciemny
tumppi - niedopałek papierosa
tundra - tundra
tundrahanhi - gęś białoczelna
tundrakuikka - nur pacyficzny
tundrakurmitsa - siewnica
tundraurpiainen - czeczotka tundrowa
tundravikla - biegus płowy
tunika - tunika
Tunisia - Tunezja
tunkio - nawóz, gnój, gnojowisko
tunneli - tunel
tunnelma - nastrój
tunnus - numer identyfikacyjny
tuntea - czuć, wyczuwać, odczuwać, znać, poznać
tunteikas - emocjonalny
tuntematon - nieznany, anonimowy
tunti - godzina
tunturi - kamienista górska tundra
tunturihaukka - białozór, sokół norweski
tunturikihu - wydrzyk długosterny
tunturikiuru - górniczek
tunturikoivu - brzoza tundrowa
tunturipöllö - sowa śnieżna
tuntuvasti - znacząco, istotnie
tuo - to
tuoda - przynieść, przynosić
tuohi - kora brzozy
tuokio - chwilka, moment, momencik
tuoli - krzesło
tuomari - sędzia
tuomiokirkko - katedra
tuonela - świat zmarłych, zaświaty
tuonti - import
tuore - świeży
tuotanto - produkcja
tuote - produkt
tuottaja - producent
tupa - izba, chata, domek
tupakka - tytoń (roślina), tytoń (produkt), papieros
tupakoida - palić tytoń, palić papierosy
tuppi - pochwa
tuppinokka - pochwodziób
turbaani - turban
turhauma - frustracja
turismi - turystyka
turisti - turysta
turkinkyyhky - synogarlica, sierpówka
turkis - futro
turkki - futro
Turkki - Turcja
turkkilainen - Turek, Turczynka, turecki
Turkmenistan - Turkmenistan
turpa - morda, pysk
tursas - ośmiornica
turska - dorsz
turva - bezpieczeństwo, ochrona
turvaisa - bezpieczny
turvallisesti - bezpiecznie
turvatyyny - poduszka powietrzna, poduszka bezpieczeństwa
turvavyö - pas bezpieczeństwa
turve - torf
tusina - tuzin
tuska - ból, cierpienie, męka
tuskainen - bolesny
tuskaisa - bolesny
tuskallinen - bolesny
tuskallisesti - boleśnie
tuskin - ledwie, zaledwie
tutka - radar
tuttu - znajomy, dobrze znany
tuuli - wiatr, humor
tuulihaukka - pustułka
tuulimylly - wiatrak
tuuma - pomysł, cal
tuura - narzędzie do odkuwania lodu, czekan
tuutulaulu - kołysanka
Tuvalu - Tuvalu
tyhjä - pusty, nic
tyhjiö - próżnia
tyhmä - głupi
tykky - ciężki, zmrożony śnieg, osadzający się po dużych opadach na drzewach, liniach energetycznych, płotach itp.
tylsä - nudny
työ - praca
työkalu - narzędzie
työläs - pracochłonny, żmudny
työntää - pchać, pchnąć
työpaja - warsztat
työskennellä - pracować
typerä - głupi, tępy, ciemny
typpi - azot
tyranni - tyran
tyrannia - tyrania
tyrannius - tyrania
tyrmä - cela, więzienie
tyrskykahlaaja - brzegowiec
tytär - córka
tytärpuoli - pasierbica
tyttö - dziewczyna
tyttöystävä - dziewczyna
tyyli - styl
tyylilaji - gatunek, rodzaj
tyynenmerenriskilä - nurnik aleucki
tyynesti - spokojnie
Tyynimeri - Ocean Spokojny, Pacyfik
Tyyni valtameri - Ocean Spokojny
tyyny - poduszka
tyypillinen - typowy
Uganda - Uganda
uhata - grozić, zagrażać
uhka - groźba, zagrożenie
uhkakuva - groźba
uhkapeluri - hazardzista
uhkavaatimus - ultimatum
uhri - ofiara, ofiarowanie
uida - pływać
uija - pływak
uikku - perkoz
uikkukana - perkołyska
uima-allas - basen
uima-asu - kostium kąpielowy
uimahalli - basen
uimahyppääjä - nurek
uimaranta - plaża, plaża pływacka
uimari - pływak
uinti - pływanie
uivelo - tracz bielaczek, bielaczek
ujo - nieśmiały, wstydliwy, bojaźliwy
ujous - nieśmiałość
ukko - starzec, dziadek, ojciec, stary, w pełni dojrzały samiec cietrzewia lub głuszca, mąż, małżonek
Ukko - najważniejszy bóg fińskiej mitologii, fińskie imię męskie
ukkonen - burza, grom, grzmot
ukkosmyrsky - burza
ukkostaa - grzmieć
ukonilma - burza
ukonkivi - kwarc
Ukraina - Ukraina
ulappakiislanen - nurniczek ciemny
ulappaliitäjä - burzyk
uljas - mężny, dzielny, heroiczny, bohaterski, okazały, postawny
ulkomaalainen - obcokrajowiec, cudzoziemiec
ulkonainen - zewnętrzny
ulkonäkö - wygląd zewnętrzny
ulkonaliikkumiskielto - godzina policyjna
ulkonema - projekcja
ullakko - strych
uloskäynti - wyjście
uloste - kał, stolec, ekskrementy
ulottuvuus - wymiar
ulsteri - płaszcz
ultimaatumi - ultimatum
ultravioletti - ultrafiolet
ulvoa - wyć, ryczeć
uneksia - śnić, marzyć
unelias - śpiący, senny
uni - sen
unikeko - popielica
unikko - mak
unikorni - jednorożec
universumi - wszechświat
univormu - mundur
unkari - język węgierski
Unkari - Węgry
unkarilainen - Węgier, Węgierka, węgierski
unohtaa - zapomnieć
untuva - puch
upota - utonąć, tonąć, zatonąć
ura - kariera
uraani - uran
urbaani - miejski
urbaaninen - miejski
urheilija - sportowiec
urheilu - sport
urheilulaji - sport
urho - bohater, śmiałek, zuch
uros - samiec
urpiainen - czeczotka
Uruguay - Urugwaj
urut - organy
-us - -uus
useaan otteeseen - wielokrotnie
usein - często
usko - wiara, religia
uskoa - wierzyć
uskollinen - wierny
uskonkappale - dogmat
uskonnollinen - religijny
uskonnollisesti - religijnie
uskonto - religia
utare - wymię
utelias - ciekawski, ciekawy
utopia - utopia
utu - zamglenie
utupilvi - mgła
uudenaikainen - nowoczesny
uudissana - neologizm
uudistus - reforma
uuni - piec
uupua - zmęczyć się, znużyć się, brakować
uusi - nowy
uusiminen - odnowienie
Uusi-Seelanti - Nowa Zelandia
Uusivuosi - Nowy Rok
uutinen - nowina, nowinka
uutiset - wiadomości, nowiny
uuttukyyhky - gołąb siniak, siniak
uutukainen - nowy
uutuus - nowość, nowa rzecz
Uzbekistan - Uzbekistan
vaahtera - klon
vaahto - piana
vaaka - waga
vaakasuora - poziomy
vaakkua - krakać
vaakuna - herb
vaakunaoppi - heraldyka
vaakunatiede - heraldyka
vaalea - jasny, blady
vaaleaihoinen - biały (kolor skóry), białego koloru skóry
vaaleanpunainen - różowy, jasno czerwony (kolor)
vaaleaverinen - blond
vaan - ale
väärä - niepoprawny, niewłaściwy
vaarallinen - niebezpieczny
vääräoppinen - heretycki
vaaraton - niegroźny, nieszkodliwy
vääristymä - deformacja
vaasi - wazon, waza
vaatetus - odzież
vaatturi - krawiec
vadelma - malina
vadelmahillo - dżem malinowy
vadelmamehu - sok malinowy
vaellus - wędrówka
vaeltaa - wędrować
vaeltaja - wędrowiec, wędrownik
väestö - ludność
väestötiede - demografia
vaha - wosk
vähä - mały, niski, mizerny, niedostateczny
vähän - trochę, mało
vahata - woskować
vähemmän - mniej
vähemmistö - mniejszość
vähennyslasku - odejmowanie
vähentää - zmniejszać, redukować, odejmować
vahinko - szkoda
vähintään - przynajmniej
vahva - mocny, silny
vahvasti - mocno, silnie
vahvistaa - umocnić, wzmocnić, potwierdzić, zatwierdzić, ratyfikować
vahviste - wzmocnienie
vähyys - rzadkość
vai - lub, albo
vaihtaa - zmieniać, zamieniać, wymieniać
vaihto - zamiana, wymiana, zbyt, obrót, przesiadka
vaihtoehto - alternatywa, opcja, wybór
vaihtoehtoinen - alternatywny
väijyntä - zasadzka
väijytys - zasadzka
vaikea - trudny, skomplikowany, ciężki
vaikeus - trudność
vaikka - chociaż, choć, przykładowo
vaikute - wpływ
vaimo - żona
vain - tylko
vainaja - trup, nieboszczyk
vaino - prześladowanie
vaisto - instynkt, popęd
vaiti - cicho
vaja - chata
vaje - deficyt
vakaa - stabilny, pewny
vakaasti - stabilnie, niezmiennie
vakava - poważny
vakavasti - poważnie
väki - ludność, lud
vakoilija - szpieg
vakooja - szpieg
vakuumi - próżnia
vala - przysięga
valaisin - lampa, lampka
valaista - oświecać, oświecić
valas - wieloryb
valehdella - kłamać
valehtelija - kłamca
valhe - kłamstwo
välillinen - pośredni
Välimeri - Morze Śródziemne
valintamyymälä - supermarket
välipala - przekąska
välissä - między, pomiędzy
välistä - niekiedy
valita - wybierać
valitettavasti - niestety
välittömästi - natychmiast
valjaat - uprząż
valkea - biały
valkeahko - białawy
valkoinen - biały
valkoisuus - biel
valkopäätiainen - sikora lazurowa
valkoposkihanhi - bernikla białolica
valkoselkätikka - dzięcioł białogrzbiety
valkosipuli - czosnek
valkosolu - krwinka biała, leukocyt
valkovenäjä - język białoruski
Valko-Venäjä - Białoruś
valkoviklo - brodziec kwokacz, kwokacz
valkuaisaine - białko
vallankumous - rewolucja
vallinsarvi - bastion
valloitus - podbój
valmis - gotowy
valmistaja - producent
valmistelu - przygotowanie
valo - światło
valokuva - fotografia, zdjęcie
valokuvaaja - fotograf
valokuvaus - fotografowanie, fotografia
valonnopeus - prędkość światła
valovuosi - rok świetlny
valpas - czujny, uważny
valta - władza, prawo
valtaistuin - tron
valtakunta - państwo, kraj
valtameri - ocean
valtimo - tętnica
valtio - państwo
valurauta - żeliwo
valuutta - waluta
vampyyri - wampir
vanadiini - wanad
vandaali - wandal
vandalismi - wandalizm
vanha - stary
vanheta - starzeć się
vanhus - stary człowiek
vanhuus - wiek, podeszły wiek
vanilja - wanilia
vankeus - uwięzienie, niewola
vanki - więzień
vankila - więzienie
vankityrmä - loch
vantti - wanta
Vanuatu - Vanuatu
vapaa - wolny, swobodny
vapaaehtoisesti - dobrowolnie
vapaaherra - baron
vapaamielinen - liberalny
vapaus - wolność, swoboda
varaani - waran
värähtely - wibracja
vararikko - bankructwo
varas - złodziej
varastaa - kraść
varhain - wcześnie
varhainen - wczesny
väri - kolor, barwa
variksenpelätin - strach na wróble
varis - wrona
värisokeus - daltonizm
varjo - cień
varjokuva - sylwetka
varkaus - kradzież
varma - pewny
varmasti - na pewno
varoitus - ostrzeżenie
varoke - bezpiecznik
varokeino - środek ostrożności
varotoimenpide - środek ostrożności
varotoimi - środek ostrożności
varovaisuus - ostrożność
varpunen - wróbel
varpushaukka - krogulec
varpuspöllö - sóweczka
varsa - źrebię
varsijousi - kusza
Varsova - Warszawa
vartalo - ciało człowieka, sylwetka
varten - w celu, dla
vartija - strażnik
vartti - kwadrans
varuskunta - garnizon
varvas - palec u nogi
vasalli - wasal
vasara - młotek
vasarapäähaikara - waruga
vasektomia - wazektomia
vasen - lewy
vasikanliha - cielęcina
vasikka - cielę
vaski - miedź
vaskitsa - padalec
vasta-aine - antyciało
vastaavanlainen - podobny
vastaavasti - odpowiednio
vastalääke - antidotum
vastapooli - antyteza
västäräkki - pliszka siwa
vastata - odpowiadać
vastaus - odpowiedź
vaste - reakcja
vastuuton - nieodpowiedzialny
vasu - kosz
väsyä - zmęczyć się, znurzyć się
väsynyt - zmęczony
vati - misa, półmisek, miednica
Vatikaan - Watykan (państwo)
Vatikaani - Watykan
Vatikaanikaupunki - Państwo Watykańskie
vatsa - brzuch
vaunu - wagon
vauva - niemowlę, dziecko
vävy - zięć
vävypoika - zięć
vedekäs - wodnisty
vegaani - weganin
vegaaninen - wegański
veganismi - weganizm
vegetaarinen - wegetariański
vegetaristinen - wegetariański
vehnä - pszenica
Veiksel - Wisła
veitsi - nóż
veksillologia - weksylologia
velho - czarodziej
veli - brat
velipuoli - brat przyrodni
veljes - brat
velka - dług
venäjä - język rosyjski
Venäjä - Rosja
Venäjän federaatio - Federacja Rosyjska
venäläinen - Rosjanin, rosyjski
vene - łódź
Venetsia - Wenecja
Venezuela - Wenezuela
veranta - weranda
verbi - czasownik
verevä - świeży
verho - zasłona, zasłonka
veri - krew
verifikaatio - weryfikacja
verifikaatti - weryfikacja
verijuotikas - pijawka lekarska
verivirtsaisuus - hematuria, krwiomocz
verkkaan - powoli
verkko - sieć, siatka
verkosto - sieć
vermutti - wermut
vero - podatek
versio - wersja
versoa - kiełkować
verstas - warsztat
vertailu - porównanie
vertailukelpoinen - porównywalny
vertauskuva - alegoria
vertikaali - pionowy
vertikaalinen - pionowy
veruke - pretekst
vesi - woda
vesihana - kran
vesihiihto - narciarstwo wodne
vesimeloni - arbuz
vesinokkaeläin - dziobak
vesipääsky - płatkonóg szydłodzioby, ptak z rodzaju
vesiputous - wodospad
vesisade - deszcz
vesitorni - wieża ciśnień
vesivaaka - poziomica, waserwaga
vesivoimala - elektrownia wodna
vetää - ciągnąć
veteraani - weteran
vetinen - wodnisty
vetopeli - akordeon
vetovoimainen - atrakcyjny
veturi - lokomotywa
vety - wodór
viallinen - wadliwy, ułomny, popsuty, uszkodzony
viattomuus - niewinność
vibraatio - wibracja
viehkeästi - wdzięcznie
viekas - przebiegły, chytry
viemäri - ściek, kanał
Vienanmeri - Morze Białe
vieraanvarainen - gościnny
vieraanvaraisuus - gościnność
vierailija - gość
vieras - obcy, nieznany, gość
viereinen - sąsiedni
vierinkivi - głaz
viesti - wiadomość, wieść, komunikat, sztafeta
viestintä - komunikacja
Vietnam - Wietnam
viha - nienawiść, gniew, złość
vihainen - zły, rozgniewany
vihamielinen - wrogi
vihannes - warzywo, jarzyna
vihata - nienawidzić
vihdoin - w końcu, nareszcie
vihellys - gwizdek
viherpeippo - dzwoniec
vihertikka - dzięcioł zielony
vihervarpunen - czyż
vihko - zeszyt
vihma - mżawka, drobny deszcz
vihollinen - wróg, wrogi
vihreä - zielony
vihta - wiązka gałązek brzozowych, którą smaga się ciało w saunie
vihuri - wichura, porywisty wiatr
viidakko - zarośla, gąszcz, dżungla, busz
viidakkoveitsi - maczeta
viides - piąty
viihde - rozrywka
viihdyke - hobby
viihdyttää - zabawiać, dostarczać rozrywki
viikate - kosa
viikko - tydzień
viikonloppu - weekend, koniec tygodnia
viikonvaihde - weekend
viiksi - wąs
viikuna - figa, figowiec, drzewo figowe
viikunanlehti - listek figowy
viikunapuu - figowiec, drzewo figowe
viimein - w końcu
viimeinen - ostatni
viimeinkin - w końcu
viime yönä - zeszłej nocy
viina - wódka, alkohol po destylacji - np. też tequila, grappa
viini - wino
viinirypäle - winogrono
Viipuri - Wyborg
viiriäinen - przepiórka
viirupöllö - puszczyk uralski
viisas - mądry
viisaus - mądrość
viisi - pięć (cyfra)
viisikulmio - pięciokąt
viisikymmentä - pięćdziesiąt
viisikymmentäkahdeksan - pięćdziesiąt osiem, 58
viisikymmentäkaksi - pięćdziesiąt dwa, 52
viisikymmentäkolme - pięćdziesiąt trzy, 53
viisikymmentäkuusi - pięćdziesiąt sześć, 56
viisikymmentäneljä - pięćdziesiąt cztery, 54
viisikymmentäseitsemän - pięćdziesiąt siedem, 57
viisikymmentäviisi - pięćdziesiąt pięć, 55
viisikymmentäyhdeksän - pięćdziesiąt dziewięć, 59
viisikymmentäyksi - pięćdziesiąt jeden, 51
viisitoista - piętnaście (liczba)
viita - gaj, zagajnik, lasek
viitatiainen - sikora uboga
viitonen - piątka
viiva - linia
vika - błąd, pomyłka, wada, uszkodzenie
vikkelästi - szybko
viklo - brodziec
vilistäjä - barglik
vilja - zboże
viljelijä - rolnik
viljelmä - plantacja, kultura
villa - wełna
villi - dziki
vino - krzywy, skośny, pochyły
vintti - strych
violetti - fioletowy (kolor)
vipu - dźwignia, dźwig, winda
vipuvarsi - dźwignia
Viracocha - Wirakocza
virallinen - oficjalny
virallisesti - oficjalnie
virhe - pomyłka, błąd, wada
viriili - męski
virike - bodziec, zachęta
virka-asu - mundur
virkamies - urzędnik
virke - zdanie, fraza, wyrażenie
viro - język estoński
Viro - Estonia
virolainen - estoński
virta - rzeka, potok, strumień, prąd
virta-alli - kamieniuszka
virtahepo - hipopotam
virtamittari - amperomierz
virtavästäräkki - pliszka górska
virtsa - mocz
virtsarakko - pęcherz moczowy
virtsata - oddawać mocz
virus - wirus
visentti - żubr
viski - whisky
viskoosinen - lepki
viskoottinen - lepki
viskositeetti - lepkość
vismutti - bizmut
visuaalinen - wizualny
visusti - blisko
visva - ropa
vitriini - gablota
vittu - pizda, kurwa!
viulu - skrzypce
vivahdus - odcień, zabarwienie
vodka - wódka
voi - masło
voida - móc, potrafić
voikukka - mniszek, mniszek lekarski, mlecz
voima - moc, siła
voimakas - silny, mocny
voimala - elektrownia, elektrociepłownia, siłownia
voimallinen - mocny
vointi - stan zdrowia, samopoczucie
voisarvi - rogalik
voitokas - zwycięski
voitollinen - zwycięski, korzystny
voittaa - wygrać
voittaja - zwycięzca
voitto - zwycięstwo, zysk, profit
voittoisa - zwycięski
vokaali - samogłoska
volframi - wolfram
voltti - wolt
volttimittari - woltomierz
voro - złodziej, złodziejaszek
votka - wódka
vrk - doba
vulkaani - wulkan
vulkaaninen - wulkaniczny
vuode - łóżko
vuodenaika - pora roku
vuohi - koza
vuokko - zawilec
vuokra - dzierżawa, wynajem
vuono - fiord
vuori - góra
vuorihemppo - rzepołuch
vuorikirvinen - siwerniak
vuoristo - łańcuch górski
vuoristoinen - górzysty
vuorokausi - doba
vuorovaikutus - interakcja
vuosi - rok
vuosituhat - tysiąclecie, millenium
vuoto - wyciek
vyö - pas, pasek
vyöhyke - strefa
vyörymä - osuwisko
vyötiäinen - pancernik
Wales - Walia
wc-paperi - papier toaletowy
Wien - Wiedeń (stolica Austrii)
Wikipedia - Wikipedia
Wikisanakirja - Wikisłownik
ydin - jądro, szpik, rdzeń, sedno
ydinase - broń jądrowa, broń atomowa
ydinfysiikka - fizyka jądrowa
ydinvoimala - elektrownia atomowa
yhdeksän - dziewięć (cyfra)
yhdeksänkymmentä - dziewięćdziesiąt
yhdeksänkymmentäkahdeksan - dziewięćdziesiąt osiem, 98
yhdeksänkymmentäkaksi - dziewięćdziesiąt dwa, 92
yhdeksänkymmentäkolme - dziewięćdziesiąt trzy, 93
yhdeksänkymmentäkuusi - dziewięćdziesiąt sześć, 96
yhdeksänkymmentäneljä - dziewięćdziesiąt cztery, 94
yhdeksänkymmentäseitsemän - dziewięćdziesiąt siedem, 97
yhdeksänkymmentäviisi - dziewięćdziesiąt pięć, 95
yhdeksänkymmentäyhdeksän - dziewięćdziesiąt dziewięć, 99
yhdeksänkymmentäyksi - dziewięćdziesiąt jeden, 91
yhdeksäntoista - dziewiętnaście (liczba)
yhdeksäs - dziewiąty
yhdeksikkö - dziewiątka
yhdenvertaisuus - równość
yhdestoista - jedenasty
yhdistää - łączyć, połączyć, jednoczyć, zjednoczyć, anektować
Yhdistyneet arabiemiirikunnat - Zjednoczone Emiraty Arabskie
Yhdistynyt kuningaskunta - Zjednoczone Królestwo
Yhdysvallat - Stany Zjednoczone, USA
yhtä - jednakowo, tak samo, podobnie, równie, identycznie
yhtäjaksoisesti - bezustannie
yhtäkkiä - nagle, nieoczekiwanie, wtem
yhtäkkinen - nagły
yhtälö - równanie
yhtäpitävä - równoważny
yhteensattuma - zbieg okoliczności
yhteentörmäys - kolizja
yhteiskunta - społeczeństwo
yhteys - związek, kontakt, obcowanie, łączność, komunikacja, połączenie, wspólnota, jedność
yhtye - zespół muzyczny, kapela, band
YK - ONZ, Organizacja Narodów Zjednoczonych
ykkönen - jedynka
yksi - jeden (cyfra), jeden z
yksiavioisuus - monogamia
yksijumalaisuus - monoteizm
yksijumalisuus - monoteizm
yksikkö - jednostka, liczba pojedyncza
yksilö - jednostka
yksilöllisesti - indywidualnie
yksimielinen - jednomyślny
yksimielisyys - jednomyślność
yksin - sam
yksinäinen - samotny
yksinäisyys - samotność
yksinvalta - autokracja
yksinvaltius - autokracja
yksisarvinen - jednorożec
yksitoista - jedenaście (liczba)
yksituumainen - jednomyślny
yksityinen - prywatny, osobisty
yksityiskohta - szczegół
yksityisyys - prywatność
ylänkö - wyżyna, płaskowyż
yläraaja - kończyna górna, kończyna przednia
yleinen - pospolity
yleisnäkymä - panorama
yleisurheilu - lekkoatletyka
ylellisyys - luksus
ylenmääräinen - nadmierny
yletön - nadmierny
ylettömästi - nadmiernie
ylijäämä - nadmiar
ylimystö - arystokracja
yliopisto - uniwersytet
yliopistollinen - akademicki
ylite - nadmiar
ylkä - pan młody
ylpeä - dumny, pyszny, butny, zarozumiały
ylpeästi - dumnie
ylpeys - duma, pycha, buta, zarozumiałość
yltäkylläinen - obfity
yltäkylläisyys - obfitość
ymmärrys - zrozumienie
ymmärtää - rozumieć, zrozumieć, pojmować, pojąć
ympärileikkaus - obrzezanie
ympäristö - otoczenie, środowisko
ympärivuotinen - całoroczny
ympyrä - okrąg
yö - noc
yöhaikara - ślepowron
yöperhonen - ćma, nocny motyl
yrittää - próbować
yrittäjä - biznesmen, przedsiębiorca
yritys - próba
yrtti - zioło, roślina zielna, marihuana
-ys - -uus
yskä - kaszel
yskiä - kaszleć
yskös - flegma, plwocina
ystävä - przyjaciel, przyjaciółka
ystävällinen - przyjazny
ystävällisyys - przyjacielskość
ystävyys - przyjaźń
ytterbium - iterb
yttrium - itr
-yys - -uus
zen - zen
zeniitti - zenit
Zimbabwe - Zimbabwe
zirkonium - cyrkon
zodiakki - zodiak
zombi - zombi
zoofobia - zoofobia
zoolatria - zoolatria
zoologi - zoolog
zoologinen - zoologiczny
zooni - strefa
