ა - pierwsza litera alfabetu gruzińskiego
ააოხრებს - zdewastuje | zrujnuje
აბაზანა - wanna | łazienka
აბანოზი - heban
აბანოს ჭია - karaluch
აბაჟური - klosz
აბასიოფილია - abasiofilia
აბატი - opat
აბდაუბდა - nonsens
აბზაცი - paragraf
აბი - pigułka | tabletka
აბლაბუდა - pajęcza sieć
აბრევიატურა - skrót
აბრეშუმა - kanianka
აბრეშუმი - jedwab
აბსტრაქტული - abstrakcyjny
აბსურდული - absurdalny
აბსურდულობა - absurd
აბჯარი - zbroja
აგვისტო - sierpień
აგიტატორი - agitator
აგნოსტიციზმი - agnostycyzm
აგონია - agonia
აგრესია - agresja
აგრესორი - agresor | napastnik
ადამიანი - człowiek | istota ludzka | osoba
ადამიანური - ludzki
ადაპტაცია - adaptacja
ადგილას - w miejscu
ადგილი - miejsce
ადეკვატური - adekwatny
ადვილი - łatwy
ადვოკატი - prawnik
ადიულტერი - zdrada małżeńska | cudzołóstwo
ადმირალი - admirał | rusałka admirał
ადრე - wcześnie | wcześniej | w przeszłości
ადრესატი - adresat
ადრეული - wczesny
ადრიანი - wczesny
აეროპორტი - lotnisko
აეროსტატი - balon
ავად - zgryźliwie | opryskliwie
ავადმყოფი - chory
ავადმყოფობა - choroba
ავაზაკი - gangster | złodziej | bandyta
ავიაცია - lotnictwo
ავიახაზი - linie lotnicze (przedsiębiorstwo)
ავოკადო - awokado
ავსტრალია - Australia
ავსტრალიური - australijski
ავსტრია - Austria
ავსტრიული - austriacki
ავტობუსი - autobus
ავტოგრაფი - autograf
ავტომატურად - automatycznie
ავტონომია - autonomia
ავტონომიური - autonomiczny
ავტორი - autor
ავტოსადგომი - garaż
ავღანეთი - Afganistan
აზერბაიჯანი - Azerbejdżan
აზია - Azja
აზნი - szlachcic
აზოტი - azot
აზრი - opinia | zdanie
ათასი - tysiąc
ათასწლეული - tysiąclecie | millenium
ათეიზმი - ateizm
ათეისტი - ateista
ათენი - Ateny
ათი - dziesięć
აი - tu | tam
აივანი - balkon
აისი - wschód Słońca
აკადემია - akademia
აკადემიკოსი - akademik
აკაზმულობა - uprząż
აკვანი - kołyska
აკვედუკი - akwedukt
აკლდამა - grób
აკორდეონი - akordeon
აკრგძალული - zakazany | zabroniony
აკრძალული - zakazany
აკუთა - piec
აკუმულატორი - akumulator
ალალმართლად - naprawdę
ალამი - flaga
ალაო - słód
ალაჰი - Allah
ალბათ - chyba | prawdopodobnie
ალბანეთი - Albania
ალბატროსი - albatros
ალბინოსი - albinos
ალგებრა - algebra
ალებასტრი - alabaster
ალეგორია - alegoria
ალერგია - alergia
ალერგიული - alergiczny
ალი - płomień
ალიგატორი - aligator
ალიზი - cegła
ალიტერაცია - aliteracja
ალკოჰოლი - alkohol
ალკოჰოლიანი - alkoholowy
ალმანახი - almanach
ალჟირი - Algeria
ალტერნატივა - alternatywa
ალტერნატიული - alternatywny
ალტიმეტრი - wysokościomierz
ალტრუიზმი - altruizm
ალუბალი - wiśnia | wiśnia pospolita
ალუმინი - glin
ალქიმია - alchemia
ალქიმიკოსი - alchemik
ამას წინათ - niedawno | przedtem
ამაყად - dumnie
ამბავი - wiadomość | informacja | historia
ამბარჩა - naszyjnik
ამბიცია - ambicja
ამდენი - tak dużo | tak wiele
ამება - ameba
ამეთვისტო - ametyst
ამერიკა - Ameryka
ამერიკული - amerykański
ამიაკი - amoniak
ამიერკავკასია - Zakaukazie
ამინდი - pogoda
ამირბარი - admirał
ამიტომ - dlatego
ამნეზია - amnezja
ამნისტია - amnestia
ამორჩევა - wybierać
ამპერი - amper
ამპერმეტრი - amperomierz
ამპუტაცია - amputacja
ამჟამად - obecnie
ამსტერდამი - Amsterdam
ამულეტი - amulet
ამფითეატრი - amfiteatr
ამფორა - amfora
ამხანაგი - towarzysz
ან - lub
ანაკონდა - anakonda
ანალიზი - analiza
ანალოგია - analogia
ანალოგიური - analogiczny
ანალური - analny
ანანასი - ananas
ანარქია - anarchia
ანარქიზმი - anarchizm
ანარქისტი - anarchista
ანატომია - anatomia
ანბანი - alfabet
ანგარიში - rachunek
ანგარიშმიუცემლად - ślepo
ანგელოზი - anioł
ანგოლა - Angola
ანდაზა - przysłowie
ანდორა - Andora
ანეკდოტი - anegdota
ანთოლოგია - antologia
ანთროპოლოგი - antropolog
ანისული - anyż
ანომალია - anomalia
ანონიმური - anonimowy
ანტიბიოტიკი - antybiotyk
ანტიკურობა - starożytność
ანტილოპა - antylopa
ანტისხეული - antyciało
ანტონიმი - antonim
ანუ - tak więc
ანძა - maszt
ანჯამა - zawias
აორტა - aorta
აპათიური - apatyczny
აპლოდისმენტი - oklaski | aplauz
აპნისი - styczeń
აპოკალიფსი - apokalipsa
აპოკრიფული - apokryficzny
აპრილი - kwiecień
არ - nie
არა - nie
არაბეთის გაერთიანებული საამიროები - Zjednoczone Emiraty Arabskie
არაბი - Arab
არაბული - arabski
არავითარი - żaden (rodzaj)
არავინ - nikt
არათანაბარი - nierówny
არაკი - bajka
არამეგობრული - wrogi
არამედ - przeciwnie | ale raczej
არაორგანული - nieorganiczny
არაპირდაპირად - pośrednio
არაპირდაპირი - pośredni
არასდროს - nigdy
არასოდეს - nigdy
არასრული - niekompletny
არაფერი - nic
არაქისი - orzech ziemny
არაყი - wódka
არაჩვეულებრივი - wspaniały
არაწესიერი - pozbawiony skrupułów
არგენტინა - Argentyna
არდადეგები - wakacje
არდი - teraz
არენა - arena
არეულდარეულობა - nieporządek
არია - aria
არითმეტიკა - arytmetyka
არისტოკრატია - arystokracja
არისტოტელე - Arystoteles | Arystoteles (imię)
არსად - nigdzie
არსებითი სახელი - rzeczownik
არსებობს - istnieje
არტერია - arteria
არტისტული - artystyczny
არტიშოკი - karczoch
არფა - harfa
არქაული - archaiczny
არქიპელაგი - archipelag
არქიტექტორი - architekt
არქიტექტურა - architektura
არჩევს - wybierać
არც… არც - ani… ani…
არწივი - orzeł
არხალუხი - archałuk
ასაკოვანი - starszy
ასე - tak | w ten sposób
ასეთი - taki
ასექსუალობა - aseksualność
ასთმა - astma
ასი - sto
ასიმილაცია - asymilacja
ასისტენტი - asystent
ასპირინი - aspiryna
ასტანა - Astana
ასტეროიდი - asteroida
ასტროლოგია - astrologia
ასტრონომი - astronom
ასტრონომია - astronomia
ასტრონომიული - astronomiczny
ასტროფიზიკა - astrofizyka
ასული - córka
ატამი - brzoskwinia
ატმოსფერული - atmosferyczny
ატოლი - atol
ატომი - atom
ატომური - atomowy
ატროფია - atrofia
აუცილებლად - niechybnie | koniecznie
აფთარი - hiena
აფორიზმი - aforyzm | sentencja
აფრა - żagiel
აფრიკა - Afryka
აფრიკული - afrykański
აფხაზეთი - Abchazja
აფხაზი - Abchaz
აქ - tutaj
აქამდის - do tej pory | dotychczas | dotąd
აქატი - agat
აქლემი - wielbłąd
აქსიომა - aksjomat
აქტივაცია - aktywacja
აქცენტი - akcent
აღარაფერი - już nic
აღდგომა - Wielkanoc
აღზრდის - wychowa
აღმაშენებელი - budowniczy
აღმოსავლეთი - wschód
აღნიშნავს - znaczy
აღწერითი - opisowy
აშკარა - oczywisty
აჩრდილი - cień
აჭარა - Adżaria
აჭარელი - Adżaryjczyk
აჭმევს - nakarmi
ახალგაზრდა - młody | młody człowiek
ახალგაზრდობა - młodość
ახალი - nowy
ახლა - teraz
ახლანდელი - teraźniejszy | obecny
ახლო - bliski | niedaleki
ახლოს - niedaleko
ახსნა-განმარტება - wyjaśnienie
ახსნა–განმარტები - wyjaśnienie
ახსნია - rozwiązać | wyjaśnić
ბ - druga litera alfabetu gruzińskiego
ბაბთა - wstążka
ბაბუა - dziadek
ბადე - sieć
ბადრიჯანი - bakłażan
ბავშვი - dziecko
ბავშვობა - dzieciństwo
ბაზალტი - bazalt
ბაზარი - rynek | bazar
ბაზი - sokół
ბაზისი - podstawa
ბაზმაკი - lampa
ბაირაღი - flaga
ბალახი - trawa
ბალეტი - balet
ბალი - czereśnia
ბალიში - poduszka
ბალონი - balon
ბამბა - bawełna
ბამბუკი - bambus
ბანანი - banan
ბანგლადეში - Bangladesz
ბანკეტი - bankiet
ბარათი - kartka pocztowa
ბარბადოსი - Barbados
ბარბაროსი - barbarzyńca
ბარგი - bagaż
ბარიკადა - barykada
ბარიუმი - bar
ბარონესა - baronowa
ბარონი - baron
ბასტიონი - bastion
ბატალიონი - batalion
ბატარეა - bateria
ბატატი - wilec ziemniaczany | batat | patat | słodki ziemniak
ბატი - gęś
ბატონი - dżentelmen
ბაღი - ogród | sad
ბაღია - ogród
ბაყაყი - żaba
ბგერა - dźwięk
ბებერა - pęcherz | bąbel
ბებია - babcia
ბებო - babcia
ბედი - los
ბედნიერება - szczęście
ბედნიერი - szczęśliwy
ბედურა - wróbel
ბედშავი - nieszczęśliwy | pechowy
ბევრი - dużo | wiele
ბეისბოლი - baseball
ბელარუსი - Białoruś
ბელგია - Belgia
ბელგიური - belgijski
ბელგრადი - Belgrad
ბენგალური - bengalski
ბენინი - Benin
ბერი - mnich
ბერილიუმი - beryl
ბერლინი - Berlin
ბერძენი - Grek | Greczynka
ბერძნული - język grecki
ბეღურა - wróbel
ბეჯითი - pilny
ბზიკი - osa
ბიბლია - Biblia | Pismo Święte
ბიბლიოთეკა - biblioteka
ბივრილი - beryl
ბიზნესმენი - przedsiębiorca
ბიზონი - bizon
ბილეთი - bilet
ბინა - mieszkanie
ბინაა - mieszkanie
ბინდი - zmierzch
ბინძური - brudny
ბიოგრაფი - biograf
ბიოგრაფია - biografia
ბიოლოგი - biolog
ბიოლოგია - biologia
ბიოლოგიური - biologiczny
ბიოქიმია - biochemia
ბირთვული - jądrowy | nuklearny
ბისექსუალობა - biseksualizm
ბისექსუალური - biseksualny
ბიუროკრატი - biurokrata
ბიუჯეტი - budżet
ბიძა - wujek
ბიძაშვილი - kuzyn
ბიჭი - chłopiec
ბლოკადა - blokada
ბნელი - ciemny | mroczny
ბოდიში - przepraszam
ბოზი - dziwka | prostytutka
ბოთლი - butelka
ბოთლის გასახსნელი - otwieracz do butelek
ბოიკოტი - bojkot
ბოლი - dym
ბოლო - ostatni
ბორა - pagórek
ბორბალი - koło
ბორკილი - kajdany | okowy
ბოროტი - zły | zepsuty
ბოსნია და ჰერცეგოვინა - Bośnia i Hercegowina
ბოსტნეული - jarzyny
ბოტანიკა - botanika
ბოქლომი - kłódka
ბოცვერი - królik
ბრა - nawias
ბრაზილია - Brazylia
ბრაზილიური - brazylijski
ბრალდება - oskarżenie
ბრინჯაო - brąz
ბრინჯი - ryż
ბრიტანეთი - Brytania
ბრიტანული - brytyjski
ბრმა - ślepy
ბროკოლი - brokuł
ბრომი - brom
ბროში - broszka
ბროწეული - granat
ბრტყელი - płaski
ბრუნვა - przypadek
ბრძოლა - bitwa
ბრწყინვალე - błyszczący | wybitny
ბრჭყალი - pazur
ბუ - sowa
ბუდაპეშტი - Budapeszt
ბუდე - gniazdo
ბუდიზმი - buddyzm
ბუკი - trąbka
ბულბული - słowik
ბულგარეთი - Bułgaria
ბულგარული - bułgarski
ბულდოზერი - buldożer
ბუმბული - pióro
ბუმერანგი - bumerang
ბუნება - przyroda | natura
ბუნებრივად - naturalnie
ბუნიობა - równonoc
ბურთი - piłka
ბუქარესტი - Bukareszt
ბუჩქი - krzak
ბუხჰალტერი - księgowy
გ - trzecia litera alfabetu gruzińskiego
გააგრძელებს - będzie kontynuował | dokończy
გააერთიანებს - zjednoczy
გაათავებს - skończy
გააღებს - otworzy
გაგება - rozumieć
გაგზავნის - wyśle
გადათარგმნის - przetłumaczy
გადაიხდის - zapłaci
გადასახადი - podatek
გადაწყვეტა - rozwiązanie
გადაწყვეტილება - decyzja
გადახდილი - płatny
გაერთიანება - zjednoczenie | unifikacja
გაერთიანებული სამეფო - Zjednoczone Królestwo
გავლენა - wpływ
გაზაფხული - wiosna
გაზეთი - gazeta
გაზომვა - mierzyć
გაზრდის - wyhoduje | wyrośnie
გათენება - świt
გაიგებს - zrozumie | od იგებს | dowie się
გაიგონებს - usłyszy
გაიჭრის - skaleczy się
გაკვეთილი - lekcja
გალაქტიკა - galaktyka
გამარჯვება - zwycięstwo
გამარჯობა - cześć | dzień dobry
გამო - z powodu | ze względu na
გამოაღვიძებს - obudzi
გამოგონება - wynalazek
გამოთქმა - wymowa
გამოკეტვა - zamknąć na klucz
გამომგონებელი - wynalazca
გამომქვეყნებელი - wydawca
გამომცემლობა - wydawnictwo
გამონაშვერი - szef
გამოუცნობი - enigmatyczny
გამოფენა - eksponat
გამოქვაბული - jaskinia
გამოცდა - egzamin
გამუდმებით - ciągle
გამყიდველი - sprzedawca
გამხდარი - chudy | szczupły
განათლება - edukacja | kształcenie
განვითარება - rozwój | kształcenie
განზე - na bok
განზომილება - wymiar
განიერი - szeroki
განიხილავს - zbada | omówi
განმავლობაში - podczas | w trakcie
განსაკუთრებით - zwłaszcza | szczególnie
განტევების ვაცი - kozioł ofiarny
განუწყვეტლად - bezustannie
განცალკევებით - osobno
განხილვა - dyskusja
გარაჟი - garaż
გარდა - poza | z wyjątkiem | oprócz
გარეთ - na zewnątrz
გარემო - środowisko
გარემოება - okoliczność
გარკვევით - zdecydowanie | bez wątpienia
გარკვეული - jasny | wyraźny | pewien
გარნიზონი - garnizon
გასასვლელი - wyjście
გასაღები - klucz
გასული - ostatni
გაფრენა - lot
გაფუფუნებული - luksusowy
გაყიდვა - sprzedawać
გაყოფადი - podzielny
გაცილებით - daleko
გახდება - stanie się | przekształci się
გედი - łabędź
გემი - statek
გემო - smak
გემრიელი - pyszny
გენერალი - generał
გენერატორი - prądnica
გენეტიკა - genetyka
გენეტიკური - genetyczny
გენი - gen
გენოციდი - ludobójstwo
გეოგრაფი - geograf
გეოგრაფია - geografia
გეოლოგი - geolog
გეოლოგია - geologia
გეომეტრია - geometria
გერმანელი - niemiecki
გერმანია - Niemcy
გერმანული - niemiecki
გესლი - trucizna
გვალვა - susza
გვარლი - sznur | lina
გვატემალა - Gwatemala
გველი - wąż
გვიან - późno
გვიმრა - paproć
გვინეა - Gwinea
გვირგვინი - korona
გვირილა - rumianek
გზა - droga
გზატკეცილი - autostrada
გთხოვ - proszę
გიბრალტარი - Gibraltar
გიგანტური - gigantyczny
გილდია - cech
გიჟი - szaleniec | wariat
გიტარა - gitara
გლადიატორი - gladiator
გლეხი - chłop | wieśniak
გლობალური - globalny
გლობალური დათბობა - globalne ocieplenie
გმირი - bohater
გმირული - bohaterski
გნომი - gnom
გოგირდი - siarka
გოგო - dziewczyna
გოგონა - dziewczyna | alternatywna pisownia słowa გოგო
გოგრა - dynia
გოდორი - kosz
გოლფი - golf
გომბეშო - ropucha
გონება - rozum
გორა - pagórek
გორილა - goryl
გრამატიკა - gramatyka
გრამატიკოსი - gramatyk
გრამატიკულად - gramatycznie
გრამატიკული - gramatyczny
გრანიტი - granit
გრაციოზულად - wdzięcznie
გრდემლი - kowadło
გრილი - chłodny
გროტესკული - groteskowy
გრძელი - długi
გრძნეული - wiedźma
გრძნობა - wyczucie | uczucie
გუგული - kukułka
გუთანი - pług
გუთური - gocki
გული - serce
გულმოდგინე - zagorzały
გუმანი - podejrzenie
გუნდი - zespół | drużyna
გუშინ - wczoraj
გუშინდელი - wczorajszy
გუშინწინ - przedwczoraj
დ - czwarta litera alfabetu gruzińskiego
და - siostra | i
დააარსებს - założy | powoła
დააგრძელებს - przedłuży
დაავადება - choroba
დაავიწყება - zapomni
დაანთებს - zapali
დაახასიათებს - scharakteryzuje | opisze
დაახლოებით - w przybliżeniu
დაბოლოება - w końcu
დადგება - wstaje
დადება - położyć
დაეხმარება - pomoże
დაზღვევა - ubezpieczenie
დათესავს - zasieje
დათვი - niedźwiedź
დაიგვიანებს - spóźni się
დაივიწყებს - zapomni
დაიკო - siostra
დაინახავს - zobaczy
დაინტერესება - interesować się
დაიწყება - zaczyna się
დალაგება - sprzątanie
დალაქი - fryzjer
დამასკო - Damaszek
დამლაშება - przesolić
დამნაშავე - przestępca
დამნგრევი - destrukcyjny
დამოუკიდებელ სახელმწიფოთა თანამეგობრობა - Wspólnota Niepodległych Państw
დამოუკიდებლად - niezależnie
დამოწმებული - poświadczony
დამქანცველი - pracochłonny | żmudny
დამწერლობა - skrypt
დანა - nóż
დანაკი - nóż
დანაშაული - przestępstwo
დანდალუკი - żółtaczka
დანია - Dania
დანიური - duński
დარგი - gałąź
დარიშხანა - arsen
დასავლეთი - zachód
დასვრილი - brudny
დასიზმრება - śnić
დასტაქარი - chirurg
დასჭირდება - będzie potrzebować
დაუვიწყარი - niezapomniany
დაუძახებს - nazywać
დაფა - tablica
დაქანცულობა - wyczerpanie
დაშნა - miecz
დაცულობა - bezpieczeństwo
დაწერს - napisze
დაწესებულება - instytucja
დაჭრის - zrani | potnie
დახატავს - namaluje
დახვდება - spotka się
დახურული - zamknięty
დაჯახება - kolizja
დაჯდება - usiądzie
დგომა - stać
დგუში - tłok
დედა - matka | mama
დედაკაცი - kobieta
დედამთილი - teściowa
დედამიწა - Ziemia -
დედაქალაქი - stolica
დედინაცვალი - macocha
დედოფალი - królowa
დევიზი - motto
დეზერტირობა - dezercja
დეიდა - ciotka
დეიზმი - deizm
დეკემბერი - grudzień
დელფინი - delfin
დემაგოგი - demagog
დემოგრაფია - demografia
დემოკრატი - demokrata
დემოკრატია - demokracja
დემოკრატიული - demokratyczny
დერეფანი - korytarz
დერმატოლოგია - dermatologia
დეფექტი - defekt | wada
დეფისი - dywiz
დვრილი - sutek
დიაბეტი - cukrzyca
დიაგნოზი - diagnoza
დიაგრამა - diagram
დიალექტი - dialekt
დიამეტრი - średnica
დიახ - tak
დიდებული - majestatyczny
დიდი - duży | wielki
დიდი ბრიტანეთი - Wielka Brytania
დიდსულოვნება - hojność | szczodrość
დიდძალი - liczny
დიდხანს - od dawna | dawno
დივანი - sofa | kanapa
დიზენტერია - dyzenteria | czerwonka
დილა - rano | ranek | poranek
დილა მშვიდობისა - dzień dobry
დილეგი - loch
დილემა - dylemat
დინამიკური - dynamiczny
დინამიტი - dynamit
დინასტია - dynastia
დინგი - ryj
დიპლომატია - dyplomacja
დიპლომატიური - dyplomatyczny
დიპლომი - dyplom
დისკუსია - dyskusja
დიუნი - wydma | diuna
დიფუზიური - rozproszony
დიქტატურა - dyktatura
დო - maślanka
დოგმა - dogmat
დოზა - dawka
დოკუმენტაცია - dokumentacja
დოკუმენტი - dokument
დოლაბი - kamień młyński
დოლარი - dolar
დოლი - bęben
დოქტრინა - doktryna
დრაკონი - smok
დრამა - dramat
დრო - czas
დროებით - na razie
დროს - podczas | w czasie
დროსტარება - hobby
დროშა - flaga
დუელი - pojedynek
დუმილი - cisza
დუმს - milczy
დუნდულოი - pośladek
დუჟინი - tuzin
დურგალი - stolarz
დუქანი - sklep
დუღს - wrze
დღე - dzień
დღევანდელი - dzisiejszy
დღეს - dzisiaj
ე - piąta litera alfabetu gruzińskiego
ებრაული - żydowski
ეგ - to
ეგვიპტე - Egipt
ეგვიპტური - egipski
ეგზოტიკური - egzotyczny
ეგრისი - Kolchida | zachodnia Gruzja
ევაკუაცია - ewakuacja
ევოლუცია - ewolucja
ევროპა - Europa
ევროპის კავშირი - Unia Europejska
ევროპული - europejski
ევფემიზმი - eufemizm
ეზო - podwórze | dwór
ეთიკური - etyczny
ეთიოპია - Etiopia
ეთნოლოგია - etnologia
ე.ი. - to jest
ეკვადორი - Ekwador
ეკვატორი - równik
ეკლესია - kościół
ეკოლოგია - ekologia
ეკოლოგიური - ekologiczny
ეკონომიკა - ekonomia
ეკრანი - ekran
ელავს - błyska
ელასტიკური - elastyczny
ელეგია - elegia
ელენთა - śledziona
ელექსირი - eliksir
ელექტრობა - elektryczność
ელექტროდი - elektroda
ელექტრონული - elektroniczny
ელვა - błyskawica
ელზასი - Alzacja
ელიფსი - elipsa
ელსმენი - telefon
ელჩი - ambasador
ემანსიპაცია - emancypacja
ემბრიოლოგია - embriologia
ემბრიონი - embrion
ენა - język | mowa
ენათმეცნიერება - językoznawstwo | lingwistyka
ენათმეცნიერი - językoznawca | lingwista
ენდემური - endemiczny
ენდოკრინოლოგია - endokrynologia
ენთუზიაზმი - entuzjazm
ენოლოგია - enologia
ენტომოლოგია - entomologia
ენციკლოპედია - encyklopedia
ეპიდემიური - epidemiczny
ეპითეტი - epitet
ეპილეფსია - padaczka | epilepsja
ეპილოგი - epilog | zakończenie
ეპისკოპოსი - biskup
ეპიტაფია - epitafium
ეპოქა - epoka
ერა - era
ერაყი - Irak
ერბო-კვერცხი - omlet
ერევანი - Erywań
ერესი - herezja
ერეტიკული - heretycki
ერთად - razem
ერთადერთი - jedyny | unikalny
ერთბაშად - od razu | nagle
ერთგვაროვანი - jednolity
ერთგული - wierny | oddany
ერთდროულად - równocześnie | jednocześnie
ერთ–ერთი - jeden z
ერთი - jeden
ერთმანეთი - wzajemnie | jeden drugiego
ერთობა - jedność
ერთსულოვანი - jednomyślny
ერთსულოვნება - jednomyślność
ერთხელ - raz | jednokrotnie
ერი - naród | lud
ეროვნება - narodowość
ეს - ten/ta/to
ესე იგი - to jest
ესთეტიკა - estetyka
ესკალატორი - schody ruchome
ესპანეთი - Hiszpania
ესპანური - hiszpański
ესპერანტო - esperanto
ესტონეთი - Estonia
ეტიკეტი - etykieta
ექვსი - sześć
ექვსკუთხა - sześciokątny
ექიმი - lekarz
ექსკრემენტი - kał | wydalina
ექსპერიმენტი - eksperyment
ექსპლუატაცია - eksploatacja | wykorzystywanie
ექსპორტი - eksport
ექსპორტიორი - eksporter
ეძებს - szukać
ეწერი - zagajnik
ეჭვი - wątpliwość | niepewność
ეჭვიანობა - zazdrość
ვაგინა - pochwa
ვაზა - wazon
ვაზი - pnącze
ვაკუუმი - próżnia
ვალსი - walc
ვამპირი - wampir
ვანდალიზმი - wandalizm
ვანილი - wanilia
ვაჟი - syn
ვაჟიშვილი - syn
ვარდი - róża
ვარდკაჭაჭა - cykoria
ვარიანტი - wariant
ვარსკვლავი - gwiazda
ვარშავა - Warszawa
ვარჯიში - ćwiczenie
ვატი - wat
ვატიკანი - Watykan
ვაქცინა - szczepionka
ვაქცინაცია - szczepienie
ვაშლი - jabłko
ვაჭარი - handlarz
ვახშამი - kolacja
ვე - identyczny | taki sam
ვეგეტარიანელობა - wegetarianizm
ვედრო - wiadro
ვეზირი - wezyr
ვეზუვი - Wezuwiusz
ველოსიპედი - rower
ვენა - Wiedeń
ვენერა - Wenus
ვენესუელა - Wenezuela
ვენეცია - Wenecja
ვენეციური - wenecki
ვერასდროს - nigdy
ვერდიქტი - werdykt
ვერსია - wersja
ვერტიკალური - pionowy
ვერტმფრენი - helikopter | śmigłowiec
ვერცხლი - srebro
ვეტერანი - weteran
ვეფხვი - tygrys
ვექტორი - wektor
ვეშაპი - wieloryb | smok
ვიდეო - wideo
ვიდრე - niż
ვიეტნამი - Wietnam
ვიზა - wiza
ვიზუალური - wizualny
ვინ - kto
ვინაიდან - ponieważ
ვინმე - ktoś | ktokolwiek
ვირთაგვა - szczur
ვირი - osioł
ვირუსი - wirus
ვირუსოლოგია - wirusologia
ვიტამინი - witamina
ვიქსიკონი - Wikisłownik
ვიღა - któż
ვიღაც - ktoś
ვიჩენცა - Vicenza (miasto)
ვოლტი - wolt
ვრცელი - rozległy
ვულკანი - wulkan
ვულკანური - wulkaniczny
ზადი - defekt | wada
ზამთარი - zima
ზამოსცი - Zamość
ზარბაზანი - działo
ზარდლი - pająk
ზარი - dzwon | strach | przerażenie
ზარმაცი - leniwy
ზაფხული - lato
ზე - na | w
ზებრა - zebra
ზეგ - pojutrze
ზედაპირი - powierzchnia
ზემო - górny
ზეფირი - aura
ზეცა - niebo
ზვიგენი - rekin
ზიზილა - stokrotka
ზიზღი - pogarda
ზმნა - czasownik
ზმნიზედა - przysłówek
ზმნიზედური - przysłówkowy
ზოგი - niektóre | niektórzy
ზოგიერთი - kilka | kilku | niektóry z nich
ზოგჯერ - czasami
ზოლიანი - pasiasty | w paski
ზომა - rozmiar, miara
ზონა - strefa
ზოოლოგი - zoolog
ზოოლოგია - zoologia
ზოოლოგიური - zoologiczny
ზოოპარკი - zoo
ზრდილობა - wychowanie | grzeczność
ზრდილობიანი - uprzejmy
ზუთხი - jesiotr
ზურგი - plecy
ზურმუხტი - szmaragd
ზუსტად - dokładnie
ზუსტი - dokładny
ზღაპარი - bajka | baśń
ზღარბი - jeż
ზღვა - morze
ზღვის ნაპირი - plaża
ზღურბლი - próg
თაგვი - mysz
თავაზიანი - uprzejmy
თავგადასავალი - przygoda
თავდაპირველი - pierwotny | oryginalny
თავდაცვითი - obronny
თავი - głowa | rozdział
თავიანთი - swój własny
თავისუფალი - wolny | swobodny | dyspozycyjny
თავისუფლება - wolność
თავკომბალა - kijanka
თავშეკავება - abstynencja
თათმანი - rękawiczka
თამადა - tamada
თამასა - deska
თამაშობს - gra | bawi się
თან - przy | koło | obok | do | na (w kierunku)
თანამედროვე - współczesny
თანაფარდობა - korelacja
თანაც - ponadto
თანახმად - według
თანდათანობით - stopniowo
თანხმობა - zgodność | zgoda
თანხმოვანი - spółgłoska
თარგი - szablon
თარგმანი - tłumaczenie | przekład
თარიღი - data
თარო - półka
თარჯიმანი - tłumacz
თაფლი - miód
თახვი - bóbr
თბილი - ciepły
თბილისი - Tbilisi
თეატრი - teatr
თებერვალი - luty
თებო - łupież
თევზი - ryba
თეთრეულს - pranie | wyprane rzeczy | bielizna
თეთრი - biały
თეთრყვავილა - przebiśnieg
თელა - wiąz
თეორია - teoria
თეორიული - teoretyczny
თერთმეტი - jedenaście
თერმიტი - termit
თერმომეტრი - termometr
თერმოპილები - Termopile
თერძი - krawiec
თექვსმეტი - szesnaście
თვალაკი - róż
თვალი - oko
თვე - miesiąc
თვითმკვლელობა - samobójstwo
თვითმფრინავი - samolot
თვითნებურად - dowolnie
თვითნებური - arbitralny
თვითონ - samego siebie | się
თვრამეტი - osiemnaście
თიაქარი - przepuklina
თივა - siano
თითბერი - mosiądz
თითი - palec
თითქმის - prawie
თოვლი - śnieg
თოვლიანი - śnieżny
თოვლჭყაპი - deszcz ze śniegiem
თოვს - śnieży
თოთხმეტი - czternaście
თოლია - mewa
თორა - Tora
თორმეტი - dwanaście
თრთვილი - mróz
თრითინა - łasica
თუ - jeśli | jeżeli
თუთა - morwa
თუთია - cynk
თუთის აბრეშუმხვევია - jedwabnik morwowy
თუთიყუში - papuga
თუთუნი - tytoń
თუთქი - ług
თუმცა - chociaż
თურმე - widocznie
თურქეთი - Turcja
თურქული - turecki
თქვენ - wy –
თხა - koza
თხზულება - dzieło | utwór
თხილამური - narta
თხილი - orzech laskowy
თხუთმეტი - piętnaście
იაგუარი - jaguar
იავნანა - kołysanka
იაკი - jak
იალქანი - żagiel
იამაიკა - Jamajka
იანვარი - styczeń
იაპონია - Japonia
იაპონური - japoński
იარაღი - broń
იასამნისფერი - liliowy
იატაკი - podłoga
იაფი - tani
იახტა - jacht
იბერია - Iberia | Iberia kaukaska
იგივე - ten sam | taki sam
იდაყვი - łokieć
იდგება - stoi
იდეალი - ideał
იდეალიზმი - idealizm
იდეალური - idealny
იდეოლოგია - ideologia
იდიომა - idiom
იდიომატური - idiomatyczny
იდიოტური - idiotyczny
იემენი - Jemen
იერარქია - hierarchia
იერიში - atak | napaść
იესო - Jezus
ივლისი - lipiec
ივნისი - czerwiec
ილუზია - iluzja
ილუსტრაცია - ilustracja
იმდენი - tyle
იმედი - nadzieja
იმიტაცია - imitacja
იმიტომ - dlatego
იმპერატორი - cesarz
იმპერია - imperium
იმპერიალიზმი - imperializm
იმპრესიონიზმი - impresjonizm
ინგლისელი - Anglik | Angielka
ინგლისი - Anglia
ინგლისური - angielski
ინგლისური ენა - język angielski
ინგრედიენტი - składnik
ინდოეთი - Indie
ინდონეზია - Indonezja
ინდონეზიური - indonezyjski
ინერცია - bezwładność
ინექცია - zastrzyk
ინვალიდის სავარძელი - wózek inwalidzki
ინჟინერი - inżynier
ინსპექტორი - inspektor
ინსტიტუტი - instytut
ინტეგრაცია - integracja
ინტენსიური - intensywny
ინტერვენცია - interwencja
ინტერიერი - wnętrze
ინტრიგა - intryga
ინტუიცია - intuicja
ინფლაცია - inflacja
ინფორმაცია - informacja
იოდი - jod
იორდანე - Jordania
ირანი - Iran
ირემი - jeleń
ირიდიუმი - iryd
ირლანდია - Irlandia | Irlandia - wyspa w Europie
ირლანდიური - irlandzki
ირონიული - ironiczny
ის - on | ona | ono –
ისარი - strzała
ისე - tak
ისევე - taki jak | właśnie taki
ისეთი - taki
ისინი - oni | one –
ისლამი - islam
ისლამური - islamski
ისლანდია - Islandia | Islandia - wyspa w Europie
ისპანახი - szpinak
ისრაელი - Izrael
ისტერია - histeria
ისტორია - historia
ისტორიკოსი - historyk
იტალია - Włochy
იტალიელი - Włoch | Włoszka
იტალიური - włoski
იუგოსლავია - Jugosławia
იუდაიზმი - judaizm
იუმორი - humor
იუპიტერი - Jowisz
იურისდიქცია - jurysdykcja
იქ - tam
იქვე - w tym samym miejscu | tamże
იქნება - არის
იღბლიანი - szczęśliwy
იღლია - pacha
იწონის - ważyć
იხვი - kaczka
იხვნისკარტა - dziobak
იჯდება - siedzi
კავალერია - kawaleria | konnica
კათოდი - katoda
კათოლიკური - katolicki
კაკაბი - kuropatwa
კაკაფონია - kakofonia
კაკაჩა - myszołów
კაკოფონია - kakofonia
კალა - cyna
კალათბურთი - koszykówka
კალათი - kosz
კალეიდოსკოპი - kalejdoskop
კალენდარი - kalendarz
კალია - konik polny
კალიუმი - potas (K)
კალიფორნია - Kalifornia
კალმახი - pstrąg
კალციუმი - wapń
კამა - koper
კამბოჯა - Kambodża
კამპანია - kampania
კანადა - Kanada
კანადური - kanadyjski
კანი - skóra
კანიბალიზმი - kanibalizm
კანიონი - kanion
კაპიტალიზმი - kapitalizm
კაპიტანი - kapitan
კარადა - regał | szafa na książki
კარალიოკი - persymona
კარანტინი - kwarantanna
კარაქი - masło
კარგად - cześć
კარგი - dobry | w porządku
კარი - drzwi
კარიერა - kariera
კარნავალი - karnawał
კარტოფილი - ziemniak | kartofel
კასტა - kasta
კატა - kot
კატაბანი - gubernator
კატალიზატორი - katalizator
კატალოგი - katalog
კატალონიური - kataloński
კატასტროფა - katastrofa
კატეგორია - kategoria
კატეხიზმო - katechizm
კაქტუსი - kaktus
კაცი - mężczyzna | człowiek
კაჭკაჭი - sroka
კბილი - ząb
კბილის პასტა - pasta do zębów
კედელი - ściana
კეთრი - trąd
კელი - kulawy
კენგურუ - kangur
კენია - Kenia
კენკრა - jagoda
კენტავრი - centaur
კერამიკული - ceramiczny
კერპი - idol
კვამლი - dym
კვერნა - kuna
კვერცხი - jajo | jajko
კვიპაროსი - cyprys
კვიპროსი - Cypr (państwo) | Cypr (wyspa)
კვირა - niedziela | tydzień
კვირადღე - niedziela
კიბერნეტიკა - cybernetyka
კიდება - wisieć
კიდევ - znowu | znów
კივი - kiwi
კითხვა - pytanie
კითხვარი - kwestionariusz
კილი - kil
კილომეტრი - kilometr
კინაღამ - prawie
კინო - film
კირქვა - wapień
კიტელი - bluzka
კიტრი - ogórek
კლანი - plemię
კლარნეტი - klarnet
კლასია - klasa (pomieszczenie w szkole)
კლიენტი - klient
კლიმატი - klimat
კლიმატოლოგია - klimatologia
კლინიკა - klinika
კლონი - klon
კნუტი - kociak
კოალა - koala
კობალტი - kobalt
კობრა - kobra
კობრი - karp
კოდალა - dzięcioł
კოდექსი - kod
კოვბოი - kowboj
კოვზი - łyżka
კოიოტი - kojot
კოკაინი - kokaina
კოლიბრი - koliber
კოლონია - kolonia
კოლოსალური - kolosalny
კოლუმბი - Kolumb (odkrywca)
კოლუმბია - Kolumbia
კომბოსტო - kapusta
კომედია - komedia
კომეტა - kometa
კომიკოსი - komediant
კომპეტენტური - kompetentny
კომპიუტერი - komputer
კომპლექსური - złożony
კომპლიმენტი - komplement
კომპოზიტორი - kompozytor
კომპრომისი - kompromis
კომუნიზმი - komunizm
კომფორტაბელურად - wygodnie
კონგრესი - kongres | konferencja
კონვერტი - koperta
კონკურენცია - rywalizacja
კონსერვის გასახსნელი - otwieracz do konserw
კონსული - konsul
კონტაქტი - kontakt
კონტექსტი - kontekst
კონტინენტი - kontynent
კონფერენცია - konferencja
კონფლიქტი - konflikt
კორეა - Korea
კორეული - koreański
კოროზია - korozja
კორონაცია - koronacja
კორპსაძრობი - korkociąg
კორსეტი - gorset
კოსმოსური - kosmiczny
კოსოვო - Kosowo
კოტეჯი - chata
კოტრი - bankructwo
კოფეინი - kofeina
კოქტეილი - koktail
კოღო - komar
კოშკი - wieża | zamek
კოშკურა - wieżyczka
კოშმარი - koszmar
კრატერი - krater
კრედიტორი - wierzyciel
კრიზისი - kryzys
კრისტალი - kryształ
კრიტიკოსი - krytyk
კუ - żółw
კუბა - Kuba
კუბელი - Kubańczyk | Kubanka
კუბიზმი - kubizm
კუდიანი - wiedźma
კუთვნილება - własność
კუთხე - kąt | narożnik | róg
კულტი - kult
კულტურა - kultura
კუნთი - mięsień
კუნძული - wyspa
კურდღელი - zając
კურსანტი - kadet
კუტუ - penis
კუჭი - żołądek
ლაბირინთი - labirynt
ლაგუნა - laguna
ლავა - lawa
ლამაზი - piękny
ლამის - prawie
ლაოსი - Laos
ლარიქსი - modrzew
ლატექსი - lateks
ლატვია - Łotwa
ლეგენდა - legenda
ლეგიონი - legion
ლეზვი - ślina
ლეიბი - materac
ლეიტენანტი - porucznik
ლეკვი - szczeniak
ლეოპარდი - lampart
ლექსიკონი - leksykon
ლექტორი - wykładowca
ლეღვი - figa
ლიბერალიზმი - liberalizm
ლიბია - Libia
ლითიუმი - lit
ლითონი - metal
ლილვი - oś
ლიმონი - cytryna
ლინგვისტიკა - językoznawstwo
ლინგვისტური - językowy
ლისაბონი - Lizbona
ლიტერატურა - literatura
ლიტერატურული - literacki
ლიტვა - Litwa
ლიტრი - litr
ლიტურგია - liturgia
ლიტურგიული - liturgiczny
ლიფი - biustonosz
ლიხტენშტაინი - Liechtenstein
ლიხტენშტეინი - Liechtenstein
ლოგიკა - logika
ლოგიკოსი - logik
ლოგიკური - logiczny
ლოგინი - łóżko
ლოთობა - pijaństwo
ლოიალობა - lojalność
ლოკოკინა - ślimak
ლომვეშაპი - mors
ლომი - lew
ლონდონი - Londyn
ლოტოსი - lotos
ლოყა - policzek
ლოცმანი - pilot
ლუდი - piwo
ლუპა - lupa
ლურჯი - niebieski
ლუქსემბურგი - Luksemburg | Luksemburg - miasto w Luksemburgu (1.1)
ლჰასა - Lhasa
მაგალითი - przykład
მაგია - magia
მაგნიტი - magnes
მაგნიტიზმი - magnetyzm
მაგნიტური - magnetyczny
მაგნიუმი - magnez
მაგრამ - ale
მადაგასკარი - Madagaskar
მადრიდი - Madryt
მავზოლეუმი - mauzoleum
მავნე - niekorzystny
მაზლი - szwagier
მათემატიკა - matematyka
მათემატიკური - matematyczny
მათი - ich
მათრახი - bicz
მათხოვარი - żebrak
მაიმუნი - małpa
მაიონეზი - majonez
მაისი - maj
მაკაო - Makau
მაკედონია - Macedonia | Macedonia - kraina historyczna w Grecji
მაკრატელი - nożyczki
მალაიზია - Malezja
მალე - wkrótce
მალტა - Malta (państwo) | Malta (wyspa)
მამა - ojciec | tata
მამალი - kogut
მამამთილი - teść
მამიკო - tata
მამინაცვალი - ojczym
მამონტი - mamut
მანანა - wrzos
მანგო - mango
მანიპულაცია - manipulacja
მანქანა - maszyna | samochód
მანქანას - samochód
მარგალიტი - perła
მარგანეცი - mangan
მართკუთხედი - prostokąt
მარილი - sól
მაროკო - Maroko
მარსი - Mars
მარტი - marzec
მარცვლოვანი - sylabiczny
მარწყვი - truskawka
მასწავლებელი - nauczyciel
მასწავლებელია - nauczycielka
მასხარა - klaun
მატარებელი - pociąg
მატრიცა - macierz
მაქსიმუმი - maksimum
მაქცია - wilkołak
მაღაზია - sklep
მაშასადამე - w rezultacie
მაჩეტე - maczeta
მაჩვზღარბა - jeżozwierz
მაჩვი - borsuk
მაცივარი - lodówka
მახვილი - strzała | miecz | akcent | ostry | spiczasty
მახსოვს - pamiętam
მაჯა - nadgarstek
მაჯლაჯუნა - koszmar
მგელი - wilk
მგელი ცხვრის ტყავში - wilk w owczej skórze
მგონია - wydaje mi się | od ჰგონია
მდგმური - najemca
მდგომარეობა - sytuacja | położenie | stan
მდიდარი - bogaty
მდინარე - rzeka
მე - ja –
მებაღე - ogrodnik
მეგობარი - kolega | przyjaciel
მეგობრობა - przyjaźń
მედალი - medal
მედიტაცია - medytacja
მედიცინა - medycyna
მეექვსე - szósty
მევახშეობა - lichwa
მეზობელი - sąsiad
მეზღაპრე - gawędziarz
მეზღვაური - marynarz
მეთევზე - rybak
მეთუნე - garncarz
მეთხილამურე - narciarz
მეკობრე - pirat
მელა - lis
მელია - lis
მენახირე - pasterz
მენიუ - menu
მენსტრუაცია - miesiączka
მეობა - osobowość
მეოთხე - czwarty
მეომარი - wojownik
მეორე - drugi
მეპაიე - udziałowiec
მერვე - ósmy
მერკური - Merkury
მერცხალი - jaskółka
მესამე - trzeci
მესიჯი - wiadomość
მეტაბოლიზმი - metabolizm
მეტად - też
მეტალი - metal
მეტალურგია - metalurgia
მეტაფიზიკა - metafizyka
მეტაფორა - metafora
მეტემფსიქოზი - metempsychoza
მეტეორი - meteor
მეტეორიტი - meteoryt
მეტეოროლოგია - meteorologia
მეტსახელი - przydomek
მეტყევე - leśniczy
მეფე - król
მეფუტკრე - pszczelarz
მექანიკური - mechaniczny
მექრთამეობა - przekupstwo | korupcja
მექსიკა - Meksyk
მექსიკური - meksykański
მეშვიდე - siódmy
მეჩეთი - meczet
მეცნიერება - nauka
მეცნიერი - naukowiec
მეცნიერული - naukowy
მეცხვარე - pasterz
მეცხრე - dziewiąty
მეწაღე - szewc
მეწისქვილე - młynarz
მეწყალსადენე - hydraulik
მეხი - piorun
მეხუთე - piąty
მზადება - przygotowanie
მზე - Słońce
მზესუმზირა - słonecznik
მზიანი - słoneczny
მზის ჩასვლა - zachód słońca
მთა - góra | wzgórze
მთავარი - wódz | główny
მთავრობა - rząd
მთარგმნელი - tłumacz
მთვარე - księżyc
მთიანი - górzysty
მიანმარი - Mjanma
მიახლოებით - około
მიახლოებითი - przybliżony
მიგნება - znaleźć | odnaleźć
მითი - mit
მითოლოგია - mitologia
მიიღებს - dostanie
მიკოლოგია - mykologia
მიკროსკოპი - mikroskop
მიკროფონი - mikrofon
მილიგრამი - miligram
მიმდინარე - aktualny
მინარეთი - minaret
მინდა - chcę | od უნდა
მინდორი - pole
მინერალი - minerał
მინერალოგი - mineralog
მინერალოგია - mineralogia
მინერალური წყალი - woda mineralna
მისამართია - adres
მისაწვდომობა - dostępność
მისია - misja
მიტრა - mitra
მიუძღვნის - poświęci
მიწა - ziemia
მიწათმოქმედი - rolnik
მიწისძვრა - trzęsienie ziemi
მიხეილ - Michał | gruzińskie imię męskie
მკვდარი - martwy
მკვეხარა - chełpliwy
მკვლელი - zabójca
მკვლელობა - morderstwo
მლოცვარე - pielgrzym
მნებავს - zechciałbym
მნიშვნელოვანი - ważny
მოაჭრევინებს - spowoduje | że odetną
მობილურობა - mobilność
მოგვიანებით - później
მოგზაური - podróżnik
მოგრძო - podłużny
მოდა - moda
მოდება - poddawać fermentacji | zakwaszać
მოზამბიკი - Mozambik
მოთეთრო - białawy
მოიგებს - wygra
მოკლე - krótki
მოკრივე - bokser
მოლარე - kasjer
მოლაღური - wilga
მოლბერტი - sztaluga
მოლდოვა - Mołdawia
მოლეკულა - cząsteczka | molekuła
მოლიბდენი - molibden
მომღერალი - śpiewak
მომწვანო - zielonkawy
მომხმარებელი - użytkownik
მონადირე - myśliwy
მონაკო - Monako
მონარქია - monarchia
მონასტერი - klasztor
მონეტა - moneta
მონოგამია - monogamia
მონოთეიზმი - monoteizm
მონტენეგრო - Czarnogóra
მონუმენტი - pomnik
მონღოლეთი - Mongolia
მორჩილობა - posłuszeństwo
მორწმუნე - wierzący
მოსამართლე - sędzia
მოსაწყენია - nudny
მოსკოვი - Moskwa
მოტივაცია - motywacja
მოუჯდება - usiądzie obok kogoś
მოქალაქეობა - obywatelstwo
მოქანდაკე - rzeźbiarz
მოქნილი - elastyczny
მოღალატე - zdrajca
მოღუშული - ponury
მოჩვენება - duch
მოციქული - apostoł
მოცურავე - pływak
მოწაფე - uczeń
მოწითალო - czerwonawy
მოწყალება - jałmużna
მოჭიდავე - zapaśnik
მოჭრის - odetnie
მოხდება - zdarzy się
მოხსენება - raport
მჟავე - kwaśny
მრგვალი - okrągły
მრჩეველი - doradca
მსაჯი - sędzia
მსგავსება - podobieństwo
მსხალი - gruszka
მსხვერპლი - ofiara
მტაცებელი - drapieżnik
მტერი - wróg
მტვერსასრუტი - odkurzacz
მტვრიანი - zakurzony
მტკივნეული - bolesny
მტრედი - gołąb
მუდამ - zawsze
მუზეუმი - muzeum
მული - szwagierka
მუსიკა - muzyka
მუსიკოსი - muzyk
მუსლიმი - muzułmanin
მუსონი - monsun
მუსულმანი - muzułmanin
მუტაცია - mutacja
მუშა - robotnik
მუშაობა - praca
მუწუკი - krosta
მუხა - dąb
მუხლუხი - gąsienica
მუხრუჭი - hamulec
მღვიმე - jaskinia
მღვიძავს - nie śpię
მყინვარი - lodowiec
მშვიდი - pokojowy
მშვიდობა - pokój
მშვიდობიანი - pokojowy
მშვიდობით - do widzenia
მშვილდოსნობა - łucznictwo
მცენარე - roślina
მცველი - ochroniarz
მძევალი - zakładnik
მძინავს - śpię
მძულვარება - nienawiść
მძულს - nienawidzę
მწერალი - pisarz
მწერი - owad
მწვანე - zielony
მწყემსი - pastuch
მწყერი - przepiórka
მჭიდრო - ciasny
მხატვარი - artysta
მხედარი - rycerz | wojownik
მხედრული - wojskowy | mchedruli
მხოლოდ - tylko
ნადირობს - poluje | od ნადირობა
ნავთობი - ropa naftowa
ნავი - łódź
ნავიგაცია - nawigacja
ნათესავი - krewny
ნათესაობა - pokrewieństwo
ნათურა - lampa
ნაიარევი - blizna
ნაკლებად - mniej
ნაკლებობა - brak | niedobór
ნალი - podkowa
ნამდვილი - prawdziwy
ნამიბია - Namibia
ნარინჯისფერი - pomarańczowy
ნარკვევი - esej | praca
ნარშავი - oset
ნატრიუმი - sód
ნაფეხური - ślad stopy
ნაღდად - rzeczywiście
ნაღმი - bomba
ნაყინი - lody
ნაშთი - pozostałość | reszta
ნაშუადღევი - popołudnie
ნაცვალსახელი - zaimek
ნაციონალიზმი - nacjonalizm
ნაციონალისტი - nacjonalista
ნაცნობი - znany | przyjaciel
ნაცრისფერი - szary
ნაძვი - świerk
ნაწარმი - produkt
ნაწარმოები - wytwór pracy
ნაწილი - część
ნაჭრილობევი - blizna
ნახავს - widzi
ნახევარი - połowa
ნახევარსფერო - półkula
ნახერხი - trociny
ნახვამდის - do widzenia
ნახშირბადი - węgiel
ნახშირი - węgiel
ნაჯახი - siekiera | topór
ნებაყოფლობით - dobrowolnie
ნევროლოგია - neurologia
ნეზვი - maciora | locha
ნეიტრალიტეტი - neutralność
ნეიტრალური - neutralny
ნეკერჩხალი - klon
ნეკნი - żebro
ნეკროლოგი - nekrolog
ნელა - wolno
ნელი - wolny | powolny
ნემსი - igła
ნემსიყლაპია - ważka
ნეოლოგიზმი - neologizm
ნეონი - neon
ნეპალი - Nepal
ნეპოტიზმი - nepotyzm
ნეპტუნი - Neptun
ნერვი - nerw
ნერწყვი - ślina
ნესვი - melon
ნესტო - nozdrze
ნეფე - pan młody
ნეხვი - gnój | łajno
ნიადაგ - ciągle
ნიანგი - krokodyl
ნიახური - seler
ნიგერია - Nigeria
ნიდერლანდები - Holandia
ნიდერლანდი - Holandia
ნივთი - rzecz
ნიკაპი - podbródek
ნიკარაგუა - Nikaragua
ნიმუში - model | wzór
ნიორი - czosnek
ნისლი - mgła
ნიჰილიზმი - nihilizm
ნოემბერი - listopad
ნომენკლატურა - nomenklatura
ნომერი - liczba
ნომინაცია - nominacja
ნორვეგია - Norwegia
ნორვეგიული - norweski
ნოხი - dywan
ნუკრი - jelonek
ნუნუა - wino
ნუში - migdał
ობელისკი - obelisk
ობობა - pająk
ობოლი - sierota
ობსერვატორია - obserwatorium
ოდნავ - lekko
ოვალი - owal
ოვალური - owalny
ოზონი - ozon
ოთახი - pokój | izba
ოთხი - cztery
ოთხშაბათი - środa
ოკეანე - ocean
ოლქი - region | dysktrykt | prowincja
ომი - wojna
ომონიმი - homonim
ოპალი - opal
ოპერა - opera
ოპიუმი - opium
ოპონენტი - oponent
ოპტიმიზმი - optymizm
ორაგული - łosoś
ორაზროვნება - niejednoznaczność
ორბი - sęp
ორგაზმი - orgazm
ორგანიზაცია - organizacja
ორგანიზმი - organizm
ორგანული - organiczny
ორგია - orgia
ორთოგრაფია - ortografia
ორი - dwa
ორიენტაცია - orientacja
ორივე - obaj | obie | oba
ორკარედი ნიჟარა - małż
ორმოცდაათი - pięćdziesiąt
ორმოცი - czterdzieści
ორნამენტი - ornament
ორსული - w ciąży
ორსულობა - ciąża
ორქიდეა - orchidea
ორშაბათი - poniedziałek
ორცხობილას - tost
ორჯერ - dwa razy
ოსეთი - Osetia
ოსტატი - rzemieślnik | majster
ოსური - osetyjski
ოფიციალურად - formalnie
ოფლი - pot
ოქრო - złoto
ოქტომბერი - październik
ოყნა - lewatywa
ოცი - dwadzieścia
ოცნება - marzenie
ოხრახუში - pietruszka
ოჯახი - rodzina
პაგოდა - pagoda
პათოლოგია - patologia
პაკისტანი - Pakistan
პალეონტოლოგია - paleontologia
პალესტინა - Palestyna
პალინდრომი - palindrom
პანამა - Panama
პანდა - panda
პანთეიზმი - panteizm
პანიკა - panika
პანორამა - panorama
პაპიროსი - papieros
პარადოქსი - paradoks
პარამეტრი - parametr
პარასკევი - piątek
პარაშუტი - spadochron
პარი - taniec
პარიზი - Paryż
პარიკმახერი - fryzjer
პარლამენტი - parlament
პასპორტი - paszport
პასტორი - pastor
პატარა - mały
პატარი - mały
პატივმოყვარეობა - ambicja
პატიმარი - więzień
პატოანი - okno
პატრიარქი - patriarcha
პატრიოტიზმი - patriotyzm
პატრიოტული - patriotyczny
პაქტი - pakt | układ
პაჩი - pocałunek
პაციენტი - pacjent
პაწაწა - maleńki
პაწია - maleńki
პედაგოგიკა - pedagogika
პეპელა - motyl
პერანგი - koszula
პერგამენტი - pergamin
პერიმეტრი - obwód
პერუ - Peru
პესიმიზმი - pesymizm
პიგმენტი - barwnik
პითონი - pyton
პილიგრიმი - pielgrzym
პილიგრიმობა - pielgrzymka
პილოტი - pilot
პილპილი - pieprz
პინგვინი - pingwin
პიონერი - pionier
პირატი - pirat
პირველი - pierwszy
პირი - usta | buzia
პირობა - obietnica
პიროვნება - osoba
პირღებინება - wymiociny
პირშუშხა - chrzan
პიცა - pizza
პლანეტა - planeta
პლანეტარული - planetarny
პლანტაცია - plantacja
პლაჟი - plaża
პლატინა - platyna
პლეონაზმი - pleonazm
პლუტონიუმი - pluton
პნევმონია - zapalenie płuc
პოეზია - poezja
პოემა - wiersz
პოეტი - poeta
პოლიგამია - poligamia
პოლითეიზმი - politeizm
პოლიტიკური - polityczny
პოლიცია - policja
პოლონეთი - Polska
პოლონური - polski
პომიდორი - pomidor
პოპლიკა - łysy
პოპულარობა - popularność
პორნოგრაფია - pornografia
პორტატული - przenośny
პორტუგალია - Portugalia
პორტუგალიური - portugalski
პოტენცია - potencjał
პოტენციური - potencjalny
პრაგმატული - pragmatyczny
პრასი - por
პრეზიდენტი - prezydent
პრეისტორია - prehistoria
პრერია - preria
პრესტიჟი - prestiż
პრიზი - nagroda
პრინტერი - drukarka
პრინცესა - księżniczka
პრინციპი - zasada | reguła
პრობლემა - problem
პროგრესი - postęp
პროდიუსერი - producent
პროექტი - projekt
პროზა - proza
პროკურორი - prokurator
პროლოგი - prolog
პროპაგანდა - propaganda
პროტეინი - białko
პროტოკოლი - protokół
პროტონი - proton
პროფესორი - profesor
პროცენტი - procent
პროცესი - proces
პრუსიული - pruski
პუბლიკაცია - publikacja
პუდელი - pudel
პუნქტუალური - punktualny
პუნქტუაცია - interpunkcja
პური - chleb
ჟამი - czas
ჟანგბადი - tlen
ჟანგვა - rdza
ჟანგი - rdza
ჟანგიანი - zardzewiały
ჟანრი - gatunek | rodzaj
ჟასმინი - jaśmin
ჟინი - kaprys
ჟირაფი - żyrafa
ჟოლო - malina
ჟოლოსფერი - karmazynowy
ჟონგლიორი - żongler
ჟურნალი - czasopismo | magazyn
რა - co
რაბინი - rabin
რაგბი - rugby
რადგან - ponieważ
რადგანაც - ponieważ
რადიაცია - promieniowanie
რადიუმი - rad
რაინდი - rycerz
რაკეტა - rakieta
რაოდენობითი - ilościowy
რატიფიკაცია - ratyfikacja
რატომ - dlaczego
რაღაც - coś
რაღაცა - coś
რაციონალიზმი - racjonalizm
რეაბილიტაცია - rehabilitacja
რეალიზმი - realizm
რეალისტური - realistyczny
რეაქცია - reakcja
რეგიონალური - regionalny
რეგულარულად - regularnie
რეგულირებადი - regulowalny | nastawny
რევოლვერი - rewolwer
რევოლუცია - rewolucja
რევოლუციური - rewolucyjny
რეზონანსი - rezonans
რეინკარნაცია - reinkarnacja
რეკომენდაცია - rekomendacja
რელიგია - religia
რელიგიურად - religijnie
რელიგიური - religijny
რეპროდუქტორი - głośnik
რეპუტაცია - reputacja
რეჟისორი - producent
რესპუბლიკა - republika
რესტორანი - restauracja
რეფორმა - reforma
რვა - osiem
რვაფეხა - ośmiornica
რვეული - zeszyt
რისთვის - dlaczego
რისი - co
რიცხვი - liczba
რკინა - żelazo
რობოტი - robot
როგორ - jak
როგორმე - jednak
როდესაც - kiedy
როზმარინი - rozmaryn
როლი - rola
რომ - że | kiedy
რომანტიული - romantyczny
რომაული - rzymski
რომი - Rzym
რტო - gałąź
რუკა - mapa
რუმინეთი - Rumunia
რუმინული - rumuński
რუსეთი - Rosja
რუსი - Rosjanin | Rosjanka
რუსული - rosyjski
რძე - mleko
რწმენა - wiara
რწყილი - pchła
სააბატო - opactwo
სააგენტო - agencja
საავადმყოფო - szpital
საათი - godzina | zegar | zegarek
საათია - godzina
საამქრო - warsztat
საბერძნეთი - Grecja
საბუთი - dokument
საბჭოთა კავშირი - Związek Radziecki
საგა - saga
საგანმანათლებლო - edukacyjny
საგარეუბნო - podmiejski
სად - gdzie
სადგური - stacja
სადიზმი - sadyzm
სადღაც - gdzieś
საეკლესიო - kościelny
საელჩო - ambasada
საერთაშორისო - międzynarodowy
სავალუტო - pieniężny
სავარჯიშო - ćwiczenie
საზამთრო - melon
საზრდო - jedzenie
სათამაშო - zabawka
სათვალე - okulary
სათითე - naparstek
სათლი - wiadro
სათნო - cnotliwy
საინტერესო - interesujący
საკეპი - siekiera | topór
საკლასო ოთახი - klasa | sala lekcyjna
საკმარისად - wystarczająco
საკუთარი - własny
საკუთრება - własność | mienie
სალავათი - modlitwa
სალათა - sałata
სალამანდრა - salamandra
სალამი - cześć
სალამურა - minóg
სალბი - mędrzec
სალტე - opona
სამართებელი - brzytwa
სამედიცინო - medyczny
სამეფო - królestwo
სამზარეულო - kuchnia
სამი - trzy | 3
სამონეტო - pieniężny
სამუდამოდ - na zawsze
სამყარო - świat
სამშაბათი - wtorek
სამხრეთ აფრიკის რესპუბლიკა - Republika Południowej Afryki
სამხრეთი - południe
სამხრეთი ოსეთი - Osetia Południowa
სანდალი - sandał
სანთელი - świeca | świeczka
სანსკრიტული - sanskrycki
სანტიმეტრი - centymetr
სან-ტომე და პრინსიპი - Wyspy Świętego Tomasza i Książęca
საპონი - mydło
სარბიელი - arena
სარდაფი - piwnica
სარდაფია - piwnica
სარეველა - chwast
სარკაზმი - sarkazm
სარკოფაგი - sarkofag
სასანთლე - świecznik
სასაფლაო - cmentarz
სასახლე - zamek
სასიამოვნო - miły | przyjemny
სასოწარკვეთილება - rozpacz
სასტუმრო - hotel
სასურველი - pożądany
სასქესო - seksualny
სასწრაფოდ - szybko
სატელეფონო წიგნი - książka telefoniczna
სატელიტი - satelita
სატვირთო მანქანა - ciężarówka
სატირა - satyra
სატირი - satyr
სატურნი - Saturn
საუდის არაბეთი - Arabia Saudyjska
საუზმე - śniadanie
საუკუნე - wiek | stulecie
საუკუნო - świecki
საფერფლე - popielniczka
საფირონი - szafir
საფლავი - grób
საფოსტო ბარათი - pocztówka
საფრანგეთი - Francja
საფულე - portfel
საქართველო - Gruzja
საღამო - wieczór
საღამო მშვიდობისა - dobry wieczór
საყლაპავის - przełyk
საყურე - kolczyk
საშიში - niebezpieczny
საშო - pochwa
საცვალი - majtki
საცხობი - piekarnia
საწერი მაგიდა - biurko | pulpit | stół do pisania
საწვავი - paliwo
საწოლი - łóżko
საჭიროება - potrzeba
საჭრისი - dłuto
საჭურისი - eunuch
სახალხოდ - publicznie
სახე - twarz
სახელი - imię | sława
სახელოვანი - słynny
სახელოსნო - warsztat
სახლი - dom
სახურავი - dach
სახურავია - dach
საჯაროობა - rozgłos | reklama
სეისმოლოგია - sejsmologia
სეიფი - sejf
სელენი - selen
სემანტიკური - semantyczny
სემინარი - seminarium
სენატი - senat
სენატორი - senator
სენდვიჩი - kanapka
სენეგალი - Senegal
სენტენცია - maksyma
სეპარატიზმი - separatyzm
სერბეთი - Serbia
სერი - pagórek | uczta
სესხი - pożyczka
სეტყვა - grad
სექსი - seks
სექსუალობა - seksualność
სექსუალურად - seksualnie
სექსუალური ორიენტაცია - orientacja seksualna
სექტა - sekta
სექტემბერი - wrzesień
სექტორი - sektor
სვეტი - kolumna
სიამაყე - duma
სიამოვნება - przyjemność
სიბერე - starość
სიბნელე - ciemność | mrok
სიბრაზე - gniew
სიბრმავე - ślepota
სიგარეტი - papieros
სიგრძე - długość
სიდედრი - teściowa
სიზმარი - sen
სითეთრე - biel
სითხე - płyn
სიკვდილი - śmierć
სილა - piasek
სილაბური - sylabiczny
სილიციუმი - krzem
სიმამაცე - śmiałość | odwaga
სიმეტრია - symetria
სიმინდი - kukurydza
სიმულაცია - symulacja
სიმფონია - symfonia
სიმღერა - pieśń | piosenka
სიმწარე - gorycz
სიმწვანე - dziewictwo
სინაგოგა - synagoga
სინგაპური - Singapur
სინდიკი - rtęć
სინთეზი - synteza
სინონიმი - synonim
სინონიმური - bliskoznaczny
სინტაქსი - składnia
სინჯი - stop
სირაქლემა - struś
სირია - Syria
სიროფი - syrop
სისირი - groch
სისტემა - system
სისტემატური - systematyczny
სისუსტე - słabość
სისხლი - krew
სისხლის აღრევა - kazirodztwo
სიტუაცია - sytuacja
სიტყვა - słowo
სიტყვარი - glosariusz
სიტყვას - słowo
სიყვარული - miłość
სიყრუე - głuchota
სიცივე - chłód | zimno
სიცილი - śmiech
სიცოცხლე - życie
სიძე - zięć
სიძულვილი - nienawiść
სიხარული - radość
სკამი - krzesło
სკანდალი - skandal
სკანერი - skaner
სკოლა - szkoła
სლენგი - slang
სლოვაკეთი - Słowacja
სლოვაკეთის რესპუბლიკა - Republika Słowacka
სლოვენია - Słowenia
სნაიპერი - snajper
სოლიდარობა - solidarność
სომხეთი - Armenia
სომხური - ormiański
სონეტი - sonet
სოსისი - kiełbasa
სოუსი - sos
სოფელი - wieś | wioska
სოციალიზმი - socjalizm
სოციოლოგი - socjolog
სოციოლოგია - socjologia
სოჭი - jodła
სპარსეთი - Persja
სპარსული - język perski
სპეტაკი - biały
სპეციფიკაცია - specyfikacja
სპილენძი - miedź
სპილო - słoń
სპირალი - spirala
სპირტი - alkohol
სპონსორი - sponsor
სპონტანური - spontaniczny
სრუტე - cieśnina | przesmyk
სტატია - artykuł
სტატისტიკა - statystyka
სტატუსი - status
სტაფილო - marchew
სტილი - styl
სტიმული - bodziec
სტუდენტი - student
სტუმარი - gość
სუბსტანცია - substancja
სუდანი - Sudan
სუვენირი - pamiątka
სულთანი - sułtan
სული - dusza
სულიერად - duchowo
სულიერი - duchowy
სუნთქვა - oddychanie
სუპერმარკეტი - supermarket
სურავანდი - szkorbut
სურვილი - pragnienie
სურო - bluszcz
სქემა - urządzenie
სწორედ - dokładnie
სწორკუთხა - kwadratowy
სწრაფი - szybki
სხვანაირად - gdzie indziej
ტაბუ - tabu
ტავტოლოგია - tautologia
ტაივანი - Tajwan
ტაილანდი - Tajlandia
ტაიური - tajski
ტალანი - korytarz
ტალანტი - talent
ტალღა - fala
ტანვარჯიში - gimnastyka
ტანი - ciało | tułów
ტარა - boks
ტარაკანი - karaluch
ტასმანია - Tasmania
ტატბერი - położna
ტაქტიკა - taktyka
ტაჯიკეთი - Tadżykistan
ტბა - jezioro
ტელევიზორი - telewizor
ტელეფონი - telefon
ტემპერატურა - temperatura
ტერმინოლოგია - terminologia
ტერმიტი - termit
ტერორიზმი - terroryzm
ტერფი - stopa
ტექნიკური - techniczny
ტექნოლოგია - technika
ტექნოლოგიური - techniczny
ტექსტი - tekst
ტვინი - mózg
ტიბეტური - tybetański
ტივი - tratwa
ტივტივა - boja | pława
ტიკინი - lalka
ტილი - wesz
ტიპური - typowy
ტირანი - tyran
ტირანია - tyrania
ტირიფი - wierzba
ტიტა - tulipan
ტიტველი - nagi
ტკბილი - słodki
ტოლობა - równość
ტომარა - worek
ტომატი - pomidor
ტორფი - torf
ტოსკანა - Toskania
ტოქსიკოლოგია - toksykologia
ტოქსიკური - trujący
ტრაგიკული - tragiczny
ტრადიცია - tradycja
ტრადიციულად - tradycyjnie
ტრაექტორია - tor | trajektoria
ტრამვაი - tramwaj
ტრანზისტორი - tranzystor
ტრანსპორტი - transport
ტრაქტორი - traktor
ტრივიალური - trywialny
ტრიუმფი - triumf
ტროპიკული - tropikalny
ტუბერკულოზი - gruźlica
ტუმბო - pompa
ტუნისი - Tunezja
ტუჩი - warga
ტყავი - skóra
ტყე - las
ტყვეობა - niewola
ტყვია - ołów | pocisk
ტყუილად - na próżno
ტყუპი - bliźniak
უბანი - ulica
უგანდა - Uganda
უგვიანესი - ostatni
უდაბნო - pustynia
უეჭველობა - autentyczność
უზბეკეთი - Uzbekistan
უზრუნველობა - lekkomyślność
უზურპატორი - uzurpator
უთანასწორობა - nierówność
უთმო - bezwłosy
უიმედობა - rozpacz
უკაცრავად - przepraszam
უკეთ - lepiej
უკვე - już
უკიდურესობა - skrajność
უკრაინა - Ukraina
ულაყი - ogier
ულვაში - wąsy
ულტიმატუმი - ultimatum
უმავთულო - bezprzewodowy
უმანკოება - niewinność
უმრავლესობა - większość
უმუშევრობა - bezrobocie
უმცირესობა - mniejszość
უნაგირი - siodło
უნგრეთი - Węgry
უნივერსიტეტი - uniwersytet
უპატიოსნო - nieuczciwy
ურანი - Uran | Uran (U)
ურდო - horda
ურიგო - zły
ურჩხული - potwór
უსახლკარო - bezdomny
უტყუარობა - autentyczność
უფლისწული - książę
უქმრო - stanu wolnego
უღელი - jarzmo
უღმერთო - bezbożny
უშნო - brzydki
უცოლო - stanu wolnego
უძლეველი - niezwyciężony | niepokonany
უხამსი - obsceniczny
უხეიროდ - niestety
უხერხული - niewygodny
ფაბრიკა - fabryka
ფაგოტი - fagot
ფალავანი - zapaśnik
ფალოსი - penis
ფანჯარა - okno
ფარდობითობა - względność
ფარმაკოლოგია - farmakologia
ფასეული - cenny
ფასი - wartość | koszt
ფაფარი - grzywa
ფაქსი - faks
ფაქტორი - czynnik
ფაშატი - klucz
ფაშიზმი - faszyzm
ფაშისტური - faszystowski
ფაწალი - śledziona
ფედერალური - federalny
ფედერაცია - federacja
ფეთქებადი - wybuchowy
ფემინიზმი - feminizm
ფერდი - szalik
ფერია - kolor
ფერმენტაცია - fermentacja
ფერმერი - rolnik
ფერფლი - popiół
ფეტვი - proso
ფეხი - noga
ფეხმძიმე - w ciąży
ფეხმძიმობა - ciąża
ფეხსაცმელი - but
ფთორი - fluor
ფიზიკა - fizyka
ფიზიკოსი - fizyk
ფიზიკურად - fizycznie
ფიზიოლოგია - fizjologia
ფითილი - knot
ფითრი - jemioła
ფილა - płyta
ფილიპინები - Filipiny
ფილმი - film
ფილოლოგია - filologia
ფილოსოფია - filozofia
ფილოსოფოსი - filozof
ფილტვი - płuco
ფინანსური - finansowy
ფინეთი - Finlandia
ფინური - fiński
ფიფქი - śnieżynka | płatek śniegu
ფიწალი - widły
ფიჭა - plaster
ფიჭვი - sosna
ფიჯი - Fidżi
ფლეიტა - flet
ფლოსტი - kapeć
ფობია - fobia
ფოთოლი - liść
ფოლადი - stal
ფოლკლორი - folklor
ფონემა - fonem
ფონეტიკა - fonetyka
ფონეტიკური - fonetyczny
ფონოლოგია - fonologia
ფორთოხალი - pomarańcza
ფორტიფიკაცია - fortyfikacja
ფოსფორი - fosfor
ფოტოგრაფია - fotografia
ფოცხვერი - ryś
ფოცხი - grabie
ფრანგული - francuski
ფრეგატი - fregata
ფრთიანი - skrzydlaty
ფრინველი - ptak
ფსელი - mocz
ფსიქიატრია - psychiatria
ფსიქოთერაპია - psychoterapia
ფსიქოლოგი - psycholog
ფსიქოლოგია - psychologia
ფსიქოლოგიური - psychologiczny
ფტორი - fluor
ფული - pieniądze | moneta
ფუნქცია - funkcja
ფუნჯი - frędzel
ფურნე - piekarnia
ფუტკარი - pszczoła
ფუტლარი - pochwa
ფქვილი - mąka
ქათამი - kurczak
ქაირო - Kair
ქალაქი - miasto | Tbilisi
ქალი - kobieta
ქალიშვილი - córka | dziewczyna
ქამელეონი - kameleon
ქანდაკება - posąg | statua
ქაოსი - chaos
ქაოტური - chaotyczny
ქარბუქი - zamieć
ქარვა - bursztyn
ქართველი - Gruzin | Gruzinka
ქართული - gruziński
ქარი - wiatr
ქარიშხალი - burza
ქარიშხალი ჭიქა წყალში - burza w szklance wody
ქარხანა - fabryka
ქატო - otręby
ქაფური - kamfora
ქაფშია - sardela
ქაღალდი - papier
ქაშაყი - śledź
ქეიფი - uczta
ქერი - jęczmień
ქერტლი - łupież
ქვა - kamień
ქვეყანა - kraj | świat
ქვეყნიერება - świat
ქვეწარმავალი - gad
ქვისლი - szwagier
ქვიშა - piasek
ქვიშაქვა - piaskowiec
ქვრივი - wdowa
ქიმია - chemia
ქიმიური - chemiczny
ქირურგი - chirurg
ქლიავი - śliwka
ქლორი - chlor
ქლოროფილი - chlorofil
ქმნილება - stworzenie
ქნარი - lira
ქომაგი - obrońca
ქონა - mieć | posiadać
ქორი - jastrząb
ქრიზანთემა - chryzantema
ქრისტე - Chrystus
ქრისტიანობა - chrześcijaństwo
ქრომი - chrom
ქრომოსომა - chromosom
ქრონოლოგიური - chronologiczny
ქრფაკი - pies
ქუთუთო - powieka
ქუნჯუტი - sezam
ქურდი - złodziej
ქუჩა - ulica
ქუხილი - grzmot
ღალატობს - zdradza
ღამე - noc
ღარიბი - biedny
ღებულებს - otrzymuje
ღვინო - wino
ღვიძლი - wątroba
ღიმილი - uśmiech
ღინღლი - puch
ღირებულება - wartość
ღმერთი - Bóg | bóg
ღმერთქალი - bogini
ღორი - świnia
ღორმუცელობა - obżarstwo
ღრმა - głęboki
ღრუბელა - gąbka
ღრუბელი - chmura
ღრუბლიანი - pochmurny
ღუზა - kotwica
ყავა - kawa
ყავისფერი - brązowy
ყაზახეთი - Kazachstan
ყანჩა - czapla
ყაყაჩო - mak
ყეენობა - karnawał
ყელსაბამი - naszyjnik
ყვავი - wrona
ყვავილი - kwiat
ყველანი - wszyscy
ყველაფერი - wszystko
ყველი - ser
ყვითელი - żółty
ყითა ნაწლავი - odbyt
ყინული - lód
ყირგიზეთი - Kirgistan
ყმაწვილობა - dojrzewanie
ყოველთვის - zawsze
ყოველი - każdy
ყოლა - mieć | posiadać
ყორანი - kruk
ყოფნა - być
ყუმბარა - granat
ყურანი - Koran
ყურბელა - skorek
ყური - ucho
შაბათი - sobota
შაბათია - sobota
შადრევანი - fontanna
შავარდენი - sokół
შავი - czarny
შამპუნი - szampon
შანტაჟი - szantaż
შარდი - mocz
შარფი - szalik
შარშან - w zeszłym roku
შაქარი - cukier
შაშხანა - karabin
შეადარებს - porówna | od ადარებს
შეაერთებს - jednoczy
შედება - położyć | złożyć
შედეგი - rezultat
შედევრი - arcydzieło
შევარდენი - jastrząb
შეთქმულება - konspiracja
შემდეგ - po | potem
შემიძლია - mogę | umiem
შემოდგომა - jesień
შემოინახავს - oszczędzi | zachowa
შემოქმედება - twórczość
შენ - ty –
შენობა - budynek
შერიფი - szeryf
შესაძლებლობა - możliwość | zdolność
შესაძლოა - prawdopodobnie
შესახვევი - uliczka
შეუგნებელი - nieprzytomny
შეუპოვრობა - wytrwałość
შეუძლებელი - niemożliwy
შექცევადი - odwracalny
შეშა - drewno na opał
შეძლება - móc
შეჭამს - zje
შეხვდება - napotka
შეჯახება - kolizja
შვედეთი - Szwecja
შვეიცარია - Szwajcaria
შვეიცარული - szwajcarski
შვეცია - Szwecja
შვიდი - siedem
შვილი - dziecko
შვილიშვილი - wnuk
შთამომავალი - potomek
-ში - w | na | do
შიგნით - wewnątrz
შიდა - wewnętrzny
შიზოფრენია - schizofrenia
შიმშილი - głód
შირმა - ekran
შიშველი - nagi
შიში - lęk
შობა - urodziny | narodzenie
შოკოლადი - czekolada
შოლტი - bicz
შორეული - daleki
შორი - odległy
შორს - daleko
შოტლანდია - Szkocja
შოშია - szpak
შპეტი - pasterz
შპიონაჟი - szpiegostwo
შპრიცი - strzykawka
შრატი - serwatka
შროშანი - lilia
შტრიხი - cecha
შუადღე - południe
შუაღამე - północ
შუბი - włócznia
შუბლი - czoło
შუგა - parasol
შუკა - ulica
შურიანი - zazdrosny | zawistny
შურისგება - odwet
შუქურა - latarnia morska
შუქური - latarnia morska
შუღლი - wrogość
შუშპარი - taniec
შხამი - jad
შხაპი - prysznic
ჩადება - włożyć | wsadzić
ჩაზნექილობა - wklęsłość
ჩათვლის - uważa za
ჩაი - herbata
ჩანგალი - widelec
ჩანჩქერი - wodospad
ჩაქუჩი - młotek
ჩახლეჩილი - ochrypły
ჩემი - mój | moja | moje
ჩერნოგორია - Czarnogóra
ჩეხეთი - Czechy
ჩეხეთის რესპუბლიკა - Republika Czeska
ჩეხური - czeski
ჩვენ - my –
ჩვენი - nasz
ჩვიდმეტი - siedemnaście
ჩილე - Chile
ჩინეთი - Chiny
ჩინური - chiński
ჩირქი - ropa
ჩიტბატონა - szczygieł
ჩიტი - ptak
ჩობანი - pasterz
ჩოგბურთი - tenis
ჩონჩხი - szkielet
ჩრდილი - cień
ჩრდილოეთი - północ
ჩრჩილი - ćma
ჩქარი - szybki
ჩხუბი - bójka
ცა - niebo
ცალკეული - oddzielny
ცამეტი - trzynaście
ცელი - kosa
ცემენტი - cement
ცენზორობა - cenzura
ცენტრიფუგა - wirówka
ცერემონია - ceremonia
ცერი - kciuk
ცეცხლი - ogień
ცვილი - wosk
ცივი - zimny
ცივილიზაცია - cywilizacja
ციკლონი - cyklon
ცინიკური - cyniczny
ცირკი - cyrk
ცირკულაცია - cyrkulacja | krążenie
ცისარტყელა - tęcza
ცისტერნა - cysterna
ცისფერი - niebieski
ციტადელი - cytadela
ციხე-დარბაზი - zamek
ციხე-სიმაგრე - twierdza | forteca
ციხესიმაგრე - forteca
ცოდვა - grzech
ცოდვილი - grzesznik
ცოლი - żona
ცოლისძმა - szwagier
ცომი - ciasto
ცოტათი - nieco | odrobinę | trochę
ცოცხი - miotła
ცრემლი - łza
ცრუმორწმუნე - przesądny
ცრურწმენა - przesąd
ცუდი - zły
ცური - wymię
ცხელა - gorąco
ცხელი - gorący
ცხენი - koń
ცხენის ძალა - koń mechaniczny
ცხვარი - owca
ცხვირი - nos
ცხვირისმიერი - nosowy
ცხვირსახოცი - chusteczka do nosa
ცხოველი - zwierzę
ცხოვრება - życie
ცხრა - dziewięć
ცხრამეტი - dziewiętnaście
ძაბრი - lejek
ძალა - siła
ძალიან - zbyt | za bardzo
ძაღლი - pies
ძე - syn
ძეგლი - pomnik
ძერანა - żagiew łuskowata
ძეხვი - kiełbasa
ძვალი - kość
ძველი - stary
ძვირი - drogi
ძვირფასი - drogi | bliski | kochany
ძილგუდა - popielica
ძილი - spać | sen | spanie
ძირთეთრა - pasternak
ძლიერი - silny | mocny
ძმა - brat
ძმარი - ocet
ძმური - braterski
ძნელი - trudny
ძროხა - krowa
ძღვენი - prezentacja
წააგებს - przegra
წაბლი - kasztan
წავი - wydra
წამი - sekunda
წამწამი - rzęsa
წარმატება - sukces
წარმატებულად - skutecznie
წარმოთქვამს - wymówi | wymawia
წარმოთქმა - wymowa
წარუმატებელი - nieudany
წებო - klej
წებოვნება - lepkość
წელი - rok | pas | talia
წერა - pisanie | წერს
წერილი - list
წერო - bocian
წესიერი - przyzwoity
წვერი - wskazówka | wierzchołek | punkt | góra | broda
წვიმა - deszcz | padać
წიგნი - książka
წითელი - czerwony
წინა - poprzedni
წინადადებას - zdanie | wniosek
წინადაცვეთა - obrzezanie
წინამხარი - przedramię
წინდა - skarpeta
წინდებული - przyimek
წინწილი - talerz | czynel
წისქვილი - młyn
წიფელი - buk
წიწიბურა - gryka
წრე - kółko
წრეწირი - obwód
წუნი - defekt | wada
წურბელა - pijawka
წურვა - wyżymać | wyciskać | przecedzać
წუხელ - zeszłej nocy
წყალბადი - wodór
წყალდიდობა - powódź
წყალი - woda
წყალმცენარე - alga | glon
წყარო - źródło
წყლტუ - bezwłosy
ჭადრაკი - szachy
ჭამა - jedzenie
ჭამს - je
ჭერამი - morela
ჭერი - sufit
ჭექა - grzmot
ჭექა–ქუხილი - burza z piorunami
ჭეშმარიტი - prawdziwy
ჭვავი - żyto
ჭია - robak
ჭიაკოკონა - ognisko
ჭიანჭველა - mrówka
ჭიაყელა - dżdżownica
ჭიდაობა - zapasy
ჭიპი - pępek
ჭირიმე - mój drogi
ჭკა - kawka
ჭკუა - rozum
ჭორფლი - pieg
ჭრილობა - rana
ჭუჭყიანია - brudny
ხაბაზი - piekarz
ხავერდი - aksamit
ხავსი - mech
ხალი - znamię
ხალიჩა - dywan
ხალხი - naród | lud
ხალხური - ludowy
ხამანწკა - ostryga
ხანდახან - czasami
ხანძარი - pożar
ხანჯალი - sztylet
ხარატი - tokarz
ხარი - byk
ხარისხობრივი - jakościowy
ხარკოვი - Charków
ხარჩო - charczo
ხატვა - rysunek
ხატი - ikona
ხახვი - cebula
ხე - drzewo
ხეიბარი - kaleka
ხელახლა - znowu | znów
ხელთათმანი - rękawiczka
ხელი - ręka | ramię
ხელისუფლება - władza
ხელმოკლე - biedny
ხელმოწერა - podpis
ხელმძღვანელი - przywódca
ხელნაწერი - rękopis | manuskrypt
ხელოვნება - sztuka | twórczość artystyczna
ხელოსანი - rzemieślnik
ხენდრო - truskawka
ხეობა - dolina
ხვალ - jutro
ხვალინდელი - jutrzejszy
ხველა - kaszel
ხვლიკი - jaszczurka
ხვრელი - dziura
ხიდი - most
ხილი - owoc
ხილის სალათს - sałatka owocowa
ხილულობა - widoczność
ხინჯი - defekt | wada
ხის ნახშირი - węgiel drzewny
ხმადაბალი - cichy
ხმადაბლა - cicho
ხმალი - miecz
ხმამაღალი - głośny
ხმამაღლა - głośno
ხმის მიცემა - głosować
ხოლმე - wciąż
ხოლო - a | ale | jednak
ხომ - ale | jednak
ხორბალი - pszenica
ხორვატია - Chorwacja
ხორცი - mięso
ხოჭო - żuk
ხოხობი - bażant
ხრამი - przepaść | wąwóz
ხრახნი - śruba
ხრეში - żwir
ხსოვნა - pamięć
ხუთი - pięć
ხუთკუთხედი - pięciokąt
ხუთშაბათი - czwartek
ხურმა - persymona
ხურო - stolarz
ხშირად - często
ხშირი - częsty
ხშირ-ხშირად - często
ჯაგარი - szczecina
ჯაზი - jazz
ჯალათი - kat
ჯამი - suma
ჯან - nazwa litery ჯ
ჯანი - zdrowie
ჯანმრთელად - mocno | silnie
ჯანმრთელი - zdrowy
ჯანმრთელობა - zdrowie
ჯანჯაფილი - imbir
ჯარი - wojsko | armia
ჯარისკაცი - żołnierz
ჯაშუში - szpieg
ჯგუფი - grupa
ჯდომა - siedzieć
-ჯერ - -razy | -krotnie
ჯერ - po pierwsze | najpierw
ჯვარი - krzyż | monastyr Dżwari w Gruzji
ჯიბგირი - kieszonkowiec | złodziej kieszonkowy
ჯიბე - kieszeń
ჯიბუტი - Dżibuti
ჯილდო - nagroda
ჯილღა - ogier
ჯინჭარი - pokrzywa
ჯიპი - dżip | jeep
ჯირკვალი - gruczoł
ჯიუტად - uparcie
ჯიუტი - uparty
ჯოგი - stado
ჯორი - muł
ჯოხი - kij
ჯოჯო - jaszczurka
ჯოჯოხეთი - piekło
ჯუნგლი - dżungla
ჯუჯა - karzeł | liliput | karłowaty
ჰაე - nazwa litery ჰ
ჰაერბურთი - balon
ჰაერი - powietrze
ჰავა - klimat
ჰალსტუკი - krawat | alternatywna pisownia słowa ჰალსტუხი
ჰალსტუხი - krawat
ჰალუცინაცია - halucynacja
ჰამაკი - hamak
ჰარმონია - harmonia
ჰარმონიული - harmonijny
ჰაშიში - haszysz
ჰეგემონია - hegemonia
ჰელიუმი - hel
ჰერმაფროდიტი - hermafrodyta | obojniak
ჰეროინი - heroina
ჰეტეროგენული - niejednorodny
ჰეტეროსექსუალობა - heteroseksualizm
ჰექტარი - hektar
ჰიგიენა - higiena
ჰიდროელექტროსადგური - elektrownia wodna
ჰიმნი - hymn
ჰიპოპოტამი - hipopotam
ჰო - tak  დიახ i კი
ჰოლანდია - Holandia
ჰოლანდიური - holenderski
ჰომოსექსუალობა - homoseksualizm
ჰონგ კონგი - Hongkong
ჰონგკონგი - Hongkong
ჰონდურასი - Honduras
ჰორმონი - hormon
ჰოროსკოპი - horoskop
ჰუმანიზმი - humanizm
ჰუმანიტარული - humanitarny
ჰუმანური - ludzki | humanitarny
ჰუნე - koń
