Aachen - Akwizgran
a baj nem jár egyedül - nieszczęścia chodzą parami
abaka - banan manilski
abakusz - abak, abakus
abaposztó - samodział
abbahagy - odstawić, porzucić, przestać, zaniechać
abbahagyni - zaprzestawać, zaprzestać
ábécé - alfabet, abecadło
ábécéskönyv - elementarz
aberráció - aberracja
abesszin - Abisyńczyk, abisyński
abház - Abchaz, abchaski
Abházia - Abchazja
Abigél - Abigail (imię żeńskie)
ablak - okno
ablakadó - podatek od okna
ablakdeszka - parapet
ablakfa - futryna okienna
ablakgitt - kit okienny
ablakkeret - rama okna
ablakos - szklarz okienny
ablakroló - roleta
ablaktörlő - wycieraczka samochodowa
ablakülés - miejsce przy oknie
ablaküveg - szyba, szkło okienne
abnormális - anormalny, nienormalny
abonens - abonent
abortál - dokonać aborcji
abortusz - poronienie, aborcja
abortuszklinika - klinika aborcyjna
ábra - rysunek
Ábrahám - Abraham
abrak - obrok, pasza, karma
ábránd - urojenie
ábrándos - marzycielski
ábrándozik - marzyć, fantazjować
ábrázol - przedstawiać
abroncs - obręcz, opona
abroncsnyomás - ciśnienie powietrza w kole (oponie)
abrosz - obrus
abszcissza - odcięta
abszint - absynt
abszolút - absolutny, bezwzględny
abszolútérték - wartość bezwzględna
abszolutizmus - absolutyzm
abszorpció - absorpcja
absztinencia - abstynencja, wstrzemięźliwość
absztrakció - abstrakcja
absztrakt - abstrakcyjny
abszurd - absurdalny
abszurdum - absurd
Abu-Dzabi - Abu Zabi
acél - stal
acélmű - stalownia
acélos - stalowy
a cél szentesíti az eszközt - cel uświęca środki
acélszürke - stalowoszary
acéltoll - stalówka
acetaldehid - acetaldehyd
acetát - octan
acetilén - acetylen
acetilkolin - acetylocholina
aceton - aceton
acidózis - kwasica
ács - cieśla
ad - dawać
adag - porcja
adagol - dawkować, dozować
adagolás - dawkowanie
Ádám - Adam, imię męskie
ádámcsutka - jabłko Adama
adaptáció - adaptacja
adás - audycja radiowa lub telewizyjna
adásszünet - przerwa w audycji radiowej lub telewizyjnej
adat - szczegół, dana
adatállomány - plik
adatbank - bank danych
adatbázis - baza danych
adatfeldolgozás - przetwarzanie danych
addig - dotychczas, dotąd
addigi - dotychczasowy
addig üsd a vasat, amíg meleg - kuj żelazo, póki gorące
Addisz-Abeba - Addis Abeba
adekvát - adekwatny, odpowiedni
Adelaida - Adelajda (miasto w Australii)
adenozin-trifoszfát - adenozynotrifosforan
adminisztráció - administracja
adminisztrációs - administracyjny
adminisztrál - administrować
adminisztratív - administracyjny
adminisztrátor - administrator
admirális - admirał
admittancia - admitancja
adó - podatek, nadajnik radiowy lub telewizyjny
adóalany - podatnik
adófizető - podatnik
adoma - anegdota
adományoz - darowywać, darować
adóparadicsom - raj podatkowy
adoptál - adoptować
Adorján - Adrian
adós - dłużnik, dłużniczka, dłużny, winien, winny
adósság - dług
adott - dany
adottság - dar, talent
adrenalin - adrenalina
Adria - Adriatyk
Adriai-tenger - Morze Adriatyckie
adszorpció - adsorpcja
adu - atut
AEÁ - Stany Zjednoczone Ameryki Północnej
aeronómia - aeronomia
aeroszol - aerozol
a falnak is füle van - ściany mają uszy
afgán - Afgańczyk, Afganka, afgański
Afganisztán - Afganistan
afganisztáni - afganistański, afgański
áfonya - borówka
aforizma - aforyzm
Afrika - Afryka
afrikaans - język afrykanerski
afrikai - afrykański, Afrykanin, Afrykanka
ág - gałąź
aga - aga
agancs - poroże
agár - chart
ágas-bogas - rozgałęziony, gałęzisty
agáve - agawa
ágazat - gałąź
agg - bardzo stary, sędziwy, starzec, staruszek
aggály - skrupuł
aggastyán - staruszek
aggasztó - alarmujący, niepokojący
agglegény - kawaler
agglomeráció - aglomeracja
aggodalom - zmartwienie
aggódik - przejmować się, martwić się
aggódó - zmartwiony
agilis - energiczny
agitáció - agitacja
agitációs - agitacyjny
agitál - agitować
Ágnes - Agnieszka
agónia - agonia
Ágoston - Augustyn
agrár - agrarny, rolny, rolniczy
agrárium - rolnictwo
agresszió - agresja
agresszív - agresywny
agronómus - agronom
agy - mózg
ágy - łóżko
agyag - glina
agyagos - gliniasty
agyar - kieł
ágyas - konkubina
ágybetét - materac
agyhártyagyulladás - zapalenie opon mózgowo-rdzeniowych
ágynemű - pościel
agyonüt - zabijać, zabić
agyrázkódás - wstrząs mózgu
agytörzs - pień mózgu
ágyú - działo, armata
agyvelő - mózg
agyvelőgyulladás - zapalenie mózgu
agyvérzés - wylew krwi do mózgu
a hazug embert hamarabb utolérik, mint a sánta kutyát - kłamstwo ma krótkie nogi
áhítozás - pragnienie
ahogy - jak
ahol - gdzie
aikidó - aikido
Aiszóposz - Ezop
aj - och
ajak - warga
ajakhasadék - rozszczep wargi
ajakrúzs - szminka
ajándék - prezent
ajándék lónak ne nézd a fogát - darowanemu koniowi w zęby się nie zagląda
ajándékoz - darować, podarować, sprezentować
ajándéktárgy - pamiątka
ajánl - zalecać, polecać, proponować
ajánlás - polecenie, dedykacja
ajánlat - propozycja
ajánlólevél - list polecający
ajóka - sardela
ájtatos - pobożny, nabożny
ájtatosság - pobożność, nabożność
ajtó - drzwi
ajtókulcs - klucz do drzwi
ajtószám - numer pokoju lub mieszkania
ájulás - omdlenie
akác - akacja
akácfa - akacja
akadály - przeszkoda
akadályoz - utrudniać, przeszkadzać
akadálytalan - niezakłócony, bez przeszkód
akadémia - akademia
akadémiai - akademicki
akadémikus - akademik
akar - chcieć
akarat - wola
akaraterő - siła woli
akaratlan - mimowolny, nieumyślny
akármikor - kiedykolwiek
akaszt - wieszać, zawieszać
akasztás - powieszenie
akasztó - wieszak
akasztófa - szubienica
akasztófahumor - czarny humor, wisielczy humor
akceleráció - przyśpieszenie
akcentus - akcent
akció - akcja
akciófilm - film sensacyjny
Akhilleusz - Achilles
aki - kto
aki keres, az talál - kto szuka, ten znajdzie
aki kíváncsi, hamar megöregszik - ciekawość to pierwszy stopień do piekła
aki másnak vermet ás, maga esik bele - kto pod kim dołki kopie, sam w nie wpada
aki mer, az nyer - kto nie ryzykuje, ten nie ma
aki nem dolgozik, ne is egyék - bez pracy nie ma kołaczy
aki sokat markol, keveset fog - chciwy dwa razy traci
aki szelet vet, vihart arat - kto sieje wiatr, ten zbiera burzę
a kivétel erősíti a szabályt - wyjątek potwierdza regułę
akkor - wówczas, wtedy
akkord - akord
akkreditáció - akredytacja
akkumulátor - akumulator
akna - mina
aknamező - pole minowe
aknász - górnik
akrilsav - kwas akrylowy
akrobata - akrobata, akrobatka
akrobatika - akrobatyka, akrobacja
akrobatikus - akrobatyczny
akrofóbia - akrofobia
akt - akt
akta - akt, dokument
aktatáska - aktówka
aktínium - aktyn
aktív - aktywny
aktivál - uaktywnić, uruchomić
aktiválás - aktywacja
aktivista - aktywista
aktivitás - aktywność
aktivizál - aktywować
aktuális - aktualny
akupunktúra - akupunktura
akusztika - akustyka
akusztikus - akustyczny
a kutya ugat, a karaván halad - psy szczekają, karawana idzie dalej
akvarell - akwarela
akvarellfestő - akwarelista
akvárium - akwarium
alá - pod
aláaknáz - podkopywać, podkopać
alabástrom - alabaster
alacsony - niski
alagsor - suterena
alagút - tunel
aláhúz - podkreślać, podkreślić
aláír - podpisywać, podpisać
aláírás - podpis
Alajos - Alojzy
alak - kształt, figura
alaki - formalny
alakít - tworzyć, formować, kształtować
alaktalan - bezpostaciowy
alaktan - morfologia
alaktani - morfologiczny
alamizsna - jałmużna
alany - podmiot
alanyeset - mianownik
alanyi - podmiotowy, subiektywny
alap - podstawa, baza
alapít - zakładać, założyć
alapítás - założenie
alapító - założyciel, fundator
alapítvány - fundacja
alapos - gruntowny, dokładny
alaposan - dokładnie
alapvető - podstawowy, fundamentalny, zasadniczy
álarc - maska
álarcos - zamaskowany, maskaradowy
álarcosbál - bal maskowy
alárendelt - podległy, podporządkowany
Alaszka - Alaska
a látszat csal - pozory mylą
alatt - pod, w
alattomos - podstępny
alattvaló - poddany, podwładny
alávaló - podły, nikczemny
alávalóság - podłość, nikczemność
alázat - pokora
alázatos - pokorny
albán - Albańczyk, Albanka, język albański, albański
Albánia - Albania
albatrosz - albatros
albérlet - sublokatorstwo
albérlő - sublokator, sublokatorka
Albin - Albin
albizottság - podkomisja
album - album
alcím - podtytuł
alcsoport - podgrupa
áld - błogosławić
áldás - błogosławieństwo
Aldebaran - Aldebaran
áldott - błogi, błogosławiony
áldoz - poświęcić
áldozat - ofiara
áldozati - ofiarny
áldozatkész - ofiarny
áldozatkészség - ofiarność
a lélek kész, de a test erőtlen - dusza chętna, ale ciało słabe
alelnök - wiceprezydent
alendronsav - kwas alendronowy
alezredes - podpułkownik
alfabetikus - alfabetyczny
alfaj - podgatunek
alföld - nizina
Alfonz - Alfons
alga - alga, wodorost, glon
algebra - algebra
algebrai - algebraiczny
Algéria - Algieria
algériai - Algierczyk, Algierka, algierski
alginsav - kwas alginowy
Algír - Algier
algoritmus - algorytm
alhas - podbrzusze
alibi - alibi, usprawiedliwienie
alig - ledwie, zaledwie
aligátor - aligator
alj - dno, spód, spódnica
aljas - niegodziwy, nikczemny
aljasság - niegodziwość, nikczemność
alka - alka
alkalmas - odpowiedni, stosowny, przydatny, zdatny
alkalmasint - prawdopodobnie
alkalmaz - angażować, zastosować
alkalmazás - zastosowanie, zatrudnienie
alkalmazható - stosowny, odpowiedni
alkalmazott - pracownik, pracownica
alkalmi - okazyjny, okolicznościowy
alkalom - okazja
alkalom szüli a tolvajt - okazja czyni złodzieja
alkamazott - pracownik, pracownica
alkar - przedramię
alkímia - alchemia
alkimista - alchemik
alkirály - wicekról
alkirálynő - wicekrólowa
alkohol - alkohol
alkoholista - alkoholik
alkoholizmus - alkoholizm
alkoholmentes - bezalkoholowy
alkoholos - alkoholowy
alkony - zmierzch, zmrok
alkonyat - zmierzch
alkot - tworzyć, stworzyć
alkotmány - konstytucja
alkotmányellenes - niekonstytucyjny
alkotmányos - konstytucyjny, konstytucjonalny
alkotó - twórca
alku - targowanie się
álkulcs - wytrych
áll - stać, stanąć
állam - państwo
államcsíny - przewrót, zamach stanu
államelnök - prezydent państwa
államférfi - mąż stanu, polityk
államfő - głowa państwa
államforma - ustrój państwa
állami - państwowy
államközi - międzypaństwowy
államosít - nacjonalizować
államosítás - nacjonalizacja
állampolgár - obywatel, obywatelka (państwa)
állampolgárság - obywatelstwo
állandó - stała
állandóan - stale
állapotos - w ciąży, ciężarny
állat - zwierzę
állati - zwierzęcy
állatkert - ogród zoologiczny
állatorvos - weterynarz
állatorvosi - weterynaryjny
állattan - zoologia
állattani - zoologiczny
allegória - alegoria
allegorikus - alegoryczny
allergia - alergia
allergiás - alergiczny
allergológia - alergologia
állhatatos - stały
állhegy - podbródek
alligátor - aligator
állít - stawiać, postawić, twierdzić, stwierdzać, stwierdzić
alliteráció - aliteracja
állítható - regulowalny, nastawny
állkapocs - szczęka
állkapocscsont - żuchwa
allofón - alofon
állóhely - miejsce stojące
állomás - stacja
allopurinol - allopurinol
alluviális síkság - równina aluwialna
alma - jabłko
almabor - cydr, jabłecznik
almafa - jabłoń
almalé - sok jabłkowy
almanach - almanach
almasav - kwas jabłkowy
almáslepény - szarlotka
álmatlan - bezsenny
álmatlanság - bezsenność
álmodik - marzyć, śnić
álmos - śpiący, senny
álmosító - śpiący, senny
álmosság - senność
alól - spod
álom - sen
alpakka - alpaka, nowe srebro
alpesi - alpejski
Alpok - Alpy
alsó - dolny
alsónadrág - majtki
alsónemű - bielizna
Alsó-Szászország - Dolna Saksonia
alsószoknya - halka
álszent - hipokryta
alszik - spać
általában - ogólnie, powszechnie
általános - powszechny, uniwersalny
általános forgalmi adó - podatek od wartości dodanej, VAT
altat - usypiać
altatódal - kołysanka
altatóorvos - anestezjolog
alternatív - alternatywny
alternatíva - alternatywa
altruista - altruista, altruistyczny
altruizmus - altruizm
aludni - spać
alumínium - glin, aluminium
aluszik - spać
alvajáró - lunatyk, lunatyczka
alvás - sen, spanie
Amadé - Amadeusz
amalgám - amalgamat
Amália - Amalia, Amelia
amatőr - amator, amatorka
Amazonas - Amazonka
ambíció - ambicja
ambiciózus - ambitny
Ambrus - Ambroży
amelyik kutya ugat, az nem harap - krowa, która dużo ryczy, mało mleka daje
amerícium - ameryk
Amerika - Ameryka
amerikai - amerykański
amerikai angol - amerykańska odmiana języka angielskiego
Amerikai Egyesült Államok - Stany Zjednoczone Ameryki
amerikaimogyoró - orzech ziemny
Amerikai Szamoa - Samoa Amerykańskie
Amerikai Virgin-szigetek - Wyspy Dziewicze Stanów Zjednoczonych, amerykańskie terytorium zależne na Morzu Karaibskim
amerikanizmus - amerykanizm
ametiszt - ametyst
amfetamin - amfetamina
amfiteátrum - amfiteatr
amfóra - amfora
amhara - amharski
ami - co
amikor - kiedy, gdy
amilyen az adjonisten, olyan a fogadjisten - jak Kuba Bogu, tak Bóg Kubie
amin - amina
aminosav - aminokwas
ammónia - amoniak
amnesztia - amnestia
amnézia - amnezja
amőba - ameba
amoxicillin - amoksycylina
amper - amper
ampicillin - ampicylina
amputál - amputować
Amszterdam - Amsterdam
amulett - amulet
anagramma - anagram
anakronizmus - anachronizm
analfabéta - analfabeta, analfabetka
analgézia - analgezja
analitikus - analityczny
analízis - analiza
analóg - analogiczny
analógia - analogia
ananász - ananas
anarchia - anarchia
anarchikus - anarchiczny
anarchista - anarchista, anarchistka
anarchizmus - anarchizm
Anasztázia - Anastazja (imię żeńskie)
Anatólia - Anatolia
anatómia - anatomia
anatómiai - anatomiczny
anatómus - anatom
Ancsa - węgierskie imię żeńskie
Andalúzia - Andaluzja
Andok - Andy
Andorra - Andora
andragógia - andragogika
András - Andrzej
Androméda - Andromeda
anekdota - anegdota
anémia - anemia
aneszteziológus - anestezjolog
Angéla - Angela
Angelika - Andżelika, Angelika
Anglia - Anglia
anglicizmus - anglicyzm
anglikán - anglikański
angol - angielski
Angola - Angola
angolna - węgorz
angolszalonna - bekon
angolszász - anglosaski
angolul - po angielsku
Anguilla - Anguilla
angyal - anioł
angyali - anielski
angyalka - cherubinek, aniołek
animáció - animacja
animizmus - animizm
Anita - Anita
anizotrop - anizotropowy
ánizs - anyż, biedrzeniec anyż
Ankara - Ankara
ankét - ankieta
Anna - Anna
annektál - anektować
anód - anoda
anomália - anomalia
anorexia - anoreksja
antagonista - antagonista
antagonizmus - antagonizm
Antal - Antoni
Antarktisz - Antarktyka
antenna - antena
antialkoholista - abstynent, osoba nie pijąca alkoholu
antibiotikum - antybiotyk
antidemokratikus - antydemokratyczny
antifasiszta - antyfaszysta
Antigua és Barbuda - Antigua i Barbuda
antik - antyczny
antiklerikális - antyklerykalny
antikvárium - antykwariat
antikvitás - starożytność
antilop - antylopa
antimon - antymon
antinómia - antynomia
antipátia - antypatia, niechęć, wstręt
antipatikus - antypatyczny
antiszemita - antysemicki
antiszemitizmus - antysemityzm
antiszociális - aspołeczny
antitest - antyciało
antitézis - antyteza
antológia - antologia
antonima - antonim
antropológia - antropologia
antropológus - antropolog
antropomorfizmus - antropomorfizm, antropomorfizacja
Antwerpen - Antwerpia
anya - matka
anyacsavar - nakrętka
anyadisznó - locha, maciora
anyaföld - ojczyzna
anyag - materiał
anyagbeszerző - zaopatrzeniowiec
anyagcsere - metabolizm
anyagi - materialny
anyagias - materialista, materialistka
anyahajó - okręt lotniczy
anyai - macierzyński, matczyny
anyajegy - znamię
anyaméh - macica
anyanyelv - język ojczysty
anyarozs - buławinka czerwona
anyaság - macierzyństwo
anyasági - macierzyński
anyós - teściowa
anyu - mama
anyuka - mamusia
aorta - aorta
apa - ojciec
apáca - zakonnica
apácafőnöknő - przeorysza
apai - ojcowski
apály - odpływ
apaság - ojcostwo
apát - opat
apátia - apatia
apatikus - apatyczny
apátnő - przeorysza
apátság - opactwo
a pénz nem boldogít - pieniądze szczęścia nie dają
aperitif - aperitif
apetítus - apetyt
Aphrodité - Afrodyta
apokalipszis - apokalipsa
ápol - pielęgnować
ápolatlan - zaniedbany
Apollónia - Apolonia
ápoló - pielęgniarz
ápolónő - pielęgniarka
ápolt - pacjent, pacjentka, wypielęgnowany
apoplexia - apopleksja, udar mózgu
após - teść
apostol - apostoł
apostoli - apostolski
aposztróf - apostrof
apparátus - aparat
április - kwiecień
áprilisi - kwietniowy
apró - drobny
apród - paź
aprófa - drewno na podpałkę, szczapa
apu - tatuś
ár - cena, ar
ara - panna młoda, ara
arab - Arab, arabski
arabeszk - arabeska
Arab-félsziget - Półwysep Arabski
áradás - powódź
Aragónia - Aragonia
árajánlat - oferta cenowa
araknofóbia - arachnofobia
áram - prąd
áramerősség - amperaż
árammérő - amperomierz
arany - złoto, złoty
arány - proporcja
aranyérem - złoty medal
aranyfa - forsycja
aranyhal - złota rybka
aranyláz - gorączka złota
aranymetszés - złoty podział
aranyos - złocisty, milutki
arányos - proporcjonalny
aranyozott - pozłacany
aranysárga - złotożółty
aránytalan - dysproporcjonalny
aranyzott - pozłacany
arasz - piędź
arat - zbierać plony
aratás - żniwa
arató - żniwiarz, żniwiarka
árboc - maszt
arborétum - arboretum
arc - twarz, policzek, mina
arcbőr - cera
arcél - profil
archaikus - archaiczny
archaizmus - archaizm
archeológia - archeologia
archeológiai - archeologiczny
archeológus - archeolog
architektúra - architektura
archívum - archiwum
arcjáték - mimika
arckép - portret
arckrém - krem do twarzy
arculütés - uderzenie otwartą dłonią w policzek
arcvonal - linia frontu
aréna - arena
argentin - Argentyńczyk, Argentynka, argentyński
Argentína - Argentyna
argó - argot
argon - argon
ária - aria
arisztokrácia - arystokracja
arisztokrata - arystokrata
arisztokratikus - arystokratyczny
Arisztotelész - Arystoteles
arisztotelianizmus - arystotelizm
aritmetika - arytmetyka
arkangyal - archanioł
Arktisz - Arktyka
árnika - arnika górska
árny - cień
árnyék - cień
árnyékos - cienisty
árok - rów, kanał
aroma - aromat
Áron - Aaron
árpa - jęczmień
arrogáns - arogancki
árt - szkodzić
ártalmas - szkodliwy
ártalmatlan - nieszkodliwy
ártatlan - niewinny
ártatlanság - niewinność
artéria - arteria
articsóka - karczoch
artikuláció - artykulacja
artista - artysta
Artúr - Artur
áru - towar
Aruba - Aruba
áruház - dom towarowy
árul - sprzedawać
áruló - zdrajca
árus - sprzedawca
árusítás - sprzedaż
árva - sierota
árvácska - bratek
árvaház - sierociniec
árverés - aukcja
árvíz - powódź
arzén - arsen
arzénsav - kwas arsenowy
ás - kopać
Ascension-sziget - Wyspa Wniebowstąpienia
ásít - ziewać
ásítás - ziewnięcie, ziewanie
askenázi - Aszkenazyjczyk, Żyd aszkenazyjski, aszkenazyjski
ásó - szpadel
aspiráns - aspirant
asszimiláció - asymilacja
Asszíria - Asyria
asszisztál - asystować
asszisztens - asystent
asszisztensnő - asystentka
asszociáció - asocjacja, skojarzenie
asszociál - asocjować
asszony - kobieta
asszonyos - kobiecy
asszonytárs - koleżanka
ásvány - minerał
ásványolaj - ropa naftowa
ásványtan - mineralogia
ásványvíz - woda mineralna
ász - as, mistrz
aszály - susza
aszeptikus - aseptyczny
a szerencsét keltegetni kell - o szczęście trzeba dbać
aszexuális - aseksualny
aszexualitás - aseksualność
aszfalt - asfalt
aszimmetrikus - asymetryczny
aszkéta - asceta
aszkorbinsav - kwas askorbinowy
a szomszéd rétje mindig zöldebb - wszędzie dobrze, gdzie nas nie ma ( łąka sąsiada zawsze bardziej zielona)
aszpirin - aspiryna
asztácium - astat
asztal - stół
asztalitenisz - tenis stołowy
asztaliteniszező - pingpongista
asztalos - stolarz
asztalosműhely - stolarnia
asztalterítő - obrus
Asztana - Astana
asztma - astma
asztrofizika - astrofizyka
asztrolábium - astrolabium
asztrológia - astrologia
asztrológus - astrolog
asztronauta - astronauta
asztronómia - astronomia
asztronómus - astronom
át - przez
átad - doręczyć, dostarczyć
átalány - ryczałt
atavizmus - atawizm
ateista - ateista
ateizmus - ateizm
Athén - Ateny
a tiltott gyümölcs mindig édesebb - zakazany owoc smakuje najlepiej
átírás - transliteracja
atka - roztocze
átlag - średnia, przeciętna
átlagos - przeciętny, średni
Atlanti-óceán - Ocean Atlantycki
atlasz - atlas
átlátszó - przeźroczysty, przezroczysty
atléta - atleta
atlétanő - atletka
atlétika - lekkoatletyka
atlétikai - lekkoatletyczny
átló - przekątna
átmenet - przejście
átmeneti - tymczasowy, przejściowy
átmenetileg - tymczasowo, przejściowo
átmérő - średnica
atmoszféra - atmosfera
átnéz - przeglądać, przejrzeć
átok - przekleństwo, klątwa
atoll - atol
atom - atom
atombomba - bomba atomowa
atomenergia - energia atomowa
atomerőmű - elektrownia atomowa
atomfegyver - broń atomowa
atommag - jądro
atomreaktor - reaktor atomowy
a történelem az élet tanítómestere - historia nauczycielką życia
atropin - atropina
attasé - attaché
áttekintés - przegląd
Attila - Attyla
áttörés - przełom
attrakció - atrakcja
attraktív - atrakcyjny
attribútum - atrybut
a tudás hatalom - wiedza to potęgi klucz
atya - ojciec
atyai - ojcowski
audiovizuális - audiowizualny
auditórium - audytorium
augusztus - sierpień
augusztusi - sierpniowy
aukció - aukcja
aura - aura
ausztrál - Australijczyk, Australijka, australijski
Ausztrália - Australia (państwo i kontynent)
Ausztria - Austria
autentikus - autentyczny
autizmus - autyzm
autó - samochód
autóbaleset - wypadek samochodowy
autóbusz - autobus
autóbuszjárat - linia autobusowa
autóbuszjegy - bilet autobusowy
autóbuszmegálló - przystanek autobusowy
autóbuszpályaudvar - dworzec autobusowy
autóbuszvezető - kierowca autobusu
autóduda - klakson
autóemelő - podnośnik samochodowy
autogram - autograf
autógumi - opona
autógyár - fabryka samochodów
autókarambol - wypadek samochodowy
autokláv - autoklaw
autóklub - automobilklub
automata - automat, automatyczny
automatikus - automatyczny
automatizál - automatyzować
autonóm - autonomiczny
autonómia - autonomia
autópálya - autostrada
autórádió - radio samochodowe
autóstop - autostop
autószerelő - mechanik samochodowy
autótérkép - mapa drogowa
autóút - droga ekspresowa
autóvezető - kierowca
autózik - jechać samochodem
avar - awarski
avas - zjełczały
avatára - awatar
a vér nem válik vízzé - krew nie woda
avokádó - awokado
axióma - aksjomat
azbeszt - azbest
Azerbajdzsán - Azerbejdżan
az éremnek két oldala van - każdy medal ma dwie strony
azeri - Azer, Azerka, azerski
az idő pénz - czas to pieniądz
azonban - ale, jednak, natomiast
azonkívül - ponadto, oprócz tego, poza tym
azonnal - natychmiast
azonos - identyczny
azonosít - identyfikować, zidentyfikować
azonosítás - identyfikacja
azonosság - tożsamość
Ázsia - Azja
ázsiai - Azjata, Azjatka, azjatycki
aztán - potem, następnie
azután - potem
-ba - do (kogo, czego)
bab - fasola, ziarenko, ziarno, fasolka
báb - kukiełka, pacynka, kokon
baba - niemowlę, niemowlak, lalka
bába - położna, wiedźma, iluzja
bababútor - meble dla lalek
babakelengye - wyprawka dziecięca
babakocsi - wózek dziecięcy
babér - wawrzyn
babérkoszorú - wieniec laurowy
babérlevél - liść laurowy
babfőzelék - potrawa z gotowanej fasoli
bábjáték - przedstawienie kukiełkowe
babkávé - kawa ziarnista
bábkormány - rząd marionetkowy
bableves - zupa fasolowa
babona - zabobon, przesąd
babonás - zabobonny, przesądny
bábszínház - teatr kukiełkowy
bacilus - bakcyl
bacitracin - bacytracyna
bácsi - wuj, wujek, stryj, stryjek, baca
badar - głupi, głupawy
badarság - bełkot, bzdura
bádog - blacha
bádogedény - naczynie blaszane
bádogos - blacharz
Bagdad - Bagdad
bagoly - sowa
bagoly mondja verébnek, hogy nagyfejű - przyganiał kocioł garnkowi, a sam smoli
bágyadt - znużony
bágyadtság - znużenie
Bahama-szigetek - Bahamy
Bahrein - Bahrajn
baj - choroba, kłopot, nieszczęście
báj - wdzięk, urok, czar
bajban ismerszik meg a jó barát - prawdziwych przyjaciół poznaje się w biedzie
bajnok - mistrz
bajnoknő - mistrzyni
bajnokság - mistrzostwo
bajonett - bagnet
bajor - bawarski, Bawarczyk, Bawarka
Bajorország - Bawaria
bajos - kłopotliwy, uciążliwy
bájos - uroczy
bajusz - wąsy
bak - kozioł
Bak - Koziorożec (gwiazdozbiór)
baka - żołnierz
bakteriológia - bakteriologia
bakteriológus - bakteriolog
baktérium - bakteria
bal - lewy
bál - bal
balalajka - bałałajka
Balázs - Błażej
Baleár-szigetek - Baleary
baleset - wypadek
balett - balet
balettcipő - baletka
balhé - draka
Bálint - Walenty, Walentyn
Balkán - Bałkany
balkáni - bałkański
balkon - balkon
ballada - ballada
ballisztika - balistyka
bálna - wieloryb
bálnavadászat - wielorybnictwo
baloldali - lewicowy
balparti - lewobrzeżny
balra - na lewo, w lewo
balsafa - ogorzałka wełnista, balsa
balsikerű - nieudany
balsors - niedola
balszerencse - pech
balta - topór, siekiera
bálterem - sala balowa
Balti-tenger - Morze Bałtyckie
bálvány - bałwan, idol, posąg bóstwa
bálványimádás - bałwochwalstwo
bálványoz - uwielbiać
balzsam - balsam
balzsamos - balsamiczny
bambara - język bambara
bambusz - bambus
bámul - podziwiać
bámulatos - wzorowy, godny podziwu
-ban - w
bán - żałować
banális - banalny
banán - banan
bánásmód - traktowanie
bánat - smutek
bánatos - smutny
bánatosan - smutno, ze smutkiem
banda - banda
bandita - bandyta
Banglades - Bangladesz
bánik - traktować
bank - bank
bankár - bankier
bankautomata - bankomat
bankett - bankiet
bankház - dom bankowy
bankjegy - banknot
bankszámla - konto bankowe
banya - czarownica, wiedźma
bánya - kopalnia
bányamérnök - inżynier górnictwa
bányász - górnik
bányászat - górnictwo
bányászik - wydobywać
bányaváros - miasto górnicze
baptizmus - baptyzm
bár - chociaż, choć
barack - morela, brzoskwinia
barackíz - marmolada morelowa
barackpálinka - morelówka
barakk - barak
bárány - baran
bárányhimlő - ospa wietrzna
bárányhús - baranina
báránysült - pieczeń barania
barát - przyjaciel, mnich, zakonnik
baráti - braterski, przyjacielski, przyjazny
barátkeselyű - sęp kasztanowaty
barátkozik - przyjaźnić się
barátnő - przyjaciółka
barátság - przyjaźń
barátságos - przyjazny, życzliwy
barátságosan - przyjaźnie, przyjacielsko
barátságosság - przyjacielskość, życzliwość
barátságtalan - nieprzyjazny
barázda - bruzda
Barbados - Barbados
barbár - barbarzyński, barbarzyńca
Barbara - Barbara
barbiturát - barbituran
bárgyú - durnowaty, durny
barhent - barchan
barikád - barykada
bariton - baryton
bárium - bar
barkócafa - jarząb brekinia
barlang - grota, jaskinia
barlangtan - speleologia
bármikor - kiedykolwiek
barna - brązowy (kolor), brunatny, brunet, brunetka
Barnabás - Barnaba
báró - baron
barokk - barok, barokowy
barom - bydło (zwierzęta hodowlane)
barométer - barometr
baromfi - drób
baromfiudvar - wybieg dla drobiu
bárónő - baronowa
bársony - aksamit, welwet
bárszék - stołek barowy
baseball - baseball
basszista - bas (śpiewak)
basszus - bas (niski głos męski)
basszusbariton - bas-baryton (głos męski)
basszusgitár - gitara basowa
bástya - baszta
baszik - rżnąć, jebać, pieprzyć
baszk - język baskijski, Bask, baskijski
bátor - dzielny, odważny
bátorít - ośmielać, dodawać odwagi
bátorság - odwaga
báty - starszy brat
bátya - starszy brat
batyu - tobołek, tłumok
bauxit - boksyt
bazár - bazar
Bázel - Bazylea
bazsalikom - bazylia
bazsarózsa - piwonia
be - w, do
-be - do (kogo, czego)
bead - podawać, podać, aplikować
beadvány - podanie (pismo)
beakaszt - zawieszać, zawiesić
bebörtönzés - uwięzienie
becs - wartość
Bécs - Wiedeń, stolica Austrii
becsap - oszukiwać, oszukać
becsempész - przemycić
becses - wartościowy, cenny
becstelen - nieuczciwy
becsuk - zamykać, zamknąć
becsül - cenić
becsület - honor
becsületes - uczciwy
becsvágy - ambicja
becsvágyó - ambitny
beépített - wbudowany, zabudowany
befagy - zamarznąć
befecskendez - wstrzyknąć
befecskendezés - zastrzyk
befejez - kończyć
befejezés - zakończenie, wykończenie
befejezetlen - niedokończony
befektet - inwestować, zainwestować
befizet - wpłacać, wpłacić
befolyásos - wpływowy
begónia - begonia
behozatal - import
beidéz - pozywać, pozwać
beismer - przyznać się, wyznać
bejárat - wejście, wjazd
bejegyez - rejestrować
bejelent - anonsować, ogłaszać
bejelentés - zawiadomienie, oświadczenie
bejgli - strucla
bejön - wchodzić, wejść
Bejrút - Bejrut
béka - żaba
békaember - płetwonurek
béke - pokój, zgoda
beken - smarować, posmarować
beképzelt - zarozumiały
békés - pokojowy
bekezdés - akapit, paragraf, ustęp
bél - jelito
Belarusz - Białoruś
beleegyezés - zgoda, pozwolenie, aprobata
belép - wchodzić, wejść
belépés - wstęp
bélés - podszewka
beleszeret - zakochać się
belföld - kraj
belföldi - krajowy
belga - belgijski
Belgium - Belgia
bélgörcs - kolka
Belgrád - Belgrad
belgyógyász - internista
Belize - Belize
Belmopan - Belmopan
Belorusszia - Białoruś
belorusz - białoruski, Białorusin, Białorusinka, białoruski (język)
belső - wewnętrzny
belsőleg - wewnętrznie
bélszín - polędwica
belül - wewnątrz
belváros - śródmieście
belvárosi - śródmiejski
bélyeg - znaczek pocztowy
bélyeggyűjtő - filatelista
bélyegző - stempel, pieczęć
bemegy - wchodzić, wejść
bemondó - spiker, spikerka
bemutat - prezentować, przedstawiać, demonstrować
bemutató - pokaz, rewia, premiera
bemutatóterem - sala wystawowa
-ben - w
béna - sparaliżowany
benazepril - benazepryl
bendzsó - banjo
Benedek - Benedykt
benedvesít - zwilżać, zwilżyć
Benin - Benin
Benjámin - Beniamin
benn - wewnątrz
bennlakó - pensjonariusz, pensjonariuszka
bennszülött - tubylczy, tubylec, autochton
bent - wewnątrz
benyomás - wrażenie
benzin - benzyna
benzinkanna - kanister
benzinkút - stacja benzynowa
benzintartály - zbiornik paliwa
benzodiazepin - benzodiazepina
beolvadás - asymilacja
beöntés - lewatywa
beperel - zaskarżyć
bepiszkít - ubrudzić
bér - płaca, czynsz, opłata
berek - gaj, zagajnik
bérel - wynająć
bérelt - wynajęty
berendezés - urządzenie
bérház - kamienica czynszowa
berill - beryl
berillium - beryl
berkélium - berkel
bérkocsi - dorożka
bérlet - abonament
Berlin - Berlin
bérlő - najemca, najemczyni
Bermuda - Bermudy
Bern - Berno
Bernadett - Bernadeta, Bernadetta
berreg - warczeć
Berta - Berta
berúg - upijać się, upić się
beruházás - inwestycja
bestiális - bestialski
beszáll - wsiadać, wsiąść
beszéd - mowa, przemówienie
beszédes - gadatliwy
beszédhangtan - fonologia
beszél - mówić
beszélget - rozmawiać
beszélgetés - rozmowa, konwersacja
beszélő - mówca, orator
betakarítás - żniwa
beteg - chory, chora, pacjent, pacjentka
beteges - chorowity
betegség - choroba
Betlehem - Betlejem
beton - beton
betonoz - betonować
betör - włamywać się, włamać się, rozbić
betörés - włamanie
betörő - włamywacz
betű - litera
betűrend - alfabet
betűszó - akronim
betűz - literować
bevall - przyznać się
bevándorlás - imigracja
bevándorló - imigrant
bevásárlóközpont - centrum handlowe
bevétel - dochód
bevezet - wprowadzić, wdrożyć
bevezetés - wprowadzenie
bevezető - wstęp, wstępny
bezár - zamykać
bézs - beżowy
Bhután - Bhutan
Bianka - Bianka
bíbic - czajka
biblia - biblia
bibliai - biblijny
bibliográfia - bibliografia
bíbor - fioletowy
bíboros - kardynał
biccent - skinąć
bicikli - rower
biciklista - rowerzysta
bicska - scyzoryk
biennálé - biennale
bifsztek - befsztyk
bika - byk
Bika - Byk
bikaviadal - korrida
bikini - bikini
bilaterális - dwustronny
bili - nocnik
biliárd - bilard
bilincs - kajdanki, kajdany
billentyű - klawisz, przycisk
billentyűs - klawiszowiec
billentyűzet - klawiatura
bimbó - pąk, pączek
bimbós kel - brukselka
bimbózik - pączkować
biofizika - biofizyka
biogáz - biogaz, agrogaz
biográfia - biografia
biográfus - biograf
biokémia - biochemia
biológia - biologia
biológiai - biologiczny
biológus - biolog
biopszia - biopsja
bioszféra - biosfera
biotechnológia - biotechnologia
bioüzemanyag - biopaliwo
bír - być w stanie coś robić, posiadać
birka - owca
birkózás - zapasy
bíró - sędzia, bír
birodalmi - imperialny, cesarski
birodalom - imperium
bírói - sądowy, sędziowski
bíróküldés - wybranie sędziego, wydelegowanie sędziego
bírónő - sędzia (kobieta), sędzina
bíróság - gmach sądu, sąd
bírósági - sądowy
birs - pigwa
birsalma - pigwa
birskörte - pigwa
birtok - majątek, posiadłość
birtokadó - podatek majątkowy
birtokadományozás - nadawanie majątku ziemskiego
birtokállapot - stan posiadania
birtokállomány - stan posiadania
birtokjog - prawo własności
birtoklevél - akt własności
birtokló - posiadacz, właściciel
birtokocska - mały majątek ziemski
birtokol - posiadać, posiąść, mieć
birtokos - posiadacz
birtokos eset - dopełniacz
birtokostárs - współwłaściciel
birtokper - proces sądowy o majątek
birtokrablás - rabunek, grabież majątku
birtoktest - masa majątkowa
Biskek - Biszkek
Bissau-Guinea - Gwinea Bissau
biszexualitás - biseksualizm
bitó - szubienica
bitófa - szubienica
bitorló - uzurpator, bezprawny posiadacz
bitumenes - bitumiczny, asfaltowy
bivaly - bawół
bivalybika - samiec bawołu
bivalytej - mleko bawole
bizalmas - poufny
bizalmaskodik - spoufalić się
bizalom - zaufanie, ufność
bizarr - dziwaczny
bízik - ufać, dowierzać
bizmut - bizmut
bizonyára - na pewno
bizonyít - dowodzić, udowadniać
bizonyítás - dowód
bizonyíték - dowód
bizonyítvány - certyfikat
bizonyos - pewny, pewien
bizonyosság - pewność
bizonytalan - niepewny, chwiejny
bizonytalanság - niepewność
bizottság - komitet, komisja
biztonság - bezpieczeństwo
biztonságos - bezpieczny
biztos - pewny, niewątpliwy
biztosan - na pewno, z pewnością
biztosít - zabezpieczać, zapewniać, gwarantować
biztosítás - ubezpieczenie
blöfföl - blefować
blog - blog
blokád - blokada
blokkol - blokować
blúz - bluza
bőbeszédű - rozmowny
bocsánat - odpuszczenie, przebaczenie
bocsánatkérés - przeprosiny
bocsánatot kér - przepraszać, przeprosić
bodega - bufet
bodnár - bednarz
bodza - bez, dziki bez
bog - węzeł
bőg - beczeć
bogáncs - oset
bogár - chrząszcz
boglárka - jaskier
boglya - sterta, stóg
bögöly - giez
bogrács - kociołek
bögre - garnuszek, kubek
bogyó - jagoda
Bohémia - Czechy (kraina geograficzna)
bohóc - klaun
bohóckodik - błaznować
bója - boja, pława
bojkott - bojkot
bojkottál - bojkotować
bojler - bojler
böjt - post
böjtöl - pościć
bók - komplement
boka - kostka
bőkezű - hojny, szczodry
bókol - prawić komplementy
bokor - krzak, krzew
bokszoló - bokser
bölcs - mądry
bölcsesség - mądrość
bölcsességfog - ząb mądrości
bölcsész - filolog
bölcső - kołyska, kolebka
bölcsődal - kołysanka
boldog - wesoły, szczęśliwy
boldogít - uszczęśliwiać
boldog karácsonyt - Wesołych Świąt! (z okazji Bożego Narodzenia)
boldogság - szczęście
boldog születésnapot - wszystkiego najlepszego z okazji urodzin
boldogtalan - nieszczęśliwy
boldogtalanság - nieszczęście
boldog új évet - szczęśliwego Nowego Roku
bölény - bizon
bolgár - bułgarski, Bułgar, Bułgarka, bułgarski (język)
bolha - pchła
bolhapiac - pchli targ
bólint - skinąć głową
Bolívia - Boliwia
bölömbika - bąk
bolond - szalony, wariat, wariatka
bolondság - obłęd, szaleństwo
bolsevizmus - bolszewizm
bolt - sklep
boltozat - sklepienie
bolygó - planeta
bomba - bomba
bombáz - bombardować
bombázás - bombardowanie
bombázó - bombowiec
bonbon - czekoladka, pralinka
boncolás - autopsja
böngésző - przeglądarka
bont - wyburzać, rozbierać
bonyolult - zawiły, skomplikowany
bonyolultság - zawiłość, złożoność
bor - wino
bór - bor
bőr - skóra
borágó - ogórecznik lekarski
Borbála - Barbara
borbély - fryzjer
borbolya - berberys
borda - żebro
bordély - dom publiczny, burdel
bordélyház - dom publiczny, burdel
bordó - bordowy
bőregér - nietoperz
bőrfejű - skinhead
bőrgyógyász - dermatolog
bőrgyógyászat - dermatologia
boríték - koperta
borító - okładka
borium - bohr
borjú - cielę
borjúhús - cielęcina
borkősav - kwas winowy
borogatás - kompres
boróka - jałowiec
borókapálinka - jałowcówka (napój alkoholowy)
borona - brona
bőrönd - walizka
borostyán - bursztyn, bluszcz
borostyánkő - bursztyn
borostyánkősav - kwas bursztynowy
Boroszló - Wrocław
borotva - brzytwa
borotvál - golić
borotválkozik - golić się
borpárlat - koniak
borpince - winiarnia
borravaló - napiwek
borravalórendszer - system napiwkowy
bors - pieprz
bórsav - kwas borowy, kwas ortoborowy, kwas trioksoborowy, kwas borny
borsikafű - cząber
borsmenta - mięta pieprzowa, mięta lekarska
borsó - groch
borsos - pieprzny
borstartó - pieprzniczka
borszag - zapach wina
borszesz - spirytus winny
börtön - więzienie
borúlátás - pesymizm
borz - borsuk
borzalmas - potworny, straszny, okropny
borzasztó - straszny, okropny
bőség - obfitość, dostatek
bőséges - obfity
bosnyák - Bośniak, Bośniaczka, język bośniacki
bosszant - dokuczać, irytować, drażnić, złościć
bosszú - zemsta
Bosznia - Bośnia
Bosznia és Hercegovina - Bośnia i Hercegowina
Bosznia-Hercegovina - Bośnia i Hercegowina
boszniai - bośniacki
boszorka - wiedźma
boszorkány - czarownica
boszorkányság - czary, gusła
boszorkányüldözés - polowanie na czarownice
Boszporusz - Bosfor
bot - kij, patyk, laska, pałka
botanika - botanika
botanikai - botaniczny
botanikus - botanik
botrány - skandal, afera
Botswana - Botswana
botulinumtoxin - botulina, toksyna botulinowa, jad kiełbasiany
Bouvet-sziget - Wyspa Bouveta, norweskie terytorium zależne na południowym Atlantyku
boxer - bokser (rasa psów)
brácsa - altówka
Brazília - Brazylia
Bréma - Brema
Bretagne - Bretania
breton - Bretończyk, Bretonka, bretoński (język), bretoński
bridzs - brydż
briliáns - brylant
bringa - rower
brit - brytyjski
Brit Indiai-óceáni Terület - Brytyjskie Terytorium Oceanu Indyjskiego
Brit Virgin-szigetek - Brytyjskie Wyspy Dziewicze
brokkoli - brokuł
bróm - brom
bronz - brąz (stop metali)
bronzérem - brązowy medal, brąz
bronzkor - epoka brązu
bross - broszka
Brunei - Brunei
Brüsszel - Bruksela
brutális - brutalny
bruttó - brutto
bú - smutek
buborék - bańka
buborékol - bulgotać
bucka - kopiec, pagórek
búcsú - pożegnanie
Budapest - Budapeszt
budapesti - budapeszteński, budapeszteńczyk, budapesztenka
Buddha - Budda
buddhista - buddyjski, buddysta, buddystka
buddhizmus - buddyzm
büdzsé - budżet
büfé - bufet
bújik - chować się, schować się
Bukarest - Bukareszt
bükk - buk
bukósisak - kask
Bulgária - Bułgaria
bulgur - bulgur
buli - balanga, impreza
bulldog - buldog
bumeráng - bumerang
bűn - grzech
bűnbak - kozioł ofiarny
bunda - futro, kożuch
bungaló - bungalow
bűnös - winny
bűnözés - przestępstwo
bűnöző - kryminalista, kryminalistka
bűntény - zbrodnia
büntet - karać
büntetés - kara
búr - burski
bura - klosz
burgonya - ziemniak, kartofel
Burjátföld - Buriacja
Burkina Faso - Burkina Faso
Burma - Birma
burnót - tabaka
bürokrácia - biurokracja
bürokrata - biurokrata
bürokratikus - biurokratyczny
Burundi - Burundi
bús - smutny
busz - autobus
buszállomás - dworzec autobusowy
büszke - dumny
büszkén - dumnie
büszkeség - duma
buszpályaudvar - dworzec autobusowy
buszvezető - kierowca autobusu
buta - głupi
bután - butan
butaság - głupota, bzdura, nonsens
butik - butik
bútor - mebel
bútordarab - mebel
bútorozott - umeblowany
búvár - nurek
bűvész - magik
bűvöl - oczarować, zaczarować
bűvös - czarodziejski, magiczny
búza - pszenica
búzavirág - chaber bławatek
buzgó - zagorzały
bűzlik - śmierdzieć, cuchnąć
buzogány - buzdygan
Canberra - Canberra
cápa - rekin
cár - car
Caracas - Caracas
Cecília - Cecylia
cédrus - cedr
cég - firma
céh - cech
cékla - burak ćwikłowy
cél - cel
célkla - ćwikła
cellulóz - celuloza, błonnik
célpont - cel
célravezető - przydatny, użyteczny, skuteczny
Celsius-fok - stopień Celsjusza
célszerű - celowy
cement - cement
centiméter - centymetr, cm
centrális - centralny
centralizáció - centralizacja
centralizmus - centralizm
centrifuga - wirówka, centryfuga
cenzúra - cenzura
cenzúráz - cenzurować
ceremónia - ceremonia
cérium - cer
cérna - nić, nitka
ceruza - ołówek
ceruzahegyező - temperówka
cet - waleń
cézium - cez
Chile - Chile
cica - kocię, kotek, kociak
cickány - ryjówka
cifero - cyfra
cigány - Cygan, Cyganka, cygański
cigaretta - papieros
cikcakk - zygzak
cikk - artykuł
cikkely - artykuł
ciklámen - cyklamen
ciklikus - cykliczny
ciklois - cykloida
ciklon - cyklon
cilinder - cylinder
cím - tytuł, adres
cimbora - kumpel, kompan, druh
címer - herb, godło
címez - adresować
címke - metka, etykieta
címszó - hasło
című - zatytułowany, pod tytułem
címzett - adresat
cin - cyna
cinege - sikora
cinikus - cyniczny
cinizmus - cynizm
cink - cynk
cinke - sikora
cionizmus - syjonizm
cipel - dźwigać, dygować
cipellő - but
cipész - szewc
cipő - but
cipőfűző - sznurowadło, sznurówka
cipőhúzó - łyżka do butów
cipőkanál - łyżka do butów
cipőtalp - podeszwa, zelówka
ciprus - cyprys
Ciprus - Cypr
cirill - cyrylicki
cirkónium - cyrkon
cirkusz - cyrk
Ciszjordánia - Zachodni Brzeg
ciszterna - cysterna, zbiornik
citrancs - grejpfrut
citrom - cytryna
citromlé - sok cytrynowy
citromsárga - cytrynowy, cytrynowożółty
civilizáció - cywilizacja
civilizált - cywilizowany
coboly - soból
cölibátus - celibat
cölöp - słupek, słup
comb - udo
Comore-szigetek - Komory
Cook-szigetek - Wyspy Cooka
copf - warkocz
Costa Rica - Kostaryka
csábít - kusić, wabić, nęcić
Csád - Czad
csahol - szczekać, ujadać
csajka - menażka
csak - tylko, dopiero
csakis - tylko, jedynie
csaknem - niemal, prawie
csakugyan - istotnie, rzeczywiście, naprawdę
csal - oszukiwać
család - rodzina
családfa - drzewo genealogiczne
családi - rodzinny
családnév - nazwisko
családtag - członek rodziny
csalán - pokrzywa
csalárd - fałszywy
csalás - oszustwo
csaló - szalbierz
csalódás - rozczarowanie, zawód, deziluzja
csalódást okoz - rozczarować
csalódott - rozczarowany, zawiedziony
csalogány - słowik rdzawy
csalogat - wabić
csap - sopel, kran, czop
csapás - cios, trop
csapat - grupa, zespół, drużyna
csapda - pułapka
csárdás - czardasz
császár - cesarz
császári - cesarski
császármetszés - cięcie cesarskie, cesarka
császárnő - cesarzowa
császárpingvin - pingwin cesarski
császárság - cesarstwo
csat - zapięcie, klamra, klamerka, sprzączka
csata - bitwa
csatlakozik - dołączyć, przyłączyć się, dobić
csatol - załączyć, załączać
csatorna - kanał
csavar - wkręt, śruba
csavarhúzó - śrubokręt, wkrętak
cseberből vederbe - z deszczu pod rynnę
csecsemő - niemowlę
csecsen - czeczeński, Czeczen, Czeczenka, czeczeński (język)
Csecsenföld - Czeczenia
cseh - czeski, Czech, Czeszka, czeski (język)
Cseh Köztársaság - Republika Czeska
Csehország - Czechy
csehszlovák - czechosłowacki
Csehszlovákia - Czechosłowacja
csekk - czek
csekk-könyv - książeczka czekowa
csekklap - przekaz pieniężny
cseléd - sługa
cselekedet - czyn, uczynek
cselgáncs - judo, dżudo
csellista - czelista, wiolonczelista
csempész - przemytnik, szmugler
csempészik - przemycać
csend - cisza
csendes - cichy
csendesen - cicho
Csendes-óceán - Ocean Spokojny
csengés - dzwonienie
csenget - dzwonić, zadzwonić
csengő - dzwonek
csepp - kropla
csere - wymiana, zamiana
cserél - wymieniać, zamieniać
cserép - dachówka, kafel, doniczka
cseresznye - czereśnia
cserje - krzew, krzak
cserkész - skaut, harcerz
csésze - filiżanka
csészealj - spodek
cseveg - pogadać
csicsereg - świergotać, ćwierkać
csicseriborsó - ciecierzyca
csiga - ślimak
csigolya - kręg
csikk - niedopałek
csiklandoz - łaskotać, łechtać
csikló - łechtaczka
csikó - źrebię, źrebak
csíkos - pasiasty
csili - chili
csillag - gwiazda
csillagász - astronom
csillagászat - astronomia
csillagászati - astronomiczny
csillagfény - światło gwiazd
csillagjós - astrolog
csillagjóslás - astrologia
csillagkép - gwiazdozbiór
csillagközi - międzygwiezdny
csillagrendszer - galaktyka
csillagtalan - bezgwiezdny
csillagváros - galaktyka
csillagvizsgáló - obserwatorium
csillagzat - gwiazdozbiór
csillapít - amortyzować, łagodzić
csillár - żyrandol
csillog - błyszczeć, lśnić, połyskiwać
csillogó - błyszczący, lśniący
csimpánz - szympans
csín - schludność
csinál - robić, czynić
csinos - ładny
csíp - szczypać
csípés - ukąszenie
csipesz - szczypce
csipet - szczypta
csipke - koronka
csípő - biodro
csípős - ostry, pikantny
csirke - kurczak
csirkehús - mięso z kurczaka
csizma - kozak
cső - rura
csobog - pluskać, bulgotać, gulgotać
csöbör - kubeł, wiadro
csőcselék - draństwo, hołota
csoda - cud
csodagyerek - cudowne dziecko
csodál - podziwiać
csodálat - podziw, zachwyt
csodálatos - cudowny, niezwykły
csodálatosan - cudownie, cudnie
csodálkozik - dziwić się
csodaszép - przecudny, przepiękny, prześliczny
csődör - ogier
csók - pocałunek
csóka - kawka
csökkenő - malejący
csökkent - zmniejszać, redukować, obniżać
csókol - całować
csokoládé - czekolada
csokoládébarna - czekoladowy
csökönyös - zawzięty, uparty
csökönyösen - zawzięcie, uparcie, uporczywie
csokor - bukiet, wiązanka
csomag - paczka
csomagol - pakować, spakować
csomagtartó - bagażnik
csomó - węzeł, supeł
csónak - łódź, łódka
csónakház - hangar na łodzie
csönd - cisza
csöndes - cichy
csont - kość
csontleves - rosół
csontos - kościsty
csonttollú - jemiołuszka
csontváz - szkielet
csontvelő - szpik kostny
csoport - zespół, drużyna, grupa
csoportos - grupowy
csoportosít - grupować
csoportosul - zbierać się, gromadzić się
csőr - dziób
csorba - przełęcz
csorda - stado, tabun
csörgő - grzechotka
csörgőkígyó - grzechotnik
csörög - grzechotać
csoszog - człapać
csótány - karaluch
csúcs - szczyt, wierzchołek, czubek
csúf - brzydki, paskudny, szpetny
csuha - habit (zakonny)
csuk - zamykać, zatrzaskiwać
csuka - szczupak
csuklás - czkawka
csuklik - mieć czkawkę, czkać
csukló - nadgarstek
csúnya - brzydki
csupán - tylko
csupasz - goły, nagi
csűr - stodoła
csúszda - zjeżdżalnia
csuszka - kowalik, bargiel
csúszós - śliski
csütörtök - czwartek
csütörtöki - czwartkowy
csúzli - proca
cukor - cukier
cukorbeteg - cukrzyk, diabetyk
cukorbetegség - cukrzyca
cukornád - trzcina cukrowa
cukorrépa - burak cukrowy
cukrász - cukiernik
cukrászda - cukiernia
cumi - smoczek
cunami - tsunami
dac - krnąbrność
dada - niania
dadaizmus - dadaizm
dadog - jąkać się, dukać
dagad - puchnąć
dagadt - spuchnięty, opuchnięty
dagályos - bombastyczny, pompatyczny
daganat - nowotwór, wrzód, opuchlizna, obrzęk
daganatáttétel - przerzut nowotworu
daganatkutatás - badanie zmian nowotworowych.
dajka - niania
dajkatej - mleko mamki
Dakka - Dhaka
dakszli - jamnik
daktiloszkópia - daktyloskopia
daktiloszkópiai - daktyloskopijny
daktilus - daktyl (miara wersyfikacyjna)
dal - piosenka
dalest - wieczór pieśni
dalia - bohater, heros
dália - dalia, georginia
dallam - melodia
dallamos - melodyjny
Dalmácia - Dalmacja
dalmáciai - dalmatyński
dalmű - opera
dalnok - bard, wieszcz
dalol - śpiewać
dalos - rozśpiewany
dalszerző - autor piosenek
dalszöveg - tekst piosenki
damaszkpenge - damascenka, szabla damasceńska
Damaszkusz - Damaszek
damaszkuszi - damasceński
damaszt - adamaszek
dámszarvas - daniel
dámvad - daniel
dán - duński, Duńczyk, Dunka, duński (język)
dancs - wykroczenie, faul
dandár - brygada
Dánia - Dania
Dániel - Daniel
dara - grysik, manna
darab - kawałek, część
darál - mielić, mleć
darázs - osa
darázskürt - wuwuzela
dárda - włócznia
darmstadtium - darmsztadt
daru - żuraw, dźwig
darwinista - darwinista
darwinizmus - darwinizm
datolya - daktyl, owoc daktylowca
dátum - data
Dávid - Dawid
de - jak! (bardzo!)
Debrecen - Debreczyn
debütál - debiutować
december - grudzień
decemberi - grudniowy
decentralizáció - decentralizacja
decibel - decybel
deciliter - decylitr
deciméter - decymetr
dédanya - prababka
dédapa - pradziadek
dedikáció - dedykacja
dedukció - dedukcja
definiál - definiować
definíció - definicja
degenerál - degenerować
degradáció - degradacja
deizmus - deizm
dekadencia - dekadencja, dekadentyzm
dekadens - dekadencki
deklaráció - deklaracja
deklináció - deklinacja
dekoltázs - dekolt
dekoráció - dekoracja, ozdoba
dekoratív - dekoracyjny, ozdobny
dél - południe (pora dnia), południe (kierunek)
Dél-afrikai Köztársaság - Republika Południowej Afryki
Dél-Amerika - Ameryka Południowa
delegáció - delegacja
delegál - delegować
delejvas - magnes
délelőtt - przedpołudnie
Dél-Európa - Europa Południowa
delfin - delfin
déli - południowy
délibáb - miraż
délibábos - mirażowy, urojony, iluzoryczny
Déli-óceán - Ocean Południowy
delírium - delirium
délkelet - południowy wschód
délkeleti - południowo-wschodni
Dél-Korea - Korea Południowa
délnyugat - południowy zachód
délnyugati - południowo-zachodni
Dél-Szudán - Sudan Południowy
deltoid - deltoid
délután - popołudnie
délutáni - popołudniowy
demagnetizáció - demagnetyzacja, rozmagnesowanie
demagógia - demagogia
demizson - gąsior (naczynie)
demográfia - demografia
demográfiai - demograficzny
demográfiailag - demograficznie
demokrácia - demokracja
demokrata - demokrata
demokratikus - demokratyczny
demokratizál - demokratyzować
demokratizmus - demokratyzm, demokratyczność
démon - demon
demonstráció - demonstracja
demonstrál - demonstrować
demoralizáció - demoralizacja
demoralizál - demoralizować
denaturál - denaturować
Dénes - Dionizy
denevér - nietoperz
depresszió - depresja
depressziós - depresyjny
dér - mróz
derék - talia, pas, mężny, dzielny
derékszög - kąt prosty
derivált - pochodna
dermatológia - dermatologia
derült - jasny, pogodny
desszert - deser
destrukció - destrukcja, zniszczenie
destruktív - destrukcyjny
deszka - deska
desztillál - destylować
detektív - detektyw
determináció - determinacja
determinál - determinować
detonáció - detonacja, eksplozja
devalvál - dewaluować
dezertőr - dezerter
dezintegráció - dezyntegracja
dezorientáció - dezorientacja
dézsa - ceber
diabétesz - cukrzyca
diadal - triumf
diadalmas - zwycięski, triumfalny
diagnózis - diagnoza
diák - uczeń, student
diáklány - uczennica, studentka
dialektika - dialektyka
dialektus - dialekt
dialógus - dialog
diazepám - diazepam
dicsér - chwalić
dicső - chwalebny
dicsőség - chwała, chluba
dicsőséges - chwalebny
didaktika - dydaktyka
diéta - dieta
differencia - różnica
differenciálegyenlet - równanie różniczkowe
differenciálszámítás - rachunek różniczkowy
diffúz - rozproszony
diffúzió - dyfuzja
diftéria - dyfteryt, błonica
diftongus - dyftong, dwugłoska
digitális - cyfrowy
digitalizál - digitalizować
díj - cena, nagroda
díjlovaglás - ujeżdżenie
diktál - dyktować
diktátor - dyktator
diktatórikus - dyktatorski
diktatúra - dyktatura
dimenzió - wymiar
dinamikus - dynamiczny
dinamit - dynamit
dinamó - prądnica
dinasztia - dynastia
dinnye - arbuz
dinoszaurusz - dinozaur
dió - orzech włoski
dióda - dioda
diófa - orzech
diótörő - dziadek do orzechów
diplomácia - dyplomacja
diplomáciai - dyplomatyczny
diplomatikus - dyplomatyczny
direktíva - dyrektywa
disszertáció - dysertacja, rozprawa
disszimiláció - dysymilacja
dísz - dekoracja, ozdoba
díszít - dekorować
díszítés - ornament, ozdoba
diszkoszvetés - rzut dyskiem
diszkrét - dyskretny
diszkrimináció - dyskryminacja
diszkriminál - dyskryminować
diszkvalifikál - dyskwalifikować
diszlexia - dysleksja
disznó - świnia
disznóhús - wieprzowina
disznóól - chlew
disznósajt - salceson
diszprózium - dysproz
disztingvál - odróżniać, rozróżniać
disztingvált - dystyngowany
díva - diwa
dívány - kanapa, sofa
divat - moda
divatjamúlt - staromodny
divatos - modny
dizentéria - dyzenteria, czerwonka
DNS - DNA
dob - rzucać, bęben
dobfelszerelés - perkusja
dobhártya - błona bębenkowa
dobol - bębnić
dobos - dobosz
doboz - pudło, pudełko, skrzynia
döf - dźgnąć, pchnąć
dög - padlina
dogma - dogmat
dogmatikus - dogmatyczny
dogmatizmus - dogmatyzm
dohány - tytoń, forsa
dohányos - palacz, palaczka
dohányzás - palenie
dohányzik - palić (papierosy)
dohos - stęchły
dokk - dok
doktor - doktor, lekarz
doktornő - pani doktor, lekarka
dokumentáció - dokumentacja
dokumentál - dokumentować
dokumentum - dokument
dolcsi - dolec
dolgozik - pracować
dolgozó - pracownik, pracownica
dolgozószoba - gabinet, pracownia
dollár - dolar
dolmány - dolman
dolog - praca, sprawa, rzecz
dölyfös - butny
dóm - katedra
domb - pagórek, wzniesienie, górka
dombormű - relief, płaskorzeźba
dominál - dominować
Dominikai Közösség - Dominika, Wspólnota Dominiki
Dominikai Köztársaság - Dominika
dominó - domino
dönget - dobijać się, stukać
döngicsél - bzyczeć
dongó - trzmiel
dönt - decydować
döntés - decyzja
döntetlen - remis
döntő - finał
dór - dorycki
dörgés - grzmot
doromb - drumla
dorombol - mruczeć
dorong - drąg
Dorottya - Dorota
dörzsöl - pocierać, trzeć
drága - drogi
drágakő - kamień szlachetny
dragonyos - dragon
drákói - drakoński
dráma - dramat
drámai - dramatyczny
drapp - beżowy
drasztikus - drastyczny
dressz - dres
Drezda - Drezno
dromedár - dromader
drót - drut
druida - druid
dualizmus - dualizm
dubnium - dubn
duda - trąbka, klakson
dudva - chwast
dugaszaljzat - gniazdko
dugattyú - tłok
dugó - korek (do butelek), korek (drogowy)
dugóhúzó - korkociąg
düh - wściekłość, gniew
dühödt - wściekły
dühös - wściekły
dumál - gadać
Duna - Dunaj
dűne - wydma, diuna
dús - bogaty, bujny, obfity
duzzad - puchnąć, obrzmiewać
duzzog - dąsać się
dzsainizmus - dźinizm
dzsámi - meczet
dzsem - dżem
dzsessz - jazz
Dzsibuti - Dżibuti
dzsihád - dżihad
dzsip - dżip, jeep
dzsúdó - judo, dżudo
dzsungel - dżungla
dzsunka - dżonka
eb - pies
ebéd - obiad
ebédel - jeść obiad
ebédlő - jadalnia
ebihal - kijanka
ébresztőóra - budzik
ecet - ocet
echó - echo
ecset - pędzel
Ecuador - Ekwador
edény - naczynie, pojemnik
édes - słodki
édesanya - matka, mamusia
édesapa - ojciec, tatuś
edzés - trening
edző - trener
efféle - taki
ég - niebo, płonąć
égbolt - niebo
egér - mysz
egérfogó - pułapka na myszy
egész - cały, całkowity, kompletny, całość
egészen - całkiem, całkowicie, zupełnie
egészség - zdrowie
egészségedre - na zdrowie!
egészségére - na zdrowie
egészséges - zdrowy
egész szám - liczba całkowita
éget - palić
éghajlat - klimat
éghajlattan - klimatologia
egocentrizmus - egocentryzm
egoizmus - egoizm
egres - agrest
egy - jeden, 1, jakiś
egyáltalán - wcale, w ogóle
egybegyűlik - zbierać się
egybekel - poślubić
egyedül - sam, bez nikogo, w pojedynkę
egyén - jednostka, osoba
egyenértékű - równoważny
egyenes - prosty, prosta
egyenesen - prosto, wprost
egyéni - indywidualny
egyéniség - indywidualność
egyenlet - równanie
Egyenlítő - równik
Egyenlítői-Guinea - Gwinea Równikowa
egyenlő - równy
egyenlőség - równość
egyenlőtlen - nierówny
egyenlőtlenség - nierówność
egyenruha - mundur
egyértelmű - jednoznaczny
egyes - jedynka
egyesülés - unia, połączenie, fuzja
egyesület - stowarzyszenie, zrzeszenie, związek
egyesült - zjednoczony
Egyesült Államok - Stany Zjednoczone
Egyesült Arab Emírségek - Zjednoczone Emiraty Arabskie
Egyesült Királyság - Zjednoczone Królestwo
Egyesült Nemzetek Szervezete - Organizacja Narodów Zjednoczonych
egyetem - uniwersytet
egyetemes - uniwersalny
egyetért - zgadzać się, zgodzić się
egyetlen - jedyny, wyłączny
egy fecske nem csinál nyarat - jedna jaskółka wiosny nie czyni
egyforma - jednakowy
egyhangúlag - jednogłośnie, jednomyślnie
egyház - kościół
Egyiptom - Egipt
egyistenhit - jedynobóstwo
egyke - jedynak
egykori - były, dawny
egy mindenkiért, és mindenki egyért - jeden za wszystkich, wszyscy za jednego
egypúpú - jednogarbny
egység - jedność, jednostka
egységes - jednolity
egysejtű - jednokomórkowy
egyszer - jeden raz
egyszerre - jednocześnie, równocześnie, niespodziewanie, nagle
egyszerű - prosty, nieskomplikowany
egyszerűen - prosto, łatwo
egyszerűség - prostota
egyszerűsít - upraszczać
egyszerűsítés - uproszczenie
egyujjas kesztyű - rękawiczka
együtt - razem
együttes - zespół, band
együttműködés - współpraca
egzisztencia - egzystencja
egzisztencializmus - egzystencjalizm
egzotikus - egzotyczny, tropikalny
éhes - głodny
ehető - jadalny
éhezik - głodować
éhség - głód
einsteinium - einstein
éj - noc
ejakuláció - ejakulacja
éjfél - północ (godzina 24)
éjjel - noc
éjjeliszekrény - szafka nocna
éjszaka - noc
éjszakai - nocny
ejtőernyő - spadochron
ék - klin
ekcéma - egzema
eke - pług
ékesszóló - elokwentny, wymowny
ékezet - kreska, akcent
eközben - w międzyczasie
ékszer - klejnot
él - żyć
elad - sprzedawać
eladás - sprzedaż, zbyt
eladó - sprzedawca
elalszik - zasnąć
elasztikus - elastyczny
elavult - przestarzały
elbarikádoz - barykadować
elbeszél - dopowiedzieć
elbeszélés - opowiadanie, opowieść
elbocsát - zwalniać, zwolnić (z pracy)
elbújik - ukryć się
elbűvöl - zachwycić, oczarować
elbűvölő - uroczy, czarujący
eldug - schować
eledel - żywność, pożywienie, jedzenie
elefánt - słoń
elefántcsont - kość słoniowa
Elefántcsontpart - Wybrzeże Kości Słoniowej
elég - dość, dosyć, wystarczająco
elegancia - elegancja
elegáns - elegancki, wytworny, wykwintny
elegendő - wystarczający, dostateczny
elégia - elegia
eleinte - początkowo, na początku, najpierw
elektrodinamika - elektrodynamika
elektrokardiográfia - elektrokardiografia
elektrokémia - elektrochemia
elektrolízis - elektroliza
elektromágnes - elektromagnes
elektromágneses - elektromagnetyczny
elektromos - elektryczny
elektromosság - elektryczność
elektron - elektron
elektronegativitás - elektroujemność
elektronika - elektronika
elektronikus - elektronowy
elektronmikroszkóp - mikroskop elektronowy
elektrosztatika - elektrostatyka
elektrotechnika - elektrotechnika
élelmiszer - jedzenie, pożywienie
elem - bateria, pierwiastek, element, składnik
elemlámpa - latarka
elemzés - analiza
elemző - analityk
elengedhetetlen - nieodzowny
élénk - żywy, energiczny, ożywiony
elér - dotrzeć, dojść, dosięgnąć
éles - ostry
éléskamra - spiżarnia
élesztő - drożdże
élet - życie
életkor - wiek, liczba lat życia
életrajz - biografia
életrajzi - biograficzny
életrajzíró - biograf
élettan - fizjologia
eleven - rześki, żywy
elfelejt - zapomnieć
elfogad - przyjmować, akceptować, zatwierdzać
elfogadható - do przyjęcia, zadowalający
elfogultság - uprzedzenie, stronniczość
elhagyatott - opuszczony, samotny
elhalaszt - przekładać na później, odraczać
elhatároz - zdecydować, postanowić
elhibáz - pomylić się, chybić
elhisz - wierzyć, uwierzyć
elhitet - wmawiać, wmówić
elhízás - otyłość
elhízott - otyły
eliminál - eliminować, likwidować
elintéz - załatwić
elixír - eliksir
eljárás - procedura
eljegyzés - zaręczyny
elkényeztet - rozpieścić
elképesztő - skandaliczny
elképzel - wyobrazić sobie
elképzelés - pojęcie, wyobrażenie
elkerül - omijać, unikać
elkészít - przygotowywać, przygotować
elkezd - zacząć, rozpocząć
elkísér - odprowadzać, odprowadzić
elkóborol - zabłądzić
elkövet - popełnić, dopuścić się, dokonać
ellát - zaopatrywać, dostarczać
ellen - przeciw, przeciwko
ellenáll - stawić opór, przeciwstawić się
ellenállhatatlan - nieodaprty
ellenfél - oponent
ellenforradalom - kontrrewolucja
ellenkező - przeciwny
ellenőriz - sprawdzać, kontrolować
ellenség - wróg, przeciwnik, nieprzyjaciel
ellenséges - wrogi
ellenszenv - antypatia, awersja
ellenszenves - antypatyczny
ellenszer - antidotum, odtrutka
ellentét - przeciwieństwo
ellentmond - zaprzeczać, zaprzeczyć
ellenvetés - obiekcja, zastrzeżenie
elme - umysł, rozum
elmegy - odchodzić, odejść, odjeżdżać, odjechać
elmélet - teoria
elméleti - teoretyczny
elmélkedik - dumać, rozmyślać, kontemplować
élmény - przeżycie
elmond - opowiadać, wygłaszać, recytować
elmúlt - przeszły
elnök - prezes, przewodniczący, prezydent
élő - żywy
előadás - odczyt, wykład, prelekcja
előcsarnok - hol, przedsionek
előfizet - prenumerować
előfizetés - abonament, prenumerata, przedpłata
előfizető - abonent, prenumerator
előfordul - występować, wystąpić, zdarzać się, zdarzyć się
előítélet - uprzedzenie
előkészít - przygotowywać
elől - przed
elöljárószó - przyimek
elolvas - przeczytać, doczytać
előny - korzyść
előnyös - korzystny
előre - naprzód
élősködő - pasożyt
előszeretet - preferencja
először - najpierw, wpierw, w pierwszej kolejności
előtt - przed
elővigyázatosság - środek ostrożności
eloxálás - anodowanie, anodyzacja, eloksalacja
előző - poprzedni
elpusztít - niszczyć, zniszczyć
elrabol - porwać, uprowadzić
elrejt - schować, ukryć
El Salvador - Salwador
első - pierwszy
elszigeteltség - izolacja
eltávolít - usuwać, usunąć
eltör - złamać, rozbić, stłuc
eltűnik - zniknąć
elutasít - odmawiać
elv - zasada, reguła
elveszít - gubić
élvez - delektować się, rozkoszować się
elvi - teoretyczny
elvonszol - ciągnąć
elvont - abstrakcyjny
elvtárs - towarzysz
elvtársnő - towarzyszka
emanáció - emanacja
ember - człowiek
ember embernek farkasa - człowiek człowiekowi wilkiem
emberi - ludzki
emberiség - ludzkość
emberség - człowieczeństwo
embertan - antropologia
embertelen - nieludzki
ember tervez, Isten végez - człowiek strzela, Pan Bóg kule nosi
embrió - embrion
emelet - piętro
emeletes - piętrowy
emellett - ponadto
emelő - dźwignia, podnośnik
emelvény - trybuna, estrada
emészt - trawić
emigráció - emigracja
emigráns - emigrant
Emilia - Emilia
emisszió - emisja
emlékeztető - pozostałość, reszta
emlékszik - pamiętać
említ - wzmiankować, wspominać, nadmieniać
emlőbimbó - sutek
emlős - ssak
emlősállat - ssak
emóció - emocja, uczucie
emocionális - emocjonalny
empirikus - empiryczny, doświadczalny
empirizmus - empiryzm
én - ja
enciklopédia - encyklopedia
endívia - endywia
Endre - Andrzej
ének - śpiew, pieśń, piosenka
énekel - śpiewać
énekes - śpiewak, wokalista
énekesnő - piosenkarka, śpiewaczka
énekkar - chór
éneklés - śpiew
energia - energia
energikus - energiczny
enged - pozwalać
engedelmes - posłuszny
engedelmesség - posłuszeństwo
engedély - pozwolenie
engedetlen - nieposłuszny
engedetlenség - nieposłuszeństwo
ennivaló - jedzenie, żywność
entomológia - entomologia
entrópia - entropia
enyhe - delikatny, łagodny
ép - cały, nieuszkodzony
epe - żółć
eper - truskawka, poziomka
eperfa - morwa
epilepszia - padaczka, epilepsja
épít - budować, zbudować, wybudować
építés - budowa, budowanie
építész - architekt, budowniczy
építészet - architektura
építmény - budowla
epizód - epizod
éppen - dopiero co, właśnie
ép testben ép lélek - w zdrowym ciele zdrowy duch
épület - budynek
épületfa - drewno budowlane
ér - żyła, dochodzić
erbium - erb
érc - ruda
érdekel - interesować, ciekawić
érdekes - interesujący, ciekawy
érdeklődés - zainteresowanie
Erdély - Siedmiogród
érdes - szorstki, chropowaty
erdész - leśnik
erdő - las
ered - pochodzić, wywodzić się
eredet - pochodzenie
eredeti - oryginalny
eredetileg - oryginalnie
eredetiség - oryginalność
eredmény - wynik, rezultat
eredményes - owocny, skuteczny, efektywny
eredményez - wynikać
ereklye - relikwia
erélyes - energiczny
érem - medal
erény - cnota
eretnek - heretyk
eretnekség - herezja
érett - dojrzały
érez - czuć, odczuwać
érint - dotykać
érintés - dotyk
Erisz - Eris, Eryda
Eritrea - Erytrea
erkély - balkon
érkezés - przybycie
érkezik - przychodzić, przyjeżdżać
erkölcs - moralność
erkölcsös - moralny
erkölcstelen - niemoralny
érme - moneta
ernyő - parasol, parasolka
erő - siła
erődítmény - forteca
erőfeszítés - wysiłek
erogén zóna - strefa erogenna
erőmű - elektrownia
erős - silny, mocny
erősít - wzmacniać, wzmocnić
erősítő - wzmacniacz
erősség - intensywność, siła
erőszakos - gwałtowny
erőteljes - silny, mocny
erotikus - erotyczny
erőtlen - bezsilny, słaby, cherlawy
érsek - arcybiskup
ért - rozumieć
érték - wartość
értékel - cenić, oceniać
értékes - wartościowy, cenny
értéktelen - bezwartościowy
értelem - rozum, inteligencja, sens, znaczenie
értelmez - rozumować, interpretować
érthetetlen - niezrozumiały
érvényes - ważny
érvénytelenít - anulować, unieważniać
érzék - zmysł, wyczucie
érzékel - spostrzegać, czuć
érzékeny - wrażliwy
érzelem - uczucie, emocja
érzelmi - emocjonalny
érzés - uczucie
Erzsébet - Elżbieta
és - i, oraz
esély - szansa
esemény - wydarzenie
esernyő - parasol, parasolka
eset - przypadek, wypadek
esetleg - ewentualnie, przypadkiem
eshetőség - ewentualność
esik - padać, upadać
esik a hó - śnieżyć
eskü - przysięga
esküdt - juror, ławnik
esküszik - przysięgać, brać ślub
esküvő - ślub
eső - deszcz
esőkabát - deszczowiec
esős - deszczowy
esővíz - deszczówka
est - wieczór
este - wieczór, wieczorem
esti - wieczorny
észak - północ
Észak-Amerika - Ameryka Północna
északi - północny
Északi-sarki-óceán - Ocean Arktyczny
északkelet - północny wschód
Észak-Korea - Korea Północna
északnyugat - północny zachód
eszcájg - sztućce
eszes - inteligentny, bystry, mądry
eszik - jeść
eszkaláció - eskalacja
eszkimó - Eskimos
eszköz - narzędzie, przyrząd
eszméletlen - nieprzytomny
eszmény - ideał
eszperantó - esperanto, esperancki
eszpresszó - espresso (kawa)
észrevesz - zauważyć, dojrzeć, dostrzec
észt - estoński, Estończyk, Estonka, estoński (język)
esztendő - rok
Eszter - Estera
esztétika - estetyka
esztétikai - estetyczny
esztétikus - estetyczny
Észtország - Estonia
etanol - etanol
étel - jedzenie
éter - eter
etet - karmić, żywić
etika - etyka
etikus - etyczny
etimológia - etymologia
etimológiai - etymologiczny
Etiópia - Etiopia
étkezés - posiłek, pożywienie, jedzenie
étkezik - stołować się, jadać
étkező - jadalnia
étlap - menu
etnológia - etnologia
étterem - restauracja
étvágy - apetyt
eufemizmus - eufemizm
eufória - euforia
eunuch - eunuch
Eurázsia - Eurazja
euró - euro
Európa - Europa
európai - europejski
Európai Unió - Unia Europejska
európium - europ
eutanázia - eutanazja
év - rok
Éva - Ewa
evakuál - ewakuować
evangélista - ewangelista
evangélium - ewangelia
évenkénti - coroczny, doroczny
évente - corocznie, dorocznie
éves - roczny
evet - wiewiórka
evező - wiosło
evezős - wioślarski, wioślarz
évezred - tysiąclecie, millenium
évforduló - rocznica
évi - roczny
evolúció - ewolucja
évszak - pora roku
évszázad - wiek, stulecie
évtized - dekada
exhumál - ekshumować
exportál - eksportować
expresszionizmus - ekspresjonizm
expresszív - ekspresyjny
extrapoláció - ekstrapolacja
ez - ten, ta, to
ezelőtt - przedtem, wcześniej
ezen - niniejszy
ezenkívül - ponadto
ezentúl - odtąd, od teraz
ezer - tysiąc, 1000
ezért - zatem, dlatego, więc
ezred - pułk
ezredes - pułkownik
ezredév - tysiąclecie, millenium
ezredik - tysięczny
ezüst - srebro
ezüstérem - srebrny medal
ezüstlakodalom - srebrne wesele
ezüstös - srebrzysty
ezúttal - tym razem
fa - drzewo, drewno
fácán - bażant
facipő - drewniany chodak, sabot
faeper - morwa
faggat - przesłuchiwać, przesłuchać
fagott - fagot
fagy - mróz, zamarznąć, zamarzać
fagyaszt - zamrażać, zamrozić
fagylalt - lody (deser)
fagyöngy - jemioła
fahéj - cynamon
fahéjfa - cynamonowiec cejloński
faj - rasa, gatunek
fáj - boleć
fájdalom - ból
fájl - plik
fakanál - drewniana łyżka, warząchew, kopyść
fakeret - drewniana ramka
fakopáncs - dzięcioł
fakul - blaknąć, tracić kolor
fal - ściana
falat - kawałek, kęs
falevél - liść
falióra - zegar ścienny
falka - sfora, stado
Falkland-szigetek - Falklandy
fallosz - fallus, penis
falu - wieś
falucska - wioska
falusi - wiejski, wieśniak, wieśniaczka
família - rodzina
fanatikus - fanatyczny
fanatizmus - fanatyzm
fánk - pączek
fantasztikus - fantastyczny
fantáziál - fantazjować, marzyć
far - tyłek
fáradt - zmęczony
fáradtság - zmęczenie
farag - rzeźbić
faragatlan - chamski, ordynarny
fáraó - faraon
farkas - wilk
farkasember - wilkołak
farmer - farmer
farok - ogon
fasiszta - faszysta, faszystowski
fasizmus - faszyzm
fasor - aleja
fatönk - pień, pniak
fatörzs - pień drzewa
fattyú - nieślubny, bękart, bastard
favágó - drwal
fazék - garnek
fazsindely - gont
február - luty
februári - lutowy
fecske - jaskółka
fecskendő - strzykawka
fegyver - broń
fegyverszünet - zawieszenie broni, rozejm
fegyverzet - zbroja
fehér - biały
Fehér Ház - Biały Dom
fehérítő - wybielacz
fehérje - białko
fehérnemű - bielizna
fehérorosz - białoruski, Białorusin, Białorusinka, białoruski (język)
Fehéroroszország - Białoruś
fehérvérűség - białaczka
fej - głowa
fejedelem - książę
fejfájás - ból głowy
fejlődés - rozwój, ewolucja
fejsze - siekiera, topór
fék - hamulec
fekély - wrzód
fekete - czarny (kolor)
fekete áfonya - borówka czarna, czarna jagoda
fekete doboz - czarna skrzynka
fekete lyuk - czarna dziura
feketerigó - kos
Fekete-tenger - Morze Czarne
fekszik - leżeć
fel - wzwyż
fél - bać się
felad - nadać, nadawać, dać za wygraną
feladás - nadanie
feladó - nadawca, nadawczyni
feláldoz - ofiarować, poświęcić
feláll - wstawać, wstać
feldolgozás - adaptacja
felé - w stronę, w kierunku, do, ku
feled - zapominać, zapomnieć
feledékeny - zapominalski
feledhetetlen - niezapomniany
felejt - zapominać, zapomnieć
felejthetetlen - niezapomniany
felel - odpowiadać, odpowiedzieć
félelem - obawa, strach
felelet - odpowiedź
felelős - odpowiedzialny
felelősség - odpowiedzialność
felelősségteljes - odpowiedzialny
félénk - bojaźliwy, lękliwy, nieśmiały
feleség - żona, małżonka
felett - nad
félév - półrocze
felfed - ujawniać
felfedezés - odkrycie
felfelé - w górę
felfoghatatlan - niezrozumiały
felhalmoz - gromadzić, akumulować
felhasználó - użytkownik, użytkowniczka
felhasználóbarát - przyjazny dla użytkownika
felhasználónév - nazwa użytkownika
felhatalmazás - pełnomocnictwo, upoważnienie
felhő - chmura
felhőkarcoló - wieżowiec, drapacz chmur
félhold - półksiężyc
felhős - pochmurny
felhúzókötél - bicz
Félix - Feliks
felkel - wstawać
fellebbez - apelować
felleg - chmura
felnőtt - dorosły
félreért - źle rozumieć, źle zrozumieć
felső - górny
félszemű - jednooki
félsziget - półwysep
felszín - powierzchnia
feltalál - wynaleźć
feltaláló - wynalazca
féltékeny - zazdrosny
féltékenység - zazdrość
féltestvér - przyrodni brat, przyrodnia siostra
feltétlenül - bezwarunkowo
felügyelő - inspektor
felület - powierzchnia
felvonó - winda
fém - metal
feminizmus - feminizm
fen - ostrzyć
fenék - pośladek
fenilketonuria - fenyloketonuria, oligofrenia fenylopirogronowa
fenn - powyżej
fennmaradó - pozostały
fent - powyżej
fentebb - powyżej
fény - światło
fenyeget - grozić
fenyegetés - groźba
fényév - rok świetlny
fénykép - zdjęcie, fotografia
fényképész - fotograf
fényképez - fotografować
fényképezőgép - aparat fotograficzny
fénylik - błyszczeć, lśnić, świecić się
fenyő - sosna
ferde - ukośny, krzywy
féreg - robak
Ferenc - Franciszek
férfi - mężczyzna
férj - mąż, małżonek
fermium - ferm
Feröer - Wyspy Owcze
fertőtlenít - dezynfekować
fertőz - zarazić
fertőzés - zakażenie, infekcja
fest - malować
festék - farba
festészet - malarstwo
festmény - malowidło, obraz
festő - malarz (artysta)
festőállvány - sztaluga
festőművész - malarz (artysta)
festőművésznő - malarka (artystka)
festőnő - malarka (artystka)
fésű - grzebień
fészek - gniazdo
fesztivál - festiwal
fetisizmus - fetyszyzm
fia - syn
fiatal - młodzieniec, młody
fiatalember - młody człowiek
fiatalos - młodzieńczy
fiatalság - młodość
Fidzsi-szigetek - Wyspy Fidżi, Fidżi
figyel - obserwować, uważać
figyelem - uwaga
figyelmes - uważny
figyelmeztet - ostrzegać
figyelmeztetés - ostrzeżenie
film - film
filológia - filologia
filológus - filolog
filozófia - filozofia
filozófiai - filozoficzny
filozofikus - filozoficzny
filozófus - filozof
fing - pierdnięcie
fingik - pierdzieć
finn - fiński, Fin, Finka, fiński (język)
Finn Köztársaság - Republika Finlandii
Finnország - Finlandia
finnországi - fiński
finom - delikatny
fiók - szuflada
fityma - napletek
fiú - chłopiec, syn
fiútestvér - brat
fivér - brat
fizet - płacić
fizetés - płaca, pensja, wypłata, wynagrodzenie
fizetett - płatny
fizika - fizyka
fizikai - fizyczny, materialny
fizikus - fizyk
fjord - fiord
flamingó - flaming, czerwonak
flexibilitás - elastyczność
flotta - flota
fluktuáció - fluktuacja
fluor - fluor
fő - główny, naczelny
főárboc - grotmaszt
fóbia - fobia
foci - piłka nożna, futbol
föderáció - federacja, związek
fodrász - fryzjer
fodrásznő - fryzjerka
fog - ząb, brać, chwytać, trzymać
fogamzás - poczęcie, zajście w ciążę
fogamzásgátlás - antykoncepcja
fogás - chwyt, danie
fogász - dentysta
fogászat - dentystyka, stomatologia
fogatlan - bezzębny
fogaysztó - konsument
fogház - więzienie
fogkefe - szczoteczka do zębów
fogkrém - pasta do zębów
foglalkozás - zawód, profesja
fogoly - więzień, kuropatwa
fogorvos - dentysta
fogvájó - wykałaczka
főiskola - szkoła wyższa, akademia
fojt - dusić, dławić
fok - stopień, schodek, stopień (jednostka)
fóka - foka
fokhagyma - czosnek
főkötő - czepek (noszony przez kobiety)
fokozatos - stopniowy
fokozatosan - stopniowo
Fokváros - Kapsztad
föld - ziemia, ląd
Föld - Ziemia
földalatti - podziemny
földelés - uziemienie
földgáz - gaz ziemny
földieper - truskawka
földimogyoró - orzech ziemny
Földközi-tenger - Morze Śródziemne
földműves - rolnik
földrajz - geografia
földrajzi - geograficzny
földrajztudós - geograf
földrengés - trzęsienie ziemi
földrész - kontynent
földszint - parter
földtan - geologia
fölé - nad, ponad
folklór - folklor
folt - plama, łata, skaza
folyadék - płyn
folyam - rzeka
folyamat - proces
folyamatosan - ciągle, stale, bezustannie
folyékony - płynny
folyik - płynąć, cieknąć
folyó - rzeka
folyóirat - periodyk, czasopismo
folyópart - brzeg rzeki
folyosó - korytarz
folytat - kontynuować
folytonos - ciągły, nieustanny, bezustanny
főnév - rzeczownik
főnök - szef
főnöknő - szefowa
fonológia - fonologia
fontos - ważny
fontosság - ważność, doniosłość, znaczenie
fordít - obracać, odwracać, tłumaczyć, przekładać
fordítás - tłumaczenie
fordító - tłumacz
forint - forint
forma - kształt, forma
formáció - formacja
formalizmus - formalizm
forog - obracać się, kręcić się
forradalmi - rewolucyjny
forradalom - rewolucja
forradás - blizna, szrama
forrás - źródło, zdrój, krynica
forráskód - kod źródłowy
forrásvíz - woda źródlana
forró - gorący
fórum - forum
foszfor - fosfor
fosztogat - plądrować, grabić, rabować
fotel - fotel
fotó - fotka, fotografia
fotogén - fotogeniczny
fotós - fotograf
főtt - gotowany
főváros - stolica
főz - gotować
főzés - gotowanie
francia - francuski, Francuz, Francuzka, francuski (język)
Francia Guyana - Gujana Francuska
Franciaország - Francja
Francia Polinézia - Polinezja Francuska
Franciska - Franciszka
francium - frans
frázis - fraza, zwrot, wyrażenie
frekvencia - częstotliwość
freskó - fresk
fridzsider - lodówka
friss - świeży
frissen - świeżo
frizsider - lodówka
frizura - fryzura
frontális - frontowy, przedni
fruktóz - fruktoza
frusztráció - frustracja
fű - trawa
Fudzsi - Fudżi
füge - figa (owoc)
függ - wisieć na czymś, zależeć od kogoś
függelék - dodatek, załącznik, aneks
független - niezależny, niepodległy
Független Államok Közössége - Wspólnota Niepodległych Państw
függetlenség - niepodległość, niezależność
függőágy - hamak
függőleges - pionowy
függöny - zasłona, kotara
függvény - funkcja
fúj - dmuchać
fül - ucho
fülbevaló - kolczyk
fülemüle - słowik rdzawy
fullánk - żądło
Fülöp - Filip
Fülöp-szigetek - Filipiny
fundamentális - fundamentalny, podstawowy, zasadniczy
fundamentalizmus - fundamentalizm
funkció - funkcja
fúr - wiercić, świdrować
fura - dziwny
furcsa - dziwny
fürdés - kąpiel
fürdő - kąpiel, kąpielowy
fürdőkád - wanna
fürdőszoba - łazienka
fűrész - piła
fűrészpor - trociny
fürj - przepiórka
fúrógép - wiertarka
furoszemid - furosemid
furulya - flet
füst - dym
fűszer - przyprawa
fűszerez - przyprawiać, zaprawiać
fut - biec
futball - piłka nożna, futbol
futballista - futbolista, piłkarz grający w piłkę nożną
fűtés - ogrzewanie, opalanie
futó - biegacz
fütty - gwizdek
futurizmus - futuryzm
fütyül - gwizdać
fuvola - flet
füzet - zeszyt
fűzfa - wierzba
Gabon - Gabon
gabona - zboże
gabonaföld - pole, na którym uprawiane jest zboże
Gábor - węgierskie imię męskie
gácsér - kaczor
gadolínium - gadolin
galagonya - głóg
galamb - gołąb
galaxis - galaktyka
galéria - galeria
Galilea - Galilea (kraina)
gallér - kołnierz
gallicizmus - galicyzm
gallium - gal
gally - gałązka
Gambia - Gambia
garancia - gwarancja
garantál - gwarantować
garázs - garaż
gardrób - garderoba
gargarizál - płukać gardło, wypłukać gardło
Gáspár - Kacper, Kasper, Gaspar
gasztronómia - gastronomia
gát - tama
gaz - chwast
gáz - gaz
gazda - gospodarz, rolnik
gazdag - bogaty
gazdagság - bogactwo
gazdálkodik - gospodarować
gazdálkodó - rolnik, gospodarz
gazdaság - gospodarstwo, farma, gospodarka
gazdasági - gospodarczy, ekonomiczny
gazdaságos - gospodarny, oszczędny
gazella - gazela
gázlámpa - lampa gazowa
gázló - bród
gebe - szkapa
gége - krtań
gejzír - gejzer
Gellért - Gerard
gém - czapla
generáció - generacja, pokolenie
generális - generał
generátor - generator
genetikai - genetyczny
genetikailag - genetycznie
genetikus - genetyczny
Genf - Genewa
genny - ropa
genocídium - ludobójstwo
geodézia - geodezja
geológia - geologia
geológus - geolog
geometria - geometria
gép - maszyna
gepárd - gepard
gépel - pisać na maszynie, szyć na maszynie
gépész - mechanik, maszynista
gépezet - mechanizm
gépírónő - maszynistka (kobieta pisząca na maszynie)
gépkarabély - karabin automatyczny
gépkocsi - samochód
géplakatos - ślusarz
géppisztoly - pistolet maszynowy
géppuska - karabin maszynowy
gereblye - grabie
gerely - oszczep
gerenda - belka
Gergely - Grzegorz
gerinc - kręgosłup, grań
gerincoszlop - kręgosłup
gerle - synogarlica
germánium - german
germanizmus - germanizm
gesztenye - kasztan
géz - gaza
Ghána - Ghana
Gibraltár - Gibraltar
giccs - kicz
giccses - kiczowaty
gida - koźlę
gigantikus - gigantyczny
giliszta - dżdżownica, glista
gimnasztika - gimnastyka
gipsz - gips
gitár - gitara
gitáros - gitarzysta
gitt - kit
glaciológia - glacjologia
gleccser - lodowiec
gliszta - glista
globális - globalny
globális felmelegedés - globalne ocieplenie
globalizáció - globalizacja
glükóz - glukoza
gnoszticizmus - gnostycyzm
gödény - pelikan
gödör - dół, dziura, jama
gőg - pycha, buta
golf - golf
gólya - bocian
golyó - kula
gomb - guzik
gömb - sfera
gomba - grzyb
gombaféle - grzyb
gombaismeret - mykologia
gombatan - mykologia
gondatlan - niestaranny, niedbały
gondol - myśleć
gondolat - myśl
gondolatjel - myślnik
gondolkodás - myślenie, rozmyślanie
gondolkodik - myśleć, rozmyślać, zastanawiać się
gondolkodó - myśliciel
gondolkozik - myśleć, rozmyślać, zastanawiać się
göndör - kędzierzawy
gondos - uważny
gondtalan - beztroski
gonosz - zły, wredny
görbe - krzywy, krzywa
görbít - zginać, zgiąć
görény - tchórz
gorilla - goryl
görkorcsolya - wrotka
görkorcsolyázik - jeździć na wrotkach
görög - grecki, Grek, Greczynka, grecki (język)
görögdinnye - arbuz
Görögország - Grecja
görögországi - grecki
gőz - para
gőzhajó - parostatek, parowiec
gőzös - parostatek, parowiec, parowóz
grafikai - graficzny
gramm - gram
grammatikai - gramatyczny
gránátalma - granat
gránit - granit
grapefruit - grejpfrut
gratulál - gratulować, pogratulować
gravitáció - grawitacja
gravitációs - grawitacyjny
Grenada - Grenada
grépfrút - grejpfrut
gróf - hrabia
grófnő - hrabina
Grönland - Grenlandia
groteszk - groteskowy
Groznij - Grozny
grúz - Gruzin, Gruzinka, gruziński (język), gruziński
Grúzia - Gruzja
Guadeloupe - Gwadelupa
Guam - Guam
Guatemala - Gwatemala
Guatemalaváros - Gwatemala
gudzsaráti - gudżarati
Guinea - Gwinea
gúla - ostrosłup
gulyás - gulasz
gumi - guma
gümőkór - gruźlica
gúnár - gąsior
gúny - szyderstwo, kpina, drwina
gúnynév - przezwisko
gusztus - gust, smak, apetyt
gusztusos - gustowny, apetyczny
Guyana - Gujana
gyakori - częsty, częstotliwy
gyakoriság - częstość, częstotliwość
gyakorlat - praktyka, wprawa, ćwiczenie
gyakorlati - praktyczny
gyakorlatilag - praktycznie
gyakorlat teszi a mestert - ćwiczenie czyni mistrza
gyakornok - praktykant
gyakorol - ćwiczyć
gyakran - często
gyalog - pieszo
gyalogos - pieszy, piechur
gyalu - strug, hebel
gyanú - podejrzenie, posądzenie
gyapjas - wełnisty
gyapjú - wełna
gyapot - bawełna
gyár - fabryka, wytwórnia, zakład przemysłowy
gyarmat - kolonia
gyarmatosít - kolonizować
gyarmatosítás - kolonizacja
gyárt - produkować, wyrabiać, wytwarzać
gyártó - producent, wytwórca
gyász - żałoba
gyászjelentés - nekrolog
gyászos - żałobny, ponury
gyáva - tchórz, strachajło, tchórzliwy
gyávaság - tchórzostwo
gyehenna - piekło
gyémánt - diament
gyenge - słaby
gyengéd - delikatny, czuły
gyengít - osłabiać, osłabić
gyengül - słabnąć
gyep - trawnik
gyerek - dziecko, dzieciak
gyerekek és bolond mindig igazat mond - dzieci i głupcy zawsze mówią prawdę
gyerekes - dziecinny, zdziecinniały
gyerekszoba - pokój dziecięcy
gyermek - dziecko
gyermekkocsi - wózek dziecięcy
gyermekkor - dzieciństwo
gyermekláncfű - mniszek lekarski
gyermekorvos - pediatra
gyermekruha - ubranko dziecięce
gyertya - świeca
gyertyatartó - świecznik
gyík - jaszczurka
gyilkol - mordować
gyilkos - morderczy, zabójczy, morderca, zabójca
gyilkosság - mord, morderstwo
gyógyít - leczyć
gyógyíthatatlan - nieuleczalny
gyógynövény - roślina lecznicza
gyógyszer - lek
gyógyszerész - farmaceuta, aptekarz
gyógyszeripar - przemysł farmaceutyczny
gyógyszertár - apteka
gyógyul - zdrowieć
gyökér - korzeń
gyom - chwast, zielsko
gyomor - żołądek
gyón - spowiadać się
gyónás - spowiedź
gyönge - słaby
gyöngy - perła, korale
gyöngytyúk - perliczka
gyöngyvirág - konwalia
gyóntató - spowiednik
gyóntatóatya - spowiednik
gyönyör - przyjemność
gyönyörű - piękny
György - Jerzy
gyors - szybki, prędki
gyorsan - prędko, szybko
gyorsaság - szybkość, prędkość
gyorsít - przyśpieszać, przyśpieszyć
gyorsulás - przyspieszenie
gyötrelem - męka, cierpienie
győzelem - zwycięstwo
győzelmes - zwycięski
gyufa - zapałka
gyújt - zapalać, zapalić
gyűjt - zbierać, zabrać
gyűjtemény - zbiór, kolekcja
gyűjtő - kolekcjoner, zbieracz
Gyula - Juliusz
gyűlés - zebranie, zgromadzenie
gyulladás - zapalenie
gyűlöl - nienawidzić
gyűlölet - nienawiść
gyűlöletes - nienawistny, znienawidzony
gyűlölködés - nienawiść
gyümölcs - owoc
gyümölcsfa - drzewo owocowe
gyümölcsíz - marmolada
gyümölcslé - sok
gyümölcsönös - wrzesień
gyümölcsös - owocowy, sad
gyűrődés - fałda, zmarszczka
gyűrű - pierścień, pierścionek
gyűszű - naparstek
ha - jeśli
hab - piana
habcsók - beza
habkő - pumeks
hableány - syrena
háború - wojna
had - armia
hadd - niech, niechaj
hadi - wojenny, wojskowy
hadihajó - okręt
haditengerészet - marynarka wojenna
hadjárat - kampania
hadművelet - operacja wojskowa
hadosztály - dywizja
hadsereg - armia, wojsko
hafnium - hafn
hagy - zostawiać, zostawić
hagyma - cebula
hagyomány - tradycja
hagyományos - tradycyjny
Haidarábád - Hajdarabad
Haiti - Haiti
haj - włosy
hajatlan - bezwłosy
hajdinakása - kasza gryczana
hajfonat - warkocz
hajít - rzucać
hajkefe - szczotka do włosów
hajlandó - skłonny, gotowy (do czegoś)
hajnal - świt
hajnalodik - świtać
hajó - statek
hajós - żeglarz
hajszárító - suszarka do włosów
hajthatatlan - nieugięty, niezłomny
hal - ryba, umierać
haladás - postęp
Halak - Ryby (gwiazdozbiór)
halál - śmierć
halálbüntetés - kara śmierci
halálos - śmiertelny
halandó - śmiertelny, śmiertelnik
halandóság - śmiertelność
halánték - skroń
hálás - wdzięczny
halász - rybak
halászik - łowić
halászsas - rybołów
halaszt - odraczać, odroczyć
haldoklás - agonia, konanie
halhatatlan - nieśmiertelny
halhatatlanság - nieśmiertelność
hall - słyszeć
halleves - zupa rybna
hallgat - słuchać, milczeć
hallgatag - małomówny, milczący
hallgató - słuchacz, słuchaczka
halló - halo!, słucham!
hallucináció - halucynacja, omam
halmaz - zbiór
háló - sieć, siatka, sidła
halom - sterta
hálószoba - sypialnia
halott - zmarły, zmarła, martwy
hálózat - sieć
hálózsák - śpiwór
halványul - blednąć, zblednąć
hamar - szybko, prędko
hamarosan - wkrótce
Hamburg - Hamburg
hamis - fałszywy
hamisítás - fałszerstwo, falsyfikacja
hamisítvány - falsyfikat
hámoz - obierać
hamu - popiół
hamutartó - popielniczka
hanem - ale, lecz
hang - głos, dźwięk
hanga - wrzos
hangol - stroić, nastroić
hangos - głośny
hangosbeszélő - głośnik
hangsúly - akcent
hangszer - instrument muzyczny
hangszóró - głośnik
hangulat - nastrój, klimat, atmosfera
hangverseny - koncert
hangya - mrówka
hangyaboly - mrowisko
hangzás - dźwięczność
hangzik - brzmieć
ha nincs otthon a macska, cincognak az egerek - gdy kota nie ma, myszy harcują
hány - wymiotować
harag - gniew, złość
haragos - zły, rozgniewany, wróg
harang - dzwon, dzwonek
harangtorony - kołokolnia, dzwonnica
harap - gryźć
harc - walka, bój
harci - wojowniczy, bojowy
harckocsi - czołg
harcol - walczyć
harcos - wojownik
harcsa - sum
hárem - harem
hárfa - harfa
harisnya - pończochy
harisnyanadrág - rajstopy
harkály - dzięcioł
harmadik - trzeci
harmadikos - trzecioklasista
harmadkor - trzeciorzęd
harmadkori - trzeciorzędowy
harmadlagos - trzeciorzędny, trzeciorzędowy
harmadnap - trzeciego dnia
harmadnapos - trzydniowy
harmadnapra - na trzeci dzień
harmat - rosa
harminc - trzydzieści, 30
harmincadik - trzydziesty
harmincegy - trzydzieści jeden, 31
harmincegyedik - trzydziesty pierwszy
harmincharmadik - trzydziesty trzeci
harminchárom - trzydzieści trzy, 33
harminchat - trzydzieści sześć, 36
harminchatodik - trzydziesty szósty
harminchét - trzydzieści siedem, 37
harminchetedik - trzydziesty siódmy
harminckettedik - trzydziesty drugi
harminckettő - trzydzieści dwa, 32
harminckilenc - trzydzieści dziewięć, 39
harminckilencedik - trzydziesty dziewiąty
harmincnégy - trzydzieści cztery, 34
harmincnegyedik - trzydziesty czwarty
harmincnyolc - trzydzieści osiem, 38
harmincnyolcadik - trzydziesty ósmy
harmincöt - trzydzieści pięć, 35
harmincötödik - trzydziesty piąty
harmónia - harmonia
harmonika - akordeon
három - trzy, 3
háromszáz - trzysta, 300
háromszög - trójkąt
háromszögű - trójkątny
harsona - puzon
has - brzuch
hasmenés - biegunka
hasnyálmirigy - trzustka
hasonló - podobny
hasonlóság - podobieństwo
haspárti - żarłok
hasszium - has
használ - używać, stosować
használat - użycie, użytkowanie
hasznos - pożyteczny, przydatny, użyteczny
haszon - korzyść, pożytek, zysk, profit
hat - sześć, 6
hát - plecy
hatalom - władza
határ - granica
határoz - decydować
határozat - decyzja
határozószó - przysłówek
határozott - zdecydowany
határozottan - stanowczo, zdecydowanie, dobitnie
hatás - efekt, rezultat
hatásos - efektowny, efektywny, skuteczny
hatékony - skuteczny, efektywny
hátha - a jeżeli, a gdyby, a jak
hátizsák - plecak
hatodik - szósty
hátra - wstecz
hátrafelé - do tyłu
hátrány - niekorzyść, wada
hátrányos - niekorzystny, wadliwy
hatszáz - sześćset, 600
hatszög - sześciokąt
háttér - tło
hattyú - łabędź
hatvan - sześćdziesiąt, 60
hatvanadik - sześćdziesiąty
hatvanegy - sześćdziesiąt jeden, 61
hatvanegyedik - sześćdziesiąty pierwszy
hatvanharmadik - sześćdziesiąty trzeci
hatvanhárom - sześćdziesiąt trzy, 63
hatvanhat - sześćdziesiąt sześć, 66
hatvanhatodik - sześćdziesiąty szósty
hatvanhét - sześćdziesiąt siedem, 67
hatvanhetedik - sześćdziesiąty siódmy
hatvankettedik - sześćdziesiąty drugi
hatvankettő - sześćdziesiąt dwa, 62
hatvankilenc - sześćdziesiąt dziewięć, 69
hatvankilencedik - sześćdziesiąty dziewiąty
hatvannégy - sześćdziesiąt cztery, 64
hatvannegyedik - sześćdziesiąty czwarty
hatvannyolc - sześćdziesiąt osiem, 68
hatvannyolcadik - sześćdziesiąty ósmy
hatvanöt - sześćdziesiąt pięć, 65
hatvanötödik - sześćdziesiąty piąty
hatvány - moc, siła, potęga
havas - śnieżny
havazik - śnieżyć
haver - kumpel
havi - miesięczny
ház - dom
haza - ojczyzna
hazafi - patriota
hazafias - patriotyczny
házasság - małżeństwo
házasságtörés - cudzołóstwo
házbér - komorne
házi - domowy
házi feladat - praca domowa
házigazda - gospodarz domu
házinyúl - królik
házmester - dozorca, stróż
házszám - numer domu
háztartás - gospodarstwo domowe
háztető - dach (domu)
hazudik - okłamywać, okłamać
hazug - kłamliwy
hazugság - kłamstwo
héber - Hebrajczyk, Hebrajka, hebrajski (język), hebrajski
hedonizmus - hedonizm
Hedvig - Jadwiga
heg - szrama, blizna
hegedű - skrzypce
hegesztő - spawacz
hegy - góra
hegycsúcs - szczyt górski
hegymászó - alpinista
hegység - pasmo górskie, góry
hej - och, hej
héj - łupina
héja - jastrząb
helikopter - helikopter, śmigłowiec
hélium - hel
Helsinki - Helsinki
hely - miejsce, miejscowość
helyes - poprawny, słuszny, właściwy, ładny, miły
helyesírás - ortografia
helyett - zamiast
helyez - umieszczać, kłaść
helyi - lokalny
helység - miejscowość
Henrik - Henryk
hentes - rzeźnik
herceg - książę
hercegnő - księżniczka
here - jądro
hering - śledź
hermelin - gronostaj
hernyó - gąsienica
hét - siedem, 7
hetedik - siódmy
heteroszexualitás - heteroseksualizm
hétfő - poniedziałek
hétfői - poniedziałkowy
hetilap - tygodnik
hétköznap - dzień powszedni
hétköznapi - powszedni
hétszáz - siedemset, 700
hétvége - weekend
hetven - siedemdziesiąt, 70
hetvenedik - siedemdziesiąty
hetvenegy - siedemdziesiąt jeden, 71
hetvenegyedik - siedemdziesiąty pierwszy
hetvenharmadik - siedemdziesiąty trzeci
hetvenhárom - siedemdziesiąt trzy, 73
hetvenhat - siedemdziesiąt sześć, 76
hetvenhatodik - siedemdziesiąty szósty
hetvenhét - siedemdziesiąt siedem, 77
hetvenhetedik - siedemdziesiąty siódmy
hetvenkettedik - siedemdziesiąty drugi
hetvenkettő - siedemdziesiąt dwa, 72
hetvenkilenc - siedemdziesiąt dziewięć, 79
hetvenkilencedik - siedemdziesiąty dziewiąty
hetvennégy - siedemdziesiąt cztery, 74
hetvennegyedik - siedemdziesiąty czwarty
hetvennyolc - siedemdziesiąt osiem, 78
hetvennyolcadik - siedemdziesiąty ósmy
hetvenöt - siedemdziesiąt pięć, 75
hetvenötödik - siedemdziesiąty piąty
hiába - daremnie, nadaremnie
hiány - niedobór, niedostatek, deficyt
hiányzó - brakujący, nieobecny
hiba - błąd, pomyłka
híd - most
hideg - zimny
hidegen - zimno
hidraulikus - hydrauliczny
hidrogén - wodór
hiéna - hiena
hierarchia - hierarchia
híg - rzadki, cienki
higany - rtęć
higiénia - higiena
hihetetlen - niebywały, niewiarygodny
himlő - ospa
himnusz - hymn
hímvessző - penis
hindi - hindi
hindu - hinduista, hinduistka, hinduistyczny
hinta - huśtawka
hintó - kareta, powóz
hipnózis - hipnoza
hipotézis - hipoteza
hír - nowina, wiadomość, wieść
hirdetés - anons, ogłoszenie, reklama
hirdetmény - obwieszczenie, ogłoszenie
híres - sławny, znany
hírlap - gazeta
hírnév - sława, reputacja, renoma
hírnök - posłaniec
hírszerzés - wywiad, instytucja wywiadowcza
hirtelen - nagle
história - historia, opowiadanie, historyjka
hisz - wierzyć
hit - wiara, przekonanie
hitelező - wierzyciel
hitelkártya - karta kredytowa
hitetlen - niewierzący, niewierny
hiúság - próżność
hiúz - ryś
hív - wołać
hivatal - biuro, urząd
hivatali - biurowy, urzędowy
hivatalos - oficjalny, urzędowy, służbowy
hivatás - zawód, profesja
hivatásos - zawodowy
hízik - tyć, przytyć
hó - śnieg
hő - ciepło
hóbagoly - sowa śnieżna
hobbi - hobby
hód - bóbr
hódít - zdobywać, podbijać
hóember - bałwan śniegowy
hófehér - śnieżnobiały
Hófehérke - Śnieżka
hóförgeteg - zamieć
hófúvás - zamieć
hógolyó - kula śnieżna
hogy - jak?
hogyan - jak
hoki - hokej
hol - gdzie
hold - księżyc
Hold - Księżyc
holdfény - światło księżyca
holdkóros - lunatyk
holdtölte - pełnia księżyca
holdvilág - światło księżyca
hölgy - pani
holland - Holender, Holenderka, holenderski (język), holenderski
Holland Antillák - Antyle Holenderskie
holland árverés - aukcja holenderska
Hollandia - Holandia
holló - kruk
holmium - holm
holnap - jutro
holnapután - pojutrze
holt - martwy
holttest - zwłoki, ciało
homár - homar
homeopátia - homeopatia
hőmérő - termometr
hőmérséklet - temperatura
homlok - czoło
homok - piasek
homoki - piaskowy
homokkő - piaskowiec
homokos - piaszczysty
homoszexuális - homoseksualny
homoszexualitás - homoseksualizm
hon - ojczyzna
hón - pacha
hónalj - pacha
hónap - miesiąc
Honduras - Honduras
honfitárs - rodak, ziomek
Hongkong - Hongkong
hópehely - śnieżynka, płatek śniegu
hópihe - śnieżynka, płatek śniegu
hörcsög - chomik
hord - nosić
horda - horda
hordár - bagażowy
hordó - beczka
hordozható - przenośny
horgony - kotwica
horizont - horyzont
horizontális - poziomy
horkol - chrapać
horog - hak, haczyk
horoszkóp - horoskop
horvát - chorwacki, Chorwat, Chorwatka, chorwacki (język)
Horvátország - Chorwacja
hős - bohater
hőség - skwar, upał
hősies - bohaterski
hősnő - bohaterka
hossz - długość
hosszú - długi
hosszúkás - podłużny
hosszúság - długość
hotel - hotel
hová - dokąd?, gdzie?
hóvihar - zamieć
hóvirág - śnieżyczka
hoz - nosić, przynosić, przynieść
hozomány - posag
hozzáad - dodawać, dodać
hozzájárul - przyczyniać się (do czegoś)
hozzávetőleg - w przybliżeniu, mniej więcej
hozzávetőleges - przybliżony
hű - wierny
Huculok - Hucuł
húg - młodsza siostra
Hugó - Hugo, Hugon
hulla - trup
hullaház - kostnica
hullám - fala
hullámos - falisty
hüllő - gad
hullócsillag - gwiazda spadająca
hülye - idiotyczny, głupi, idiota, idiotka
humán - ludzki
humanitárius - humanitarny
humanizmus - humanizm
humor - humor
humorérzék - poczucie humoru
humorista - humorysta
húr - struna, cięciwa
hurok - pętla
hurrikán - huragan
hús - mięso
hűs - chłodny
husáng - drąg, pała
hűség - wierność, lojalność
hűséges - wierny
húsvét - Wielkanoc
húsz - dwadzieścia, 20
huszadik - dwudziesty
huszár - huzar, kawalerzysta, skoczek
huszonegy - dwadzieścia jeden, 21
huszonegyedik - dwudziesty pierwszy
huszonharmadik - dwudziesty trzeci
huszonhárom - dwadzieścia trzy, 23
huszonhat - dwadzieścia sześć, 26
huszonhatodik - dwudziesty szósty
huszonhét - dwadzieścia siedem, 27
huszonhetedik - dwudziesty siódmy
huszonkettedik - dwudziesty drugi
huszonkettő - dwadzieścia dwa, 22
huszonkilenc - dwadzieścia dziewięć, 29
huszonkilencedik - dwudziesty dziewiąty
huszonnégy - dwadzieścia cztery, 24
huszonnegyedik - dwudziesty czwarty
huszonnyolc - dwadzieścia osiem, 28
huszonnyolcadik - dwudziesty ósmy
huszonöt - dwadzieścia pięć, 25
huszonötödik - dwudziesty piąty
hűtőgép - chłodziarka, lodówka
hűtőszekrény - lodówka, chłodziarka
hüvely - pochwa
hüvelyk - cal
hüvelykujj - kciuk
hűvös - chłodny
húz - ciągnąć
ibolya - fiołek, fioletowy, fiołkowy
ide - tu, tutaj
ideál - ideał
ideális - idealny
idealizál - idealizować
ideg - nerw
idegen - cudzy, obcy, cudzoziemski, cudzoziemiec, cudzoziemka
idegengyűlölet - ksenofobia
idegenvezető - przewodnik, cicerone
idegkórtan - neurologia
idegorvos - neurolog
idegrendszer - układ nerwowy
idegsejt - neuron
identifikáció - identyfikacja
ideológia - ideologia
idéz - cytować, zacytować
idézet - cytat
idióta - idiota
idő - czas, pogoda
időjárás - pogoda
időközben - w międzyczasie
időrendi - chronologiczny
idős - stary
időszak - okres, period, cykl
ifjú - młodzieniec, młody
iga - jarzmo
igaz - prawdziwy
igazán - doprawdy, rzeczywiście, naprawdę
igazgat - zarządzać, administrować
igazgató - dyrektor
igazi - prawdziwy, istny
igazság - prawda, sprawiedliwość
igazságos - sprawiedliwy
igazságtalan - niesprawiedliwy
igazságtalanság - niesprawiedliwość
ige - czasownik
igen - tak
ígér - obiecać
igeragozás - koniugacja
ígéret - obietnica
így - tak, w ten sposób
igyekezet - dążenie, dążność
igyekszik - starać się, usiłować
íj - łuk
íjász - łucznik
íjászat - łucznictwo
iker - bliźniak
ikra - ikra
Ikrek - Bliźnięta
illat - zapach (przyjemny)
illatszer - perfumy
illatszerbolt - perfumeria
illatszertár - perfumeria
illegális - nielegalny
illusztráció - ilustracja
illusztrál - ilustrować
illusztrált - ilustrowany
illúzió - iluzja, złudzenie
Ilona - Ilona, Helena
ilyen - taki
ima - modlitwa
imád - uwielbiać, adorować, wielbić, czcić
imádás - wielbienie, czczenie, adoracja
imádkozik - modlić się, pomodlić się
imaginárius - urojony
imbisz - przekąska
immorális - niemoralny
imperialista - imperialista
imperializmus - imperializm
impertinencia - impertynencja
implikáció - implikacja
imponál - imponować
imponáló - imponujący, okazały
import - import, przywóz
importál - importować
impregnál - impregnować
impresszárió - impresario
impresszionizmus - impresjonizm
improduktív - nieprodukcyjny, nieproduktywny
improvizáció - improwizacja
improvizál - improwizować
impulzív - impulsywny, porywczy
Imre - Emeryk
ín - ścięgno
India - Indie
indiai - indyjski
Indiai-óceán - Ocean Indyjski
indiszkrét - niedyskretny
indium - ind
individuális - indywidualny
individualizmus - indywidualizm
indoeurópai - indoeuropejski
indonéz - Indonezyjczyk, Indonezyjka, indonezyjski (język), indonezyjski
Indonézia - Indonezja
indukció - indukcja
indulás - odjazd
indulatszó - wykrzyknik
infekció - infekcja, zakażenie
infláció - inflacja
influenza - grypa, influenca
információ - informacja
informál - informować, powiadamiać, zawiadamiać
informatika - informatyka
informatikus - informatyk
infrastruktúra - infrastruktura
infravörös - podczerwony
infúzió - napar
ing - koszula
inga - wahadło
ingatlan - nieruchomość
inger - bodziec
ingovány - bagno, grzęzawisko, trzęsawisko
ingyenes - bezpłatny, nieodpłatny, darmowy
injekció - zastrzyk, iniekcja
inkább - raczej
inkonzisztens - niespójny
innováció - innowacja
ínség - niedostatek
inspekció - inspekcja
inspiráció - inspiracja, natchnienie
integráció - integracja
integrál - całkować, całka
intellektuális - intelektualny
intellektus - intelekt
intelligencia - inteligencja
intelligens - inteligentny
intenció - zamiar
intenzív - intensywny
interjú - wywiad (dziennikarski)
interlingva - interlingua
internacionalizmus - internacjonalizm
internet - internet
interpelláció - interpelacja
interpretáció - interpretacja
intervenció - interwencja
intézet - instytut
intonáció - intonacja
intrika - intryga
intuíció - intuicja
invázió - inwazja
invitál - zaprosić
íny - dziąsło
ipar - przemysł
ipari - przemysłowy
ír - irlandzki, Irlandczyk, Irlandka, irlandzki (język), pisać
Irak - Irak
Irán - Iran
irány - kierunek
irányelv - dyrektywa, zasada, wytyczna
irányít - kierować, dowodzić, sterować
iránytű - kompas, busola
írás - pisanie, pismo
írástudatlan - niepiśmienny, analfabeta
irat - dokument, pismo
Irén - Irena
irídium - iryd
irigy - zazdrosny, zawistny
irigyel - zazdrościć
irigykedő - zazdrosny, zawistny
irigység - zazdrość, zawiść
író - pisarz
íróasztal - biurko
iroda - biuro
irodalmi - literacki
irodalom - literatura
írógép - maszyna do pisania
irónia - ironia
írónő - pisarka
Írország - Irlandia
írországi - irlandzki
irracionális - irracjonalny
irt - tępić, trzebić, karczować
is - też, także, również
iskola - szkoła
iskolai - szkolny
iskolatáska - tornister, plecak
ismer - znać
ismeret - wiedza, znajomość
ismeretes - znany
ismeretlen - nieznany, anonimowy
ismerős - znajomy
ismét - znowu, znów
ismétel - powtarzać
ismétlés a tudás anyja - ćwiczenie czyni mistrza
ispán - żupan
istálló - stajnia
isten - bóg, bóstwo
Isten - Bóg
isteni - boski
istennő - bogini
istenség - bóstwo
istentisztelet - nabożeństwo
István - Stefan
iszap - błoto
iszik - pić
Iszlámábád - Islamabad
Isztambul - Stambuł
ital - napój
Itália - Włochy
itáliai - włoski
ítél - sądzić, osądzić
ítélet - osąd, opinia, zdanie, orzeczenie
iteráció - iteracja
itt - tu, tutaj
ittas - pijany, nietrzeźwy
ittasság - pijaństwo, opilstwo
itterbium - iterb
ittrium - itr
ív - łuk
Ivett - Iweta
ivóvíz - woda pitna
íz - smak, dżem, konfitura, marmolada
Izland - Islandia
izlandi - Islandczyk, Islandka, islandzki (język), islandzki
ízlés - gust, smak
ízletes - smaczny, apetyczny
-izmus - -izm, -yzm
izolacionizmus - izolacjonizm
izom - mięsień
izotóp - izotop
Izrael - Izrael
izzad - pocić się
izzadság - pot
izzólámpa - żarówka
jacht - jacht
jaguár - jaguar
jak - jak
Jakab - Jakub
Jamaica - Jamajka
Jamaika - Jamajka
janicsár - janczar
János - Jan
január - styczeń
januári - styczniowy
japán - Japończyk, Japonka, japoński (język), japoński
Japán - Japonia
jár - chodzić
járás - chód, chodzenie, powiat
járat - linia, trasa
járda - chodnik, trotuar
jármű - wehikuł, środek transportu
járművezető - kierowca
járom - jarzmo
járőrözik - patrolować
Jaroszlav - Jarosław
Jaroszláv - Jarosław
járvány - epidemia
játék - gra, zabawka
játékos - zawodnik, gracz, figlarny
játékvezető - sędzia
játszik - grać, bawić się
játszótér - plac zabaw
Jáva - Jawa
javaslat - propozycja, sugestia
javasol - sugerować
javít - poprawiać, ulepszać, doskonalić, naprawiać, remontować
javítás - remont, naprawa
javul - polepszać się, poprawiać się, ulegać poprawie
javulás - polepszenie, poprawa
jázmin - jaśmin
jég - lód
jégcsap - sopel
jegenyefenyő - jodła
jeges - lodowaty
jegesmedve - niedźwiedź polarny
jégeső - grad
Jeges-tenger - Morze Arktyczne, Ocean Arktyczny
jéghegy - góra lodowa
jégkorong - hokej na lodzie
jegy - bilet
jegyes - narzeczony, narzeczona
jegyzék - lista, spis
jel - oznaka, symbol, znak
jelen - teraźniejszość
jelenleg - obecnie, aktualnie
jelent - oznaczać, znaczyć, donosić, powiadamiać
jelentős - znaczący
jelkép - symbol
jellegzetes - charakterystyczny
jellegzetesség - cecha, charakter, właściwość
jellem - charakter, osobowość
jellemző - charakterystyczny
jelmez - kostium, strój
jelölt - kandydat, kandydatka
jelszó - hasło
jelzálog - hipoteka
jelző - przydawka
jelzőlámpa - światło sygnalizacyjne
Jemen - Jemen
Jenő - Eugeniusz
Jenyiszej - Jenisej
Jereván - Erywań
Jeruzsálem - Jerozolima
jeti - yeti
Jézus - Jezus
jiddis - jidysz
jin-jang - yin i yang
jó - dobry
jobb - prawy
jobban - lepiej
jobb félni, mint megijedni - lepiej zapobiegać niż leczyć
jobb későn, mint soha - lepiej późno niż wcale
jobb ma egy veréb, mint holnap egy túzok - lepszy wróbel w garści niż gołąb na dachu
jobboldal - prawica
jobbra - na prawo, w prawo
jód - jod
jó éjszakát - dobranoc
jó éjszakát kívánok - dobranoc
jó estét - dobry wieczór
jó estét kívánok - dobry wieczór
jó étvágyat - smacznego
jog - prawo
jogar - berło
jogász - prawnik
joghurt - jogurt
jogi - prawny
jogigény - roszczenie prawne
jogos - słuszny
jogosult - uprawniony
jogtalan - bezprawny
jóizű - smaczny
jókedvű - wesoły
jól - dobrze
jön - przychodzić
jó napot - dzień dobry
jó napot kívánok - dzień dobry
Jónás - Jonasz
Jordánia - Jordania
jó reggelt - dzień dobry
jó reggelt kívánok - dzień dobry
jós - wróżbita
jósnő - wróżka
jótékony - korzystny
jó tett helyébe jót várj - przysługa za przysługę
jóváhagy - aprobować, zatwierdzać
jóváhagyás - aprobata, afirmacja, akceptacja
jóváírás - uznanie
jövedelem - dochód
jövendő - przyszłość
jövő - przyszłość
jövőbeli - przyszły
jövő idő - czas przyszły
jövőkutatás - futurologia
józan - trzeźwy
József - Józef
jubileum - jubileusz
judaizmus - judaizm
Judit - Judyta
jugoszláv - jugosłowiański
Jugoszlávia - Jugosławia
jugoszláviai - jugosłowiański
juh - owca
juhar - klon
juharfa - klon
juhász - juhas, pasterz owiec
juhászkutya - owczarek
juhnyáj - stado owiec
juhsajt - owczy ser
juj - och
Júlia - Julia
Juliánusz - Juliusz
július - lipiec
júliusi - lipcowy
június - czerwiec
júniusi - czerwcowy
Jupiter - Jowisz, Jupiter
jurta - jurta
jutalom - nagroda
kabala - talizman
kabaré - kabaret
kabát - płaszcz, kurtka
kábel - kabel
kábítószer - narkotyk
kabóca - cykada
Kabul - Kabul
kacaj - śmiech
kacsa - kaczka
kacsacsőrű emlős - dziobak
kád - wanna
kadmium - kadm
Kafarnaum - Kafarnaum
Kairó - Kair
kajak - kajak
Kajmán-szigetek - Kajmany
kajszi - morela
kajszibarack - morela
kakadu - kakadu
kakaó - kakao
kakas - kogut
kaktusz - kaktus
kakukk - kukułka
kalács - kołacz
kaland - przygoda
kalandor - poszukiwacz przygód
kalap - kapelusz
kalapács - młot, młotek
kalász - kłos
kalcium - wapń
kaleidoszkóp - kalejdoskop
kalifa - kalif
Kalifornia - Kalifornia
kalifornium - kaliforn
kálium - potas
kalkuláció - kalkulacja
kalóz - pirat
kalózkodás - piractwo
kálvinizmus - kalwinizm
kályha - piec
kamat - procent, odsetki
Kambodzsa - Kambodża
kaméleon - kameleon
Kamerun - Kamerun
kámfor - kamfora
kamilla - rumianek
kampány - kampania
kan - samiec
Kanada - Kanada
kanadai - kanadyjski
kanál - łyżka
kanári - kanarek
kanárimadár - kanarek
Kanári-szigetek - Wyspy Kanaryjskie
kanca - klacz
kandúr - kocur
kanna - bańka, konewka, czajnik
kannibalizmus - kanibalizm
kantár - uzda
kanyaró - odra
kanyon - kanion
káosz - chaos
kap - dostać
kapa - motyka
kapar - drapać, skrobać
kapcsol - łączyć, przyłączać
kapcsolódik - połączyć
kapecitabin - kapecytabina
kapitány - kapitan
kapocs - sprzączka, klamra
kápolna - kaplica
kapor - koper
káposzta - kapusta
kappan - kapłon
kaptár - ul
kapu - brama, wrota, bramka
kapucni - kaptur
kapus - bramkarz, bramkarka
kar - ramię
kár - uszkodzenie, szkoda, strata
karabély - karabin
karácsony - Boże Narodzenie
Karácsony - Boże Narodzenie
karácsonyfa - drzewko bożonarodzeniowe, choinka
Karácsony-sziget - Wyspa Bożego Narodzenia
karaj - schab
karakter - charakter
karalábé - kalarepa
karambol - karambol
karamell - karmel
karate - karate
karaván - karawana
karcol - drapać
kard - miecz
kardszárnyú delfin - orka
kardvirág - mieczyk
karfiol - kalafior
karikatúra - karykatura
karkötő - bransoletka
karmazsin - karmazynowy
karmester - dyrygent
karnevál - karnawał
Károly - Karol
karom - pazur, szpon
káromkodik - kląć, przeklinać, bluzgać
karóra - zegarek
karosszék - fotel
Kárpátok - Karpaty
Kartúm - Chartum
kártya - karta, kartka, pocztówka
karvaly - krogulec, jastrząb wróblarz
kas - ul
kása - kasza
Kassa - Koszyce
kastély - zamek
kasza - kosa
kaszárnya - koszary
kaszinó - kasyno
kaszt - kasta
kasztrál - kastrować
katalán - Katalończyk, Katalonka, kataloński (język), kataloński
Katalin - Katarzyna
katalizátor - katalizator
Katalónia - Katalonia
Katar - Katar
katasztrófa - katastrofa, klęska
katedrális - katedra, kościół katedralny
kategória - kategoria
katicabogár - biedronka
katlan - kocioł, kotlina
katolicizmus - katolicyzm
katolikus - katolik, katoliczka, katolicki
katona - żołnierz
katonai - wojskowy, militarny
kátrány - smoła
Katyńi vérengzés - zbrodnia katyńska
kávé - kawa
kávébab - ziarenko kawy
kávédaráló - młynek do kawy
kávéház - kawiarnia
kaviár - kawior
Kazahsztán - Kazachstan
kazán - kocioł, piec
kecske - koza
kedd - wtorek
keddi - wtorkowy
kedvel - lubić
kedvenc - ulubiony, ulubieniec
kedves - drogi, kochany
kedvezmény - zniżka, ulga
kefe - szczotka
kegyelem - łaska, ułaskawienie
kegyetlen - okrutny
kehely - kielich
kék - niebieski
kékes - niebieskawy
keksz - herbatnik
kel - wstawać
kelbimbó - brukselka
kelet - wschód
Kelet-Ázsia - Azja Wschodnia
Kelet-Európa - Europa Wschodnia
keleti - wschodni
Kelet-Timor - Timor Wschodni
kell - musieć, potrzebować
kellemes - miły
kellemetlen - niemiły
kém - szpieg
kemence - piec, piekarnik
kemény - twardy
kémény - komin
keményítő - skrobia, krochmal
kéményseprő - kominiarz
kémia - chemia
kémiai - chemiczny
kémikus - chemik, chemiczka
ken - smarować
kén - siarka
kender - konopie
kendő - chustka
kenguru - kangur
kengyel - strzemię
Kenya - Kenia
kenyér - chleb
kenyérbolt - piekarnia
kenyérpirító - opiekacz, toster
kép - obraz, obrazek
képernyő - ekran
képeslap - pocztówka
képesség - zdolność, uzdolnienie, możliwość
képtelen - niedorzeczny, absurdalny
képtelenség - niedorzeczność, absurd, nonsens
képvisel - reprezentować
képviselő - reprezentant, poseł, deputowany
képzel - wyobrazić sobie
képzeletbeli - urojony
kér - prosić
kérdés - sprawa, pytanie, zagadnienie
kérdez - pytać
kérdőív - kwestionariusz
kérdőjel - pytajnik, znak zapytania
kerecsensólyom - raróg
kéreg - kora
kéregető - żebrak
kerek - okrągły
kerék - koło
kerekesszék - wózek inwalidzki
kerekít - zaokrąglać
kerékpár - rower
kerékpáros - rowerzysta
keres - szukać, zarabiać
kérés - prośba
kereskedelem - handel
kereskedelmi - komercyjny
kereskedő - kupiec, handlowiec, handlarz
kereslet - popyt
kereszt - krzyż
keresztanya - matka chrzestna
keresztapa - ojciec chrzestny
keresztcsont - krzyż, kość krzyżowa
keresztel - chrzcić
keresztelés - chrzest
keresztény - chrześcijański, chrześcijanin, chrześcijanka
kereszténység - chrześcijaństwo
keresztnév - imię
keresztre feszít - ukrzyżować
keret - rama
kerítés - ogrodzenie, płot
kert - ogród
kertész - ogrodnik
kerül - kosztować, dostać się
kerület - dzielnica, obwód
kés - nóż
keselyű - sęp
keserű - gorzki
keskeny - wąski
készít - robić, sporządzać
készpénz - gotówka
kesztyű - rękawiczka
két - dwa
kételkedés - wątpliwość
kétéltű - płaz
kétely - wątpliwość
ketrec - klatka
kétség - wątpliwość
kétségbeesés - rozpacz
kétszáz - dwieście, 200
kétszer - dwa razy
kettő - dwa, 2
kettős - duet, podwójny
kever - mieszać
keverék - mieszanka
kevés - mało, niedużo
kéz - dłoń
kezd - rozpoczynać, zaczynać
kezdet - początek, rozpoczęcie
kézigránát - granat ręczny
kézikönyv - podręcznik
kézilabda - piłka ręczna
kézirat - rękopis, manuskrypt
kézitáska - torebka
ki - kto
kiabál - krzyczeć
kiadvány - publikacja
kiállítás - wystawa
kiált - krzyczeć
kiáltás - krzyk, wrzask
kibernetika - cybernetyka
kicsi - mały
kiejtés - wymowa
kielégítő - zadowalający
kifejezés - wyrażenie
kifizet - wypłacać, wypłacić
kígyó - wąż, żmija
kiherél - kastrować
kihívás - wyzwanie
kijárat - wyjście
kijavít - poprawiać
kijelent - deklarować, oświadczać
Kijev - Kijów
kikérdez - wypytywać, wypytać
ki korán kel, aranyat lel - kto rano wstaje, temu Pan Bóg daje
kikötő - port
kilenc - dziewięć, 9
kilencedik - dziewiąty
kilencszáz - dziewięćset, 900
kilencven - dziewięćdziesiąt, 90
kilencvenedik - dziewięćdziesiąty
kilencvenegy - dziewięćdziesiąt jeden, 91
kilencvenegyedik - dziewięćdziesiąty pierwszy
kilencvenharmadik - dziewięćdziesiąty trzeci
kilencvenhárom - dziewięćdziesiąt trzy, 93
kilencvenhat - dziewięćdziesiąt sześć, 96
kilencvenhatodik - dziewięćdziesiąty szósty
kilencvenhét - dziewięćdziesiąt siedem, 97
kilencvenhetedik - dziewięćdziesiąty siódmy
kilencvenkettedik - dziewięćdziesiąty drugi
kilencvenkettő - dziewięćdziesiąt dwa, 92
kilencvenkilenc - dziewięćdziesiąt dziewięć, 99
kilencvenkilencedik - dziewięćdziesiąty dziewiąty
kilencvennégy - dziewięćdziesiąt cztery, 94
kilencvennegyedik - dziewięćdziesiąty czwarty
kilencvennyolc - dziewięćdziesiąt osiem, 98
kilencvennyolcadik - dziewięćdziesiąty ósmy
kilencvenöt - dziewięćdziesiąt pięć, 95
kilencvenötödik - dziewięćdziesiąty piąty
kilincs - klamka
kilogramm - kilogram
kilométer - kilometr
ki mint vet, úgy arat - jak sobie pościelesz, tak się wyśpisz
kín - ból
Kína - Chiny
kínai - chiński, Chińczyk, Chinka, chiński (język)
Kínai Népköztársaság - Chińska Republika Ludowa
kincs - skarb
kincstárnok - skarbnik
kinematika - kinematyka
kinevez - desygnować, powołać
kinn - na zewnątrz
kínoz - torturować, męczyć
kínszenvedés - tortura
kint - na zewnątrz
kinyit - otwierać
kirakat - wystawa, witryna
király - król
királyi - królewski
királyné - królowa
királynő - królowa
királyság - królestwo
kirándulás - wycieczka
Kirgizisztán - Kirgistan
Kiribati - Kiribati
kis - mały
kisasszony - panna, panienka
kisbaba - dzidziuś, bobasek
kiscsikó - źrebię
kisebbség - mniejszość
kísér - akompaniować, towarzyszyć
kísérlet - eksperyment
kísérleti - eksperymentalny
kísértet - duch
kisfiú - chłopak
kiskacsa - kaczątko
kiskecske - koźlę, koziołek
kiskutya - szczeniak
kissé - nieco, odrobinę, trochę
kitart - wytrwać, dotrwać
kitérő - objazd
kitörés - erupcja
kitűnő - doskonały, świetny
kiválaszt - wybierać, wybrać
kiváló - znakomity, doskonały
kíván - życzyć, chcieć, pragnąć
kívánatos - pożądany
kíváncsi - ciekawy, ciekawski, dociekliwy
kívánság - chęć, życzenie
kivétel - wyjątek
kivételes - wyjątkowy
kivéve - poza, oprócz
kivilágítás - oświetlenie
kivonás - odejmowanie
kívül - poza, na zewnątrz, oprócz, prócz
klán - klan
klarinét - klarnet
klasszicizmus - klasycyzm
klaviatúra - klawiatura
kleptománia - kleptomania
klíma - klimat
klinika - klinika
klór - chlor
klorofill - chlorofil
kő - kamień
koala - koala
kobalt - kobalt
kőbánya - kamieniołom
kobra - kobra
koca - maciora, locha
kocka - sześcian
kockacukor - kostka cukru
kockázat - ryzyko
kócsag - czapla
kocsi - wóz, wagon
kocsis - woźnica, stangret
kocsma - karczma, knajpa, gospoda
kód - kod
köd - mgła
kódex - kodeks
koffein - kofeina
kohászat - metalurgia
köhög - kasłać, kaszleć
koktél - koktail
kókusz - kokos
kókuszdió - kokos
Kókusz-szigetek - Wyspy Kokosowe
kolbász - kiełbasa
kölcsönhatás - interakcja
köldök - pępek
koldus - żebrak
köles - proso
kolibri - koliber
kolléga - kolega
kollégium - akademik, dom studencki
kollektív - zbiorowy
kollektivizmus - kolektywizm
kolónia - kolonia
kolonializmus - kolonializm
kolosszális - kolosalny
kolostor - klasztor
költemény - wiersz
költészet - poezja
költő - poeta
költőnő - poetka
költségterv - budżet
költségvetés - budżet
költségvetési - budżetowy
Kolumbia - Kolumbia
Kolumbusz - Kolumb (odkrywca), Kolumb (imię męskie)
kölyök - szczeniak, szczenię, smarkacz, bachor
kombináció - kombinacja
kombinatorika - kombinatoryka
kömény - kminek
komló - chmiel
kommentár - komentarz
kommunikáció - komunikacja
kommunista - komunistyczny, komunista
kommunizmus - komunizm
komoly - poważny, rzetelny
komp - prom
kompenzáció - kompensata
kompetencia - kompetencja
komplexitás - złożoność
komplex szám - liczba zespolona
kompozíció - kompozycja, skład, utwór, wypracowanie
kompromisszum - kompromis
kőműves - murarz
koncentráció - koncentracja
koncentrációs tábor - obóz koncentracyjny
koncert - koncert
konferencia - konferencja
konfiguráció - konfiguracja
konfirmál - potwierdzać
konfliktus - konflikt
konföderáció - konfederacja
konformizmus - konformizm
Konfuciusz - Konfucjusz
Kongó - Kongo
Kongói Demokratikus Köztársaság - Demokratyczna Republika Konga
Kongói Köztársaság - Republika Konga
kongresszus - kongres, konferencja
konklúzió - wniosek
konkoly - kąkol
könny - łza
könnyebb utolérni a hazugot, mint a sánta kutyát - kłamstwo ma krótkie nogi
könnyen - lekko, łatwo
könnyezik - ronić łzy, łzawić
könnyű - lekki, łatwy
konspiráció - konspiracja
konstans - stały
Konstantinápoly - Konstantynopol
konstruktivizmus - konstruktywizm
konszenzus - konsensus, zgoda
kontaktlencse - soczewka kontaktowa
kontaktus - kontakt
kontextus - kontekst
kontinens - kontynent
konty - kok
konvencionális - konwencjonalny
konyak - koniak
konyha - kuchnia
könyök - łokieć
könyörög - błagać
könyv - książka
könyvárus - księgarz
könyvelő - księgowy
könyvesbolt - księgarnia
könyvespolc - biblioteczka, regał na książki
könyvészet - bibliografia
könyvjelző - zakładka
könyvkiadó - wydawca
könyvkötő - introligator
könyvszekrény - regał na książki
könyvtár - biblioteka
könyvtáros - bibliotekarz
konzerv - konserwa
konzervatív - konserwatywny
konzervativizmus - konserwatyzm
konzul - konsul
konzulátus - konsulat
kőolaj - ropa naftowa
kooperáció - kooperacja, współpraca
kooperál - współpracować
koordináta - współrzędna
köp - pluć
kopasz - łysy
kopaszodik - łysieć
kopaszság - łysina
kopernícium - kopernik
koponya - czaszka
koporsó - trumna
Koppenhága - Kopenhaga
kopt - koptyjski
kor - epoka, era, cykl, okres
kór - choroba
kör - okrąg
korai - wczesny
korall - koral, koralowiec
korán - wcześnie
Korán - Koran
korbács - bicz, batog
korcsolya - łyżwa
kordbársony - sztruks
koreai - Koreańczyk, Koreanka, koreański (język), koreański
Koreai Köztársaság - Republika Korei
Koreai Népi Demokratikus Köztársaság - Koreańska Republika Ludowo-Demokratyczna
kórház - szpital
koriander - kolendra
kőris - jesion
kormány - kierownica, ster, rząd
kormánykerék - kierownica
kormánylapát - ster
kormányoz - panować, rządzić
kormorán - kormoran
kormos - zakopcony
környezet - otoczenie, środowisko
környezettan - ekologia
korom - sadza
köröm - paznokieć
korona - korona
koronáz - koronować
koronázás - koronacja
korosodó - starszy
köröz - krążyć
korpa - otręby, łupież
korreláció - korelacja
korrózió - korozja
korrupció - korupcja
korszak - okres, epoka
kórtan - patologia
körte - gruszka
körtefa - grusza
körül - dookoła, wokół
körülbelül - około
körülmetélés - obrzezanie
körülvesz - okrążać, otaczać
kórus - chór
körút - bulwar
Korzika - Korsyka
kos - baran
Kos - Baran (gwiazdozbiór), Baran (znak zodiaku)
kosár - kosz
kosárlabda - koszykówka
kóstol - próbować, spróbować
kosz - brud
Kosz - Kos
köszi - dzięki
koszinusz - cosinus
köszön - dziękować, pozdrawiać
köszönöm - dziękuję
koszos - brudny
Koszovó - Kosowo
kötél - lina
kötény - fartuch
kötőjel - dywiz, łącznik
kötőszó - spójnik
kötvény - obligacja
kova - krzemień
kovács - kowal
kövér - gruby, tłusty
követ - poseł
követel - domagać się, żądać
következik - wynikać
következmény - rezultat, skutek, wynik
következő - kolejny, następny
köz - zaułek, uliczka
közben - podczas, w czasie
közel - blisko
közéleti - publiczny
közeli - bliski
közép - środek, centrum
Közép-afrikai Köztársaság - Republika Środkowoafrykańska
Közép-Amerika - Ameryka Środkowa
Közép-Európa - Europa Środkowa
Középfölde - Śródziemie
középkor - średniowiecze
középkori - średniowieczny
középpont - centrum
közgazdaságtan - ekonomia
közgazdaság-tudomány - ekonomia
közgazdász - ekonomista
közlekedés - transport
közlekedési lámpa - światło sygnalizacyjne
kozmetika - kosmetyka
kozmikus - kosmiczny
közmondás - przysłowie, powiedzenie
közönség - widownia, publika
közönséges - zwyczajny, zwykły, powszechny
közös - wspólny
közösség - społeczność, wspólnota
között - między, pomiędzy
központ - centrum
központi - centralny
köztársaság - republika
köztársasági - republikański
közvetett - pośredni
közvetlen - bezpośredni
Krakkó - Kraków
kráter - krater
kreatív - kreatywny
kréta - kreda (do pisania)
kretén - kretyn
krikett - krykiet
kriptográfia - kryptografia
kripton - krypton
kristály - kryształ
Kristóf - Krzysztof
Krisztián - Krystian
Krisztina - Krystyna
Krisztus - Chrystus
kritikai - krytyczny
krizantém - chryzantema
krízis - kryzys
krokodil - krokodyl
króm - chrom
kromoszóma - chromosom
krónika - kronika
krumpli - ziemniak, kartofel
Kuba - Kuba
kubizmus - kubizm
kukac - robak, małpa
kukorékol - piać
kukorica - kukurydza
kulcs - klucz
kulcscsont - obojczyk
kulcslyuk - dziurka od klucza
küldetés - misja, posłannictwo
külföld - zagranica
külföldi - zagraniczny, cudzoziemiec, cudzoziemka
külföldön - za granicą, za granicę
kullancs - kleszcz
külön - osobno, oddzielnie
különálló - odrębny, oddzielny, osobny
különböző - różny, rozmaity
különbség - różnica
különleges - specjalny, szczególny
különösen - szczególnie
külső - zewnętrzny, wygląd zewnętrzny, powierzchowność
kultúra - kultura
kulturális - kulturalny
külvárosi - podmiejski
kúp - stożek
kupola - kopuła
kúra - kuracja, leczenie
kurázsi - odwaga
kurd - Kurd, kurdyjski (język)
Kurdisztán - Kurdystan
kűrium - kiur
kurrens - aktualny
kürt - róg
kurta - krótki, zwięzły
kurva - kurwa
kusza - niejasny, zawiły
kúszik - czołgać się, pełzać
küszöb - próg
kút - studnia
kutacs - ciemiączko
kutatás - badanie, poszukiwanie
kutató - badacz
kutya - pies
kutyából nem lesz szalonna - natura ciągnie wilka do lasu
kutyaól - buda dla psa
kutyatej - wilczomlecz
Kuvait - Kuwejt
küvetta - kuweta
kuvik - sówka
kvalitatív - jakościowy
kvantitatív - ilościowy
kvantum - kwant
kvarc - kwarc
láb - noga
lábbeli - obuwie
lábbilincs - kajdany, okowy
labda - piłka
labdarúgás - piłka nożna
labdarúgó - piłkarz
lábfej - stopa
lábikra - łydka
labirintus - labirynt
lábnyom - ślad stopy
laboratórium - laboratorium
lábszár - goleń
lábujj - palec u nogi
láda - skrzynia, kufer
lagúna - laguna
lágy - miękki
Lajos - Ludwik
lakás - mieszkanie
lakat - kłódka
lakatos - ślusarz
lakik - mieszkać, zamieszkać
lakk - lakier
lakó - lokator, mieszkaniec, mieszkalny
lakóház - dom mieszkalny
lakoma - stypa
lakonikus - lakoniczny
lakos - mieszkaniec, mieszkanka
lakosság - ludność, populacja
laktanya - koszary
lámpa - lampa
lámpaernyő - abażur
lámpás - latarnia
lánc - łańcuch
láng - płomień
lángelme - geniusz
lángész - geniusz
langyos - ciepławy
lantán - lantan
lány - dziewczyna, córka
lánya - córka
lánytestvér - siostra
Laosz - Laos
lap - ściana, strona, stronica
lapát - łopata
lapos - płaski
lappantyú - lelek kozodój
lárva - larwa
lassacskán - powoli
lassan - powoli
lassú - powolny
László - Władysław
lát - widzieć
látás - wzrok
látens - ukryty
láthatatlan - niewidoczny, niewidzialny
látható - widoczny, ewidentny
látogat - odwiedzić
látóhatár - horyzont, widnokrąg
látomás - widmo, zjawa
laurencium - lorens
lavina - lawina
láz - gorączka
lazac - łosoś
le - na dół, w dół
lé - sok
leány - dziewczyna, córka
lecke - lekcja
lecserél - zastępować, wymieniać
lefizet - spłacać, spłacić, zapłacić
lefordít - tłumaczyć, przekładać
legalábbis - przynajmniej
legenda - legenda
legendás - legendarny
legény - chłopak
léggömb - balon
légi - lotniczy, powietrzny
légikisasszony - stewardesa
légiposta - poczta lotnicza
légitársaság - linie lotnicze (przedsiębiorstwo)
légkör - atmosfera
légköri - atmosferyczny
légkörtan - meteorologia
legutóbbi - ostatni
légy - mucha
legyező - wachlarz
lehetetlen - niemożliwy
lehető - możliwy
lehetőség - możliwość
lehetséges - możliwy
leírás - opis
lélegzet - oddech, tchnienie, dech
lélegzik - oddychać
lélek - duch, dusza
lélektan - psychologia
lélekvándorlás - reinkarnacja, transmigracja
lelki - duchowy
lelkiismeret - sumienie
lelkiismeretes - sumienny
lelkiismeretesen - sumiennie
lelkiismeretesség - sumienność
lelkipásztor - pastor
lemez - blacha, dysk
lemezjátszó - gramofon, adapter
lemond - rezygnować, zrezygnować, odwoływać, odwołać
lemondás - rezygnacja, zrzeczenie się, dymisja, abdykacja
len - len
Lénárd - Leonard
lencse - soczewka
lengyel - polski, Polak, Polka, polski (język)
Lengyelország - Polska
leninizmus - leninizm
lenni - być, stawać się
lény - istota, stworzenie
leopárd - lampart
lépcső - schody
lépcsőház - klatka schodowa
lepényhal - flądra
lépés - krok
lepke - motyl
lepra - trąd
Lesotho - Lesotho
lesz - stawać się, zostać
leszármazástan - genealogia
leszbikus - lesbijski
letartóztat - aresztować
létezik - istnieć
létra - drabina
létrehoz - tworzyć, stworzyć
lett - łotewski, Łotysz, Łotyszka, łotewski (język)
Lettország - Łotwa
leukémia - białaczka, leukemia
leül - siąść, usiąść
levegő - powietrze
levél - liść, list, pismo, dokument
levéltár - archiwum
levendula - lawenda
lever - stłumić, zgnieść, pokonać
leves - zupa
lexikon - leksykon, słownik
lézer - laser
Lhásza - Lhasa
liba - gęś
Libanon - Liban
liberális - liberalny
Libéria - Liberia
Líbia - Libia
lidércnyomás - koszmar
Lídia - Lidia (imię)
Liechtenstein - Liechtenstein
likopin - likopen
likőr - likier
lila - fioletowy
liliom - lilia
Lima - Lima (stolica)
limonádé - lemoniada
lineáris - liniowy
lingvisztika - językoznawstwo
Lipcse - Lipsk
Lisszabon - Lizbona
liszt - mąka
liter - litr
lítium - lit
litván - Litwin, Litwinka, litewski (język), litewski
Litvánia - Litwa
ló - koń
lő - strzelać, strzelić
lobogó - flaga, sztandar, chorągiew, proporzec
lóca - ławka
locsolókanna - konewka
lódarázs - szerszeń
lóerő - koń mechaniczny
logaritmus - logarytm
logika - logika
lóhere - koniczyna
lök - pchać, popychać
lokális - lokalny
lom - śmieć
London - Londyn
lop - kraść
lópatkó - podkowa
Lóránt - Roland
lőszer - amunicja
lótusz - lotos
lovag - kawaler, rycerz
lovagias - rycerski, uprzejmy, szarmancki
lovas - jeździec
lovasság - kawaleria, konnica
lövedék - nabój, pocisk
löveg - działo
lövés - strzał
Luca - Łukasz
lucfenyő - świerk
lúd - gęś
lúg - ług
luk - dziura
Lukács - Łukasz
lusta - leniwy
lustaság - lenistwo
lutécium - lutet
Luxemburg - Luksemburg
lyuk - dziura, otwór, nora, jama
lyukacska - dziurka
lyukas - dziurawy
lyukasztó - dziurkacz
ma - dzisiaj
macedón - Macedończyk, Macedonka, macedoński
Macedónia - Macedonia
Macedónia Volt Jugoszláv Köztársaság - Była Jugosłowiańska Republika Macedonii
macesz - maca
maci - pluszowy miś
mackó - miś
mackóruha - kombinezon
macska - kot, kotka
macskakaparás - bazgranina, gryzmoły
macskazene - kocia muzyka
Madagaszkár - Madagaskar
madár - ptak
madarász - ptasznik
madárijesztő - strach na wróble
madártan - ornitologia
madártej - ptasie mleczko
Madeira - Madera
Madrid - Madryt
madridi - madrycki
madzag - sznur, sznurek
mag - nasienie, nasiono, ziarno
maga - się, siebie
magabiztos - pewny siebie
magabiztosság - pewność siebie
magán - prywatny
magánhangzó - samogłoska
magántanuló - samouk
magány - samotność
magányos - samotny, osamotniony
magas - wysoki
magasság - wysokość
magasságmérő - wysokościomierz
magasugrás - skok wzwyż
magatartás - postawa, zachowanie, prowadzenie się
magatehetetlen - bezwładny, bezradny
Magdolna - Magdalena
magfizika - fizyka jądrowa
mágia - magia
mágikus - magiczny
máglya - stos (do spalenia)
mágnes - magnes
mágneses - magnetyczny
magnetofon - magnetofon
magnézium - magnez
maguk - ich, siebie (oni, one)
mágus - magik
magyar - węgierski, Węgier, Węgierka, węgierski (język)
Magyarország - Węgry
magyarországi - węgierski
mai - dzisiejszy, współczesny
máj - wątroba
majd - potem, później
majdnem - prawie
majom - małpa
majomkenyérfa - baobab afrykański
majonéz - majonez
majoránna - majeranek
május - maj
májusi - majowy
mák - mak
Makaó - Makau
Makedónia - Macedonia
makréla - makrela
makroökonómia - makroekonomia
malac - prosię, prosiak
maláj - Malezyjczyk, Malezyjka, malezyjski (język), malezyjski
Malajzia - Malezja
malária - malaria
maláta - słód
Malawi - Malawi
Maldív-szigetek - Malediwy
Mali - Mali
málna - malina
malom - młyn
Málta - Malta
mama - mama
mamut - mamut
mancs - łapa
mandarin - mandarynka
mandarinréce - mandarynka
mandula - migdałowiec, migdał
mangán - mangan
mangó - mango
manipuláció - manipulacja
manó - chochlik, diablik
mar - gryźć
már - już
maraton - maraton
Marcell - Marceli
március - marzec
márciusi - marcowy
margarin - margaryna
marha - bydło
marhahús - wołowina
marihuána - marihuana
máris - natychmiast
Márk - Marek
márka - znak towarowy
markolat - rękojeść
markológép - koparka
Marokkó - Maroko
Mars - Mars
marsall - marszałek
Marshall-szigetek - Wyspy Marshalla
Márta - Marta
mártás - sos
Martinique - Martynika
mártír - męczennik
márvány - marmur
marxizmus - marksizm
más - drugi, inny
máshol - gdzie indziej
másik - drugi, inny
masina - maszyna
második - drugi
másodperc - sekunda
másol - kopiować
mássalhangzó - spółgłoska
mászik - wspinać się, wspiąć się
maszk - maska
Maszkat - Maskat
Máté - Mateusz
matematika - matematyka
matematikai - matematyczny
matematikus - matematyk
materializmus - materializm
matrac - materac
mátrix - macierz
matróz - żeglarz
Mátyás - Maciej
Maugli - Mowgli
Mauritánia - Mauretania
Mauritius - Mauritius
mauzóleum - mauzoleum
mázsál - ważyć
mazsola - rodzynek, rodzynka
meccs - mecz, rozgrywka
mechanizmus - mechanizm
mecset - meczet
medence - basen, pływalnia, miednica
meditáció - medytacja
medve - niedźwiedź
meg - oraz, i, plus, dodać
még - nadal, wciąż, jeszcze
megáld - błogosławić
megálló - przystanek
megállóhely - przystanek autobusowy
megbán - pożałować
megbecstelenít - gwałcić
megbeszélés - spotkanie
megbocsát - wybaczać
megbüntet - ukarać
megcsal - zdradzać
megdagad - napuchnąć
megérint - dotykać, dotknąć
megérkezik - przyjechać, przyjść
megért - rozumieć, pojmować
megfagy - zamarznąć
megfázás - przeziębienie
megfelelő - dogodny, stosowny, odpowiedni
megfertőz - zarazić
megfigyelő - obserwator
megfizet - zapłacić
meggy - wiśnia
meggyújt - zapalać, zapalić
meghal - umierać, umrzeć
meghatároz - definiować
meghív - zaprosić
meghűlés - przeziębienie
mégis - jednak, lecz
megjavít - ulepszać, naprawiać
megjegyzés - uwaga
megjelenik - pojawić się, zjawić się
megjutalmaz - wynagrodzić
megkérdez - zapytać
megkoronáz - koronować
megkóstol - kosztować, skosztować
megköszön - dziękować, podziękować
megközelítő - przybliżony
meglát - dostrzec, dojrzeć, zobaczyć
meglátogat - odwiedzać
meglep - zaskakiwać
megmaradó - pozostały
megmentő - wybawca, zbawca
megnéz - oglądać, obejrzeć, popatrzeć
megöl - zabić
megpróbál - próbować
megsemmisít - zniszczyć
megszokott - zwyczajny
megszűnik - ustać, przestać istnieć
megtámad - napadać, napaść
megtestesülés - inkarnacja
megtilt - zabraniać
megválaszt - wybrać
megváltoztat - zmieniać, zmienić
megvesz - kupować
megvitatás - dyskusja
megy - iść
méh - pszczoła, macica
méhész - pszczelarz
méhkas - ul
méhkirálynő - królowa pszczół
meitnerium - meitner
meleg - ciepło, upał, ciepły, gorący (np. dzień)
melegház - cieplarnia
mell - pierś
mellbimbó - sutek
melléknév - przymiotnik
mellesleg - przy okazji
mellett - obok
mellhártya - opłucna
mellkas - klatka piersiowa
melltartó - biustonosz
melódia - melodia
méltóság - godność, dostojeństwo
mély - głęboki
melyik - który
memória - pamięć, wspomnienie
mén - ogier
mendelévium - mendelew
menedékház - schronisko
menedzser - menadżer, manager
menekült - uchodźca
menet - marsz, pochód, chód, bieg, przebieg
menetel - maszerować
menni - iść, pójść
menny - niebo
mennydörgés - grzmot
mennyezet - sufit
mennyi - ile
mennyiség - ilość
mennyiségi - ilościowy
mennyország - raj
menstruáció - miesiączka, menstruacja
menta - mięta
mentőautó - karetka, ambulans
menü - menu
meny - synowa
menyét - łasica
mer - śmieć, mieć odwagę
mér - mierzyć
meredek - stromy
méreg - jad
méregtan - toksykologia
merész - dzielny, odważny
merészel - mieć śmiałość, ośmielić się, odważyć się
méret - rozmiar, wielkość, wymiar
merevlemez - dysk twardy
mérföld - mila
mérges - trujący, zły, rozgniewany
mérgez - otruć
mérgező - trujący, toksyczny
Merkúr - Merkury
mérleg - waga
Mérleg - Waga
mérlegel - rozważać, deliberować
mérnök - inżynier
merőleges - prostopadły
mert - ponieważ
mértan - geometria
mese - bajka
messze - daleko
messzi - daleki
messzire - daleko
mester - majster, mistrz, magister
mesterséges - sztuczny
mész - wapno
mészárlás - masakra
mészáros - rzeźnik
meszkalin - meskalina
mészkő - wapień
metafora - metafora, przenośnia
metélőhagyma - szczypiorek
meteorit - meteoryt
meteorológia - meteorologia
méter - metr
metró - metro
Mexikó - Meksyk
Mexikóváros - Meksyk (miasto)
méz - miód
mézes - miodowy
mezítláb - boso, na bosaka
mező - pole, rola
mezőgazdaság - rolnictwo
mezőgazdasági - rolniczy
mézsör - miód pitny
meztelen - nagi, goły
mi - my, cóż za…, jak…, mi
Mianmar - Myanmar
Micimackó - Kubuś Puchatek
miért - dlaczego
míg - dopóki, póki
migráció - migracja
Mihály - Michał
Mikeás - Micheasz
Miklós - Mikołaj
mikor - kiedy
mikrobiológia - mikrobiologia
Mikronézia - Mikronezja
mikroorganizmus - mikroorganizm
mikroszkóp - mikroskop
mikroszkopikus - mikroskopowy
Mikulás - święty mikołaj
Milánó - Mediolan
milliárdos - miliarder
milligramm - miligram
milliméter - milimetr
millió - milion
milliomos - milioner
milliomosnő - milionerka
milyen - jaki
minaret - minaret
minden - każdy
mindenhol - wszędzie
minden jó, ha a vége jó - wszystko dobre, co się dobrze kończy
mindennap - codziennie
minden út Rómába vezet - wszystkie drogi prowadzą do Rzymu
mindenütt - wszędzie
mindenütt jó, de legjobb otthon - wszędzie dobrze, ale w domu najlepiej
mindig - zawsze
mindjárt - zaraz
mindörökké - na zawsze
miniszoknya - minispódniczka
miniszter - minister
miniszterelnök - premier
minisztérium - ministerstwo
minőség - jakość
minőségi - jakościowy
Minszk - Mińsk
minta - wzór, deseń, wzorzec
mise - msza
Miskolc - Miszkolc
misszió - misja
mit - co
mitológia - mitologia
mitra - mitra
mivel - skoro, ponieważ, gdyż
mobiltelefon - telefon komórkowy
Möbius-szalag - wstęga Möbiusa
mocsár - moczary, bagno, trzęsawisko
mocskos - brudny
mód - sposób
modell - model
mögött - za
mogyoró - orzech laskowy
moha - mech
Mohamed - Mahomet
mohamedán - muzułmański
mohó - łakomy, żarłoczny
móka - zabawa, ubaw, frajda
mókus - wiewiórka
Moldova - Mołdawia
molekula - molekuła, cząsteczka
molibdén - molibden
molnár - młynarz
móló - molo
moly - ćma
Monaco - Monako
monarchia - monarchia
mond - mówić
monda - legenda
mondanivaló - wiadomość
mondat - zdanie
mondattan - składnia
mongol - Mongoł, Mongołka, mongolski (język), mongolski
Mongólia - Mongolia
mongúz - mangusta
monostor - klasztor
monoteizmus - monoteizm
monszun - monsun
Montenegró - Czarnogóra
morál - moralność
morális - moralny
morféma - morfem
morfin - morfina
mos - myć
mosdó - umywalka
mosógép - pralka
mosoly - uśmiech
mosolyog - uśmiechać się
mosómedve - szop pracz
mosónő - praczka
most - teraz
mostanában - obecnie, teraz
mostani - aktualny
mostohaanya - macocha
mostohaapa - ojczym
moszkitó - komar
Moszkva - Moskwa
motiváció - motywacja
motor - silnik
motorbicikli - motocykl
motorkerékpár - motocykl, motor
mottó - motto
Mozambik - Mozambik
mozdony - lokomotywa, parowóz
mozdonyvezető - maszynista
mozdulat - ruch
mozdulatlan - nieruchomy
Mózes - Mojżesz
mozgalom - ruch
mozgás - ruch
mozi - kino
mozog - ruszać się, poruszać się
mozsár - moździerz
mű - dzieło, utwór
műanyag - plastik, tworzywo sztuczne
műemlék - zabytek
müezzin - muezin
műfaj - gatunek, rodzaj
mufti - mufti
műhely - pracownia, warsztat
műhold - satelita
működik - działać, funkcjonować
műkorcsolyázónő - łyżwiarka figurowa
múlt - przeszłość
multikulturális - wielokulturowy
múmia - mumia
mumpsz - świnka
muníció - amunicja
munka - praca
munkaadó - pracodawca
munkanélküli - bezrobotny
munkanélküliség - bezrobocie
munkás - robotnik
munkásnő - robotnica
műsor - program
mustár - musztarda, gorczyca
muszáj - musieć
mutáció - mutacja
mutat - pokazywać
mutató - indeks, miernik, wskaźnik
mutatóujj - palec wskazujący
művész - artysta
művészet - sztuka, twórczość artystyczna
művészi - artystyczny
múzeum - muzeum
muzsika - muzyka
muzsikus - muzyk
nacionalizmus - nacjonalizm
nád - trzcina
nadrág - spodnie
nadragulya - belladonna, pokrzyk wilcza jagoda
nagy - duży
nagyanya - babcia, babka
nagyapa - dziadek
nagybácsi - stryj, stryjek, wuj, wujek
nagybőgő - kontrabas
Nagy-Britannia - Wielka Brytania
Nagy-Britannia és Észak-Írország Egyesült Királysága - Zjednoczone Królestwo Wielkiej Brytanii i Irlandii Północnej
nagyétkű - żarłok
nagykövet - ambasador
nagykövetség - ambasada
nagymama - babka
nagynéni - ciocia, wujenka, stryjenka
nagyon - bardzo
nagypapa - dziadek
Nagypéntek - Wielki Piątek
nagyszámú - liczny
nagyszerű - wspaniały, znakomity
Nagyvárad - Oradea
Nairobi - Nairobi
Namíbia - Namibia
nap - dzień, doba, słońce
Nap - Słońce
napéjegyenlőség - równonoc
napfény - światło słoneczne
napforduló - przesilenie, solstycjum
napilap - dziennik, codzienna gazeta
napló - dziennik
Nápoly - Neapol
napos - słoneczny
nappali - dzienny, salon, pokój dzienny
napraforgó - słonecznik
naprendszer - Układ Słoneczny
Naprendszer - Układ Słoneczny
napsütés - światło słoneczne
naptár - kalendarz
narancs - pomarańcza (roślina), pomarańcza (owoc), pomarańczowy (kolor)
narancssárga - pomarańcz, oranż
narancsszínű - pomarańczowy
nárcisz - żonkil
narkotikum - narkotyk
nászút - miodowy miesiąc
nátha - przeziębienie
nátrium - sód
naturalizmus - naturalizm
Nauru - Nauru
navigáció - nawigacja
NDK - NRD
nedves - mokry
nedvesség - wilgoć
ne ébreszd fel az alvó oroszlánt - nie wywołuj wilka z lasu
nefelejcs - niezapominajka
négy - cztery, 4
negyedik - czwarty
négyszáz - czterysta, 400
négyszög - czworokąt
negyven - czterdzieści, 40
negyvenedik - czterdziesty
negyvenegy - czterdzieści jeden, 41
negyvenegyedik - czterdziesty pierwszy
negyvenharmadik - czterdziesty trzeci
negyvenhárom - czterdzieści trzy, 43
negyvenhat - czterdzieści sześć, 46
negyvenhatodik - czterdziesty szósty
negyvenhét - czterdzieści siedem, 47
negyvenhetedik - czterdziesty siódmy
negyvenkettedik - czterdziesty drugi
negyvenkettő - czterdzieści dwa, 42
negyvenkilenc - czterdzieści dziewięć, 49
negyvenkilencedik - czterdziesty dziewiąty
negyvennégy - czterdzieści cztery, 44
negyvennegyedik - czterdziesty cztery
negyvennyolc - czterdzieści osiem, 48
negyvennyolcadik - czterdziesty ósmy
negyvenöt - czterdzieści pięć, 45
negyvenötödik - czterdziesty piąty
négyzet - kwadrat
néha - czasami
néhány - kilka, kilkoro, parę
nehéz - ciężki, trudny
nehézség - ciężkość, trudność
ne igyál előre a medve bőrére - nie dziel skóry na niedźwiedziu, nie chwal dnia przed zachodem słońca
ne keltsd fel az alvó oroszlánt - nie wywołuj wilka z lasu
nekrológ - nekrolog
nélkül - bez
nélkülözés - niedostatek
nélkülözhetetlen - nieodzowny
nem - nie
néma - niemy
nem a ruha teszi az embert - nie szata zdobi człowieka
nem esik messze az alma a fájától - niedaleko pada jabłko od jabłoni
német - niemiecki, Niemiec, Niemka, niemiecki (język)
Német Demokratikus Köztársaság - Niemiecka Republika Demokratyczna
Németország - Niemcy
németországi - niemiecki
Német Szövetségi Köztársaság - Republika Federalna Niemiec, Niemcy Zachodnie
nemi - seksualny
nem mind arany, ami fénylik - nie wszystko złoto, co się świeci
nemrégiben - ostatnio
nemsokára - niedługo, wkrótce
nemzedék - pokolenie, generacja
nemzet - naród
nemzeti - narodowy
nemzetiség - narodowość
nemzetközi - międzynarodowy
neodímium - neodym
neologizmus - neologizm
neon - neon
nép - naród
Nepál - Nepal
nepáli - Nepalczyk, Nepalka, nepalski (język), nepalski
népirtás - ludobójstwo
népszerű - popularny
neptúnium - neptun
Neptunusz - Neptun
neuma - neuma
neutron - neutron
név - imię
nevelő - wychowawczy, wychowawca
névelő - rodzajnik
nevelőnő - wychowawczyni
nevet - śmiać się
nevetés - śmiech
nevetség - pośmiewisko, kpiarstwo
nevetséges - śmieszny, komiczny
nevezetesen - mianowicie
névmás - zaimek
névnap - imieniny
névrokon - imiennik
névtelen - anonimowy
névutó - postpozycja
New York - stan Nowy Jork, miasto Nowy Jork
néz - patrzeć
Nicaragua - Nikaragua
Nicosia - Nikozja
Niger - Niger
Nigéria - Nigeria
nihilizmus - nihilizm
nikkel - nikiel
nikotin - nikotyna
Nílus - Nil
nincsen rózsa tövis nélkül - nie ma róży bez kolców
nióbium - niob
nitrogén - azot
Niue - Niue (wyspa), Niue (państwo)
nő - kobieta
nobélium - nobel
Noé bárkája - arka Noego
nőgyógyász - ginekolog
noha - choć
nőies - kobiecy
nómenklatúra - nomenklatura
nőnem - płeć żeńska, rodzaj żeński
nonszensz - nonsens
Norbert - Norbert
Norfolk-sziget - Norfolk
norvég - Norweg, Norweżka, norweski (język), norweski
Norvégia - Norwegia
norvégiai - norweski
nőstény - samiczy, samica
nóta - pieśń, piosenka
növekedés - wzrost, przyrost
november - listopad
novemberi - listopadowy
növény - roślina
növénytan - botanika
növényvilág - flora
nővér - starsza siostra, pielęgniarka
Novoszibirszk - Nowosybirsk
nozológia - nozologia
nudizmus - nudyzm
nudli - makaron
nukleáris - jądrowy, nuklearny
nulla - zero, nic
nyáj - stado
nyak - szyja, kark
nyakfodor - kryza
nyakkendő - krawat
nyaklánc - naszyjnik
nyaksál - szalik
nyakszirt - kark
nyaktekercs - krętogłów
nyaktiló - gilotyna
nyal - lizać
nyál - ślina
nyálkahártya - błona śluzowa
nyalóka - lizak
nyár - lato
nyárfa - topola
nyári - letni
nyel - łykać, połykać
nyelőcső - przełyk
nyelv - język
nyelvész - językoznawca, lingwista
nyelvészet - językoznawstwo
nyelvészeti - językowy
nyelvjárás - dialekt
nyelvtan - gramatyka
nyelvtani - gramatyczny
nyelvtörő - łamaniec językowy
nyelvtudás - znajomość języka
nyelvtudomány - językoznawstwo
nyer - wygrywać, wygrać
nyereg - siodło
nyereség - zysk
nyereséges - korzystny
nyertes - zwycięzca
nyest - kuna domowa
nyíl - strzała, strzałka
Nyilas - Strzelec (gwiazdozbiór)
nyílás - otwór
nyílik - otwierać
nyílt - otwarty
nyilván - oczywiście
nyilvánosház - dom publiczny, burdel
nyilvánosság - rozgłos, reklama
nyilvánvalóan - oczywiście
nyír - ciąć, ścinać
nyírfa - brzoza
nyirkos - wilgotny
nyit - otwierać
nyitott - otwarty
nyolc - osiem, 8
nyolcadik - ósmy
nyolcszáz - osiemset, 800
nyolcvan - osiemdziesiąt, 80
nyolcvanadik - osiemdziesiąty
nyolcvanegy - osiemdziesiąt jeden, 81
nyolcvanegyedik - osiemdziesiąty pierwszy
nyolcvanharmadik - osiemdziesiąty trzeci
nyolcvanhárom - osiemdziesiąt trzy, 83
nyolcvanhat - osiemdziesiąt sześć, 86
nyolcvanhatodik - osiemdziesiąty szósty
nyolcvanhét - osiemdziesiąt siedem, 87
nyolcvanhetedik - osiemdziesiąty siódmy
nyolcvankettedik - osiemdziesiąty drugi
nyolcvankettő - osiemdziesiąt dwa, 82
nyolcvankilenc - osiemdziesiąt dziewięć, 89
nyolcvankilencedik - osiemdziesiąty dziewiąty
nyolcvannégy - osiemdziesiąt cztery, 84
nyolcvannegyedik - osiemdziesiąty czwarty
nyolcvannyolc - osiemdziesiąt osiem, 88
nyolcvannyolcadik - osiemdziesiąty ósmy
nyolcvanöt - osiemdziesiąt pięć, 85
nyolcvanötödik - osiemdziesiąty piąty
nyomás - ciśnienie
nyomban - natychmiast
nyomda - drukarnia
nyomozó - detektyw
nyomtat - drukować
nyomtató - drukarka
nyoszolya - łóżko
nyű - czerw
nyugalmazott - emerytowany
nyugat - zachód
Nyugat-Berlin - Berlin Zachodni
Nyugat-Európa - Europa Zachodnia
Nyugat-Szahara - Sahara Zachodnia
nyugdíj - emerytura
nyugdíjas - emeryt, emerytowany
nyugodalmas - pokojowy
nyugodt - spokojny
nyúl - królik, zając, tchórz
nyuszt - kuna leśna
ó - stary
ő - on / ona / ono
oázis - oaza
obeliszk - obelisk
öblít - płukać
oboa - obój
öböl - zatoka
obszervatórium - obserwatorium
óceán - ocean
Óceánia - Oceania
ocelot - ocelot
öcs - młodszy brat
oda - tam
odaad - dać
odavész - ginąć
oh - och
óh - och
ok - przyczyna, powód
ők - oni, one
okcitán - język prowansalski
okkultizmus - okultyzm
okmány - dokument
ököl - pięść
ökológia - ekologia
ökológiai - ekologiczny
ökölvívás - boks
ökölvívó - pięściarz
ökör - wół
okos - mądry
ökoszisztéma - ekosystem
okoz - powodować
oktat - nauczać, edukować, kształcić
oktatási - edukacyjny
október - październik
októberi - październikowy
ól - pomieszczenie dla zwierząt
öl - zabijać
olaj - olej
olajbogyó - oliwka (owoc)
olajfa - drzewo oliwne, oliwka
olajoz - smarować olejem
olasz - włoski, Włoch, Włoszka, włoski (język)
Olaszország - Włochy
olaszországi - włoski
olcsó - tani
oldal - bok, strona, stronica
oldat - roztwór
oldószer - rozpuszczalnik
ölelés - uścisk, objęcie
olívabogyó - oliwka
olívaolaj - olej z oliwek, oliwa
olló - nożyczki, nożyce
ólom - ołów
oltár - ołtarz
öltöny - garnitur
öltözik - ubierać
öltözködik - ubierać się, ubrać się
öltöztet - ubierać
olvad - tajać, topnieć
olvas - czytać
olvasás - czytanie
olvasó - czytelnik, czytelniczka, czytnik, różaniec
olyan - taki
olykor - czasami
ölyv - myszołów
Omán - Oman
omlett - omlet
ón - cyna
ön - Pan, Pani
ondó - sperma
önéletrajz - życiorys, autobiografia
önfejű - uparty
öngyilkos - samobójczy, samobójca
öngyilkosság - samobójstwo
önkormányzat - samorząd
önök - wy (forma uprzejma)
önrendelkezés - autonomia
önt - nalewać, nalać, wlewać, wlać
öntöz - podlewać, polewać
önzés - egoizm
önzetlen - altruistyczny, bezinteresowny
önzetlenség - altruizm, bezinteresowność
önző - samolubny
opál - opal
opció - opcja
opera - opera
operációs rendszer - system operacyjny
operaház - opera
operett - operetka
ópium - opium
optimizmus - optymizm
őr - stróż, dozorca, strażnik, wartownik
óra - zegar, zegarek, godzina, godzina lekcyjna
orangután - orangutan
orca - policzek
orchidea - orchidea
ördög - diabeł
öreg - stary
öregasszony - staruszka
organikus - organiczny
organizál - organizować
orgazmus - orgazm
orgona - lilak, bez, organy
óriási - ogromny
őriz - pilnować, strzec
örmény - armeński, Armeńczyk, Armenka, armeński (język)
Örményország - Armenia
ornitológia - ornitologia
örök - wieczny, wieczysty
örökké - na zawsze
örökkévalóság - wieczność
örököl - odziedziczyć
örökre - na zawsze, na amen
öröm - radość
orosz - rosyjski, Rosjanin, Rosjanka, rosyjski (język)
oroszlán - lew
Oroszlán - Lew (gwiazdozbiór)
Oroszország - Rosja
orr - nos
orrszarvú - nosorożec
Orsolya - Urszula
ország - kraj
országos - krajowy
ortodox - ortodoksyjny
ortopéd orvos - ortopeda
örül - cieszyć się
orvos - lekarz
orvosi - medyczny
orvosnő - lekarka
orvosság - lek, lekarstwo
orvostan - medycyna
orvostudomány - medycyna
ős - przodek
ősi - starożytny, antyczny
őskor - prehistoria
őskori - prehistoryczny
őslénytan - paleontologia
ősnemzés - abiogeneza
össze - razem
összead - dodawać
összeadás - dodawanie
összeg - kwota, suma
összegyűjt - gromadzić, zbierać
összehasonlít - porównywać, porównać
összehasonlítás - porównanie
összehasonlítható - porównywalny
összehív - zwoływać, zwołać
összes - cały, wszystek
összesen - w całości, razem, łącznie, ogółem
összetett - złożony
összevisszaság - nieład, nieporządek, bałagan
ostoba - durny, głupi
ostor - bat
ostrom - oblężenie
ösvény - ścieżka
ősz - jesień
őszi - jesienny
őszibarack - brzoskwinia
őszibarackfa - brzoskwinia (drzewo)
őszinte - szczery
oszlop - filar, kolumna
oszt - dzielić
osztály - klasa, kategoria
osztályterem - klasa
osztás - dzielenie
oszthatatlan - niepodzielny
osztriga - ostryga
öszvér - muł
öt - pięć, 5
óta - od
ötlet - pomysł
ötödik - piąty
ötszáz - pięćset, 500
ötszög - pięciokąt
ott - tam
otthon - dom
ötven - pięćdziesiąt, 50
ötvenedik - pięćdziesiąty
ötvenegy - pięćdziesiąt jeden, 51
ötvenegyedik - pięćdziesiąty pierwszy
ötvenharmadik - pięćdziesiąty trzeci
ötvenhárom - pięćdziesiąt trzy, 53
ötvenhat - pięćdziesiąt sześć, 56
ötvenhatodik - pięćdziesiąty szósty
ötvenhét - pięćdziesiąt siedem, 57
ötvenhetedik - pięćdziesiąty siódmy
ötvenkettedik - pięćdziesiąty drugi
ötvenkettő - pięćdziesiąt dwa, 52
ötvenkilenc - pięćdziesiąt dziewięć, 59
ötvenkilencedik - pięćdziesiąty dziewiąty
ötvennégy - pięćdziesiąt cztery, 54
ötvennegyedik - pięćdziesiąty czwarty
ötvennyolc - pięćdziesiąt osiem, 58
ötvennyolcadik - pięćdziesiąty ósmy
ötvenöt - pięćdziesiąt pięć, 55
ötvenötödik - pięćdziesiąty piąty
ötvös - złotnik
ötvözet - stop (metali)
óv - chronić
öv - pas, pasek
ovális - owalny
óvatos - ostrożny, czujny
óvatosság - ostrożność, czujność
övezet - strefa
óvoda - przedszkole
ovuláció - owulacja, jajeczkowanie
oxidáció - oksydacja, utlenianie
oxigén - tlen
őz - sarna
ozmium - osm
ózon - ozon
özvegy - wdowiec, wdowa
özvegyasszony - wdowa
páciens - pacjent, pacjentka
pacifizmus - pacyfizm
pacsirta - skowronek
pad - ławka
padlás - poddasze
padlásszoba - pokój na poddaszu, facjatka
padlizsán - oberżyna, bakłażan
padló - podłoga, posadzka
páfrány - paproć
pagoda - pagoda
pajzs - tarcza
Pakisztán - Pakistan
pakisztáni - pakistański, Pakistańczyk, Pakistanka
paktum - pakt, układ
Pál - Paweł
pala - łupek
palack - butelka
palacsinta - naleśnik
Palau - Palau
paleontológia - paleontologia
palesztin - Palestyńczyk
Palesztina - Palestyna
pálinka - palinka
palládium - pallad
palota - pałac
pályaudvar - dworzec
pamut - bawełna
panasz - skarga
pandeizmus - pandeizm
pánik - panika
paníroz - panierować
panoráma - panorama
pánszexualitás - panseksualizm
pap - kapłan, ksiądz, duszpasterz
papa - tatuś, tata
pápa - papież
papagáj - papuga
papaja - papaja
papír - papier
paplan - kołdra
papnő - kapłanka
paprika - papryka
Pápua Új-Guinea - Papua-Nowa Gwinea
pár - para
pára - para, opar
parádé - parada
paradicsom - pomidor
paradoxon - paradoks
paragrafus - paragraf
Paraguay - Paragwaj
paraj - szpinak
paralelogramma - równoległobok
paralízis - paraliż
paraméter - parametr
parancs - rozkaz
paraszt - chłop
parazita - pasożyt
párbaj - pojedynek
párbajtőr - szpada
párbeszéd - rozmowa
párduc - pantera
parfüm - perfumy
párhuzamos - równoległy
Párizs - Paryż
park - park
parkol - parkować
parlament - parlament
parlamentáris - parlamentarny
parlamenti - parlamentarny
párna - poduszka
párnahuzat - poszewka, powłoczka
part - brzeg, wybrzeże
partitúra - partytura
passzió - hobby, pasja
passzív - bierny
pástétom - pasztet
paszternák - pasternak
pasztinák - pasternak
pásztor - pasterz
paszuly - fasola
pata - kopyto
patak - potok
patika - apteka
patikus - aptekarz
patkány - szczur
patkol - podkuć
patológia - patologia
patologikus - patologiczny
patriotizmus - patriotyzm
pattanás - krosta
páva - paw
pávián - pawian
pázsit - trawnik
Pécs - Pecz
pecsenye - pieczeń
pecsét - pieczątka, pieczęć
pedagógiai - pedagogiczny
pedál - pedał
pék - piekarz
Peking - Pekin
példa - przykład, wzór, wzorzec
példány - egzemplarz
pelenka - pielucha, pieluszka
pelikán - pelikan
penész - pleśń
penge - ostrze
pénisz - penis
péntek - piątek
pénteki - piątkowy
pénz - pieniądz
pénz beszél, kutya ugat - pieniądze otwierają wszystkie drzwi
pénztárca - portfel
pénztáros - kasjer
pénzügy - finanse
per - proces, sprawa sądowa
perc - minuta
periódus - okres, cykl
periódusos rendszer - układ okresowy
peron - peron
Peru - Peru
pesszimizmus - pesymizm
pestis - dżuma
petefészek - jajnik
Péter - Piotr
petrezselyem - pietruszka
pezsgő - szampan
Phenjan - Pjongjang
piac - rynek
picsa - pizda
pietizmus - pietyzm
pihen - odpoczywać, wypoczywać
piknik - piknik
pilla - rzęsa
pillanat - chwila, moment
pillangó - motyl
pillangóúszás - motylek, styl motylkowy
pillantás - spojrzenie
pilóta - pilot, sternik
pince - piwnica
pincér - kelner
pincérnő - kelnerka
pingál - malować
pingpong - ping-pong
pingpongasztal - stół do ping-ponga
pingvin - pingwin
pinty - zięba
pióca - pijawka
pipa - fajka
piramis - piramida
Pireneusok - Pireneje
pirkad - świtać
pirkadat - świt
pirománia - piromania
piros - czerwony, jasnoczerwony
Piroska - Pryska
pirotechnikus - pirotechnik
pirula - pigułka
piszkos - brudny
piszok - brud
pisztoly - pistolet
pisztráng - pstrąg
Pittsburgh - Pittsburgh (stolica Allegheny)
pitypang - mniszek lekarski
pizsama - piżama
pizza - pizza
plágium - plagiat
planéta - planeta
planetárium - planetarium
planetológia - planetologia
plántál - sadzić
plasztikus - plastyczny
platina - platyna
Platón - Platon
pleonazmus - pleonazm
pletyka - plotka
pletykafészek - plotkarz, plotkara
plexiüveg - pleksi, szkło akrylowe
Plútó - Pluton
plutónium - pluton
pneumatikus - pneumatyczny
Pó - Pad
pocsolya - kałuża
poéma - wiersz
poéta - poeta
pofa - pysk, morda, ryj, gęba
poggyász - bagaż
pohár - szklanka
pók - pająk
Pókember - Spider-Man
pókháló - pajęczyna
pökhendi - arogancki
pokol - piekło
polc - półka
polgár - obywatel, obywatelka
polgármester - burmistrz
poli- - poli-
polifenol - polifenol
poligámia - poligamia
Polinézia - Polinezja
polinom - wielomian
polip - ośmiornica
politeizmus - politeizm
politika - polityka
politikai - polityczny
polónium - polon
poloska - pluskwa
póni - kucyk
póniló - kucyk
pont - kropka
pontos - dokładny
ponty - karp
por - kurz, pył
porc - chrząstka
póré - por
póréhagyma - por
pornográf - pornograficzny
pornográfia - pornografia
poros - zakurzony
porosz - pruski
Poroszország - Prusy
porszívó - odkurzacz
portás - portier, odźwierny
portugál - portugalski, Portugalczyk, Portugalka, portugalski (język)
Portugália - Portugalia
pórus - por
posta - poczta
postabélyeg - znaczek pocztowy
postahivatal - poczta
postaláda - skrzynka pocztowa
postás - listonosz
poszméh - trzmiel
posztó - sukno
Pozsony - Bratysława
Prága - Praga
pragmatikus - pragmatyczny
praktikus - praktyczny
prazeodímium - prazeodym
precizitás - precyzja
preferál - woleć
prém - futro
préri - preria
prérifarkas - wilk preriowy, kojot
prezentáció - prezentacja
primitív - prymitywny
prímszám - liczba pierwsza
princípium - zasada, reguła
privát - prywatny
privilégium - przywilej
próba - próba, test
próbál - próbować
probléma - problem
produkció - produkcja
prófécia - przepowiednia
professzor - profesor
próféta - prorok, profeta
prófétanő - prorokini, profetka
profitábilis - korzystny
progeszteron - progesteron
program - program
projekció - projekcja
projekt - projekt
prométium - promet
prosperitás - pomyślność, dobrobyt
protaktínium - protaktyn
protekcionizmus - protekcjonizm
proton - proton
provokáció - prowokacja
pszichiáter - psychiatra
pszichiátria - psychiatria
pszichológia - psychologia
pszichológiai - psychologiczny
pszichológus - psycholog
Ptah - Ptah
publikáció - publikacja
publikus - publiczny
pucér - goły, nagi
Puerto Rico - Portoryko
puha - miękki
puhafa - drewno miękkie
pulóver - sweter, pulower
pulyka - indyk
puma - puma
pumpa - pompa, pompka
puncs - poncz
pupilla - źrenica
puritanizmus - purytanizm
puska - karabin
püspök - biskup
püspöksüveg - mitra
puszi - całus, buziak
puszil - całować
puszta - puszta, pustkowie
rab - więzień
rablás - rabunek, grabież, plądrowanie
rabszolga - niewolnik
racionális szám - liczba wymierna
radiáció - promieniowanie, radiacja
radikalizmus - radykalizm
rádió - radio
radioaktív - radioaktywny
rádium - rad
radon - radon
radzerfordium - rutherford
ráfizet - dopłacać, dopłacić, źle na czymś wyjść
rag - przyrostek, sufiks
rág - żuć
ragadós - lepki
ragasztó - klej
ragasztószer - klej
rágcsáló - gryzoń
rágógumi - guma do żucia
raj - rój
Rajna - Ren
rájön - uprzytomnić sobie
rajz - rysunek
rajzfilm - film rysunkowy
rajzol - rysować
rajzolás - rysowanie
rajzoló - rysownik
rajztábla - rysownica
rak - kłaść, ładować
rák - rak
Rák - Rak
rakéta - rakieta
randevú - randka, rendez-vous
rasszizmus - rasizm
ráz - trząść, potrząsać
reaktor - reaktor
reális - prawdziwy
realisztikus - realistyczny
realitás - rzeczywistość
realizmus - realizm
rebarbara - rabarbar
réce - cyraneczka, kaczka
recept - przepis, receptura, recepta
recesszió - recesja
reformáció - reformacja
régens - regent
regény - powieść
régész - archeolog
régészet - archeologia
reggel - ranek
reggeli - śniadanie
reggelizik - jeść śniadanie
régi - stary
regionális - regionalny
regisztráció - rejestracja
regruta - rekrut
rehabilitáció - rehabilitacja
reinkarnáció - reinkarnacja
rejt - chować, ukrywać
rejtelmes - tajemniczy
rejtély - tajemnica
rejtélyes - tajemniczy
rejtett - ukryty
rekamié - tapczan
rekeszizom - przepona
reklám - reklama
relativitás - względność
relikvia - relikwia
remény - nadzieja
rén - renifer
rendetlen - niechlujny, nieporządny, zaniedbany
rendetlenség - nieporządek, bałagan
rendező - reżyser
rendkívüli - wyjątkowy
rendőr - policjant
rendőrnő - policjantka
rendőrség - policja, posterunek policji
rendszer - system, ustrój
rendszertan - taksonomia
rénium - ren
renovál - odnawiać
rénszarvas - renifer
répa - burak, marchew
reparál - naprawiać
repce - rzepak
reprodukció - reprodukcja
reptér - lotnisko
repül - latać
repülés - lot
repülő - samolot
repülőgép - samolot, aeroplan
repülőgép-anyahajó - transportowiec samolotów
repülőgép-hordozó - lotniskowiec
repülőtér - lotnisko
rés - szpara, szczelina
rest - leniwy
rész - część
részeg - pijany, nietrzeźwy, pijak
reszelő - tarka
részesedés - udział
részlet - szczegół
részletes - szczegółowy
részvétel - uczestnictwo
rét - łąka
retek - rzodkiewka
retesz - rygiel, zasuwa
rettenetes - okropny
reuma - reumatyzm
reverenda - sutanna
revolver - rewolwer
réz - miedź
rí - płakać, szlochać
riadó - alarm
ribizli - porzeczka (owoc)
Richárd - Ryszard
rideg - nieprzyjazny
Riga - Ryga
rigó - drozd
Rijád - Rijad
rím - rym
rinocérosz - nosorożec
riport - raport
riporter - reporter
ritka - rzadki, zachodzący rzadko
ritkán - rzadko
ritkaság - rzadkość
ritmus - rytm
rituális - rytualny
rivális - rywal
rivalizálás - rywalizacja
rizikó - ryzyko
rizóma - kłącze
rizs - ryż
robban - wybuchać, eksplodować
robbanás - eksplozja, detonacja, wybuch
robbanóanyag - materiał wybuchowy
Róbert - Robert
ródium - rod
ródli - sanki
rögtön - natychmiast
roham - atak
rohan - lecieć, pędzić, gnać
róka - lis
rokon - krewny
rokonság - pokrewieństwo
rokonszenves - sympatyczny
Roland - Roland
Róma - Rzym
római - rzymski
román - Rumun, Rumunka, rumuński (język), rumuński
Román - Roman (imię)
Románia - Rumunia
romániai - rumuński
romanticizmus - romantyzm
romantikus - romantyczny
rombol - demolować, dewastować
rombolás - zniszczenie
rombusz - romb
ronda - brzydki
ront - zepsuć
rontás - przekleństwo
röplabda - siatkówka
rossz - zły
rovar - owad
rövid - krótki
rövidít - skrócić
rövidítés - skrót
rövidnadrág - szorty, spodenki
rozmár - mors
rozmaring - rozmaryn
rozs - żyto
rózsa - róża
rózsafüzér - różaniec
rózsaszín - różowy
rozsda - rdza
rőzse - chrust
Ruanda - Rwanda
rubel - rubel
rubídium - rubid
rúg - kopać
rugó - sprężyna
rüh - świerzb
ruha - ubranie, ubiór, ciuch
ruhatár - garderoba, szatnia
ruhaujj - rękaw
rum - rum
rumli - bałagan
ruténium - ruten
rúzs - szminka
sablon - szablon
Saint Kitts és Nevis - Saint Kitts i Nevis
Saint Vincent és a Grenadine-szigetek - Saint Vincent i Grenadyny
saját - własny
sajátos - specyficzny, swoisty, osobliwy
sajnál - żałować
sajnos - niestety
sajt - ser
sajtó - prasa
sakál - szakal
sakk - szachy
sál - szalik, szal
salak - szlaka
Salamon-szigetek - Wyspy Salomona
saláta - sałata, sałatka
salétromsav - kwas azotowy
Salvador - Salwador
sámán - szaman
sámánizmus - szamanizm
sámli - taboret, stołek
sampon - szampon
Sámuel - Samuel
Sándor - Aleksander
Sanghaj - Szanghaj
San Marino - San Marino
sánta - kulawy, chromy
São Tomé és Príncipe - Wyspy Świętego Tomasza i Książęca
sápadt - blady
sapka - czapka
sár - błoto
sárga - żółty
sárgabarack - morela
sárgabarackfa - morela
sárgadinnye - melon
sárgaláz - żółta febra, żółta gorączka
sárgarépa - marchew, marchewka
sárgaréz - mosiądz
sárgarigó - wilga
sárkány - smok
sarló - sierp
sarlósfecske - jerzyk
sarok - kąt, róg (np. ulicy), pięta
sas - orzeł
sáska - szarańcza
sátán - szatan, diabeł
sátor - namiot
sav - kwas
savanyú - kwaśny
savó - serwatka
Schrödinger macskája - kot Schrödingera
seb - rana
sebes - prędki, szybki
sebesség - prędkość, szybkość
sebész - chirurg
sebészet - chirurgia
sebhely - blizna
segéd - pomocnik
segg - dupa
segít - pomagać
segítség - pomoc
segíts magadon, s az Isten is megsegít - Bóg pomaga tym, co sami sobie pomagają
sehol - nigdzie
sejt - komórka, domniemywać, domniemać
sejttan - cytologia
sekély - płytki
sekrestye - zakrystia
selyem - jedwab
selymes - jedwabisty
semleges - neutralny
semlegesít - neutralizować
semlegesség - neutralność
semmi - nic
seprű - miotła
sereg - armia, wojsko, tłum, duża grupa ludzi, stado ptaków, mnogość, duża ilość czegoś
seregély - szpak
seriff - szeryf
serleg - puchar
serpenyő - patelnia
sertés - świnia
sértés - obelga, obraza
sertéshús - wieprzowina
séta - przechadzka, spacer
sétál - spacerować, przechadzać się
Seychelle-szigetek - Seszele
sí - narta
síelő - narciarz
Sierra Leone - Sierra Leone
siet - śpieszyć się
sietség - pośpiech
sík - płaszczyzna, równy, płaski
siker - sukces
sikertelen - nieudany
síkság - równina
sima - gładki
simogat - głaskać
sín - szyna
síp - gwizdek
sípcsont - goleń
sír - grób, mogiła, płakać
sirály - mewa
sisak - hełm, kask
sivatag - pustynia
skarlát - szkarlatyna, szkarłatny
Skócia - Szkocja
skorbut - szkorbut
skorpió - skorpion
Skorpió - Skorpion (gwiazdozbiór)
sláger - hit, przebój, szlagier
sligovica - śliwowica
smaragd - szmaragd
smink - makijaż
só - sól
sofőr - kierowca, szofer
sógor - szwagier
sógornő - szwagierka
soha - nigdy
sóhaj - westchnienie
sóhajt - wzdychać, westchnąć
sohasem - nigdy
sok - liczny, dużo, wiele
sokféle - rozmaity, zróżnicowany, różnorodny
sokk - szok, wstrząs
sokszög - wielokąt
sólyom - sokół
sonka - szynka
söpör - zamiatać
sor - rząd
sör - piwo
sörény - grzywa
sorompó - bariera, szlaban
soros - rzędowy
sors - los, dola
sós - słony, solny
sose - nigdy
sosem - nigdy
sóska - szczaw
sőt - a nawet, co więcej
sötét - ciemny, ciemność
sötétkék - granatowy
sötétség - ciemność
sovány - chudy
sövény - żywopłot
sovinizmus - szowinizm
sóz - solić
spaghetti - spaghetti
spanyol - hiszpański, Hiszpan, Hiszpanka, hiszpański (język)
spanyolnátha - grypa hiszpanka
Spanyolország - Hiszpania
spanyolországi - hiszpański
spárga - szpagat, szparag
speciális - specjalny, szczególny
spenót - szpinak
spion - szpieg
spirál - spirala
spiritizmus - spirytyzm
spirituális - duchowy
sport - sport
sportoló - sportowiec
Srí Lanka - Sri Lanka
stadion - stadion
statisztika - statystyka
statisztikai - statystyczny
statisztikailag - statystycznie
stilisztika - stylistyka
stílus - styl
Stockholm - Sztokholm
stóla - stuła
strand - plaża
stratégia - strategia
stratégiai - strategiczny
stroncium - stront
strucc - struś
sugár - promień, wiązka promieniowania
sugárút - aleja
sugárzás - promieniowanie
sügér - okoń
süket - głuchy
süketség - głuchota
sült - pieczony, upieczony, pieczeń
súly - ciężar
sün - jeż
sündisznó - jeż
sürgős - pilny, naglący
Suriname - Surinam
súrlódás - tarcie
sűrű - gęsty
sűrűség - gęstość
suszter - szewc
süt - smażyć, usmażyć
sütemény - ciasto, ciastko
suttog - szeptać
Svájc - Szwajcaria
svájci - Szwajcar, Szwajcarka, szwajcarski
svéd - szwedzki, Szwed, Szwedka, szwedzki (język)
Svédország - Szwecja
szabad - wolny, swobodny, niezależny
szabadalmaztat - patentować
szabadalom - patent
szabadidő - czas wolny
szabadság - wolność, swoboda, wakacje
szabály - reguła
szablya - szabla
szabó - krawiec
szabotázs - sabotaż
szaftos - soczysty
szag - zapach (ostry)
szagol - wąchać, powąchać
Szahara - Sahara
száj - usta
szajkó - sójka
szájkosár - kaganiec
Szajna - Sekwana
szájpadlás - podniebienie
szakács - kucharz
szakácskönyv - książka kucharska
szakadék - otchłań, przepaść
szakáll - broda (owłosienie)
szakállas - brodaty
szakasz - przedział, pluton, okres, przedział czasu
szakember - fachowiec, ekspert, znawca, biegły
szakértő - ekspert
szakma - fach, zawód
szál - źdźbło
szalad - biec, biegnąć
szalámi - salami
szálka - ość, drzazga
száll - latać, fruwać
szállít - przewozić, transportować
szállítás - przewóz, transport
szálloda - hotel
szalma - słoma
szalon - salon
szalonka - słonka
szalonna - słonina
szalvéta - serweta, serwetka
szám - liczba
szamár - osioł
szamárium - samar
szamárköhögés - krztusiec, koklusz
számítógép - komputer
számjegy - cyfra, liczba
számla - rachunek, paragon, faktura
számlál - liczyć
Szamoa - Samoa
szamóca - poziomka
számol - liczyć
számos - liczny
számrendszer - system liczbowy
szán - sanie
szandál - sandał
szándék - chęć, zamiar, intencja
szankció - sankcja
szánkó - sanki
szánt - orać
szappan - mydło
szappanopera - opera mydlana
szar - gówno, gówniany, kiepski
szár - źdźbło
szárad - schnąć
Szarajevó - Sarajewo
száraz - suchy
szardella - sardela
szarik - srać, zesrać się
szárító - suszarka, suszenie, wysuszenie
szarka - sroka
szarkofág - sarkofag
szárny - skrzydło
szarv - róg
szarvas - jeleń
szarvasmarha - bydło
szász - saksoński
Szászország - Saksonia
szatíra - satyra
Szaturnusz - Saturn
Szaúd-Arábia - Arabia Saudyjska
szavaz - głosować, zagłosować
szavazat - głos (w wyborach)
szavazó - głosujący
szaxofon - saksofon
száz - sto, 100
század - stulecie, wiek
századik - setny
szeder - jeżyna
Szeged - Segedyn, miasto na Węgrzech
szegény - biedny, ubogi
szegénység - ubóstwo
szegfű - goździk
szegfűszeg - goździk
szégyen - wstyd
szék - krzesło
szekerce - siekiera, topór
székesegyház - katedra, kościół katedralny
széklet - stolec
székrekedés - zatwardzenie, zaparcie, obstrukcja
szekrény - szafa
szekta - sekta
szektor - sektor
szekularizáció - sekularyzacja
szél - wiatr, krawędź, brzeg, kant
szelektál - wybierać
szelén - selen
szeles - wietrzny
széles - szeroki, rozległy
szélesség - szerokość
szelfi - selfie
szelíd - delikatny, łagodny, miły, oswojony
szellem - widmo, duch, zjawa
szellemi - umysłowy
szellőztet - wietrzyć
szélmalom - wiatrak
szélsőséges - skrajny
szem - oko
szemafor - semafor
személy - osoba
személyes - osobisty
személyi - osobisty, personalny
szemérem - skromność
szemész - okulista
szemeszter - semestr
szemét - śmieci
szemgolyó - gałka oczna
szemhéj - powieka
szeminárium - seminarium
szemle - przegląd, rewia
szemöldök - brew
szemorvos - okulista
szempilla - rzęsa
szemrehányás - zarzut
szemtanú - naoczny świadek
szemtelen - zuchwały
szemüveg - okulary
szén - węgiel
széna - siano
szenátor - senator
szenátus - senat
széncinege - bogatka, sikora bogatka
szendvics - kanapka
Szenegál - Senegal
szenny - brud
szent - święty
Szent Ilona - święta Helena, Wyspa Świętej Heleny
szentimentalizmus - sentymentalizm
Szentpétervár - Petersburg, Sankt Petersburg
szenved - cierpieć
szenvedés - cierpienie
szép - piękny
szépanya - babka prababci / pradziadka
szépapa - dziadek prababci / pradziadka
szeparál - oddzielić
szeparatizmus - separatyzm
szépen - ładnie, pięknie
szeplő - pieg
szeplős - piegowaty
szépség - piękno, uroda
szeptember - wrzesień
szeptemberi - wrześniowy
szer - środek
szerb - Serb, serbski
Szerbia - Serbia
Szerbia és Montenegró - Serbia i Czarnogóra
szerda - środa
szerdai - środowy
szerecsendió - gałka muszkatołowa
szerelem - miłość
szerelő - mechanik, monter
szerencse - szczęście
szerencsés - szczęśliwy
szerencsétlen - nieszczęśliwy
szerencsétlenség - nieszczęście
szerény - skromny
szeret - kochać
szeretet - miłość
szeretett - ukochany
szeretkezik - kochać się, współżyć
szerető - kochanek
szerint - według, zgodnie z
szerkesztő - redaktor, redaktorka
szerszámosláda - skrzynka z narzędziami, przybornik
szérum - serum, surowica
szerv - narząd, organ
szerves - organiczny
szervez - organizować
szervezet - organizacja
szervusz - cześć!
szerző - autor
szesz - spirytus, alkohol
szeszes - alkoholowy, zawierający alkohol, wyskokowy
szeszfőzde - gorzelnia
szex - seks
szexuális - seksualny
szexuális irányultság - orientacja seksualna
szexualitás - seksualność
szezám - sezam
szféra - sfera
szfinx - sfinks
szia - cześć
Szibéria - Syberia
sziborgium - seaborg
Szicília - Sycylia
sziget - wyspa
szigetvilág - archipelag
szignifikáns - znaczący
szigony - harpun
szigorú - srogi, surowy
szíj - pas, pasek
szikhizmus - sikhizm
szikla - skała
sziklafal - urwisko
sziklamászás - wspinaczka
szikra - iskra
szilárd - solidny, mocny, trwały, stały
Szilárd - Konstanty, Konstantyn
szilícium - krzem
szilva - śliwka
Szilveszter - Sylwester (imię)
szimbolikus - symboliczny
szimbólum - symbol
szimfónia - symfonia
szimmetria - symetria
szimpatikus - sympatyczny
szimuláció - symulacja
szín - kolor, barwa
szinapszis - synapsa
színes - kolorowy, barwny
színész - aktor
színésznő - aktorka
Szingapúr - Singapur
színház - teatr
színházi - teatralny
színlel - udawać
szinonima - synonim
szinonimahalmozás - pleonazm
színpad - scena, estrada
szint - poziom
szinte - prawie
szintén - również, także
szintetikus - syntetyczny
szintézis - synteza
Szíria - Syria
szirom - płatek
szirup - syrop
szisztematikus - systematyczny
Sziszüphosz - Syzyf
szita - sito
szitakötő - ważka
szituáció - sytuacja
szív - serce
szivacs - gąbka
szivar - cygaro
szivárvány - tęcza
szivattyú - pompa
szívesen - chętnie, ochoczo
szkandium - skand
szkinhed - skinhead
Szkopje - Skopje
szláv - słowiański
szleng - slang
szlovák - słowacki, Słowak, Słowaczka, słowacki (język)
Szlovákia - Słowacja
Szlovák Köztársaság - Republika Słowacka
szlovén - Słoweniec, Słowenka, słoweński (język), słoweński
Szlovénia - Słowenia
szó - słowo, wyraz
sző - tkać
szoba - pokój (pomieszczenie)
szobafestő - malarz pokojowy
szóbeli - słowny, ustny
szóbeszéd - plotka, pogłoska
szobor - statua, posąg
szobrász - rzeźbiarz
szobrászat - rzeźba
szociáldemokrácia - socjaldemokracja
szocialista - socjalistyczny, socjalista
szocializmus - socjalizm
szociológia - socjologia
szociológus - socjolog
szófejtés - etymologia
Szófia - Sofia
szófogadó - posłuszny
szög - gwóźdź, kąt
szójabab - soja warzywna, soja owłosiona
szójaszósz - sos sojowy
szokatlan - nietypowy
szőke - blond
szökés - ucieczka
szoknya - spódnica
szökőár - tsunami
szökőév - rok przestępny
szökőkút - fontanna
Szókratész - Sokrates
szokványos - zwyczajny
szól - mówić, rzec
szolga - sługa, służący
szőlő - winogrono
szőlőskert - winnica
Szomália - Somalia
Szomáliföld - Somaliland
szombat - sobota
szombati - sobotni
szomj - pragnienie
szomjas - spragniony
szomjazik - być spragnionym
szomjúság - pragnienie
szomorú - smutny
szomszéd - sąsiad
szomszédos - sąsiedni
szomszédság - sąsiedztwo
szonáta - sonata
szonett - sonet
szőnyeg - dywan, kobierzec
szopik - ssać
szoprán - sopran
szoptat - karmić
szórakozás - rozrywka, zabawa
szórakoztat - zabawiać, bawić
szórakoztató - rozrywkowy
szorgalmas - pracowity
szorgalom - pracowitość
szőrme - futro
szörny - potwór
szörnyeteg - potwór
szörnyű - straszny
szoros - ciasny
szoroz - mnożyć
szörp - syrop
szorzás - mnożenie
szósz - sos
szószaporítás - pleonazm
szószék - ambona
szótag - sylaba
szótár - słownik
szótartó - słowny, rzetelny
Szöul - Seul
szöveg - tekst
szövet - materiał, tkanka
szövetség - związek, zrzeszenie
szövetségi - federalny
szovjet - radziecki, sowiecki
Szovjet Szocialista Köztársaságok Szövetsége - Związek Socjalistycznych Republik Radzieckich
Szovjetunió - Związek Radziecki
szpeleológia - speleologia
szponzor - sponsor
SZSZKSZ - ZSRR
sztálinizmus - stalinizm
sztár - gwiazda, gwiazdor
sztrájk - strajk
sztyepp - step
szuahéli - suahili
Szudán - Sudan
szudáni - sudański
szűk - wąski, ciasny
szuka - suka
szükség - konieczność, potrzeba
szükséges - konieczny, potrzebny
szükségtelen - niepotrzebny
szül - rodzić
szülész - położnik, akuszer
szülésznő - położna, akuszerka
születés - poród, urodzenie, narodziny
születésnap - urodziny
született - urodzony
születik - urodzić się
szülő - rodzic
szülőföld - ojczyzna
szultán - sułtan
szünet - przerwa, pauza
szúnyog - komar
szupermarket - supermarket
szúr - kłuć
szürke - szary (kolor)
szűrő - filtr
szurok - smoła
szurony - bagnet
szürrealizmus - surrealizm
szuvenír - suwenir, pamiątka
szűz - dziewica
Szűz - Panna (gwiazdozbiór)
szüzesség - dziewictwo
Szváziföld - Suazi
tábla - tablica
táblázat - tabela, tablica
tabletta - tabletka
tábor - obóz
táborhely - obozowisko, koczowisko
tábori - obozowy, polowy
tábornagy - marszałek
tábornok - generał
Tádzsikisztán - Tadżykistan
taft - tafta
tag - członek
tágas - przestrzenny
tagjelölt - kandydat
táj - krajobraz
tájékozódás - orientacja
tájékozódik - orientować się, zorientować się
tájékoztat - informować, poinformować
tájékoztatás - informacja, poinformowanie
tájfun - tajfun
tajga - tajga
tájkép - krajobraz, pejzaż
tájoló - kompas
Tajvan - Tajwan
takács - tkacz, tkaczka
takaró - koc, kapa
taktika - taktyka
tál - misa, miska
talajjavítás - melioracja
talajjavítási - melioracyjny
talál - znajdować, znaleźć
találkozás - spotkanie
találkozik - spotkać
találkozó - spotkanie
talán - może
talár - toga
tálca - taca, tacka
talicska - taczka
talizmán - talizman
Tallinn - Tallinn
tallium - tal
talp - podeszwa
tályog - ropień
támad - atakować
támadás - atak
Tamás - Tomasz
támasz - wsparcie, pomoc
támogat - wspierać, wesprzeć, wspomagać, wspomóc
támogatás - subwencja, dotacja, subsydium
tan - doktryna
tanács - rada, porada, zarząd
tanácsadó - doradca
tanár - nauczyciel
tanárnő - nauczycielka
tánc - taniec
táncol - tańczyć
táncos - tancerz, taneczny
táncosnő - tancerka
tangens - tangens
tangó - tango
tangóharmonika - akordeon
tanít - uczyć
tanítani - tanít
tanítás - nauczanie
tanító - nauczyciel
tanítónő - nauczycielka
tankönyv - podręcznik
tantál - tantal
tanterem - klasa
tanul - uczyć się
tanuló - uczeń, uczennica
tanult - uczony
tanya - zagroda, ferma
tányér - talerz
Tanzánia - Tanzania
taoizmus - taoizm
tapasztal - doświadczać, doznać
tapasztalat - doświadczenie
taps - oklaski, brawa
tapsol - klaskać, bić brawo
tar - łysy
tárca - portfel
tárgy - rzecz, przedmiot, obiekt, temat
tárgyas - przechodni
tárgyas ige - czasownik przechodni
tárgyeset - biernik
tarka - pstry, różnobarwny
tarkó - kark
társ - towarzysz, kompan, wspólnik
társadalmi - socjalny, społeczny
társadalom - społeczeństwo
társalgás - konwersacja, rozmowa, pogadanka
társaság - towarzystwo, stowarzyszenie, kompania, spółka
társasági - towarzyski
tart - trzymać, uważać
tartalmaz - zawierać, obejmować
tartalom - treść, zawartość
tartály - zbiornik
tartós - długotrwały, trwały
tartozik - należeć do, być dłużnym, winnym
tartózkodik - przebywać, bawić
táska - torba
tat - rufa
tatár - Tatar, tatarski
tatu - pancernik
táv - odległość
tavacska - sadzawka
tavaly - w zeszłym roku
tavasz - wiosna
tavaszi - wiosenny
távcső - lornetka
távgépiró - dalekopis
távirat - telegram, depesza
távíró - telegraf
távol - daleko
távoli - daleki
távolság - odległość, dystans
taxidermia - taksydermia
Tbiliszi - Tbilisi
te - ty
tea - herbata
teáskanál - łyżeczka do herbaty
teáskanna - imbryk, czajnik
technécium - technet
technika - technika
technikai - techniczny
technikus - technik
technológia - technologia
technológiai - technologiczny
tegez - kołczan
tégla - cegła
téglalap - prostokąt
tegnap - wczoraj
tegnapelőtt - przedwczoraj
tehát - więc, zatem, toteż
tehén - krowa
teher - ciężar
teherautó - ciężarówka
tehetség - talent
tej - mleko
tejcsokoládé - mleczna czekolada
tejpor - mleko w proszku
tejszín - śmietana, śmietanka
Tejút - Droga Mleczna
Tejútrendszer - Droga Mleczna
tekintélyes - szanowany
tekintet - spojrzenie
teknős - żółw
teknősbéka - żółw
teknősök - żółw
tél - zima
tele - pełny
telefon - telefon
telefonál - telefonować
telek - grunt, plac, działka
televízió - telewizor
teli - pełny
téli - zimowy
telihold - pełnia księżyca
teljes - cały, całkowity, kompletny
teljesen - całkowicie
teljesít - dopełnić, wykonać
tellúr - tellur
téma - temat
Temesvár - Timiszoara
temetés - pogrzeb
temető - cmentarz
templom - kościół
Temze - Tamiza
tengelic - szczygieł
tengely - oś
tenger - morze
tengeralattjáró - łódź podwodna, okręt podwodny
tengerész - marynarz
tengeri - morski
tengeri csillag - rozgwiazda
tengerimalac - świnka morska
tengernagy - admirał
tengerpart - wybrzeże
tenisz - tenis
tény - fakt
tényleg - rzeczywiście, naprawdę, faktycznie
teológia - teologia
tér - plac, skwer
terasz - taras
terbium - terb
térd - kolano
térdel - klęczeć
terem - sala, rosnąć
teremt - stwarzać, tworzyć
terhes - ciężarny, brzemienny
terhesség - ciąża, brzemienność
terítő - serweta, obrus
terjeszt - rozpowszechniać, upowszechniać, propagować
térkép - mapa
termel - produkować, wytwarzać
termelés - produkcja
termelő - producent
termesz - termit
természet - przyroda, natura
természetes - naturalny
természetesen - naturalnie, oczywiście
természetes szám - liczba naturalna
terminológia - terminologia
terület - pole
területi - terytorialny
terv - plan
tervez - planować
test - ciało
testes - korpulentny
testőr - ochroniarz
testvér - członek rodzeństwa
testvérek - rodzeństwo
tesz - czynić, umieszczać
teszt - test
tészta - ciasto, makaron
tető - dach
tetovál - tatuować
tetoválás - tatuaż
tett - akt, czyn
tettes - sprawca, winowajca
tetű - wesz
teve - wielbłąd
tévedni emberi dolog - błądzić jest rzeczą ludzką
tevékenység - aktywność, działalność
téves - błędny, omyłkowy
thai - Tajlandczyk, Tajlandka, tajski (język), tajski
Thaiföld - Tajlandia
Thészeusz - Tezeusz
ti - wy
Tibet - Tybet
tigris - tygrys
tilos - wzbroniony
tilt - zakazywać, zabraniać
tiltakozás - protest
tinta - atrament
tintahal - kalmar
tipikus - typowy
Tirrén-tenger - Morze Tyrreńskie
tiszafa - cis
tiszt - oficer
tiszta - czysty
tisztaság - czystość
tisztel - szanować, poważać, czcić
tisztelet - cześć, poważanie, szacunek
tisztít - czyścić
tisztítótűz - czyściec
titán - tytan
titkár - sekretarz
titkárnő - sekretarka
titkos - sekretny
titok - sekret, tajemnica
titokzatos - tajemniczy
tíz - dziesięć, 10
tizedik - dziesiąty
tizenegy - jedenaście, 11
tizenegyedik - jedenasty
tizenharmadik - trzynasty
tizenhárom - trzynaście, 13
tizenhat - szesnaście, 16
tizenhatodik - szesnasty
tizenhét - siedemnaście, 17
tizenhetedik - siedemnasty
tizenkét - dwanaście, 12
tizenkettedik - dwunasty
tizenkettő - dwanaście
tizenkilenc - dziewiętnaście, 19
tizenkilencedik - dziewiętnasty
tizennégy - czternaście, 14
tizennegyedik - czternasty
tizennyolc - osiemnaście, 18
tizennyolcadik - osiemnasty
tizenöt - piętnaście, 15
tizenötödik - piętnasty
tó - jezioro
többség - większość
több szem többet lát - co dwie głowy, to nie jedna
Tóbiás - Tobiasz
toboroz - rekrutować
tócsa - kałuża
Togo - Togo
tőgy - wymię
tojás - jajo, jajko
tojáshéj - skorupka jajka
tojássárgája - żółtko
tök - dynia
Tokaj - Tokaj
tőke - kapitał
tőkehal - dorsz
tökéletes - doskonały, perfekcyjny
tökéletesség - doskonałość, perfekcja
tőkés réce - kaczka krzyżówka
Tokió - Tokio
tol - pchać, pchnąć
tölcsér - lejek
tölgy - dąb
tölgyfa - dąb
toll - ptasie pióro, pióro do pisania
tollaslabda - badminton
tolltartó - piórnik
tolmács - tłumacz
tolószék - wózek inwalidzki
tolvaj - złodziej
tomboló - wściekły
tömeg - masa, rzesza, tłum
tompa - tępy, stępiony
tonhal - tuńczyk
tonna - tona
topáz - topaz
tor - stypa, konsolacja
tör - łamać, rozbijać, tłuc
tőr - sztylet
törekvés - dążenie, aspiracja
Torino - Turyn
tórium - tor
torkolat - ujście (rzeki)
torma - chrzan, roślina o jadalnym korzeniu
torna - gimnastyka
tornádó - tornado
torok - gardło
török - turecki, Turek, Turczynka, turecki (język)
Törökország - Turcja
törökországi - turecki
töröl - kasować
torony - wieża
törpe - karzeł
torta - tort
történelem - historia
történelmi - historyczny
történész - historyk
történet - opowieść
történeti - historyczny
történik - zdarzać się, wydarzać się, dziać się
törülköző - ręcznik
törvény - prawo
törvényalkotás - ustawodawstwo
törvényes - prawny, prawomocny, legalny
törvényhozói - ustwodawczy
törvényszék - trybunał, sąd
törzs - plemię
Toszkána - Toskania
továbbá - dalej
tövis - cierń
toxikológia - toksykologia
tőzeg - torf
tőzegáfonya - żurawina
tradíció - tradycja
tragédia - tragedia
tragikus - tragiczny
trágya - gnój
traktor - traktor, ciągnik
traktoros - traktorzysta
traktorosnő - traktorzystka
tranzakció - transakcja
tranzisztor - tranzystor
trapéz - trapez
tréfa - żart
treff - trefl
tréner - trener
Trieszt - Triest
trigonometria - trygonometria
Trinidad és Tobago - Trynidad i Tobago
triviális - trywialny
trombita - trąbka
trombitás - trębacz
trón - tron
trónszék - tron
trónus - tron
trópusi - tropikalny
tű - igła
tuba - tuba
tubák - tabaka
tuberkulózis - gruźlica
tucat - tuzin
tücsök - świerszcz
tud - wiedzieć, potrafić, umieć
tudás - wiedza
tüdő - płuco
tüdőgyulladás - zapalenie płuc
tudomány - nauka
tudományos - naukowy
tudós - naukowiec
tukán - tukan
tükör - lustro
túl - za, zbyt
tulajdon - własność, majątek
tulajdonnév - nazwa własna
tulajdonos - właściciel, właścicielka
túlél - przeżywać, przeżyć
tulipán - tulipan
túlium - tul
túlzás - przesada
tünet - symptom, objaw
Tunézia - Tunezja
tűnik - wydawać się, zdawać się
tunika - tunika
Tunisz - Tunis
túr - ryć, kopać, grzebać
turbán - turban
turbina - turbina
türelem - cierpliwość
türelmes - cierpliwy
türelmetlen - niecierpliwy
turista - turysta
turizmus - turystyka
türkiz - turkus, turkusowy
Türkmenisztán - Turkmenistan
túró - twaróg, biały ser
tusfürdő - żel pod prysznic
tüske - cierń
tüsszent - kichnąć
tüsszentés - kichnięcie
túsz - zakładnik, zakładniczka
tutaj - tratwa
Tuvalu - Tuvalu
tűz - ogień
tüzér - artylerzysta
tüzérség - artyleria
tűzfegyver - broń palna
tűzhányó - wulkan
tűzhely - piec
tűzőgép - zszywacz
túzok - drop
tűzoltó - strażak
tűzszünet - zawieszenie broni
tűzvész - pożar
tyúk - kura
tyúkól - kurnik
uborka - ogórek
udvar - dziedziniec, podwórze, dwór
udvarias - uprzejmy, grzeczny
udvariasság - uprzejmość, grzeczność
udvariatlan - niegrzeczny
üdvözlés - powitanie, pozdrowienie
üdvözöl - witać, przywitać, pozdrawiać, pozdrowić
Uganda - Uganda
ugar - ugór
ugat - szczekać
üget - kłusować
ugrás - skok
ugrik - skakać, skoczyć
ugródeszka - trampolina
ugrókötél - skakanka
úgy - tak, w taki sposób
ügy - sprawa
ugyancsak - również, też, także
ügyes - zręczny, zwinny
ügyesség - zręczność, zwinność
ügyész - prokurator
ügyetlen - niezręczny, niezgrabny
ügyfél - klient
úgyhogy - więc, zatem
ügyintézés - administracja
ügyintéző - administrator
ügynök - agent
ügyvéd - adwokat
ügyvédnő - adwokat (kobieta)
új - nowy
újból - znów, znowu
újhold - nów
ujj - palec
Új-Kaledónia - Nowa Kaledonia
újra - znów, znowu, ponownie
újság - dziennik, gazeta z wiadomościami, wiadomość, nowina, wieść
újságcikk - artykuł
újságírás - dziennikarstwo
újságíró - dziennikarz
új seprű jól seper - nowy szef, nowe porządki
Új-Zéland - Nowa Zelandia
ükanya - praprababka
ükapa - prapradziadek
Ukrajna - Ukraina
ukrán - ukraiński, Ukrainiec, Ukrainka, ukraiński (język)
ül - siadać, siedzieć
ül a babérjain - spocząć na laurach
Ulánbátor - Ułan Bator
üldöz - ścigać, gonić
ülés - siedzenie
üllő - kowadło
ültet - sadzić, posadzić
ültetvény - plantacja
un - być znudzonym
unalmas - nudny
unalom - nuda
undorító - wstrętny
unió - unia, zjednoczenie
univerzum - wszechświat
ünnep - święto, uroczystość
ünnepel - świętować
ünnepélyes - uroczysty
unoka - wnuk
unokahúg - bratanica
unokaöcs - siostrzeniec/bratanek
unokatestvér - kuzyn/kuzynka
ununoktium - ununoctium
ununpentium - ununpentium
ununszeptium - ununseptium
ununtrium - ununtrium
úr - pan
űr - przestrzeń
ural - panować, władać, rządzić
Urál - Ural, rzeka płynąca przez Rosję i Kazachstan, góry na granicy Europy i Azji
urán - uran
Uránia - Urania
Uránusz - Uran, Uranos
urbánus - miejski
üres - pusty
üresség - pustka
űrhajó - statek kosmiczny
űrhajós - astronauta
úriember - dżentelmen
ürmös - wermut
ürmösbor - wermut
úrnő - dama
urológus - urolog
Uruguay - Urugwaj
ürülék - kał, wydalina
üst - kocioł
üstökös - kometa
úszás - pływanie
úszik - pływać, płynąć
úszó - pływak
üsző - jałówka
uszoda - pływalnia, basen
úszómedence - pływalnia, basen
úszónő - pływaczka
uszony - płetwa
út - droga, szosa
üt - bić, uderzać
utál - nienawidzić
után - po
utánoz - naśladować
utas - podróżny, pasażer
utazás - podróż
utazási iroda - biuro podróży
utazik - podróżować
utazó - pasażer
utca - ulica
ütés - cios, uderzenie
ütközet - bitwa, bój
útlevél - paszport
ütő - rakieta, paletka
utolsó - ostatni
utópia - utopia
úttest - jezdnia
üveg - butelka, szklany
üvegház - szklarnia
üvegpalack - szklana butelka
űz - gonić, ścigać
üzbég - Uzbek, Uzbeczka, uzbecki (język), uzbecki
Üzbegisztán - Uzbekistan
üzem - zakład przemysłowy
üzemanyag - paliwo
üzemzavar - awaria
üzenet - wiadomość
üzlet - sklep
üzletember - przedsiębiorca
vacsora - kolacja, wieczerza
vad - dziki
vád - obwinienie, oskarżenie
vadász - myśliwy
vadászat - myślistwo
vadászik - polować
vadászkürt - waltornia
vadászrepülőgép - myśliwiec, samolot myśliwski
vaddisznó - dzik
vadkacsa - kaczka krzyżówka
vadkan - dzik
vádli - łydka
vadmacska - żbik
vadregényes - romantyczny
vág - ciąć, kroić, krajać
vágány - tor
vagon - wagon
vagy - lub, albo
vagyon - aktywa, dobytek, majątek, mienie
vaj - masło
vajda - wojewoda
Vajdaság - Wojwodina
vajon - czy
vak - ślepy
vakar - drapać
vakcina - szczepionka
vakon - ślepo
vakond - kret
vakság - ślepota
vákuum - próżnia
-val - (kim, czym) (z)
valag - pośladek
valahol - gdzieś
valahová - gdzieś
valaki - ktoś
valami - coś
válás - rozwód
válasz - odpowiedź
válaszol - odpowiadać
választ - wybrać, wybierać
választás - wybór
válik - rozwieść się
váll - bark, część ciała w miejscu połączenia ręki lub (u zwierząt) kończyny przedniej z tułowiem, ramię
vállalat - przedsiębiorstwo
vállalatvezető - dyrektor przedsiębiorstwa
vállalkozás - przedsięwzięcie
vallás - religia, wyznanie
vallásos - bogobojny, pobożny, religijny
vállkendő - szal
valóban - rzeczywiście
valódi - prawdziwy
valós - rzeczywisty
valóság - rzeczywistość
valós szám - liczba rzeczywista
valószínű - prawdopodobny
valószínűleg - prawdopodobnie
valószínűség - prawdopodobieństwo, szansa
válság - kryzys
változás - zmiana, przemiana
változatos - różnorodny
változik - zmienić się
változtat - zmieniać, zmienić
vályú - koryto, żłób
vám - cło
vámpír - wampir
van - jest
vanádium - wanad
vandalizmus - wandalizm
vándorsólyom - sokół wędrowny
vanília - wanilia
vánkos - poduszka
Vanuatu - Vanuatu
var - strup
vár - cytadela, zamek, forteca
várakozik - czekać
varangy - ropucha
varangyos béka - ropucha
varánusz - waran
váratlan - niespodziewany, nieoczekiwany
varázslat - magia, czary
varázslatos - magiczny
varázsló - mag, czarownik, czarodziej
variáns - wariant
varjú - wrona
város - miasto
városháza - ratusz
városi - miejski
városka - miasteczko
városnegyed - dzielnica miasta
váróterem - poczekalnia
varr - szyć
varrat - szew
Varsó - Warszawa
vas - żelazo
vasal - prasować, wyprasować
vasaló - żelazko
vásár - targi, targ, targowisko, jarmark
vásárló - nabywca, kupujący
vasárnap - niedziela
vasárnapi - niedzielny
vásárol - kupować
vastag - gruby
vasút - kolej
vasútállomás - stacja kolejowa
vasutas - kolejarz
vasvilla - widły
vaszektómia - wazektomia
vászon - płótno
Vatikán - Watykan (państwo)
váza - wazon
véd - bronić, chronić
védekezés - obrona
veder - wiadro
védjegy - znak towarowy
vég - koniec
veganizmus - weganizm
végbélnyílás - odbyt
véges - skończony
vegetarianizmus - wegetarianizm
vegetáriánus - wegetariański
végett - w celu
végez - kończyć
végleges - definitywny, ostateczny
végső - końcowy, ostateczny
végtelen - nieskończony, bezkresny, bezgraniczny, nieskończoność
végtelenség - nieskończoność, bezkres
végül - ostatecznie
vegyész - chemik
vegyészet - chemia
vegyi - chemiczny
vegytan - chemia
végzet - przeznaczenie, los
vekker - budzik
vékony - chudy, szczupły, cienki
vektor - wektor
-vel - (kim, czym) (z)
vél - uważać, sądzić
Velence - Wenecja
vén - stary
vénasszony - staruszka
vendég - gość
vendéglő - restauracja
vendégszeretet - gościnność
Venezuela - Wenezuela
ventilátor - wentylator
Vénusz - Wenus
ver - bić, uderzać, walić
vér - krew
veranda - weranda
veréb - wróbel
verekszik - bić się, walczyć
verem - dół, jama
véres - krwawy
verés - bicie
vereség - porażka
vérfertőzés - kazirodztwo
veríték - pot
vermut - wermut
vers - wiersz
verseny - współzawodnictwo, konkurs
vérszegénység - niedokrwistość, anemia
vért - pancerz (część zbroi)
vértanú - męczennik
vertikális - pionowy
vérzik - krwawić
verzió - wersja
vese - nerka
vessző - przecinek
vesz - brać, wziąć, kupować, kupić
veszedelmes - niebezpieczny
veszély - niebezpieczeństwo
veszélyes - niebezpieczny
veszít - przegrywać
veszteség - strata, ubytek
vet - rzucać
vetés - siew
vevő - klient
vexillológia - weksylologia
vezér - szef, przywódca, dowódca, wódz, hetman
vezet - prowadzić kogoś, kierować pojazdem
vezetéknév - nazwisko
vezető - kierownik, kierowca
viadal - walka
viasz - wosk
viaszgyertya - świeca woskowa
vicc - żart, dowcip, kawał
viccel - żartować
vicces - zabawny, dowcipny
vidám - wesoły
videó - wideo
vidra - wydra
Vietnam - Wietnam
vietnami - wietnamski, Wietnamczyk
vigasz - pociecha, pocieszenie
vigasztalás - otucha, pociecha, pocieszenie
vihar - burza
víkend - weekend
világ - świat, iluminacja, światło, jasność
világegyetem - wszechświat, kosmos, uniwersum
világi - świecki
világítótorony - latarnia morska
világos - jasny
villa - widelec, willa
villám - błyskawica
villámcsapás - piorun
villámhárító - piorunochron
villamos - elektryczny, tramwaj
villamosság - elektryczność
villamosszék - krzesło elektryczne
villanykörte - żarówka
villanyszerelő - elektryk
Vilmos - Wilhelm
Vilnius - Wilno
virág - kwiat
virágágy - klomb
virágcserép - doniczka
virágcsokor - bukiet kwiatów
virágzat - kwiatostan
virradat - świt
vírus - wirus
viselkedés - zachowanie
viselkedik - zachowywać się, postępować
vissza - wstecz
visszafizet - spłacać, spłacić
visszhang - oddźwięk, echo
visz - nieść, nosić
viszket - swędzieć, swędzić
viszlát - na razie!, nara!, narka!, cześć!, pa!
viszontlátásra - do widzenia
Visztula - Wisła
vita - debata
vitorla - żagiel
vitorláshajó - żaglowiec
vitorlázás - żeglarstwo
vívás - szermierka
víz - woda
viza - jesiotr
vízcsap - kran, kurek
vizel - sikać
vizelet - mocz
vizes - wodny, wodnisty, mokry
vízesés - wodospad
víziló - hipopotam
vízimadár - ptak wodny
Vízöntő - Wodnik (gwiazdozbiór)
vizsga - egzamin
vizsgál - badać
vízszintes - poziomy
vizuális - wizualny
vízum - wiza
vízvezeték-szerelő - hydraulik
vő - zięć
vodka - wódka
vödör - wiadro
vőlegény - narzeczony, pan młody
volfrám - wolfram
völgy - dolina
volt - wolt
von - pociągać, ciągnąć
vonal - linia
vonalkód - kod kreskowy
vonat - pociąg
vonatkozik - dotyczyć
vonó - smyczek
vonzó - atrakcyjny
vörheny - szkarlatyna
vörös - czerwony, ciemnoczerwony
vörösbegy - rudzik, raszka
vörösbor - czerwone wino
vöröshagyma - cebula
Vöröskereszt - Czerwony Krzyż
vörösréz - miedź
Vörös-tenger - Morze Czerwone
vörös vércse - pustułka, sokół pustułka
vulkán - wulkan
vulkanizmus - wulkanizm
Wales - Walia
walesi - język walijski, Walijczyk, Walijka
Wallis és Futuna - Wallis i Futuna
watt - wat
webböngésző - przeglądarka internetowa
weboldal - strona internetowa
whisky - whisky
Wikipédia - Wikipedia
wurlitzer - szafa grająca
xenofóbia - ksenofobia
xenon - ksenon
xilofon - ksylofon
zab - owies
zabál - żreć, wcinać
zacskó - torebka, worek
Zágráb - Zagrzeb
zagyva - zawiły, niejasny
zagyvaság - bełkot, bzdura
zaj - hałas
zajlik - mieć miejsce, odbywać się
zajong - hałasować
zajos - hałaśliwy
zálog - zastaw
Zambia - Zambia
Zanzibár - Zanzibar
zápor - ulewa
zár - zamek (u drzwi), zamykać
zarándok - pielgrzym
zarándoklat - pielgrzymka
zarándokol - pielgrzymować
zárda - klasztor
zárva - zamknięty
zászló - flaga, sztandar, chorągiew, proporzec
zászlóalj - batalion
zavar - przeszkadzać, przeszkodzić, zamęt, zamieszanie
zebra - zebra
zeller - seler
zendülés - bunt
zene - muzyka
zenekar - orkiestra
zenél - grać na instrumencie muzycznym
zenész - muzyk
zeneszerző - kompozytor
zenetanár - nauczyciel muzyki
zéró - zero
Zeusz - Zeus
Zimbabwe - Zimbabwe
zivatar - ulewa
zodiákus - zodiak
zokni - skarpeta
zöld - zielony
zöldbab - fasola
zöldborsó - groch
Zöld-foki Köztársaság - Republika Zielonego Przylądka
zöldpaprika - zielona papryka
zöldség - warzywo, jarzyna, zielenina
zóna - strefa
zongora - pianino
zongorista - pianista
zoológia - zoologia
zoológiai - zoologiczny
zsák - wór, worek, torba, torebka
zsakett - żakiet
zsákmány - łup, zdobycz
zsákmányol - łupić, grabić
zsákol - nosić worki
zsákutca - ślepa uliczka
zsalu - okiennica
zsalugáter - okiennica
zsálya - szałwia
zsámoly - stołek, taboret
zsandár - żandarm
Zsanett - Żaneta
zsargon - żargon
zsarnok - tyran, despota
zsarnokság - tyrania
zsarol - szantażować
zsarolás - szantaż
zsaroló - szantażysta
zsaru - gliniarz, glina
zseb - kieszeń
zsebkendő - chusteczka do nosa
zsebkés - scyzoryk
zsebkönyv - notatnik, notes
zseblámpa - latarka
zsebmetsző - kieszonkowiec, złodziej kieszonkowy
zsebóra - zegarek kieszonkowy
zsebpénz - kieszonkowe
zsebtolvaj - kieszonkowiec, złodziej kieszonkowy
zselatin - żelatyna
zselé - żel
zsemle - bułka
zseni - geniusz
zseniális - genialny
zsenialitás - genialność
zsidó - Żyd, żydowski
zsinagóga - synagoga
zsinór - sznur, sznurek
zsír - tłuszcz
zsiráf - żyrafa
zsírleszívás - liposukcja
zsírsav - kwas tłuszczowy
Zsófia - Zofia
zsold - żołd
zsoldos - najemnik
zsoldoskatona - najemnik
zsoltár - psalm
zsonglőr - żongler
zsugori - skąpy, skąpiec, sknera, dusigrosz
zsúpfedél - strzecha
zsűri - jury
zsűritag - członek jury
zsurló - skrzyp
zsurnalisztika - dziennikarstwo, żurnalistyka
Zsuzsa - Zuzanna
Zsuzsanna - Zuzanna
zúg - szumieć, huczeć, buczeć
zuhany - prysznic
zuhanyozik - brać prysznic
zümmög - brzęczeć, buczeć, bzyczeć
zűrzavaros - chaotyczny
zúz - kruszyć, gnieść, miażdżyć
