Abcáis - Abchazja
abhacád - awokado
abhaill - jabłoń, sad
abhainn - rzeka
acastóir - oś
achtainiam - aktyn
adamh - atom
adamhach - atomowy
aerfort - lotnisko
Aetóip - Etiopia
áfach - jednak
Afganastáin - Afganistan
Afraic - Afryka
Afraic Theas - Republika Południowej Afryki
ag iompar clainne - w ciąży
agus - i, oraz
aibhinne - aleja
aibidil - alfabet
aibítir - alfabet
Aibreán - kwiecień
aibreog - morela
aigéad - kwas
aigéan - ocean
Ailgéir - Algieria
ailtire - architekt
ailtireacht - architektura
aindiachaí - ateista
aindiachas - ateizm
Aindriú - Andrzej
ainm - imię
ainmhí - zwierzę
ainmníocht - nomenklatura
aint - ciotka
aintín - ciotka
aircív - archiwum
airgead - pieniądze, srebro
Airgintín - Argentyna
Airméin - Armenia
Áise - Azja
aisteoir - aktor
aithin - rozpoznawać
áitiúil - lokalny
álainn - piękny
Albain - Szkocja
Albáin - Albania
alcól - alkohol
alcólach - alkoholowy
almóinn - migdał
almsa - jałmużna
alt na coise - kostka
am - czas
amaideach - głupi
amárach - jutro
amas - atak
amh - surowy
amhras - wątpliwość
an - czy, is
anabaí - przedwczesny
analach - analogia
anam - dusza
anann - ananas
ancaireacht - kotwicowisko
Andóra - Andora
Andórach - andorski
Angóla - Angola
anois - teraz
an Ríocht Aontaithe - Zjednoczone Królestwo
anseo - tutaj
ansmacht - tyrania
antalóp - antylopa
Aoine - piątek
aonbheannach - jednorożec
aonchineálach - jednolity
aon déag - jedenaście
aondiachas - monoteizm
aonsúileach - jednooki
Aontas Eorpach - Unia Europejska
Aontas na Éimíríochtaí Arabacha - Zjednoczone Emiraty Arabskie
aontoilíocht - jednomyślność
aontumha - celibat
aos - lud
ápa - małpa
aracnafóibe - arachnofobia
Araib Shádach - Arabia Saudyjska
araltas - heraldyka
arán - chleb
araon - razem
árasán - mieszkanie
Arastotail - Arystoteles
arcán talún - mrównik
aréir - zeszłej nocy
arís - znowu
armadailín - pancernik
asal - osioł
Asarbaiseáin - Azerbejdżan
aspal - apostoł
Astráil - Australia
astralaíocht - astrologia
astúchán - emisja
at - obrzęk, opuchlizna
athair - ojciec
athbhealach - objazd
ba - bó, is
bábóg - lalka
báicéir - piekarz
bailé - balet
baincéir - bankier
bain greim as - gryźć
bainne - mleko
bainniúil - mleczny
baintreach - wdowa
baintreach fir - wdowiec
Bairéin - Bahrajn
báisteach - deszcz
ban - bean
bán - biały
ban-aisteoir - aktorka
banaltra na cuaiche - świergotek łąkowy
banana - banan
banbh - prosię
banbharún - baronowa
banc - bank
banchliamhain - synowa
bándearg - różowy
bandiúc - księżna
banfhile - poetka
banfhlaith - księżniczka
banfhreastalaí - kelnerka
Banglaidéis - Bangladesz
banphrionsa - księżniczka
barántúlacht - autentyczność
barún - baron
bás - śmierć
básmhaireacht - śmiertelność
básmhar - śmiertelny
béabhar - bóbr
beagnach - prawie
béal - usta, buzia, otwór
Bealach na Bó Finne - Droga Mleczna
Bealarúis - Białoruś
Béal Feirste - Belfast
Bealtaine - maj
bean - kobieta, żona
bean chabhrach - położna
bean chéile - żona
bean ghlúine - położna
bean tí - gospodyni domowa
béar bán - niedźwiedź polarny
béarlagair - żargon, slang
beathaisnéis - biografia
beathaisnéisí - biograf
Beilg - Belgia
beirilliam - beryl
beirt - dwa
b'fhéidir - może
bí - być
bia - jedzenie
biachlár - menu
bialann - restauracja
biathaigh - karmić, odżywiać
bíonn adharca fada ar na buaibh thar lear - wszędzie dobrze, gdzie nas nie ma, cudze chwalicie, swego nie znacie, krowy za granicą mają długie rogi
biorán cniotála - drut do robótek
bior fiacla - wykałaczka
bíosún - bizon
bitheolaí - biolog
bitheolaíoch - biologiczny
bitheolaíocht - biologia
blaisféim - bluźnierstwo
blas - smak, akcent
bláth - kwiat
bliain - rok
bó - krowa
bocht - biedny
bodhar - głuchy
bogha báistí - tęcza
boghdóir - łucznik
boghdóireacht - łucznictwo
Boisnia - Bośnia
Boisnia-Heirseagaivéin - Bośnia i Hercegowina
Bolaiv - Boliwia
bolcán - wulkan
bolcánach - wulkaniczny
bollán - głaz
bolscaireacht - rozgłos, reklama, propaganda
bonneagar - infrastruktura
both - chata
Botsuáin - Botswana
bráisléad - bransoletka
Brasaíl - Brazylia
breab - przekupić, łapówka
bréag - kłamstwo
bréagán - zabawka
bréagchéadfa - halucynacja
bréagfholt - peruka
Breatain - Brytania
Breatain Mhór - Wielka Brytania
breithlá - urodziny
breosla - paliwo
briathar - słowo, czasownik
bríce - cegła
bricfeasta - śniadanie
broc - borsuk
bród - duma
bróidnéireacht - haft
broigheall - kormoran
brónach - smutny
bronntanas - prezent
bruachbhaile - przedmieście
bruachbhailteach - podmiejski
Brúiné - Brunei
Bruiséil - Bruksela
bua - zwycięstwo, wygrana
buabhall uisce - bawół domowy
buanfas - trwałość
Búcairist - Bukareszt
buí - żółty
buidéal - butelka
builiúil - wściekły
Buircíne Fasó - Burkina Faso
buirgléir - włamywacz
búistéir - rzeźnik
Bulgáir - Bułgaria
bumbóg - trzmiel
Burúin - Burundi
bus - autobus
Bútáin - Bhutan
cabáiste - kapusta
cadás - bawełna
cág - kawka
cailif - kalif
cailleach - wiedźma
cailleach dhubh - kormoran
cailleach oíche - sowa
cainneann - por
cainníocht - ilość
caipín súile - powieka
caipitleachas - kapitalizm
caipitlí - kapitalista
cairdiúil - przyjazny
cairdiúlacht - przyjacielskość
callagrafaíocht - kaligrafia
Cambóid - Kambodża
can - śpiewać
cannabas - konopie
canúint - dialekt
canúint aonair - idiolekt
caoi - sposób
caoireoil - baranina
caol na coise - kostka
caolsráid - uliczka
caonach - mech
caora - owca
capabára - kapibara
capaillín - kucyk
capall - koń
cár - gdzie
cara - przyjaciel
carbón - węgiel
caróg - wrona
cárta poist - pocztówka
Casacstáin - Kazachstan
catastróf - katastrofa
cathain - kiedy
cathair - miasto
cathair ghríobháin - labirynt
Cathair na Vatacáine - Państwo Watykańskie
catóid - katoda
ceacht - lekcja
céad - sto, pierwszy
Céadaoin - środa
Ceanada - Kanada
ceannbhrat - baldachim
ceannchathair - metropolia
ceapaire - kanapka
cearpantóir - stolarz
ceathair - cztery
ceimic - chemia
ceirmeach - ceramiczny
ceirtlis - jabłecznik, cydr
ceist - pytanie
ceithre - cztery
ceoltóir - muzyk
cheana - już
chomh maith - także, również, też
ciaróg - żuk
ciclipéid - encyklopedia
cigire - inspektor
cineál - kategoria, typ
ciorcal - kółko
cíor mheala - plaster
Cipir - Cypr
Cirgeastáin - Kirgistan
cistin - kuchnia
cíteolaíocht - cytologia
cith - prysznic
claíomh - miecz
clann - dzieci (w obrębie jednej rodziny), potomstwo, potomkowie, grupa ludzi wywodzących się od wspólnego przodka, następcy, sukcesorzy, naśladowcy
cliamhain - zięć
clóbhuail - drukować
cloch - kamień
clóscríobhán - maszyna do pisania
cnáib - konopie
cnámh - kość
cnó coill - orzech laskowy
cnó gaelach - orzech laskowy
cóála - koala
cocún - kokon
codail - spać
cógaseolaíocht - farmakologia
coigistigh - konfiskować
coileach - kogut
coileáinín - szczeniak
cóip - kopia
Cóiré - Korea
Coireallach - cyrylicki
Cóiré Theas - Korea Południowa
Cóiré Thuaidh - Korea Północna
colm - gołąb, blizna
comhchiallach - synonim, bliskoznaczny
comhfhios - świadomość
comhthéacs - kontekst
cóngar - bliskość, sąsiedztwo, okolica
contúirt - niebezpieczeństwo
córas - system
cor bealaigh - objazd
corcarghorm - fioletowy
corcra - fioletowy
corcscriú - korkociąg
cos - stopa, noga
cósta - wybrzeże, przybrzeżny
cráin - locha, maciora
creath - drżeć
creid - wierzyć
críochnaigh - skończyć
Críost - Chrystus
criostal - kryształ
criticeas - krytyka
criticeoir - krytyk
croí - serce
croiméal - wąsy
croineolaíoch - chronologiczny
croinic - kronika
Cróit - Chorwacja
crosbhogha - kusza
crosóg mhara - rozgwiazda
crúigh - doić
cú - pies myśliwski, chart
cuach - kukułka
Cúba - Kuba
cuideog - pająk
cúig - pięć
cuing - jarzmo
cuir pionós ar - karać
cúisín - poduszka
culaith shnámha - kostium kąpielowy
cultúr - kultura
cumarsáid - komunikacja
cúntach - pomocny, pomocniczy
cuntasóir - księgowy
curaí - curry
cúrsa timpill - objazd
dabht - wątpliwość
dáileog - dawka
dair - dąb
dall - ślepy
dallóg fhéir - popielica
Damaisc - Damaszek
damh - wół
damhán alla - pająk
damhsa - taniec
Danṁairg - Danmhairg
Danmhairg - Dania
daonlathach - demokratyczny
daonlathas - demokracja
daonnachtúil - ludzki
dath - kolor, barwa
dátheangach - dwujęzyczny
deamhan - demon
deamhan fola - wampir
déan caimiléireacht ar - oszukiwać
déan cneámhaireacht ar - oszukiwać
déan gáire - śmiać się
déan miongháire - uśmiechać się
dearbh - pewny
Déardaoin - czwartek
dearg - czerwony
deartháir - brat
deatach - dym
de chóir - blisko
deich - dziesięć
déimeagrafaíocht - demografia
deirfiúr - siostra
Dé Luain - poniedziałek, w poniedziałek
deoch - napój
déthaobhach - dwustronny
dia - bóg, dzień
Dia - Bóg
diabhal - diabeł
dí-ainm - anonimowy
dialann - dziennik
diamhasla - bluźnierstwo
difear - różnica
dífhostaíocht - bezrobocie
dífhostaithe - bezrobotny
dínáireach - bezwstydny
dinimiciúil - dynamiczny
dínit - godność
dírbheathaisnéis - autobiografia
díreach - prosty
dírialta - arbitralny
diúilicín - małż
dlúthchara - bliski przyjaciel, najlepszy przyjaciel
dó - dwa, 2
dó dhéag - dwanaście
doiléir - ciemny, słabo oświetlony
dóire - palnik
Domhan - Ziemia
Domhnach - niedziela
doras - drzwi
dorchadas - ciemność
dos - kępka
draíodóir - magik
dreap - wspinać się
dromadaire - dromader
drúis - żądza
druma - bęben
dubh - czarny
dufair - dżungla
duine muinteartha - krewny
dúnmharú - morderstwo
éabann - heban
each - wierzchowiec, rumak, koń
each-chumhacht - koń mechaniczny
eacnamaíocht - ekonomia
eadra - późny poranek, przedpołudnie
eagla - strach
éagobhsaíocht - niestabilność
eagraíocht - organizacja
eagras - organizacja
eala - łabędź
ealaín - sztuka
éamú - emu
éan - ptak
Eanáir - styczeń
éaneolaíocht - ornitologia
éan lachan - kaczątko
eantrópacht - entropia
earótach - erotyczny
eas - wodospad
éascaí - księżycowy
easpacht - niedobór
Eastóin - Estonia
easumhlaíocht - nieposłuszeństwo
éiceolaíoch - ekologiczny
éiceolaíocht - ekologia
Éigipt - Egipt
eilifint - słoń
Eilvéis - Szwajcaria
Eimile - Emilia
eipidéimeach - epidemiczny
Éire - Irlandia
Éireannach - irlandzki, Irlandczyk, Irlandka, mieszkaniec/mieszkanka Irlandii
eiriceacht - herezja
eiriciúil - heretycki
Eiritré - Erytrea
eisceacht - wyjątek
eisceachtúil - wyjątkowy
éist - słuchać
eiticiúil - etyczny
eitleán - samolot
eitlíocht - lotnictwo
eitneachas - narodowość
eitneacht - narodowość
eolaíocht ríomhaireachta - informatyka
Eoraip - Europa
fabhal - bajka
fabhcún - sokół
fabhcún gorm - sokół wędrowny
fabhcún tuaithe - białozór
fad - długość
fada - długi, daleki
faighin - pochwa
fáinleog - jaskółka
fáinne cluaise - kolczyk
faitíos - strach
faoi chosc - zakazany
faolchú - wilk
farraige - morze
farraige mhór - ocean
fásta - osoba dorosła
fata - ziemniak
fáthadh an gháire - uśmiech
Feabhra - luty
fead - gwizdek
feamainn - wodorost
fear - mężczyzna, mąż
féar - trawa, siano
fearán - gołąb
fear bréige - strach na wróble
fear céile - mąż
fear falsa - strach na wróble
fearg - gniew
feartlaoi - epitafium
féasógach - brodaty
feidearálach - federalny
feidearálacht - federacja
feighlí bó - pasterz
féileacán - motyl
feimineachas - feminizm
féinchanúint - idiolekt
féinmharú - samobójstwo
feirm - farma
feirmeoir - rolnik
feithideolaíocht - entomologia
feochadán - oset
fia - jeleń
fiacail - ząb
fiach mara - kormoran
fiaile - chwast
fiann - żołnierz
fichiú - dwudziesty
file - poeta
filíocht - poezja
fioghual - węgiel drzewny
fíon - wino
fíonchaor - winogrono
Fionlainn - Finlandia
fíon mormónta - wermut
fíordheimhneacht - autentyczność
fireann - męski
fírinne - prawda
fírinne an scéil - rzeczywistość
físeán - wideo
fiseolaíocht - fizjologia
fisic - fizyka
fisiceoir - fizyk
fisicí - fizyk
flannbhuí - pomarańczowy
fo-bhaile - przedmieście
fobhán - białawy
fobhríste - majtki
focail mhóra agus mogaill fholmha - wiele hałasu o nic, burza w szklance wody, wielkie słowa, a oczka (sieci) puste
focal - słowo
fo-cheannteideal - podtytuł
focleolaí - filolog
fodhearg - podczerwony
fóibe - fobia
foirnéis - piec
folamh - pusty
fo-mhírcheann - podtytuł
fomhuireán - łódź podwodna, okręt podwodny
foraois - las
fo-rúibric - podtytuł
fostaí - pracownik
fostaíocht - zatrudnienie
fostóir - pracodawca
fo-uair - sporadycznie
fo-uirbeach - podmiejski
francach - szczur
francach dubh - szczur
fraochán - borówka amerykańska
freagair - odpowiedzieć
freagracht - odpowiedzialność
frithghníomhaíocht - reakcja
fuaimiúil - akustyczny
fuath - nienawiść
fuathaigh - nienawidzić
fuilleamhóir - inwestor
fuinneog - okno
fuisce - whisky
fungas - grzyb
furasta - łatwy
gabha - kowal
gabhar - koza
gabh seilbh ar - konfiskować
Gabúin - Gabon
gadaí - złodziej
gadhar - pies
Gaeilge - język irlandzki
Gaelainn - język irlandzki
gailliam - gal
gailseach - skorek
Gaimbia - Gambia
gaineamh - piasek
gairdín - ogród
gairleog - czosnek
gallchnó - orzech włoski
gan amhras - bez wątpienia
gan dabht - bez wątpienia
gaofar - wietrzny
garathair - pradziadek
gariníon - wnuczka
garmhac - wnuk
garraí - ogród, pole
garsún - chłopak
gas - łodyga
gás - gaz
gasail - gazela
gasta - szybki
gasúr - chłopak
geac - jak
Geansaí - Guernsey
géar - ostry, kwaśny
Gearmáin - Niemcy
gearrchapall - kucyk
geimhreadh - zima
géineolaíocht - genetyka
geografaíocht - geografia
geolaíocht - geologia
giorria - zając
giosta - drożdże
giotár - gitara
glas - zielony
gleoiseach - makolągwa
gliomach - homar
gliú - klej
gluaisteán - samochód
gnéas - seks
gnéasach - seksualny
gnéasachas - seksizm
gnéasaíochas - seksizm
gnéas béil - seks oralny
gníomhaireacht - agencja
go maith - dobrze
go n-éirí an bóthar leat - dobrej podróży
go raibh maith agaibh - dziękuję ( niech dobro będzie przy was)
go raibh maith agat - dziękuję ( niech dobro będzie przy tobie)
grá - miłość
gráigbhaile - wioska
gráigh - kochać
gramadach - gramatyka
Gréig - Grecja
grianghrafadóir - fotograf
grianghrafadóireacht - fotografia
grianstad - przesilenie
grúdlann - browar
grúpa - grupa
Guáin - Gujana
gual - węgiel
gualach - węgiel drzewny
Guine - Gwinea
Guine Mheánchiorclach - Gwinea Równikowa
gunnán - rewolwer
guthán - telefon
haisis - haszysz
hata - kapelusz
heicseagánach - sześciokątny
héiliam - hel
heitrighnéasacht - heteroseksualizm
hidrigin - wodór
hipitéis - hipoteza
homaighnéasachas - homoseksualizm
homaighnéasacht - homoseksualizm
homaigineach - jednolity
i - w
iaguar - jaguar
ialtóg - nietoperz
ialtóg leathair - nietoperz
Iaráic - Irak
Iaráin - Iran
iarnóin - popołudnie
iarnra - hardware
iarsmalann - muzeum
iarthuaisceart - północny zachód
Iarúsailéim - Jerozolima
iasc - ryba
iascaire - rybak
iascaire coirneach - rybołów
i bhfad - daleko
idéal - ideał
idéalach - idealny
idéalachas - idealizm
idé-eolaíocht - ideologia
idióileict - idiolekt
idirnáisiúnta - międzynarodowy
ildiachas - politeizm
ilphósadh - poligamia
im - masło
imbhualadh - kolizja
imchuairt - obwód
imdhíonacht - odporność
imghearradh - obrzezanie
impire - cesarz
impireacht - imperium
India - Indie
Indinéis - Indonezja
infhaighte - dostępny
infhaighteacht - dostępność
infreastruchtúr - infrastruktura
infridhearg - podczerwień, podczerwony
iníon - córka
inléite - czytelny
inné - wczoraj
innealtóir - inżynier
innealtóireacht - inżynieria
in-nite - zmywalny
inniu - dziś, dzisiaj
inrochtaineacht - dostępność
Iodáil - Włochy
iolar - orzeł
iolar fíréan - orzeł przedni
ioncam - dochód
iondúil - zwyczajny
iora - wiewiórka
Iorua - Norwegia
Íosa - Jezus
Íoslainn - Islandia
Ioslamach - islamski
iostán - chata
iriseoireacht - dziennikarstwo
is fearr éan sa dorn ná beirt sa tom - lepszy wróbel w garści niż gołąb na dachu, lepszy (jeden) ptak w garści niż dwa w krzakach
is fuath le - nienawidzić
ispín - kiełbasa
ith - jeść
Iúgslaiv - Jugosławia
Iúil - lipiec
jin - gin, dżin
lá - dzień
labhair - mówić
Labradar - Labrador
lá breithe - urodziny
lacha - kaczka
lachín - kaczątko
lag - słaby
laghairt - jaszczurka
láib - błoto
láidir - mocny, silny, intensywny
láithreoireacht - prezentacja
Laitvia - Łotwa
lámhainn - rękawiczka
lampa - lampa
lán - pełny
lánstad - kropka
laoch - wojownik, bohater
laofheoil - cielęcina
lapa - łapa, płetwa
lárnach - centralny
lártheifneoir - wirówka
lasair - płomień
leaba - łóżko
leabhar - książka
leabharlann - biblioteka
leachtach - płynny
leadhbóg leathair - nietoperz
leadóg - tenis
leamhan - ćma
leanbh - dziecko
leann úll - jabłecznik, cydr
léarscáil - mapa
leasainm - przydomek
leasathair - ojczym
leasmhac - pasierb
leasmháthair - macocha
le chéile - razem
leictreachas - elektryczność
leictreamaighnéadach - elektromagnetyczny
leictreoir - elektryk
leictreon - elektron
leictreonaic - elektronika
leifteanant - porucznik
léigh - czytać
léine - koszula, tunika
leon - lew
leorga - wystarczający
Leosóta - Lesotho
liamhán - długoszpar
liamhán gréine - długoszpar
liamhán mór - długoszpar
Libia - Libia
licéar - likier
Lichtinstéin - Liechtenstein
ligh - lizać
Liobáin - Liban
líomanáid - lemoniada
líomóid - cytryna
Liotuáin - Litwa
litríocht - literatura
loch - jezioro
logánta - lokalny
loighic - logika
lon - kos
Londain - Londyn
lon dubh - kos
long - statek
loscann - żaba
luamhán - dźwignia
Luan - poniedziałek
luch - mysz
luch chodlamáin - popielica
luch francach - szczur
luchóg mhor - szczur
luibheolaíocht - botanika
Lúnasa - sierpień
madra - pies
madra alla - wilk
madra allta - wilk
madra rua - lis
maidin - ranek
maighdean mhara - syrena
maighnéad - magnes
maighnéadach - magnetyczny
máinlia - chirurg
Máirt - wtorek
mairteoil - wołowina
máistir striapach - alfons, sutener
maith - dobry
malairt slí - objazd
Maláiv - Malawi
mall - powolny
Málta - Malta
manach - mnich
Manainn - Wyspa Man
mangó - mango
marcra - kawaleria, konnica
Márta - marzec
másailéam - mauzoleum
matamaitic - matematyka
matamaiticiúil - matematyczny
máthair - matka
máthair shúigh - kalmar
mé - ja, mnie
meaisín - maszyna
mealbhacán - melon
méanfach - ziewnięcie
meangadh gáire - uśmiech
meán oíche - północ
méar - palec
méaracán - naparstek
méar an fháinne - palec serdeczny
Meicsiceo - Meksyk
Meiriceá - Ameryka
Meitheamh - czerwiec
Mheánmhuir - Morze Śródziemne
mí - miesiąc
mianadóir - górnik
mianreolaí - mineralog
mianreolaíocht - mineralogia
míbhunreachtúil - niekonstytucyjny
míceolaíocht - mykologia
micreafón - mikrofon
mídhaonna - nieludzki
mí-éifeacht - nieefektywność
mí-éifeachtach - nieskuteczny
mí-ionraic - nieuczciwy
míle - mila, tysiąc
milis - słodki
mill - zepsuć
mímhacánta - nieuczciwy
mímhorálta - niemoralny
mímhoráltacht - niemoralność
Mí na Nollag - grudzień
minic - częsty, często
minicíocht - częstotliwość
mínormálta - nienormalny
míol - zwierzę, stworzenie, owad, wesz
míol cnis - wesz
mionphláinéad - asteroida
miontúr - minaret
miotal - metal
miotaleolaíocht - metalurgia
miotas - mit
miotaseolaíocht - mitologia
moch - wczesny
móinéar - łąka
Moldóiv - Mołdawia
moll - sterta
monarcacht - monarchia
Mongóil - Mongolia
Montainéagró - Czarnogóra
mór - duży
mosc - meczet
Moscó - Moskwa
Moslamach - muzułmanin, muzułmański
muc - świnia
múinteoir - nauczyciel
murnán - kostka
murtall - otyłość
músaem - muzeum
naí - niemowlę
naíon - niemowlę
naíonán - niemowlę
náire - wstyd
Náisiúin Aontaithe - Organizacja Narodów Zjednoczonych
Namaib - Namibia
namhaid - wróg
naoi - dziewięć
Na Oileáin Fhilipíneacha - Filipiny
Na Scigirí - Na Scigirí ( nazwa Wysp Owczych)
nathair - wąż
néaltach - pochmurny
neamh - niebo
neamhábharthacht - niematerialność
neamhbhásmhaireacht - nieśmiertelność
neamhbhásmhar - nieśmiertelny
neamhdhíobhálach - niegroźny, nieszkodliwy
neamhdhleathach - nielegalny
neamhfhoirfeacht - niedoskonałość
neamhfhostaithe - bezrobotny
neamhlitearthacht - analfabetyzm
neamhní - nic
neamhspleáchas - niepodległość, niezależność
neamhthábhacht - niematerialność
néareolaíocht - neurologia
neart - siła, potęga
neodracht - neutralność
neoidimiam - neodym
Nigéir - Nigeria
Nígir - Niger
nimh - trucizna
nítrigin - azot
nó - lub
nochtacht - nagość
nóinín - stokrotka
noitmig - gałka muszkatołowa
Nollaig - Boże Narodzenie
nua - nowy
nua-aimseartha - nowoczesny
nua-aoiseach - nowoczesny
nuachtán - gazeta
nuair - kiedy
Nua-Shéalainn - Nowa Zelandia
núicléach - jądrowy, nuklearny
óch - niestety
ocht - osiem
ócht - dziewictwo
ochtapas - ośmiornica
ochtó - osiemdziesiąt
ocras - głód
óg - młody
ógántacht - dojrzewanie
oibrigh - pracować
oíche - noc
oideachasúil - edukacyjny
oidhre - spadkobierca
oidhreachtúil - dziedziczny
oighear - lód
Oileáin Muir Mhuir nIocht - Wyspy Normandzkie
oileán - wyspa
oileánra - archipelag
oileánrach - archipelag
oilithreacht - pielgrzymka
olagarcacht - oligarchia
Óman - Oman
ómra - bursztyn
ór - złoto
ortagrafaíocht - ortografia
oscail - otwierać
oscailte - otwarty
os cionn - nad
Ostair - Austria
otracht - otyłość
paidir - modlitwa
páirteachas - uczestnictwo
páiste - dziecko
Páras - Paryż
peaca - grzech
peacach - grzesznik
Peadar - Piotr
pearóid - papuga
peileacán - pelikan
péineas - penis
péint - farba, kolor
péitseog - brzoskwinia
Phortaingéil - Portaingéil
pianmhar - bolesny
pianó - pianino
pinc - różowy
piobar - pieprz
pionósaigh - karać
piorra - gruszka
pit - srom, pochwa
pláinéad - planeta
plásóg fhéir - trawnik
platanam - platyna
plúirín sneachta - śnieżyczka przebiśnieg
pluma - śliwka
plúr - mąka, kwiat
poblacht - republika
poblachtachas - republikanizm
poblachtánachas - republikanizm
Poblacht na hAfraice Láir - Republika Środkowoafrykańska
Poblacht na Seice - Czechy
póca - kieszeń
póg - całować, pocałunek
poiblí - publiczny
Polainéis na Fraince - Polinezja Francuska
Polainn - Polska
Polainnis - język polski
polaitiúil - polityczny
Polannach - polski, polska, Polak, Polka
poll ancaire - kotwicowisko
pornagrafaíocht - pornografia
Portaingéil - Portugalia
portráid - portret
pós - poślubić
potaire - garncarz
pótaire - pijak
potaisiam - potas
práta - ziemniak
préachán - wrona
príomhchathair - stolica
prionsa - książę
príosún - więzienie
príosúnach - więzień
próiseas - proces
prótachtainiam - protaktyn
puball - namiot
rachmas - bogactwo
rachmasach - bogaty
rachmasaí - kapitalista
rachmasaíocht - kapitalizm
radacachas - radykalizm
radaighníomhaíocht - radioaktywność, promieniotwórczość
raideog - woskownica europejska
raidhfil - karabin
raidió - radio
randamach - przypadkowy
rannpháirteachas - uczestnictwo
rásúr - brzytwa
réabhlóideach - rewolucyjny
reachtaíocht - ustawodawstwo
réalachas - realizm
réalaíoch - realistyczny
réaltacht - rzeczywistość
reiligiúnach - religijny
réiltín - asterysk, gwiazdka: *
Réin - Ren
réinfhia - renifer
reiptíl - gad
reitric - retoryka
reo - mróz
reoiteog - lody
rialtas - rząd
ridire - rycerz
rince - taniec
ríomhaire - komputer
ríomheolaíocht - informatyka
ríomhphost - poczta elektroniczna
ríora - dynastia
rís - ryż
ríshliocht - dynastia
roghnaigh - wybierać
roimh - przed
Róimh - Rzym
roimh am - przedwczesny
Rómáin - Rumunia
ronnach - makrela
rosualt - mors
roth - koło
rothar - rower
rua - rudy (o włosach), rdzawy, miedziany, czerwono-brązowy  brązowo-czerwony
rúibín - rubin
Rúis - Rosja
rúitín - kostka
rum - rum
sa - i + an
sa bhaile - w domu
sábháilteacht - bezpieczeństwo
sabhdán - sułtan
saighdeoir - łucznik
saighdeoireacht - łucznictwo
saighdiúir - żołnierz
sail - brud
Saimbia - Zambia
salach - brudny
salann - sól
Samhain - listopad, Samhain
samhradh - lato
Samó - Samoa
sanasaíocht - etymologia
saoirse - wolność
saolach - długowieczny
saolmhar - długowieczny
saor adhmaid - stolarz
São Tomé agus Príncipe - Wyspy Świętego Tomasza i Książęca
Sasana - Anglia
Satharn - sobota
scáileán - ekran
scamall - chmura
scaraoid - obrus
scian - nóż
sciath - tarcza
sciathán leathair - nietoperz
sciorta - spódnica
scoil - szkoła
scothbhán - białawy
scothbhuí - żółtawy
scothdhearg - czerwonawy
scothghlas - zielonkawy
scothghorm - niebieskawy
scréachóg - sójka
scread - krzyk
scríbhneoir - pisarz
scriú - śruba
scuab fiacla - szczoteczka do zębów
scuab phéinte - pędzel
scuid - kalmar
seabhac gorm - sokół wędrowny
seabhac seilge - sokół wędrowny
seacht - siedem
seachtain - tydzień
seachtó - siedemdziesiąt
seacláid - czekolada
seadóg - grejpfrut
seagal - żyto
seaimpéin - szampan
sealgaire - myśliwy
sealgaireacht - polowanie
seamair - koniczyna
seamhan - sperma
seampú - szampon
sean - stary
seanadóir - senator
seanathair - dziadek
seanbhean - staruszka
seandálaíocht - archeologia
seanfhear - starzec
seangán - mrówka
seanmháthair - babka
seánra - gatunek, rodzaj
Seapáin - Japonia
Seic - Czechy
seilg - polowanie
seineafóibe - ksenofobia
Seineagáil - Senegal
Seirbia - Serbia
Séiséil - Seszele
seomra - pokój
seomra bia - jadalnia
sféarúil - sferyczny
sí - ona
síceolaí - psycholog
síceolaíoch - psychologiczny
síceolaíocht - psychologia
Sicil - Sycylia
sileacan - krzem
siméadracht - symetria
simpeansaí - szympans
Sín - Chiny
Singeapór - Singapur
sintéis - synteza
síoda - jedwab
siolla - sylaba
Siombáib - Zimbabwe
sionagóg - synagoga
sionnach - lis
siopa - sklep
siorc - rekin
Siria - Syria
sirriam - szeryf
siúcra - cukier
sláintiúil - zdrowy
sliabh - góra
sliogán mara - muszla
slíogart - pumeks
Slóivéin - Słowenia
Slóvaic - Słowacja
sméar dhubh - jeżyna
snag breac - sroka
snagcheol - jazz
snag darach - dzięcioł
snáthaid mhór - ważka
sneachta - śnieg
sneachtúil - śnieżny
sobalchlár - opera mydlana
sobaldráma - opera mydlana
socair - łatwy
socheolaí - socjolog
socheolaíocht - socjologia
sóidiam - sód
solas tráchta - światło sygnalizacyjne
Somáil - Somalia
sona - szczęśliwy
Spáinn - Hiszpania
speal - kosa
spéisiúil - interesujący
spionáiste - szpinak
spíonán - agrest
spioradálta - duchowy
Sprantais - esperanto
spúnóg - łyżka
sráid - ulica
srón - nos
stail - ogier
stair - historia
stáisiún - stacja
Stáit Aontaithe - Stany Zjednoczone
Stáit Aontaithe Mheiriceá - Stany Zjednoczone Ameryki
Steafán - Stefan
Stiofan - Stefan
stroighin - cement
Sualainn - Szwecja
suanlios - akademik, dom studencki
suantraí - kołysanka
sú craobh - malina
Súdáin - Sudan
suí - suigh, posiedzenie
súigh - ssać, absorbować
súil - oko, nadzieja
suimiúil - interesujący
suipéar - kolacja
sula - zanim
sular - zanim
sú talún - truskawka
svaeid - zamsz
tabhair faoi deara - zauważyć
tacsaí - taksówka
tae - herbata
táirgeoir - producent
taitin - błyszczeć
taitneamh na gréine - światło słoneczne
talamh - ziemia, ląd
Talamh an Éisc - Nowa Fundlandia
Talamh an Éisc agus Labradar - Nowa Fundlandia i Labrador
talmhaíoch - rolniczy
talmhaíocht - rolnictwo
Tansáin - Tanzania
taos fiacla - pasta do zębów
tarbh - byk
tarra - smoła
tart - pragnienie
te - ciepły, gorący
teach - dom
teachín tuaithe - chata
teach solais - latarnia morska
téacsleabhar - podręcznik
teangaire - interpretacja
teangaireacht - interpretacja
teangeolaí - językoznawca
teangeolaíoch - językowy
teangeolaíocht - językoznawstwo
Téaváin - Tajwan
teibí - abstrakcyjny
teibíocht - abstrakcja
teicnéitiam - technet
teicneoir - technik
teicneolaíoch - techniczny
teicneolaíocht - technika
teicniúil - techniczny
teileafón - telefon
teileagraf - telegraf
téip - taśma
teochriosach - tropikalny
teocht - ciepło, temperatura
teoiric - teoria
teoiriciúil - teoretyczny
tine - ogień
tíogar - tygrys
Tíomór Thoir - Timor Wschodni
tiomsaitheach - zbiorowy
tionónta - najemca
tionscal - przemysł
tír dhúchais - ojczyzna
tíreolaíocht - geografia
tírghrá - patriotyzm
tirim - suchy
tit - upaść
tocsaineach - trujący
Tóga - Togo
toisc go - ponieważ
toisc gur - ponieważ
toitín - papieros
tollán - tunel
tonn - fala
tonnfhad - długość fali
toradh - owoc
torrach - w ciąży
traidisiún - tradycja
tráta - pomidor
tráthnóna maith agat - dobry wieczór
trí - trzy, 3
tríocha - trzydzieści, 30
trócaire - litość, miłosierdzie
trodaí - wojownik
troimpéad - trąbka
troitheán - pedał
trópaiceach - tropikalny
tua - topór
tuáille - ręcznik
tuar ceatha - tęcza
tuig - rozumieć
Tuirc - Turcja
tuirse - zmęczenie
tuirseach - zmęczony
tuiseal ainmneach - mianownik
tuismitheoir - rodzic
túr - wieża
turas - wycieczka
turas oilithreachta - pielgrzymka
turasóir - turysta
Turcach - Turek, turecki
turtar - żółw
tús - początek, start
tús maith leath na hoibre - dobry początek jest połową pracy
uachtar reoite - lody
uaigh - grób
uamhan damhán alla - arachnofobia
uamhan sráide - agorafobia
uan - jagnię
ubh - jajko
ubhagán - jajnik
ubhthoradh - bakłażan
Úcráin - Ukraina
Uganda - Uganda
uibheagán - omlet
uiríollaí - reprezentant
uirlis cheoil - instrument muzyczny
Úisbéiceastáin - Uzbekistan
uisce - woda
ulchabhán - sowa
úll - jabłko
ullmhaigh - przygotowywać
uncail - wujek
Ungáir - Węgry
úr - nowy, świeży
Uragua - Urugwaj
urlabhairt - artykulacja
urlabhra aonair - idiolekt
urlabhraíocht - artykulacja
urlaic - wymiotować
urraitheoir - sponsor
urramaigh - szanować, czcić
úsáid - używać, korzystać z
úsáideoir - użytkownik
vacsaín - szczepionka
vaigín - wagon
Vanuatú - Vanuatu
Vársá - Warszawa
Vatacáin - Watykan
veidhlín - skrzypce
veigeán - weganin
veilbhit - aksamit
vitimín - witamina
Vítneam - Wietnam
vodca - wódka
xeanón - ksenon
xileafón - ksylofon
zú - zoo
