ち - 血, 地, 千
が - partykuła podmiotu, ale, lub, 蛾 - ćma, mól
れ - re
ア - a
き - 木, 気, 機, 記, 黄, 季, 生, 期, 己, 其, 癸, 伎, 倚, 几, 匱, 揆, 既
へ - do, ku, w kierunku, 屁
か - か - partykuła pytajna, dodana na końcu zdania tworzy pytanie, 科 - rodzina, wydział, oddział, kurs studiów, 課 - lekcja, sekcja, odział, klasyfikator rozdziałów (książki), 蚊 - komar, 家 - osoba, wykonawca pewnej czynności, 化 - -zacja (końcówka tworząca rzeczowniki odprzymiotnikowe), 可 - możliwy, wykonalny, dozwolony
め - 目
わ - 和, 輪, 羽, 把, 環
ほ - 歩, 穂, 帆, 保する
ゑ - znak odczytywany we, znak odczytywany e
て - 手, wyraża wyliczenie oraz kontrast, wyraża kolejność wykonywania czynności, wyraża powód, przyczynę, wyraża sposób, metodę, wyraża stan, wyraża aspekt czasownika, wyraża prośbę lub rozkaz w zażyły sposób
は - partykuła tematu, 歯 - ząb, zęby, 刃 - ostrze (noża, miecza ), 葉 - liść, źdźbło
け - 毛, ~家
で - de, て
と - i, jeśli, kiedy
こ - 子, 児, 個, 小
ご - 五 - pięć, 5, 伍 - pięć, 碁 - gra Go, 語 - język (przyrostek określający język, dodawany najczęściej po nazwie kraju), słowo, 御 - przyrostek honoryfikatywny
な - ależ, ach jak …!, nie!
だ - 堕, 兌, 儺, 拿
に - na, w, wskazuje miejsce, w którym znajduje się predykat, wskazuje przynależność do podmiotu zdania, do, wskazuje kierunek oraz miejsce na które skierowana jest czynność, wskazuje osobę na którą lub w kierunku której skierowana jest czynność, wskazuje stan powstały na skutek zmiany, jako, wyraża cel czynności, od, wskazuje punkt odniesienia dla opisywanego stanu, dla, 二, 荷
、 - przecinek (,)
し - i, oraz, ponadto, oprócz tego
あ - wykrzyknienie służące wyrażaniu stanów uczuciowych, takich jak m.in.: zachwyt, zaskoczenie, przestrach, irytacja, podziw, zdziwienie, pragnienie
ね - prawda? dobrze? nieprawdaż?, ależ, 音, 根, 子, 寝, 値
も - też, także, zarówno ten, jak i ten, ani …, aż, nawet, ani, 藻, 喪, 裳, 摸
の - partykuła dzierżawcza, 野 - pole
い - 胃, 井, 亥, 意, 医
や - 矢, i …, i tym podobne, takie jak
た - 田
〇 - znak kanji oznaczający zero, 0 (ゼロ, zero), okrąg, koło (まる, maru)
お - 尾, 緒, 御
え - 柄 (trzonek; łopata; trzonek łopaty), 絵 (obraz, portret), co? co takiego?
よ - 世, 代
ひ - 火, 日, 比, 灯, 碑, 非, 費
ふ - 負, 府, 歩, 譜, 斑, 不, 付する, 賦する
ヨブ - Hiob
うで - 腕
ずつ - każdemu, odpowiednio, po …
ねこ - 猫
みせ - 店
ねん - 年, 念
がか - 画家, 画架, 雅歌
カー - samochód
むし - 虫, 蒸
むね - 胸
ゴム - guma
たす - 足す, タス
ひめ - 姫, 媛
ひげ - 髭, 卑下
ひそ - 砒素, ヒ素
ひじ - 肘
ひふ - 皮膚
さけ - 酒, 鮭
ひと - 人, 一
パン - chleb
バス - autobus, łazienka, bas, bass, magistrala komunikacyjna, bus
たる - 足る, 樽
パリ - Paryż
ペン - pióro (do pisania)
いる - 居る, 射る, 入る, 煎る, 炒る, 熬る, 鋳る, 鑄る, 要る
かに - 蟹
けつ - 穴, 尻
かげ - 影, 陰， 蔭
つめ - 爪
アイ - oko
かず - 数, 下図
なる - stać się (wyraża zmianę stanu), 生る, 成る, 鳴る
かた - 方, 肩, 型, 片
かぜ - 風, 風邪
ろく - 六, 碌な
いう - 言う, 謂う
どこ - 何処 - gdzie
いけ - 池, 行け
どう - jak, jaki, 同, 動, 銅, 胴, 働, 僮
いな - 否
にわ - 庭
いみ - 意味, 忌み, 斎
ぼく - 僕
えん - 円, 園, 苑, 縁, 塩, 偃, 冤, 艶
える - 得る, 獲る
ええ - słowo podkreślające, że dzielimy ten sam pogląd co przedmówca, słowo bez konkretnego znaczenia występujące przy rozpoczynaniu rozmowy lub dla zapełnienia pauzy między zdaniami, słowo podkreślające złość lub irytację, słowo wyrażające zdziwienie
えき - 易, 液, 益, 駅, 役, 奕
えび - 海老
せい - 背, 姓, 性, 精, 所為, 正, 生, 制する, 製する, 聖, 世, 制, 製
スズ - cyna
のり - 海苔, 糊, 乗り
のる - 乗る, 載る
のむ - 飲む, 呑む
のう - 能, 脳, 農
へや - 部屋
せん - 千, 先, 線, 栓, 腺
きる - 切る, 着る, 斬る, 剪る, キル
えだ - 枝
あせ - 汗
タイ - Tajlandia
きく - 聞く, 聴く, 訊く, 効く, 菊
きし - 騎士, 岸, 季子, 棋士, 貴紙, 貴誌, 旗幟, 棄死, 貴姉, 起死, 己巳
こい - 恋 (miłość romantyczna), 故意 (cel, zamierzenie), 鯉 (karp), 戀, 古意, 乞い, 請い, 来い (chodź!), 濃い (mocny, silny  smak), 濃い (głęboki  kolor), 濃い (gęsty  mgła)
しぬ - 死ぬ
なら - skoro, jeśli, gdyby, jeśli chodzi o …
だれ - 誰
だん - 段 - stopień, poziom, 田 - pole ryżowe, plantacja ryżu
こん - 紺, 今
げき - dramat, sztuka
ある - 有る, 在る, 或る, 或
ぐん - 軍, 郡, 群
ゆき - 雪
ゆび - 指
しお - 塩, 潮
へび - 蛇
へい - 丙, 塀, 並, 併, 凭
へそ - 臍
いろ - 色, 情夫
いや - 厭, 厭や, 嫌, 否
いく - 行く, 逝く, 幾, 畏懼
いい - 良い
いす - 椅子
いぬ - 犬, 戌
いと - 糸
いつ - 佚 - zgubić, ukryć, błąd, kolej, z kolei, piękny, pokój, mir, 何時 - kiedy? jak szybko?
いち - 一, 壱  (używane w oficjalnych dokumentach), 位置, 位地, 市
いま - 今, 居間 duży pokójw stylu zachodnim
しま - 島, 縞, 志摩, 揣摩, 死魔, 四魔, 詩魔
ドア - drzwi
しろ - 白, 城, 代
しる - 知る, 汁
なつ - 夏
なく - 泣く, 鳴く, 啼く
しち - 七, 死地, 質
はる - 春
ぜひ - koniecznie, za wszelką cenę
ぜん - 禅
リン - fosfor
いえ - 家, 否
はは - 母
はな - 花, 華, 鼻
はち - 八, 蜂, 鉢
ビア - piwo
ちち - 父, 乳
ひく - 引く
ちず - 地図
みず - 水
ぎん - 銀
なな - 七
ぶん - 分
ここ - tutaj, tu, to miejsce, w ciągu najbliższych (, ), 個個, 個々
こえ - 声
こう - 凰, 項, 甲, 候, 効, 香, 稿, 抗, 劫, 孝, 庚, 溝, 江, 倖, 興, 侯, 校, 公, 岡, 句, 腔, 勾, 匣, 伉, 倥, 請う, 乞う, 恋う, tak, w ten sposób (wskazuje, że to, co się dzieje, ma bliski związek z mówiącym), tak oto, w ten sposób (wskazuje, że to, o czym właśnie wspomniano, ma bliski związek z mówiącym; jednocześnie zapowiada tę część wypowiedzi, która nastąpi później)
これ - これ - to
こめ - 米
てご - język migowy
てき - 敵
この - ten, ta, to
けん - 県
れい - 零, 礼, 例, 霊, 令
あき - 秋, 安芸, 空き, 明き, 飽き
はだ - 肌
まる - 円
まち - 街
にし - 西
おす - 押す - pchać, odcisnąć, stawiać pieczątkę, 推す - dedukować, wyciągać wnioski, wnioskować, wspierać, 牡, 雄 - samiec
あざ - 字, 痣, 黶
おく - 奥, 臆, 億, 置く, 措く
おい - 甥, hej!
おう - 追う, 負う, 生う, 王, 翁, 凹, 凰
ヘア - włosy
おば - 叔母, 伯母
それ - 其 - to, tamto
そら - そら - spójrz na mnie!, popatrz!, uważaj!, 空 - niebo
ゼロ - zero, 0
まん - 万, 満
つか - 塚, 柄
かい - 貝, 界, 甲斐, 回, 会, 階
おゆ - お湯
あね - 姉, 姐
ばか - 馬鹿, 破家, 莫迦
さる - 猿, 去る
よる - 夜
くに - 国, 邦
くち - 口
くま - 熊
くび - 首
あな - 穴, 孔
くも - 雲, 蜘蛛
かう - 買う, 飼う
です - jest
チリ - Chile
よん - 四
にじ - 虹
バー - bar
みき - 幹
ふん - 分
ふゆ - 冬
ごご - 午後, 午后
すむ - 住む, 済む, 澄む, 清む
よし - 葦, 良し
よい - 良い, 好い, 酔い, 宵
ヌコ - kot
はい - 灰, 肺, 胚, 這い, 蠅, 杯, 敗, 配する, 廃する, tak
でも - ale, lecz
うず - 渦
うた - 歌, 唄
メス - skalpel, samica
うえ - 上 - górna część, góra, powyżej, wyżej (wyższy) w hierarchii, rankingu, zwierzchnik, senior, starszy, 飢え - głód, głodowanie
のど - 喉
うま - 馬
する - czasownik posiłkowy, który doczepiony do rzeczownika zamienia go w czasownik, robić, czynić, wykonywać, decydować się na coś, wybierać coś, 刷る, 掏る, 擦る, 摩る
くつ - 靴
すぎ - po
うる - 売る, 得る
ぬの - 布
みみ - 耳
みち - 道, 路, 途, 未知
みそ - 味噌
みぎ - 右
かみ - 紙, 神, 髪, 上, 加味, 佳味, 咬む, 噛む
かお - 顔
かぎ - 鍵, 鉤
かぐ - 家具, 嗅ぐ
かさ - 傘
かじ - 火事, 家事
うし - 牛, 丑
から - od, z, przez, po, ponieważ, dlatego, że, 空, 殻
かわ - 川, 河
あの - 彼の
ぞく - 属
うみ - 海, 産み, 生み, 膿
やる - dać, robić, zajmować się, uprawiać, pracować, wykonywać, żyć za coś, utrzymywać się
まつ - 待つ, 松, 末
その - tamten, tamta, tamto, ten
やぎ - 山羊
やあ - halo, hej
やね - 屋根
うち - 家, 中, 内, 裡
もり - 森
ぶた - 豚
かめ - 亀, 瓶
マリ - Mali
あい - 愛, 藍, 相, 合い
あう - 会う, 逢う, 遇う, 遭う, 合う
ああ - tak, w ten sposób, taki, tego rodzaju, ach!, niestety!, właśnie tak, hej!, a, więc to tak (吁)
あく - 悪, 灰汁, 開く, 空く, 明く, 飽く
あお - 青
あか - 赤, 垢, 亜科
あご - 顎, 頤, 齶
あさ - 朝, 麻
あし - 足, 脚, 葦, 蘆, 悪し
あじ - 味, 阿字, 鯵, 鰺
あす - 明日
ゆか - Yuka, japońskie imię żeńskie, 床, ćwiczenia wykonywane na ziemi
あと - 後, 跡
さん - pan, pani, 三 - trzy, 3, 参 - trzy, 賛 - opis, legenda, 山 - góra, 酸 - kwas
あに - 兄
あみ - 網, 罔, 醤蝦
バラ - róża, materiały homoseksualne o charakterze pornograficznym
あむ - 編む
あめ - 雨, 飴
あれ - tamten, genitalia, miesiączka, menstruacja, 荒れ
あり - 蟻
さす - 指す, 指す 将棋, 刺す, 差す, 射す, 差す, 挿す, 砂州
さき - 先, 崎, 崎, 岬, 左記
さか - 坂
ほん - 本
かれ - 彼
ゆめ - 夢
とし - 年, 年, 歳, 齢, 都市, 徒死
とお - 十
とく - 特
とき - 時
とり - 鳥
すし - sushi
とも - 友, 共
イカ - 烏賊
ほほ - 頬
ほね - 骨
ほお - 頬
おしえ - 教え
でんし - 電子, 電視
かぞく - 家族, 華族
はいる - 入る, 配流
でんき - 電気
わかつ - 分かつ
ハイチ - Haiti
いびき - chrapanie
でんわ - 電話
あおい - 青い, 蒼い, 碧い, 葵
おしり - お尻
やっつ - 八つ
のぼる - 上る  (np. po schodach)), 登る  w górach, 昇る  (o słońcu), awansować, wzrastać (o cenach)
てがみ - 手紙
カエル - żaba
とても - bardzo, niezwykle, strasznie, zupełnie, całkowicie, bezwzględnie
ガーナ - Ghana
まゆげ - 眉毛
けんし - 検視, 検死, 犬歯, 剣士, 絹糸, 研紙
いれる - 入れる, 函れる
あびる - 浴びる
きつね - 狐
セレン - selen
アーチ - łuk
しけん - 試験
きせい - 規制
おなじ - 同じ
おなか - お腹, 御腹
ケニア - Kenia
おうあ - 欧亜
いおう - 硫黄, 言おう
おうい - 王位
ドレス - sukienka
ナイフ - nóż
よごす - 汚す
あきる - 飽きる, 厭きる
もくぶ - 木部
ちくび - 乳首
えいご - 英語, 穎悟
かこう - 火口, 火光, 加工, 下降, 下行, 河口, 河港, 化工, 佳肴, 嘉肴, 歌稿, 花梗, 花香, 華甲, 囲う, 書こう, 欠こう, 描こう, 掻こう
えいが - 映画, 栄華
ジブチ - Dżibuti
あちら - tam (彼方), tamten, tamto
かせい - 火星, 加勢, 家政, 苛性, 火勢
あたい - 値, ja
あたし - ja
よごれ - 汚れ
はさみ - 鋏
あたま - 頭
よげん - 予言, 預言, 余弦
ネオン - neon
アルバ - Aruba
ドイツ - Niemcy
ゆうき - 勇気, 有機, 幽鬼, 誘起
してつ - 私鉄
テルル - tellur
ちじん - 知人, 痴人
ダガー - sztylet
プール - basen
ひろい - 広い, 寛い
パラオ - Parau
いとこ - 従兄弟, 従弟,　従兄, 従姉妹,　従妹　従姉
まぶた - 目蓋, 瞼
ひとつ - 一つ
ふるす - 古す
ふるさ - 古さ
ローマ - Rzym, Cesarstwo Rzymskie
ふるい - 古い, 篩, 震い
はなび - 花火
いいや - 否
はなす - 話す, 放す
おわる - 終る, 終わる
くうき - 空気
チェス - szachy
チェコ - Czechy
おさら - お皿
あばら - 肋
くらい - 暗い, 位, około, mniej więcej
おさけ - お酒, 御酒
せきゆ - 石油
いいえ - 否
はなや - 花屋
ねずみ - 鼠
ミラノ - Mediolan
ミラー - mirror, serwer lustrzany
イエス - Jezus
よだん - 余談
たまご - 卵, 玉子
かぶき - 歌舞伎
るざい - 流罪
ふたつ - 二つ
なごむ - 和む
ギニア - Gwinea
やはり - również, także, podobnie, tak samo jak, podobnie jak poprzednio, w dalszym ciągu, tak jak oczekiwano
かいわ - 会話
やすい - 安い, 易い
アリア - aria
ソース - źródło
しゅと - 首都, 酒徒, 衆徒
おとな - 大人
きしゃ - 汽車 - pociąg (parowy, nie elektryczny), 記者 - reporter, dziennikarz, 貴社 - (Państwa) firma, praca, 騎射 - łucznictwo konne, 帰社 - powrót do biura, 喜捨 - jałmużna, rozdawanie jałmużny
アジア - Azja
おとこ - 男
どなる - 怒鳴る
めいし - 名詞, 名刺
しもべ - 僕
べんり - 弁理, 便利
どなた - 何方
ぎしき - 儀式
うしろ - 後ろ, 後
エーッ - yy?, co?, no tak!
カジノ - kasyno
つぶら - 円ら
あかい - 赤い
ほけん - 保険
あかじ - 赤字
あかす - 飽かす, 証す, 明かす
あそこ - 彼処
あそぶ - 遊ぶ
こおり - 氷, 氷り, 凍り, 郡, 桑折
たんそ - 炭素
たんご - 単語, タンゴ
はるか - 遥か
サーバ - serwer
あかり - 明かり, 灯り
とじる - 閉じる, 綴じる
けいそ - ケイ素, 珪素
にくい - 憎い, 悪い, 難い
まぬけ - 間抜け
ずっと - bardziej, znaczniej, dawno, w odległym czasie, cały czas, od początku do końca, wszędzie, prosto, bezpośrednio
どうろ - 道路
けがす - 汚す
どせい - 土星, 土製, 怒声
マルタ - Malta
メール - e-mail
ひつじ - 羊
ボール - piłka, miska
まるい - 円い, 丸い
ズボン - spodnie
あまい - 甘い
きれい - 奇麗, 綺麗
くるま - 車, 俥
えふで - 絵筆
あえん - 亜鉛
おこす - 起こす
よわい - 齢, 弱い
くぼみ - 凹み
じょし - 助詞, 女子, 女史, 叙賜, 序詞, 序歯
ふくし - 副詞, 福祉, 副使, 複視, 復し
くぼむ - 凹む
バイト - bajt
シリア - Syryjska Republika Arabska, Syria
ふびん - 不敏, 不憫, 不愍
きいろ - 黄色
パナマ - Panama
あえぐ - sapać, oddychać z trudem, cierpieć
どうし - 動詞
なのか - 七日
ポプラ - topola
トンガ - Tonga
バレエ - balet
しょく - 食, 職
うさぎ - 兎
コーラ - coca-cola
コーン - kukurydza
コート - płaszcz
ずのう - 頭脳
テレビ - telewizja, telewizor
いのり - 祈り
ポール - Paweł
ちかい - 近い, 誓い, 地界, 地階, 地塊
くりや - 厨,　廚,　庖
ようそ - ヨウ素, 沃素, 要素
まける - 負ける
しばん - 指板
ベッド - łóżko
セロリ - seler
ごはん - 御飯, ご飯
いさむ - 勇む
ゆうひ - 夕日
スーラ - sura
ひたい - 額
わたし - 私, 俺 (おれ, ore) (chełpliwie ja), 僕 (ぼく, boku), 我 (われ, ware)
でぐち - 出口
あんな - taki, tego rodzaju
えんう - 煙雨
あんず - 杏, 杏子
りろん - 理論
あんこ - 餡子, 安固
おりる - 下りる, 降りる
えんそ - 塩素, 遠祖
しぜん - 自然
けむい - 煙い
いつか - 五日, 何時か
ことば - 言葉
くろい - 黒い
チャド - Czad
いつも - 何時も, 何時も  (z czasownikiem w formie zaprzeczenia)
のせる - 乗せる, 載せる
いつつ - 五つ, 伍つ
アニメ - anime
ファン - miłośnik, fan
バイク - motocykl
たりる - 足りる
けむり - 煙
ペニス - penis, męski członek
よっつ - 四つ
けむる - 煙る
コロン - dwukropek
クロム - chrom
たかい - 他界, 高い
ふっそ - フッ素
だいぶ - 大分
モナコ - Monako
カナダ - Kanada
ちぶさ - 乳房
エイズ - AIDS, zespół nabytego zaniku odporności
びがく - 美学
もうふ - 毛布
アヒル - kaczka (domowa)
セクト - sekta
あなた - ty, 貴女, 貴方, 彼方
さんそ - 酸素
エイト - osiem
そして - 然して – i, i wtedy, a teraz
てんき - 天気, 転機, 転記, 天機
すべて - 全て
さんぽ - 散歩
こやま - 小山
まつげ - 睫毛
はやし - 林
はやい - 速い, 早い
かえす - 返す, 帰す, 孵す, 反す, 還す
わける - 分ける
ぎぜん - 偽善
アテネ - Ateny, Atena
えかき - 絵書き
めだま - 目玉
ラドン - radon
したぎ - 下着
やさい - 野菜
うわぎ - 上衣, 上着, 表着
パスタ - makaron
ひばな - 火花
つよい - 強い
タオル - ręcznik
かざん - 火山
あくる - 明くる
まなぶ - 学ぶ
きのこ - 茸
かえる - 蛙, 帰る, 還る, 返る, 代える, 換える, 替える, 孵る, 反る, 変える
せまい - 狭い
しめい - 氏名
まるみ - 円み
いしゃ - 医者, 慰藉, 慰謝
いしょ - 遺書, 医書
ギター - gitara
ごめん - 御免
ていぎ - 定義
たべる - jeść posiłek
いたい - 痛い, 遺体, 異体, 衣帯, 居たい
ヒグチ - banknot o nominale 5000 jenów
きこう - 根雪
にもつ - 荷物
しめる - 閉める, 占める, 締める, 絞める, 湿る
いしき - 意識
タバコ - tytoń
さとう - 砂糖, 左党
あわれ - 哀れ
ならば - なら
ビット - bit
あした - 明日
かかる - 掛かる - zawiesić, 掛かる - wziąć, zająć, kosztować, 掛かる - nałożyć, 掛かる - zależeć od, 掛かる - zacząć działać, 掛かる - konsultować (z doktorem) (医者に), 架かる - budować, 罹る - paść ofiarą (choroby), cierpieć
およぐ - 泳ぐ
いちご - 苺
スパイ - szpieg
マウス - mysz
ミント - mięta
しろい - 白い
あまり - niezbyt, nie tak, zbyt, bardzo, za bardzo, tak bardzo, zbytnio, nazbyt
テスト - test
かかと - 踵
わかる - 分かる
マッチ - zapałka
インド - Indie
うおざ - 魚座
イラン - Iran
ひだり - 左
プラハ - Praga
かない - 家内
いなか - 田舎
イチイ - cis japoński
イチゴ - truskawka
さかな - 魚
たいほ - 逮捕
コイン - moneta
ピアノ - fortepian, pianino
チタン - tytan
からて - 空手
ちっそ - 窒素
チーズ - ser
さくら - さくら – wiśnia (drzewo), さくら – kwiat wiśni
こころ - 心
りこん - 離婚
レソト - Lesotho
ふかみ - 深み
おそう - 襲う
おそい - 遅い
リビア - Libia, Libijska Arabska Dżamahiria
インク - atrament
ふかい - 深い (głęboki, o dużej głębokości), 深い (gęsta  mgła), 深い (głęboki  sen, cisza, załamanie), 深い (głęboki, przenikliwy, pełen sensu  myśl, idea), 不快 (nieprzyjemny, niekomfortowy), 不快 (dyskomfort)
タワー - wieża
いがく - 医学
ほりょ - 捕虜
サイト - strona www
こいぬ - 仔犬, 子犬, 小犬
ななつ - 七つ
パンツ - majtki, bokserki, spodenki, krótkie spodnie
ニオブ - niob
よてい - 予定
かおく - 家屋
タイガ - tajga
げんき - 元気, 原器, 衒気
うすい - 雨水, 薄い
スキー - narty, narciarstwo
しゃか - 釈迦, 瀉下
げんご - 言語
げんし - 原子
のぞみ - 望み
かんし - 監視, 漢詩, 冠詞
かんじ - 漢字, 感じ, 官事, 冠辞, 幹事, 監事
みらい - 未来, 味蕾
ホテル - hotel
モデム - modem
ラオス - Laotańska Republika Ludowo-Demokratyczna, Laos
モデル - model, modelka
むっつ - 六つ
せいと - 生徒
せいか - 聖歌
まさる - 優る, 勝る
みみわ - 耳輪
ちしき - 知識
ウラン - uran
におい - zapach
みっつ - 三つ
いけん - 意見, 異見, 違憲
きゅう - 急, 九, 級, 球, 旧
かれら - 彼ら, 彼等
ナポリ - Neapol
いわし - 鰯
ウール - wełna
ラジオ - radio
コンマ - przecinek
ながい - 長い, 永い, 長居
シャブ - narkotyki, stymulanty, prochy
グラム - gram
コンゴ - Kongo
ワイン - wino
キエフ - Kijów
ケーキ - ciasto
アプス - absyda
ぐらい - około, w przybliżeniu
こちら - tutaj, tu, to miejsce, ta osoba, ja, my, ta rzecz
ドバイ - Dubaj
レモン - cytryna
あざな - 字
あぶる - smażyć, piec
あぶら - 油, 脂, 膏, 膩
できる - 出来る
やがて - niebawem, prędko, wkrótce, wnet
まんが - 漫画
おどる - 踊る, 躍る
せっし - 摂氏, 切歯
クラス - klasa
クラゲ - meduza
バナナ - banan
おきる - 起きる
ひゃく - 百
アズキ - fasola azuki, czerwona soja
いそぐ - 急ぐ
あつみ - 厚み, 温海
あつい - 暑い, 厚い, 熱い, 篤い
あつさ - 暑さ, 厚さ, 熱さ
バハマ - Bahamy
しいる - 強いる
へこむ - 凹む
きぼう - 希望
けがれ - 汚れ
ツバル - Tuvalu
せすじ - 背筋
シスマ - schizma
あける - 開ける, 空ける, 明ける
くつう - 苦痛
ウェブ - web, sieć
こども - 子ども, 子供
わかい - 和解, 若い
こくご - 国語
あげる - dać, podarować, zrobić coś dla kogoś, oddać komuś przysługę (w połączeniu z formą łącznikową て czasownika), 挙げる, 揚げる, 上げる
わいろ - 賄賂
データ - dane
かがく - 化学, 科学
りょう - 寮
トマト - pomidor
げすい - 下水
イラク - Irak
マカオ - Makau
かがみ - 鏡, 鑑, 鑒
うたう - 唄う, 歌う, 謡う, 謳う
いくつ - 幾つ
コレラ - cholera
ポテト - ziemniak, kartofel
ゲーム - gra
しんり - 真理
かばん - torba, teczka
ちかう - 誓う, 盟う
くすり - 薬
おおい - おおい, 多い, 被い, 覆い
ごげん - 語源
オペラ - opera
まかす - 負かす, 任す
きゃく - 客
ロシア - Rosja
しまい - 姉妹, 仕舞い
じゅう - 十, 銃, 中
えらぶ - 選ぶ
わさび - 山葵
はかる - 計る, 測る, 量る: mierzyć, 図る, 謀る: kreślić, planować, projektować, 諮る: konsultować z
あいだ - 間
ほんや - 本屋
えらい - 偉い
ガボン - Gabon
かえん - 火炎, 火焔
あーあ - a, och, o Boże
すうし - 数詞
いくら - 幾ら
ビール - piwo
あるく - 歩く
オゾン - ozon
つなみ - 津波
トーゴ - Togo
あひる - 鶩, 家鴨
フォト - fotografia
とうふ - 豆腐
ビゴス - bigos
おちゃ - お茶, 御茶
グレー - szary
ペルー - Peru
おかね - お金, 御金
コモロ - Komory
ふべん - niewygoda, niepraktyczność, niewygodny
おかし - お菓子, 御菓子
ベナン - Benin
つよさ - 強さ
ねだん - 値段
イルカ - delfin
ユカン - liściokwiat garbnikowy
つくえ - 机
ざっし - 雑誌
おんど - 温度
ほうい - 包囲
たてる - 建てる, 立てる, 点てる, 閉てる
カメラ - aparat fotograficzny
ふさく - 不作
トルコ - Turcja
からだ - 体, 身体, 躰
かせつ - 仮説
あゆむ - 歩む
つよみ - 強み
けしき - 景色, 化色, 気色
いたみ - 痛み, 傷み
ねむり - 眠り
わしん - 和親
せなか - 背中
わめく - 喚く
タリン - Tallinn
はんが - 版画, 板画
りんご - 林檎
かたき - 敵, 仇
おもう - 思う
どだい - 土台
せいゆ - 精油, 製油, 聖油
ゴジラ - Godzilla
みどり - 緑
いたむ - 痛む, 傷む, 悼む
スリル - dreszcz
あくま - 悪魔
すいそ - 水素
じめん - 地面
おんな - 女
あらう - 洗う
あらた - 新た
ころぶ - 転ぶ
ナウル - Nauru
おもい - 重い, 想い, 思い
ボタン - guzik (przy ubraniu), przycisk
ピンク - kolor różowy
バター - masło
こてん - 個展, 古典
あくむ - 悪夢
こわい - 恐い, 怖い, 強い
にほん - 二本, 日本
アンプ - wzmacniacz
ぬすむ - 盗む
スイス - Szwajcaria
まどか - 円か
ひくい - 低い
モスク - meczet
キリン - żyrafa
ヒデヨ - banknot o nominale 1000 jenów
ほうそ - ホウ素, 硼素
ミルク - mleko
たすけ - 助け
せかい - 世界
たばこ - タバコ
あだな - あだ名
ただす - 正す
あいぶ - 愛撫
わるい - 悪い
しんしつ - 寝室, 心室
おとつい - 一昨日
イタリア - Włochy
オレンジ - pomarańcza, kolor pomarańczowy
ふかめる - 深める
れいこん - 霊魂
サターン - Saturn
あべこべ - przeciwny, odwrotny
かいだん - 会談, 階段, 怪談, 解団
ちゅうじ - 中耳
たいよう - 太陽, 大洋, 大要
きょうし - 教師
コーヒー - kawa
シンボル - symbol
アッシジ - Asyż
いっしょ - 一緒
こたえる - 答える, 応える
ペンギン - pingwin
おぼえる - 覚える, 憶える
アルバム - album, klaser, album muzyczny, album pamiątkowy
てんれい - 典礼
ロケット - rakieta
ねんれい - 年齢
サッカー - piłka nożna
トランス - trans, trance
ジュース - sok, napój z owoców
あきらか - 明らか
さしょう - 査証
たのしい - 楽しい, 愉しい
ソマリア - Somalia
ごろつき - 破落戸
ウィルス - wirus, wirus (komputerowy)
キリバス - Kiribati
いりぐち - 入り口, 入口
せいかつ - 生活
ほっぺた - 頬っぺた
ゴーレム - golem
こいびと - 恋人
よごれる - 汚れる
ウガンダ - Uganda
おばさん - 叔母さん, 小母さん, 伯母さん
きょうぎ - 競技, 教義
ヨルダン - Jordania
タンタル - tantal
たましい - 魂
マントラ - mantra
アイロン - żelazko, prostownica do włosów
みずうみ - 湖
マラウイ - Malawi
おもしろ - 面白
リベリア - Liberia
しゃかい - 社会
しりあい - 知合, 知合い, 知り合, 知り合い
かみさま - 神さま, 神様
つよがる - 強がる
かわいい - 可愛い
マナーマ - Manama
ネクタイ - krawat
ブルネイ - Brunei, Brunei Darussalam
しょくじ - 食事
はちみつ - 蜂蜜
ベルギー - Belgia
ちきゅう - 地球, 恥丘
ブロック - blok
メキシコ - Meksyk
なごやか - 和やか
はんざい - 犯罪
ケベック - Québec, Quebec
きしどう - 騎士道
イエメン - Jemen
プードル - pudel
もんだい - 問題
おとうと - 弟
せんせい - 先生
はいれつ - 配列
モルドバ - Mołdawia
さいみん - 催眠
クラクフ - Kraków
オーボエ - obój
フェリー - prom
おそわる - 教わる
かくめい - 革命
ののしる - 罵る
あばれる - 暴れる
セリウム - cer
かんすう - 関数
キルギス - Kirgistan
くだもの - 果物
デパート - supersam, dom towarowy
こうもん - 肛門, 校門
ともだち - 友達
れいがい - 例外
わたくし - 私
ガチョウ - gęś
マラソン - maraton
はなむこ - 花婿
きにゅう - 記入
はちがつ - 八月
シドニー - Sydney
がくせい - 学生
ハッシュ - hash
ガリウム - gal
リスボン - Lizbona
おくれる - 遅れる, 後れる
しんくう - 真空
ロボット - robot
ぎじんか - 擬人化
なんとう - 南東, 南島, 何等, 何党, 何頭, 何棟
こうちゃ - 紅茶
エジプト - Egipt
ガンビア - Gambia
よしゅう - 予習
はんけい - 半径
ブータン - Bhutan
フィジー - Fidżi
きんえん - 禁煙
ヘロイン - heroina, diacetylomorfina
えいこく - 英国
いちげつ - 一月
セネガル - Senegal
あぶない - 危ない
やつがれ - 僕
ヘリウム - hel
あんこく - 暗黒
エリート - elita, elitarny
オアシス - oaza
エディタ - edytor
こつばん - 骨盤
そくしつ - 側室
アメリカ - Ameryka (kontynent), Stany Zjednoczone Ameryki
ナミビア - Namibia
こんばん - 今晩
こんにち - 今日
しんがく - 神学
あさって - 明後日
ワセリン - wazelina
あふれる - być pełnym, przepełnionym, przelewać się
まいつき - 毎月
しんぞう - 心臓, 心像, 新造
おおかみ - 狼, 狼座
むらさき - 紫
ファラオ - faraon
シュガー - cukier
ペルシア - Persja
ロジバン - lojban
ネパール - Nepal
レポート - praca semestralna, praca zaliczeniowa, raport
オカリナ - okaryna
おととし - 一昨年
おととい - 一昨日
かわぎし - 川岸
ばくだん - 爆弾
イメージ - obrazek
キリスト - Chrystus
かいよう - 海洋, 潰瘍
ガソリン - benzyna, paliwo
とうこつ - 頭骨
アイコン - ikonka
ベルリン - Berlin
やっぱり - やはり
かぶしき - 株式
こくせき - 国籍
アンドラ - Andora
ボツワナ - Botswana
せいしょ - 聖書
タクシー - taksówka, taxi
メソッド - metoda
らんそう - 卵巣
けつえき - 血液
キセノン - ksenon
すなわち - lub, to jest, mianowicie, innymi słowy
トリウム - tor
くちべに - 口紅
チベット - Tybet
おいしい - 美味しい
マチェイ - Maciej
じしゃく - 磁石
にちぼつ - 日没
ふじさん - 富士山
フォーク - widelec, ludowy
はたらき - 働き
ざひょう - 座標
うまれる - 生まれる, 生れる
おはよう - お早う
アンマン - Amman
メラニン - melanina
シャワー - prysznic
ライター - zapalniczka
たべもの - 食べ物
きりゅう - 気流, 寄留
ウィーク - tydzień, słaby
はたらく - 働く
ウイルス - wirus
スタジオ - atelier
やわらぐ - 和らぐ
こつがく - 骨学
ミンスク - Mińsk
ふかまり - 深まり
ふかまる - 深まる
トレード - handel
ちちくび - 乳首
ヤンキー - Jankes, popularne określenie mieszkańca Stanów Zjednoczonych, młodociany przestępca, japońska subkultura lat 80. i 90. naśladująca w ubiorze i zachowaniu amerykańską młodzież
セルビア - Serbia
けっこん - 結婚
ちいさい - 小さい
ニッケル - nikiel
クリーム - krem, bita śmietana, śmietanka
アイドル - idol, bożyszcze
ファウル - faul
しろがね - 銀, 白金
けんえき - 検疫
かみなり - 雷
ひんしつ - 品質
ついたち - 一日
サイコロ - さいころ
ショコラ - czekolada
はいぞう - 肺臓
ポズナン - Poznań
せっぷん - 接吻
グレナダ - Grenada
パターン - wzorzec
ハングル - hangul
あまみず - 雨水
ハルキウ - Charków
オランダ - Holandia
まんがか - 漫画家
てんじる - 転じる
アパート - mieszkanie, blok mieszkalny, apartament, kamienica czynszowa
セシウム - cez
バリウム - bar
じょせい - 女性, 女声, 助勢, 助成, 女婿
スカート - spódnica
かようび - 火曜日
いしょく - 移植
ひんぱん - 頻繁
えんとつ - 煙突
フォント - czcionka
うんてん - 運転
スペイン - Hiszpania
ほんのう - 本能
きいろい - 黄色い
アフリカ - Afryka
ドミニカ - Dominika
しょうゆ - 醤油
チャンス - szansa
かんたん - 簡単, 感嘆, 感歎
かいしゃ - 会社
アンテナ - antena
ぎんこう - 銀行, 銀鉱, 銀鉱
ネオジム - neodym
ラトビア - Łotwa
マフィア - mafia
ひとつき - 一月
しんこう - 親交, 進行, 信仰, 振興, 侵攻
マイアミ - Miami
アルジェ - Algier
どようび - 土曜日
きいちご - 木苺
はるめく - 春めく
しゅうそ - 臭素, 宗祖
ミラクル - cud
リソース - zasób
じつざい - 実在
パソコン - PC, komputer
グルジア - Gruzja
しゅうと - 舅
つよめる - 強める
ルワンダ - Rwanda
たいせい - 大勢, 体制, 体勢, 態勢, 胎生, 退勢, 頽勢, 大成, 対生, 耐性, 泰西, 大聖
あいいろ - 藍色
じちけん - 自治権
だいがく - 大学
メニュー - menu
スーダン - Sudan
いちがつ - 一月
ブラウザ - przeglądarka
すなはま - 砂浜
クッキー - ciastko
ロジウム - rod
ブラウン - brązowy
ギリシア - Grecja
おんなじ - 同じ
エアコン - klimatyzacja (urządzenie), używać klimatyzacji
おじさん - 叔父さん, 小父さん, 伯父さん
しきゅう - 子宮, 支給, 至急
えんぴつ - 鉛筆
おわせる - 負わせる
くださる - prosić o wykonanie jakiejś czynności, forma często używana w połączeniu z formą koneksywną., dawać
りくぐん - 陸軍
かきょく - 歌曲
チュニス - Tunis
おもちゃ - 玩具
おんたい - 温帯
これから - odtąd, od teraz
あやうい - 危うい
しんぶん - 新聞
アンゴラ - Angola
あやうく - 危うく
こひつじ - 仔羊, 子羊, 小羊
みらいは - 未来派
どきょう - 度胸
しんらい - 信頼
スリナム - Surinam
こうへい - 工兵, 公平
いりくち - 入り口, 入口
ころがる - 転がる
ピーター - Piotr
ファイル - plik, teczka
ころがす - 転がす
フランス - Francja
さいころ - kości do gry
おくさん - 奥さん
こくおう - 国王
あんなに - tak, w ten sposób, do tego stopnia
あつがる - 暑がる
ファンド - fundusz
カタール - Katar
あんぜん - 安全, 暗然
やすまる - 安まる
モンゴル - Mongolia
スコープ - zasięg nazwy
いちじつ - 一日
チャット - chat, rozmowa
マンガン - mangan
ようさん - 葉酸
モロッコ - Maroko
テーブル - stół, stolik
ガイアナ - Gujana
かのじょ - 彼女
ビーバー - bóbr
オオカミ - wilk
こうどう - 行動
フィルタ - filtr
メートル - metr
じどうし - 自動詞
ウィーン - Wiedeń, stolica Austrii
しつれい - 失礼
チョーク - kreda (materiał), kreda (do tablicy)
ころげる - 転げる
どうとく - 道徳
おおぜい - 大勢
エンジン - silnik
フライト - lot, rejs, przelot
せきたん - 石炭
あわれみ - 哀れみ
あわれむ - 哀れむ
せっけん - 石鹸
ずいぶん - bardzo, dużo, sporo, dosyć
じゅなん - 受難
もじれつ - 文字列
こくさい - 国際
レッスン - lekcja
バチカン - Watykan
しまざい - 歯磨剤
おんがく - 音楽
けんぽう - 憲法
ベリーズ - Belize
でんしゃ - 電車
いちばん - 一番
はいいろ - 灰色
へんすう - 変数
こうかい - 更改
じょうき - 蒸気, 上記, 上気, 常軌, 条規
スレッド - wątek
スプーン - łyżka
つわもの - 兵
かしょう - 歌唱
くうこう - 空港
パレルモ - Palermo
にっぽん - 日本
しゃしん - 写真
あんじん - 安心 w buddyzmie
フィルム - film, klisza
きたない - 汚い
きゅうき - 吸気
きゅうし - 休止, 急死, 九死, 臼歯
ランタン - lantan
ローマじ - ローマ字
こうがく - 工学, 光学, 後学, 好学, 攻学, 高額
きんにく - 筋肉
たどうし - 他動詞
ふりがな - 振り仮名
あげもの - 揚げ物
こうとう - 喉頭 (
おんかい - 音階 (
ただしい - 正しい
クローン - klon
タリウム - tal
えんげき - 演劇
ばくしゅ - 麦酒
いもうと - 妹
だいにん - 大人, 代人, 代任
カリウム - potas
くちびる - 唇
ボリビア - Boliwia
こうずい - 洪水
かたかな - 片仮名 (katakana)
ほうほう - 方法
あいさつ - powitanie, pozdrowienie
いためる - 痛める, 傷める, 炒める
かいもの - 買い物
あじわう - 味わう
あじわい - 味わい
わしょく - 和食
しんけい - 神経
くものす - 蜘蛛の巣
かぞえる - 数える
せつびじ - 接尾辞
はいらん - 排卵
しゃせい - 射精, 写生, 社製
けがれる - 汚れる
ギリシャ - Grecja
やすらか - 安らか
アベック - para
がいこく - 外国
サウンド - dźwięk
ベトナム - Wietnam
イギリス - Wielka Brytania, Anglia
マラリア - malaria
レーダー - radar
はつおん - 発音
せつめい - 説明
イスラム - islam
ブラジル - Brazylia
あつかう - 扱う
あつかい - 扱い
ロンドン - Londyn
けんこう - 健康
せわしい - 忙しい
ペガサス - Pegaz
ユーザー - użytkownik
ウォッカ - wódka
ツリウム - tul
すいぎん - 水銀
メロディ - melodia
アルゴン - argon
アクセス - dostęp
モスクワ - Moskwa
じんしゅ - 人種
りょうり - 料理
フルート - flet
うけざら - 受け皿
かなしみ - 悲しみ, 哀しみ
かなしい - 悲しい, 哀しい
べんごし - 弁護士
かなしさ - 悲しさ, 哀しさ
あかるむ - 明るむ
ライオン - lew
コバルト - kobalt
むそうか - 夢想家
せいてん - 聖典
おしえる - 教える, 訓える, 教える
こくみん - 国民
きつえん - 喫煙
やさしい - 優しい, 易しい
びょうき - 病気
ファイト - walka
どうぶつ - 動物
カーテン - kurtyna, zasłona
けしゴム - 消しゴム
えらがる - 偉がる
つづける - 続ける
おおきい - 大きい, 巨い
がっこう - 学校
かなしむ - 悲しむ, 哀しむ
あっする - 圧する
ラーメン - ramen
そんざい - 存在
がいそう - 咳嗽
れんごう - 連合, 連合する
かわぐち - 川口, 河口
ゆいごん - 遺言
じんこう - 人口, 人工
ひらがな - 平仮名 (hiragana)
コカイン - kokaina
ブルンジ - Burundi
あめりか - 亜米利加
スポーツ - sport
ザモシチ - Zamość
いちにち - 一日
ニコシア - Nikozja
リチウム - lit
ぶんぽう - 文法
そうほん - 草本
ここのつ - 九つ
すぐれる - 優れる, 勝れる
キューバ - Kuba
ナイロビ - Nairobi
おうすい - 王水
つよまる - 強まる
ほとんど - prawie wszystko, prawie
うけつけ - 受付
ゆうこう - 友好, 有効
はっきん - 白金, 発禁
さいがい - 災害
ビタミン - witamina
あちこち - tam i nazad, tam i z powrotem
こうせい - 厚生, 公正, 後世
ラジウム - rad
ザンビア - Zambia
ニュース - wiadomości, dziennik (radiowy, telewizyjny)
でんせつ - 伝説
ちかてつ - 地下鉄
ルアンダ - Luanda
ぐんたい - 軍隊
キプロス - Cypr
シナプス - synapsa
しぜんび - 自然美
すうがく - 数学
レバノン - Liban
ビスマス - bizmut
のみもの - 飲物
れっしゃ - 列車, 劣者
だいじん - 大臣, 大尽
じむしつ - 事務室
はいしゃ - 歯医者
レニウム - ren
じょうい - 上位, 上意
こうえん - 公園
こぎって - 小切手
いろいろ - 色々, 色色
にわとり - 鶏
いたがる - 痛がる
かいろう - 回廊
まろやか - 円やか
フロント - recepcja
あやぶむ - 危ぶむ
コメント - komentarz
あんしん - 安心
ザコパネ - Zakopane
もんげん - 門限
わかれる - 分かれる
エミリア - Emilia
たいくつ - 退屈
たいへん - 対辺, 大変
オリーブ - oliwka (drzewo), oliwka (owoc)
あかるい - 明るい
ログオフ - wylogowanie
けいかん - 警官, 景観
ゆうがた - 夕方
おんしゃ - 恩赦
ワカモレ - guacamole
テルミン - theremin
ログイン - log-in, zalogowanie
わすれる - 忘
おういつ - 横溢
ふでばこ - 筆箱
オマーン - Oman
モペッド - motorower
キャベツ - kapusta
グリーン - zielony
べいこく - 米穀, 米国
ひょうし - 拍子
あからむ - 明らむ, 赤らむ
だいすき - 大好き
ひょうが - 氷河
てんずる - 転ずる
じんみん - 人民
ひょうひ - 表皮
ライセンス - licencja
かのじょら - 彼女等, 彼女ら
ものがたり - 物語
カレンダー - kalendarz
うらないし - 占い師
アンケート - kwestionariusz, ankieta
どうじょう - 同情, 同上, 道場
ボールペン - długopis
おういんご - 欧印語
エルビウム - erb
けいしょう - 継承, 形象, 敬称, 軽傷, 軽症
ジャスミン - jaśmin
りょうほう - 両方
はいりぐち - 入り口, 入口
アーカイブ - archiwum
ありがとう - 有り難う, 有難う
けいようし - 形容詞
あいきどう - 合気道
ひゃくまん - 百万
あなたたち - wy (uprzejmie)
ヨーグルト - jogurt
ブルガリア - Bułgaria
パンティー - majtki, majteczki
げつようび - 月曜日
ニカラグア - Nikaragua
エストニア - Estonia
イリジウム - iryd
こうぎょう - 工業
ノルウェー - Norwegia
あいじょう - 愛情, 哀情, 愛嬢, 愛孃
ファイター - wojownik, gracz
パラジウム - pallad
ニジェール - Niger
おべんとう - お弁当
にゅうぼう - 乳房
でんりゅう - 電流
そつぎょう - 卒業
ごうしゅう - 豪州
あなたがた - 貴方々, 貴方方
じてんしゃ - 自転車
あさごはん - 朝ご飯, 朝御飯
ぶっきょう - 仏教
ハフニウム - hafn
ベネズエラ - Wenezuela
セロトニン - serotonina
にちようび - 日曜日
マケドニア - Macedonia
はんぼいん - 半母音
プログラム - program
よげんする - 予言する
ていきけん - 定期券
むきかがく - 無機化学
エチオピア - Etiopia
ナトリウム - sód
しゅちょう - 首長
いそがしい - 忙しい
スリランカ - Sri Lanka
ブカレスト - Bukareszt
カメルーン - Kamerun
エリトリア - Erytrea
わたしたち - 私達
オセアニア - Oceania
クロアチア - Chorwacja
フロッピー - dyskietka
アーモンド - migdał, migdałowiec
ちょっけい - 直径, 直経, 直系
リトアニア - Litwa
おんなのこ - 女の子
こうむいん - 公務員
ちょくせつ - 直接
コスタリカ - Kostaryka
ギャンブル - hazard
やすんじる - 安んじる
しきべつし - 識別子
テルビウム - terb
しゅうかん - 習慣, 週間, 収監
かがくてき - 科学的, 化学的
バルコニー - balkon
メッセージ - wiadomość
ポロニウム - polon
あんらくし - 安楽死 (eutanazja)
にゅうもん - 入門
ルーマニア - Rumunia
セッション - sesja
げんごがく - 言語学
カルシウム - wapń
エクアドル - Ekwador
スクリプト - skrypt
みんしゅく - 民宿
ソーセージ - kiełbasa
ファミコン - gry komputerowe, telewizyjne
ヘルメット - kask, hełm
ドーピング - doping
ブダペスト - Budapeszt
よっぱらう - 酔っ払う
よっぱらい - 酔っ払い
アカウント - konto
ヨーロッパ - Europa
コンパイラ - kompilator
オンライン - online, w sieci
バルバドス - Barbados
アンチモン - antymon
ズブロッカ - żubrówka
ライブラリ - biblioteka
あたらしい - 新しい
カドミウム - kadm
サトウキビ - trzcina cukrowa
しつりょう - 質量
はくちょう - 白鳥
バラライカ - bałałajka
ボーリウム - bohr
じゅうどう - 柔道
びじゅつか - 美術家
ゆうしょく - 夕食
カンボジア - Kambodża
おてあらい - お手洗い, 御手洗い
プリンター - drukarka
ブラジャー - biustonosz, stanik
こくゆうか - 国有化
ミャンマー - Birma
ログアウト - logout, wylogowanie
ブルテリア - bulterier
あたたかい - 暖かい, 温かい
じゅんれい - 巡礼
ゆうじょう - 友情
ハイキング - piesze wycieczki, wędrówki
おんがっか - 音楽家
アトリウム - atrium
オートバイ - motocykl
スロベニア - Słowenia
ポーランド - Polska
クリスマス - Boże Narodzenie
しょくどう - 食堂
アルメニア - Armenia
サマリウム - samar
しょうせつ - 小説
ファックス - faks
フォーラム - forum
コンドーム - prezerwatywa, kondom
デンマーク - Dania
アスタチン - astat
ぎょぎょう - 漁業
おんどけい - 温度計
あかちゃん - 赤ちゃん
おとうさん - お父さん, 御父さん
カーペット - dywan
クウェート - Kuwejt
じどうしゃ - 自動車
きょうせい - 強勢, 強制, 強請, 共生, 共棲, 矯正, 嬌声, 教生, 匡正, 胸声
アデレード - Adelajda
バーレーン - Bahrajn
ベラルーシ - Białoruś
ジュネーヴ - Genewa
キュリウム - kiur
バイオマス - biomasa
よていする - 予定する
でいりぐち - 出入口
ギガバイト - gigabajt
ホルミウム - holm
どうみゃく - 動脈
ファゴット - fagot
パキスタン - Pakistan
おとこのこ - 男の子, 男の児
ハクション - apsik!, a psik!
にゅうさん - 乳酸
さんちょう - 山頂
レストラン - restauracja
チュニジア - Tunezja
ひょうめん - 表面
けいたいそ - 形態素
がんばって - 頑張って
とうにゅう - 豆乳, 投入
としょかん - 図書館
けいさんき - 計算機, 計算器
おにいさん - お兄さん, 御兄さん
かんがえる - 考える
あどけない - niewinny, naiwny
ルビジウム - rubid
アルバニア - Albania
きんようび - 金曜日
いさましい - 勇ましい
カレンシー - waluta
クルアーン - Koran
おじいさん - お祖父さん, お爺さん, 御祖父さん, 御爺さん
ヴィシュヌ - Wisznu
ちゅうおう - 中央
アスピリン - aspiryna
キーボード - klawiatura
ジャマイカ - Jamajka
すきまかぜ - 隙間風
モルディブ - Malediwy
マレーシア - Malezja
ハンガリー - Węgry
だいめいし - 代名詞
アルコール - alkohol
えいごばん - 英語版
せいじがく - 政治学
メタげんご - メタ言語
イスラエル - Izrael
カンガルー - kangur
かがくこつ - 下顎骨
せいちゅう - 成虫
ウィスキー - whisky
ドクトリン - doktryna
ろんりがく - 論理学
バナジウム - wanad
ルテニウム - ruten
エアバッグ - poduszka powietrzna
おもちゃや - 玩具屋, おもちゃ屋
クリプトン - krypton
あばらぼね - 肋骨
メラトニン - melatonina
クリスタル - kryształ
こんにちは - 今日は - dzień dobry
やわらげる - 和らげる
モジュール - moduł
サングラス - okulary przeciwsłoneczne
きっさてん - 喫茶店
ポルトガル - Portugalia
グアテマラ - Gwatemala
もりあがる - 盛り上がる
ルテチウム - lutet
すみません - Przepraszam! (gdy zrobiło się coś złego), Przepraszam! (zwrócenie na siebie uwagi), Dziękuję! (gdy ktoś coś dla nas zrobił)
ジャガイモ - ziemniak
ニヒリズム - nihilizm
あきらめる - zrezygnować, zaniechać, pogodzić się z …
アレルギー - alergia, uczulenie
さんぎょう - 産業
あらいぐま - 洗熊
ばかやろう - 馬鹿野郎
インジウム - ind
フォーマル - formalny
げんしょう - 現象
ベイルート - Bejrut
ドブニウム - dubn
あたらしさ - 新しさ
アキレウス - Achilles
ジンバブエ - Zimbabwe
いっしょに - 一緒に
エロティカ - erotyka
ようすいろ - 用水路
サッカリン - sacharyna
せいかがく - 生化学
よげんしゃ - 予言者
げいじゅつ - 芸術
タンザニア - Tanzania, Zjednoczona Republika Tanzanii
フォーカス - fokus
マドリード - Madryt
いたましい - 痛ましい, 傷ましい
もくはんが - 木版画
おばあさん - お祖母さん, 御祖母さん, お婆さん, 御婆さん
オプション - opcja
こんばんは - 今晩は
オスミウム - osm
やかましい - hałaśliwy, głośny
ハッシウム - has
あからめる - 赤らめる
パラグアイ - Paragwaj
ぎょうれつ - 行列
ボクシング - boks
ヘルシンキ - Helsinki
かっこいい - 格好いい
じゅっぷん - 十分
トウシキミ - anyż gwiazdkowy, badian właściwy ( Hook. f.)
キロバイト - kilobajt
いでんがく - 遺伝学
コロンビア - Kolumbia
マンション - blok mieszkalny
けつにょう - 血尿
おねえさん - お姉さん, 御姉さん, お姐さん, 御姐さん
べんきょう - 勉強
イテレータ - iterator
カルダモン - kardamon
さようなら - do widzenia
ベリリウム - beryl
もくようび - 木曜日
せんたくき - 洗濯機
サンルーフ - szyberdach
ウクライナ - Ukraina
ウルグアイ - Urugwaj
モリブデン - molibden
おもしろい - 面白い
くろいちご - 黒苺
サンマリノ - San Marino
しゅうしふ - 終止符
あつりょく - 圧力
フォルダー - folder
むずかしい - 難しい
すいようび - 水曜日
プロセッサ - procesor
メスカリン - meskalina
セルロース - celuloza
トスカーナ - Toskania
セイシェル - Seszele
ビリニュス - Wilno
さんぽする - 散歩する
スロバキア - Słowacja
マージャー - fuzja, łączenie, połączenie
ばんごはん - 晩ご飯, 晩御飯
プレゼント - prezent, dar, podarunek
ひるごはん - 昼御飯, 昼ご飯
かがくしゃ - 化学者
チェチェン - Czeczenia
じょうだん - 冗談, 上段
アーケード - arkada
ファースト - pierwszy
おかあさん - お母さん, 御母さん
セルライト - cellulit
パスワード - hasło dostępu
パレスチナ - Palestyna
おんがくか - 音楽家
フィリピン - Filipiny
キーワード - słowo kluczowe
あったかい - 暖かい, 暖い, 温かい
のうぎょう - 農業
しょうさん - 硝酸, 称賛, 勝算, 消散
ワルシャワ - Warszawa
パラダイム - paradygmat
ひだりきき - 左利き
あきっぽい - 飽きっぽい, 厭きっぽい, 秋っぽい
メガバイト - megabajt
しょしがく - 書誌学
しあさって - 明明後日, 明々後日
みょうにち - 明日
パーティー - przyjęcie, impreza
えいがかん - 映画館 budynek
フィルター - filtr
ファスナー - suwak
きょくせん - 曲線
サラエヴォ - Sarajewo
しゃしんや - 写真屋
りょうりや - 料理屋
うけみけい - 受身形
せいねんき - 青年期
インドネシア - Indonezja
あんていはん - 安定版
フィンランド - Finlandia
アイスランド - Islandia
フェルミウム - ferm
チューリッヒ - Zurych
ゆだやきょう - ユダヤ教
にんしきろん - 認識論
イングランド - Anglia
シーシュポス - Syzyf
モーリタニア - Mauretania
アイルランド - Irlandia
そそっかしい - nieostrożny, roztrzepany, roztargniony
アステリスク - asterisk, znak *, gwiazdka
すうがくしゃ - 数学者
キルギスタン - Kirgistan
きょうりゅう - 恐竜
タジキスタン - Tadżykistan
にほんごはん - 日本語版
いっさくじつ - 一昨日
じょうみゃく - 静脈
ブロッコリー - brokuły
だいがくせい - 大学生
アルミニウム - glin
ギニアビサウ - Gwinea Bissau
セットアップ - setup, ustawienie
サンドイッチ - kanapka
スワジランド - Suazi
がいこくじん - 外国人
あいさつする - witać, pozdrawiać
かんらんしゃ - 観覧車
いっさくねん - 一昨年
さしだしさき - 差し出し先
はくぶつかん - 博物館
シエラレオネ - Sierra Leone
ヒストグラム - histogram
ソフトウェア - oprogramowanie
ジブラルタル - Gibraltar
マルチニーク - Martynika
ダウンロード - download
げんけいしつ - 原形質
ペドフィリア - pedofilia
モニュメント - pomnik, zabytek
ネプツニウム - neptun
てんきよほう - 天気予報
だいじょうぶ - w porządku, OK
データベース - baza danych
たいへいよう - 太平洋
きょうきゃく - 橋脚
ハンバーガー - hamburger
パラドックス - paradoks
ホームページ - strona domowa
へんとうえん - 扁桃炎
ふくすうけい - 複数形
ひょうじょう - 表情, 評定, 兵仗
でんしメール - 電子メール
イデオロギー - ideologia
プラセオジム - prazeodym
コントロール - przycisk
ユウロピウム - europ
はんぶっしつ - 反物質
タングステン - wolfram
がんせきがく - 岩石学 ( petrologia)
グアドループ - Gwadelupa
ファッション - moda
りょうりにん - 料理人
ほうこくしょ - 報告書
アルジェリア - Algieria
ホンジュラス - Honduras
しゅごてんし - 守護天使
しゅうきょう - 宗教
せいかつする - 生活する
どうぶつがく - 動物学
あおしんごう - 青信号
オルガスムス - orgazm, szczytowanie
しほんしゅぎ - 資本主義
ガドリニウム - gadolin
テルモピュレ - Termopile
あつかましい - 厚かましい
ハンドバッグ - torebka (damska)
りょうりしょ - 料理書
トランペット - trąbka
マドリガーレ - madrygał
きしょうだい - 気象台
ピッツバーグ - Pittsburgh (stolica Allegheny)
ふっかつさい - 復活祭
けっこんしき - 結婚式
エントロピー - entropia
エアロビクス - aerobik
しょうせつか - 小説家
ディレクトリ - katalog
きにゅうする - 記入する
ひじょうぐち - 非常口
ねつりきがく - 熱力学
ふるめかしい - 古めかしい
ふるめかしさ - 古めかしさ
モーリシャス - Mauritius
さきおととい - 一昨昨日
わたくしたち - 私達
フェニックス - feniks
シンガポール - Singapur
たいいくかん - 体育館
しゃかいがく - 社会学
ナイジェリア - Nigeria
プランクトン - plankton
ファイナンス - finanse
エレベーター - winda
アメリシウム - ameryk
フェンシング - szermierka
スウェーデン - Szwecja
げいじゅつか - 芸術家
クライアント - klient
うでたてふせ - 腕立て伏せ
けいさつけん - 警察犬
ニューデリー - Nowe Delhi
でんきかがく - 電気化学
アクチニウム - aktyn
オーストリア - Austria
ぶっぴんぜい - 物品税
せいたいがく - 生態学
ネットワーク - sieć
きつえんしゃ - 喫煙者
えんきんほう - 遠近法
どうとくげき - 道徳劇
ていとうけん - 抵当権
アスタリスク - asterysk
モザンビーク - Mozambik
じょうりゅう - 蒸留, 上流
インスタンス - instancja
はじめまして - 始めまして, 初めまして
くんしゅせい - 君主制
ダイヤモンド - diament, brylant
エスペラント - esperanto
よしゅうする - 予習する
バークリウム - berkel
エンタルピー - entalpia, miara zawartości ciepła
アルゼンチン - Argentyna
オークション - aukcja
こうこうせい - 高校生
ビデオカード - karta graficzna
カリフラワー - kalafior
ニューヨーク - Nowy Jork (miasto)
カザフスタン - Kazachstan
プルトニウム - pluton
もうどうけん - 盲導犬
りょうりほう - 料理法
ぶんけんがく - 文献学
ぶんげいがく - 文芸学
カーボベルデ - Wyspy Zielonego Przylądka
ファンタジー - fantazja
ばんそうこう - 絆創膏
オーケストラ - orkiestra
ジルコニウム - cyrkon
テントウムシ - biedronka
しょうぎょう - 商業
フルクトース - fruktoza
ブリュッセル - Bruksela
バーミューダ - Bermudy
こうじつせい - 向日性
コンピュータ - komputer
しんかんせん - 新幹線
マダガスカル - Madagaskar
けがらわしい - 汚らわしい
ボランティア - wolontariat
ジェノサイド - ludobójstwo
バレーボール - siatkówka
サイクリング - kolarstwo
プロメチウム - promet
ほうほうろん - 方法論
モンテネグロ - Czarnogóra
くっこうせい - 屈光性
おんせいがく - 音声学
テクネチウム - technet
ビデオカメラ - kamera
しゅじんこう - 主人公
サルデーニャ - Sardynia
コントラバス - kontrabas
レインコート - płaszcz przeciwdeszczowy
キシリトール - ksylitol
ゲルマニウム - german
ヘリコプター - śmigłowiec, helikopter
スカンジウム - skand
しつごしょう - 失語症
イットリウム - itr
オープンカー - kabriolet
あぐらをかく - siedzieć ze skrzyżowanymi nogami, siedzieć po turecku, spocząć na laurach
チョコレート - czekolada
はいらんつう - 排卵痛
ノーベリウム - nobel
フェミニスト - feministka, feminista
ハードウェア - sprzęt
マザーボード - płyta główna
あちらこちら - tam i nazad, tam i z powrotem
プエルトリコ - Portoryko
わすれっぽい - 忘
マグネシウム - magnez
イスタンブル - Stambuł, Istambuł
はつでんしょ - 発電所
フランシウム - frans
モガディシュ - Mogadiszu
ベジタリアン - wegetarianin
てんもんがく - 天文学
ゆうきかがく - 有機化学
うんてんする - 運転する
フォーマット - format
メランコリー - melancholia
カサブランカ - Casablanca
かいはつはん - 開発版
うりかけきん - 売掛金
ウィキペディア - Wikipedia
コマンドライン - linia komend
ヴィーガニズム - weganizm
ブルキナファソ - Burkina Faso
フライドポテト - frytki
あくじゅんかん - 悪循環
そうじゅうかん - 操縦桿
りょうりばさみ - 料理鋏
げんしばんごう - 原子番号
サンスクリット - sanskryt
やっきょくほう - 薬局方
ウィークエンド - weekend, koniec tygodnia
プラークリット - prakryt
ガストロノミー - gastronomia
ホワイトボード - biała tablica (do pisania mazakiem)
ラザホージウム - rutherford
グリーンランド - Grenlandia
アルファベット - alfabet
メンデレビウム - mendelew
バングラデシュ - Bangladesz
コペンハーゲン - Kopenhaga
ウズベキスタン - Uzbekistan
しぜんさいがい - 自然災害
プラネタリウム - planetarium
フレンドシップ - przyjaźń
クラスメソッド - metoda klasy
シーボーギウム - seaborg
あつでんこうか - 圧電効果
メールアドレス - adres e-mail
しんようじょう - 信用状
きょうじゅがく - 教授学
ジスプロシウム - dysproz
インフルエンザ - grypa
アイスクリーム - lody, lichwiarz
アフガニスタン - Afganistan
ユーティリティ - utility software (program użytkowy)
パフォーマンス - wydajność
フォークランド - Falklandy
ノートパソコン - laptop
ヴィチェンツァ - Vicenza (miasto)
たいぎゃくざい - 大逆罪
アムステルダム - Amsterdam
プログラミング - programowanie
フェリーボート - prom
フォークダンス - taniec ludowy
オープンソース - Open Source, otwarte źródła
イリュージョン - iluzja
カリホルニウム - kaliforn
やくそくてがた - 約束手形
ローレンシウム - lorens
マイトネリウム - meitner
ようしえんぐみ - 養子縁組
ぶんせきかがく - 分析化学
だいとうりょう - 大統領
レントゲニウム - roentgen
スーパークラス - nadklasa
スコットランド - Szkocja
ねつこうかんき - 熱交換機
がくせいしょう - 学生証
ダッシュボード - deska rozdzielcza
サウジアラビア - Arabia Saudyjska
エルサルバドル - Salwador
しょくぶつがく - 植物学
おんきょうがく - 音響学
にんげんのせい - 人間の性
ひゃくにちぜき - 百日咳
にりつはいはん - 二律背反
エアターミナル - terminal lotniczy
どくさいせいじ - 独裁政治
アコーディオン - akordeon
モントリオール - Montreal
はっけっきゅう - 白血球
マルチスレッド - wielowątkowość
こんちゅうがく - 昆虫学
オーストラリア - Australia
エスカレーター - schody ruchome
ウラジオストク - Władywostok
しんしょうしゃ - 身障者
オルシュティン - Olsztyn
そつぎょうする - 卒業する
ジャーナリスト - dziennikarz
はっけつびょう - 白血病
ルクセンブルク - Luksemburg
ぜんたいしゅぎ - 全体主義
マイクロフォン - mikrofon
インターネット - internet
せいしょくせん - 生殖腺
ストロンチウム - stront
びせいぶつがく - 微生物学
アンフェタミン - amfetamina
ちほうぶんけん - 地方分権
グラフィックス - grafika
せいねんがっぴ - 生年月日
しょうこうぐん - 症候群
マーケティング - marketing
サーチエンジン - wyszukiwarka
フェスティバル - festiwal
オルタネーター - alternator
せいしんびょう - 精神病
イッテルビウム - iterb
ユーゴスラビア - Jugosławia
しんめいさいばん - 神明裁判
めいそうしんけい - 迷走神経
アメリカンサモア - Samoa Amerykańskie
リップスティック - szminka
じょうたいどうし - 状態動詞
サンフランシスコ - San Francisco
ウィクショナリー - Wikisłownik
せいろくめんたい - 正六面体
コートジボアール - Wybrzeże Kości Słoniowej
アゼルバイジャン - Azerbejdżan
メーリングリスト - lista dyskusyjna
ファーストネーム - imię
さいしょくしゅぎ - 菜食主義
ネフェルティティ - Nefertiti
おうきゅうしょち - 応急処置
ファーストクラス - pierwsza klasa
アプリケーション - aplikacja
バスケットボール - koszykówka
エチレンオキシド - tlenek etylenu
さんだんろんぽう - 三段論法
どうちゃくごほう - 撞着語法
つめたいせんそう - 冷たい戦争
きゅうきゅうしゃ - 救急車
ニューカレドニア - Nowa Kaledonia
コートジボワール - Wybrzeże Kości Słoniowej
トルクメニスタン - Turkmenistan
パトリオティズム - patriotyzm
テキストフィルタ - filtr tekstu
せいきひょうげん - 正規表現
はんじゅうりょく - 反重力
グレープフルーツ - grejpfrut
フォーマットする - sformatować dysk
どうぶつのけんり - 動物の権利
ヨーロッパイチイ - cis pospolity
ベジタリアニズム - wegetarianizm
きかんしぜんそく - 気管支喘息
にゅうがくしけん - 入学試験
ナンバープレート - tablica rejestracyjna
ニュージーランド - Nowa Zelandia
バイセクシュアル - biseksualista, biseksualny, czujący pociąg do obu płci
ナノテクノロジー - nanotechnologia
とうにょうびょう - 糖尿病
タクシーメーター - taksometr
しんきんこうそく - 心筋梗塞
ファンデーション - fluid, puder
とっきゅうでんしゃ - 特急電車
おはようございます - dzień dobry
リヒテンシュタイン - Liechtenstein
にゅうしゅつりょく - 入出力
フリーソフトウェア - Free Software, wolne oprogramowanie
おうしゅうれんごう - 欧州連合
じょうほうこうがく - 情報工学
プロトアクチニウム - protaktyn
ミネラルウォーター - woda mineralna
アインスタイニウム - einstein
モジュールメソッド - "metoda modułu" ( module method)
ファースト・フード - fast food
こうせいしんかろん - 恒星進化論
デーヴァナーガリー - dewanagari
パプアニューギニア - Papua Nowa Gwinea
きゅうこうでんしゃ - 急行電車
ハイパフォーマンス - wysoka wydajność
コスモポリタニズム - kosmopolityzm
りょこうだいりてん - 旅行代理店
とうちはんぷくほう - 倒置反復法
コジェネレーション - kogeneracja
パターンマッチング - pattern matching (dopasowywanie wzorca)
ビデオテープレコーダ - magnetowid
たねんせいしょくぶつ - 多年生植物
どうぶつこうどうがく - 動物行動学
インターネットカフェ - kafejka internetowa
トリニダード・トバゴ - Trynidad i Tobago
にんちてきふきょうわ - 認知的不協和
にんしょうだいめいし - 人称代名詞
ショックアブソーバー - amortyzator
サントメ・プリンシペ - Wyspy Świętego Tomasza i Książęca
アコースティックギター - gitara akustyczna
リファレンスマニュアル - podręcznik
ユーザインターフェース - interfejs użytkownika
さいがいきゅうじょけん - 災害救助犬
あめりかがっしゅうこく - アメリカ合衆国
すいみんじゆうこうしょう - 睡眠時遊行症
ボスニア・ヘルツェゴビナ - Bośnia i Hercegowina
アンティグア・バーブーダ - Antigua i Barbuda
オペレーティングシステム - system operacyjny
アラブしゅちょうこくれんぽう - アラブ首長国連邦
ja| 場所 - miejsce, lokalizacja, pomieszczenie
一 - jeden, 1, naj- (w, wśród), napój herbaciany firmy Coca-Cola
一つ - jeden, jeden rok
一人 - jedna osoba
一人は皆の為に、皆は一人の為に - jeden za wszystkich, wszyscy za jednego
一日 - いちにち, dzień, jeden dzień, ついたち, pierwszy dzień miesiąca
一昨年 - おととし, przedostatni rok, rok przed poprzednim
一月 - styczeń, いちげつ, jeden miesiąc
一番 - pierwszy, najlepszy, numer jeden, jedna gra, runda, numer, utwór, piosenka, para, dwie osoby, naj-
一緒 - spotkanie, towarzystwo, razem, z, jednocześnie, w tym samym czasie, na raz
七 - しち, siedem, 7
七月 - lipiec, okres siedmiu miesięcy
万 - dziesięć tysięcy, bardzo dużo, mnóstwo, wszystko
万有引力 - grawitacja
三 - trzy, 3
三月 - marzec
三段論法 - sylogizm
三角州 - delta
上 - powyżej, na górze, wyżej, góra, wierzchnia część, czubek, wierzchołek, górny, zewnętrzny, powierzchniowy
上がる - iść w górę, wspinać się, podwyższać się, rosnąć, jeść, pić
上げる - podnosić, przenosić (z dołu do góry), podwyższać (cenę, wartość, stopień), dawać, podarować, ofiarowywać
上座 - kamiza (honorowe miejsce siedzące)
上座部仏教 - buddyzm therawada/theravada
上役 - przełożony
上映 - wyświetlanie (filmu) w kinie
上着 - wierzchni ubiór, marynarka, mundur, bluza, żakiet, płaszcz
上衣 - kurtka, marynarka, żakiet, wyściółka
下 - poniżej, na dole, niżej, pod, przy, w warunkach, dół, spód, podstawa, niższa część, poddany, podporządkowany, niższy, か, drugi, zły, kiepski
下士官 - podoficer, sierżant
下水 - kanalizacja, kanały ściekowe
下着 - bielizna
下顎骨 - żuchwa
不 - nie-, zły, brzydki
不作 - kiepskie zbiory, nieurodzaj
不便 - współczucie, niewygoda, biedny, nieszczęsny, niewygodny, niepraktyczny, nieporęczny, nieodpowiedni
不健康 - niezdrowy, szkodliwy
不勉強 - nieuczący się, leniwy
不動の - nieruchomy
不動産 - nieruchomość
不十分 - niedostateczny, niewystarczający
不可欠 - konieczny, niezbędny
不可能 - niemożliwość, niemożliwy
不合格 - dyskwalifikacja, niezaliczenie
不均斉 - asymetria
不安 - niepokój, obawa, niespokojny, zaniepokojony
不安定 - niepewność, obawa, niepewny, nieokreślony, niestabilny
不完全 - niekompletność, niedoskonałość, niekompletny, niedokładny
不平 - skarga, niezadowolenie
不幸 - nieszczęście, nieszczęśliwy
不必要 - niepotrzebny
不快 - niemiły, przykry
不思議 - dziwny, cudowny, tajemniczy, niepojęty, dziwo, cud
不愍 - współczucie, biedny, nieszczęsny
不意に - nagle, niespodziewanie
不憫 - współczucie, biedny, nieszczęsny
不敏 - tępota, powolność, brak bystrości, tępy, wolno myślący, mało bystry
不明 - niejasny, niezrozumiały
不景気 - recesja, kryzys
不況 - zastój, stagnacja, recesja
不注意 - nieuwaga, nieuważny
不満 - niezadowolenie, skarga
不潔 - nieczysty, niehigieniczny
不自由 - niewygoda, brak swobody, niedostatek, niepełnosprawność
不規則 - nieregularność, nieregularny
世 - świat, społeczeństwo, życie, wiek, era
世の中 - świat, społeczeństwo, ludzie, życie, czasy, wiek, era
世代 - pokolenie, generacja
世俗 - światowość, ziemskość, doczesność, świeckość
世界 - świat, Ziemia, kula ziemska, społeczeństwo, ludzie
世界史 - historia świata
世紀 - wiek, era, stulecie
世話 - opieka, pomoc, troska, zajmowanie się
世論 - opinia publiczna
お世辞 - pochlebstwo, komplement, grzeczność
丘 - wzgórze, pagórek
両方 - oba, obie strony, oba sposoby
両親 - rodzice
中 - w, w środku, wewnątrz, wśród, między, pomiędzy, środek, Chiny, chiński
中世 - średniowiecze
中国 - Chiny, Państwo Środka
中国語 - język chiński
中立 - neutralność, bezstronność
中立国 - kraj neutralny
中耳 - ucho wewnętrzne
中華料理 - kuchnia chińska, potrawy chińskie
丸 - krąg, okrąg, kółko, perfekcja, doskonałość, zupełnie, całkowicie, okrągły, sferyczny, nadawać okrągły kształt, pocisk, kula, pigułka
主 - あるじ - głowa rodziny, mąż, władca, właściciel posesji, しゅ - władca, ぬし - władca, właściciel, duch opiekuńczy
主人公 - bohater, główna postać utworu literackiego
主役 - główna rola
ロマン主義 - romantyzm
久 - długi, długotrwały, stary, dawny
乗 - rozprowadzanie　się, wchłanianie się, wsiąść do/na, pojechać czymś, umieścić, wziąć na pokład, wsadzić kogoś na, potęga
九 - く, dziewięć
九州 - Kiusiu
九月 - wrzesień, okres dziewięciu miesięcy
乳房 - ちぶさ, piersi, biust
乳酸 - kwas mlekowy
乳首 - ちくび, sutek
乾杯 - toast
亀 - żółw
了 - koniec, zakończenie, zrozumienie
予定 - plan, program, oczekiwanie, przypuszczenie, planować, przypuszczać, oczekiwać
予習 - wcześniejsze przygotowanie się do lekcji (przeczytanie zawczasu o czym będą nadchodzące zajęcia), przygotowywać się do lekcji
予言 - przepowiednia, proroctwo, przepowiadać
予言者 - prorok
争う - kłócić się, sprzeczać się, konkurować, rywalizować
事 - rzecz, sprawa, kwestia, zdarzenie, wypadek, wydarzenie
二 - dwa, 2
二十 - dwadzieścia, 20
二律背反 - antynomia
二日酔い - kac
二月 - luty
二酸化炭素 - dwutlenek węgla
亍 - robić małe kroki
云 - い.う, mówić, powiedzieć, opisywać
五 - pięć, 5
五十音 - japoński sylabariusz
五日 - pięć dni, piąty dzień miesiąca
五月 - maj, piąty miesiąc w kalendarzu lunarnym, okres pięciu miesięcy
井 - studnia
亜 - być następnym, przybyć po, Azja, azjatycki
亜科 - podrząd, podrodzina
亜米利加 - Ameryka (kontynent), Stany Zjednoczone Ameryki
亜米利加合衆国 - Stany Zjednoczone Ameryki (USA)
亜鉛 - cynk
亡くなる - umrzeć
京 - stolica, dziesięć biliardów
京都市 - Kioto
人 - człowiek, osoba, klasyfikator do liczenia osób, przyrostek oznaczający osobę wykonującą pewien zawód, przyrostek oznaczający człowieka, np. obywatela kraju
パレスチナ人 - Palestyńczyk
フィリピン人 - Filipińczyk, Filipinka
フランス人 - Francuz, Francuzka
アラビア人 - Arab, Arabka, Arabowie
イギリス人 - Anglik, Angielka
人口 - populacja
人工妊娠中絶 - aborcja
人民 - ludzie, społeczeństwo
人相 - wygląd, fizjonomia, odczytywanie przeznaczenia człowieka z wyglądu jego twarzy
人種 - rasa
人見知り - nieśmiałość
人質 - zakładnik
人間 - osoba
人間の性 - seksualność
人魚 - syrena
今 - teraz, dziś, w tej chwili
今日 - きょう, dzisiaj, dziś, obecnie, współcześnie, dzisiejsze czasy
今日は - 今日は (こんにちは) - dzień dobry
今晩 - dziś wieczór, dzisiejszy wieczór
今晩は - dobry wieczór
仏 - budda
仏像 - wizerunek buddy
仏僧 - buddyjski kapłan
仏壇 - ołtarzyk buddyjski
仏教 - buddyzm
仏文 - literatura francuska
仏語 - język francuski
仔 - potomstwo, potomek
仔羊 - jagnię, owieczka, baranek
仕事 - praca, zawód, zajęcie, zatrudnienie
仕事日 - dzień roboczy
仕入れ先 - dostawca
他界 - 他界 (たかい) - śmierć, życie po śmierci
付記 - dopisek, adnotacja
付近 - sąsiedztwo, okolica
代 - pokolenie, cena, opłata, koszt, wiek, epoka, stulecie, świat
代謝 - metabolizm
仮説 - hipoteza
企画 - plan, projekt
伍つ - 伍つ (いつつ) - pięć (sztuk czegoś)
伍長 - kapral
休 - odpoczywać, spać, być wypoczętym, zrelaksowanym, być nieobecnym, opuszczać (lekcję), zwalniać się (ze szkoły, pracy), odpocząć, sprawić by coś wypoczęło, wypoczynek, dzień wolny
会 - spotkanie, towarzystwo, organizacja, stowarzyszenie
ユーザ会 - grupa użytkowników
会員 - członek, członkostwo
会社 - firma, korporacja
会話 - rozmówki, konwersacje
会談 - rozmowa, dyskusja, konferencja, wywiad
会議 - spotkanie, konferencja
伝説 - tradycja, legenda, folklor
伯母さん - 伯母さん (おばさん) -  ciocia, ciotka
伯父 - wujek
伯父さん - 伯父さん (おじさん) - wuj, stryj, mężczyzna w średnim wieku
位地 - miejsce, położenie, sytuacja, stanowisko
位置 - miejsce, położenie, sytuacja, stanowisko
住 - mieszkać, żyć
住所 - adres
体 - ciało, organizm, substancja, obiekt, タイ, wygląd zewnętrzny, stan, korpus, szkielet
体育 - wychowanie fizyczne, gimnastyka
何処 - 何処 (どこ)- gdzie
何方 - kto
何時 - 何時 (いつ, itsu) - kiedy? jak szybko?, 何時 (なんじ, nanji; なんどき, nandoki) - która godzina?
何時か - kiedyś, w innym czasie, innego dnia
何時も - zawsze, zwykle, nigdy (z czasownikiem w formie zaprzeczenia)
余り - pozostałości, resztki, nadwyżka
余る - pozostawać, być w nadmiarze
佛教 - buddyzm
作 - praca, produkcja, produkować, tworzyć, robić, budować
作家 - autor, pisarz, powieściopisarz, artysta
使う - używać, użytkować, używać języka, mówić w danym języku
使い先 - punkt docelowy, miejsce, gdzie ktoś jest wysyłany
使用料 - opłata za korzystanie (użytkowanie, najem)
例外 - wyjątek
依存症 - uzależnienie
アルコール依存症 - alkoholizm
価値 - wartość
便 - dogodność, wygoda, udogodnienie
便利 - wygodny, użyteczny
係 - obowiązek, kompetencje, człowiek odpowiedzialny za …
係る - oddziaływać, mieć wpływ
係わる - dotyczyć, być zaangażowanym
係争 - dyskusja, sprzeczka
係員 - członek obsługi
係属 - związek, relacja
係結び - związek, relacja
保険 - ubezpieczenie
信仰 - wyznanie, wiara religijna
信用状 - akredytywa
信頼 - zaufanie
俺 - ja
個展 - indywidualna wystawa, wystawa jednej osoby
値 - wartość, cena, być wartym, zasługiwać
倫理学 - etyka
偉 - wielki, wspaniały, sławny, być zarozumiałym, zachowywać się w sposób zarozumiały
健康 - zdrowie, stan zdrowia, zdrowy
偶像 - idol, wizerunek, statua
偽善 - hipokryzja
傘 - parasol, parasolka
催眠 - hipnoza
働 - praca
僕 - ja, sługa
僧 - mnich, kapłan
儀式 - rytuał
億 - sto milionów
儒 - konfucjanizm, wyznawca konfucjanizmu
優 - miły, uprzejmy, delikatny, przewyższać, przodować, być lepszym, wybijać się, celujący, szóstka, najlepsza ocena
元彼 - były chłopak
元気 - zdrowie, zdrowy, krzepki, rześki
兄 - starszy brat
お兄さん - starszy brat
兄弟 - bracia, rodzeństwo
リア充 - styl życia wypełniony interakcjami z innymi ludźmi (w opozycji do spędzania życia samotnie w domu przed komputerem)
先 - poprzedni, poprzedzający, były, czubek, końcówka, koniec, naprzód, dalej, przyszłość, najpierw, pierwszy, pierwszeństwo, przed, poprzedzanie, wcześniej
お先 - najbliższa przyszłość
先生 - tytuł grzecznościowy dodawany po nazwisku (zamiast końcówki -さん)
光 - światło, promień, świecić, promieniować
光合成 - fotosynteza
光学 - optyka
ご免 - ご免 (ごめん) - przepraszam
入 - い.る, wchodzić, wpływać, wstępować, wpuszczać, wkładać
入出力 - wejście-wyjście
入口 - いりぐち, wejście, brama
入り口 - いりぐち, いりくち, wejście, wjazd
入場料 - opłata za wstęp (wejście)
入学試験 - egzamin wstępny
入門 - wprowadzenie, wstęp, tutorial
全 - wszystko, całkowicie, wszyscy, każdy, cały, pełny, kompletny
全て - wszystko, całkowicie, całościowo
全体 - całość, całkowity, pełny
全体主義 - totalitaryzm
全国 - cały kraj (naród), całe państwo
全然 - wcale, w ogóle, całkowicie, zupełnie, nic a nic
全部 - wszystko, całość, ogół, wszyscy, całkowicie, ogółem
八 - osiem, 8
八月 - sierpień
八百屋 - sklep warzywny
公 - publiczny, rządowy, oficjalny
公務員 - pracownik państwowy, urzędnik, pracujący w państwowej firmie
公園 - park
公平 - sprawiedliwość, bezstronność, sprawiedliwy, słuszny, bezstronny
公立 - publiczny
六 - ろく, sześć, 6
六月 - czerwiec
共和国 - republika, rzeczpospolita, wspólnota
ドミニカ共和国 - Wspólnota Dominiki
共生 - symbioza, parageneza (minerałów), sytuacja, w której kilka osób mieszka razem
共産主義 - komunizm, kolektywizm
兵 - żołnierz, maszyna wojenna, broń, sztuka wojenna, strategia, odważny człowiek
典礼 - liturgia
内 - wewnątrz, w środku, podczas, w ciągu, własny, mój, nasz
内省 - introspekcja
内部 - wnętrze, środek
円 - jen, okrąg, koło, okrągłość, krągłość, okrągły, łagodny, spokojny
冗語 - pleonazm
冗談 - dowcip, żart, gag
写る - być fotografowanym, robić zdjęcia, dobrze wyjść (o zdjęciach)
写す - zrobić zdjęcie, sfilmować, kopiować, przepisywać, reprodukować, duplikować, imitować (o rzeczach naśladujących swoją formą, kształtem inne rzeczy)
写し - kopia, duplikat
写生 - szkic z natury
写真 - zdjęcie, fotografia
写真器 - aparat fotograficzny
写真家 - fotograf
写真屋 - fotograf, studio fotograficzne
写真帳 - album fotograficzny
写真機 - aparat fotograficzny
冠詞 - rodzajnik
冥王星 - Pluton
冬 - zima
冷たい - zimny
冷兵器 - broń biała
凰 - おう, feniks
凱 - pieśń zwycięstwa
凹 - wklęsłość, zagłębienie, zapadlina, zapaść się, stać się wklęsłym, zostać wgniecionym
出 - wychodzenie, wypływanie, pochodzenie, coś, co wychodzi, wypływa
出会う - spotkać, napotkać (przypadkiem)
出会い頭 - chwila, kiedy obie strony nagle spotykają się (zwłaszcza na rogu lub na skrzyżowaniu)
出し先 - adres
出入口 - wejście i wyjście
出口 - wyjście
函 - pudełko, pudło, włożyć, wkładać
刀 - miecz, nóż
刃 - ostrze, krawędź (miecza), miecz
分 - część, dola, procent, minuta, jedna setna, procent (jeden), bu
分子 - cząsteczka, licznik
分析化学 - chemia analityczna
切 - uprzejmość, życzliwość
切手 - znaczek pocztowy
切歯 - siekacz
切符 - bilet
切腹 - seppuku
前 - ぜん, poprzedni, wcześniejszy, przed, z przodu
前世 - poprzednie życie, poprzednie wcielenie
剣 - miecz
副 - zastępca, wice-
副大臣 - wiceminister
副社長 - wiceprezes, wicedyrektor
副詞 - przysłówek
劇場 - teatr
力 - siła, moc, umiejętność, zdolność
力学 - mechanika
功利主義 - utylitaryzm
助ける - pomagać
労働組合 - związek zawodowy
労組 - 労働組合
勃起 - erekcja
勇 - odważny, mężny, zbierać siły, zapalać się, podbudować się psychicznie, odwaga, heroizm
勇気 - odwaga, męstwo
勉強 - nauka, studiowanie
動機 - motyw, powód działania
動機づけ - motywacja
動物 - zwierzę
動物園 - zoo
動物の権利 - prawa zwierząt
動物相 - fauna
動物行動学 - etologia
動画 - ruchomy obraz, animacja
動脈 - tętnica
動詞 - czasownik
勤め先 - miejsce pracy
包 - paczka, pakunek, zawijać, owijać, pakować
包囲 - oblężenie
化 - zmiana, -izacja, przyrostek oznaczający przemianę, przekształcenie
化学 - chemia
化学者 - chemik
フッ化水素 - fluorowodór
北 - północ (kierunek)
北海道 - Hokkaido
区 - dzielnica, dystrykt, rejon
区画 - dywizja, sekcja, oddział
医 - medycyna, leczenie, lekarz, doktor
医学 - medycyna, nauki medyczne
医学部 - wydział medycyny
医師 - doktor, lekarz
医療 - terapia, leczenie, opieka medyczna
医療費 - wydatki na opiekę medyczną
医者 - doktor (medycyny), lekarz, chirurg
医者の不養生 - sytuacja, gdy ktoś komuś doradza i prawi kazania, a sam nie stosuje się do własnych rad
医院 - klinika, przychodnia, szpital
十 - dziesięć, 10
十一月 - listopad
十二 - dwanaście, 12
十二月 - grudzień
十月 - październik
千 - tysiąc, 1000
午 - siódmy znak chińskiego zodiaku (koń), południe
午后 - po południu
午後 - po południu
半 - połowa, pół
半島 - półwysep
半径 - promień, połowa średnicy
卒業 - ukończenie (szkoły, uniwersytetu, itp.), ukończyć (szkołę, uniwersytet, itp.)
協同組合 - spółdzielnia
南 - południe
単語 - słowo
博物館 - muzeum, galeria
占い - wróżenie, wróżbiarstwo
占い師 - wróżbita
占星術 - astrologia
印 - znak, dowód, marka, piętno
印刷 - druk, drukowanie
印刷所 - drukarnia
印刷機 - maszyna drukarska
印刷物 - druki
印度 - Indie
印象 - wrażenie
印象的 - sugestywny, imponujący
危ない - niebezpieczny, ryzykowny
危機 - kryzys, sytuacja kryzysowa
卵 - jajko, jajo, ikra
卵巣 - jajnik
卸 - hurt, sprzedawać hurtowo
厚い - gruby, serdeczny, przyjacielski
厚さ - grubość
厚み - grubość
厚かましい - bezczelny, zuchwały
厚情 - serdeczne nastawienie
厚意 - dobroć, życzliwość
厚生 - opieka społeczna, troska o zdrowie
厚生省 - ministerstwo opieki społecznej
厚着 - noszenie ciepłej odzieży
厚紙 - gruby papier, tektura
原 - pole, równina, tundra, preria
原始星 - protogwiazda
原子 - atom
原子番号 - liczba atomowa
原料 - surowiec, materiał, tworzywo
原油 - nierafinowana ropa naftowa
厭や - nieprzyjemny, ohydny, wstrętny, przykry, obrzydliwy
友 - kumpel, przyjaciel, towarzysz
友達 - przyjaciel, kolega, towarzysz
反教権主義 - antyklerykalizm
反映 - odzwierciedlenie, odbicie
反物質 - antymateria
反省 - skrucha, samokrytyka
反重力 - antygrawitacja
叔母さん - 叔母さん (おばさん) - ciocia, 叔母さん (おばさん) - starsza pani, pani w średnim wieku
叔父さん - 叔父さん (おじさん) - wuj, stryj, mężczyzna w średnim wieku
受付 - recepcja
受け皿 - talerzyk, spodek
受難 - pasja
受験料 - opłata egzaminacyjna
口 - usta, くち, wejście, otwór
口紅 - szminka, pomadka
古 - stary, wiekowy, dawny, antyczny, staroświecki, przestarzały, przebrzmiały, zużyć się, zniszczyć się od częstego używania, starość, wiekowość, staroświeckość
古い - stary, wiekowy, przestarzały
可愛い - śliczny, cudowny, uroczy
台 - baza, podstawa, piedestał
台所 - kuchnia
台風 - tajfun, huragan, sztorm
右 - prawy
吁 - ach!, niestety!, tak, właśnie tak, zgadza się, hej!, a!, ach tak, więc to tak, zrozumiałem
各 - かく każdy jeden
合 - miara objętości równa około 0,18 litra, oznacza pierwsze miejsce po przecinku, miara powierzchni gruntu równa około 0,33 metra kwadratowego, jedna dziesiąta część wysokości góry od jej podstawy do szczytu, koniunkcja, klasyfikator do liczenia ilości meczów sportowych, zawodów, turniejów, walk i bitew, starć zbrojnych, klasyfikator do liczenia ilości naczyń, pojemników, garnków itp. (tylko przedmiotów z pokrywką)
合図 - sygnał, znak
合図する - sygnalizować
合衆国 - Stany Zjednoczone Ameryki (USA)
同 - ten sam, taki sam
同人 - grupa literacka (koteria), ta sama osoba, osoba, o której była mowa wcześniej, klika, braterstwo, bratnia dusza, towarzysz, kolega
同情 - współczucie
名 - imię, reputacja, twarz, sławny, wielki, znany
ファイル名 - nazwa pliku
あだ名 - przydomek, przezwisko
名前 - imię, nazwisko, nazwa
名医 - znany lekarz
名詞 - rzeczownik
名誉 - honor
君主制 - monarchia
否 - odmowa, zaprzeczenie, nie-, a-, odrzucać, zaprzeczać, いな, いや, いえ, いいえ, nie!
否定 - negacja, zaprzeczenie
含む - zawierać, wliczać
吸気 - inhalacja
吸血鬼 - wampir, upiór
吹く - wiać, dmuchać
吹き出す - wydmuchać
吹き替え - dubbing
吹雪 - śnieżyca, zamieć
告げる - powiedzieć
告白 - wyznanie, spowiedź
周波数 - częstotliwość
味 - smak
味噌 - miso
和 - pokój, mir, Japonia, japoński, spokojny, delikatny, harmonijny, osłabnąć, uspokoić się, zelżeć, łagodzić, osłabiać, uspokajać
和解 - kompromis, wstawiennictwo, mediacja, porozumienie
咳嗽 - kaszel
哀 - あわ.れ, litość, współczucie, かなし.さ, smutek, ból, żal, smutny, litować się, współczuć, smucić się, opłakiwać
哀情 - 哀情 (あいじょう) - smutek
品 - produkt, dobro, jakość, elegancja, wdzięk
品質 - jakość
員 - członek (np. grupy)
哲学 - filozofia
唄 - piosenka (często z akompaniamentem samisenu), śpiewać piosenkę
唇 - warga, wargi
商業 - handel
問 - pytanie, problem
問い合わせ先 - informacja, miejsce, w którym można zasięgnąć informacji
問題 - pytanie, problem, zadanie, sprawa
喉 - gardło, głos
喉頭 - krtań
喚く - krzyczeć, wrzeszczeć
喜劇 - komedia
喧嘩 - kłótnia, sprzeczka, kłócić się, sprzeczać się
喫煙 - palenie (papierosów)
喫煙者 - palacz
喫茶店 - kawiarnia, herbaciarnia
営 - エイ　―　zawód, zatrudnienie, zajęcie, 営む　いとなむ　ー　prowadzić, toczyć, odbywać, praktykować
嗚呼 - 嗚呼 - ach!! och!!
嗟 - smucić się, ubolewać, obchodzić się
嗟乎 - ach!, och!
嗟夫 - 嗟夫 - ach!! och!!
嘘 - kłamstwo, nieprawda
噫 - czkawka, beknięcie, wybuch, czkać
噴水 - fontanna
噴火 - wybuch wulkanu, erupcja
噴火する - wybuchnąć
四 - よん, cztery, 4, cztery (sztuki), cztery lata (o wieku), czwórka
四月 - kwiecień, okres czterech miesięcy, przez cztery miesiące
四諦 - Cztery Szlachetne Prawdy
回 - raz, okazja, moment, runda, kółko, zmiana ( innings, inning), razy, obracać się, kręcić się, obiegać, robić kółko, cyrkulować, obracać, kręcić
回廊 - krużganek
回転 - obrót, obracanie się, obroty
団子 - dango
図 - rysunek, ilustracja, diagram, wykres, mapa, plan
図書館 - biblioteka
国 - państwo, kraj
国名 - nazwa kraju
国家 - państwo
国有化 - nacjonalizacja
国民 - naród
国王 - król, monarcha
国立 - narodowy, państwowy
国立公園 - park narodowy
国立劇場 - teatr narodowy
国立博物館 - Muzeum Narodowe
国立大学 - uniwersytet państwowy
国立病院 - szpital państwowy
国籍 - narodowość
国語 - język japoński, język ojczysty (narodowy, państwowy)
国語学 - filologia japońska (w Japonii)
国語辞典 - słownik języka japońskiego
国際 - międzynarodowy
園 - ogród, park, miejsce wypoczynku lub nauki
土 - ziemia, klepisko
土台 - podstawa, fundament
土星 - Saturn
土曜日 - sobota
圧 - ciśnienie, nacisk, ucisk, dominować, uciskać, tyranizować, przytłaczać
圧力 - ciśnienie
圧電効果 - piezoelektryczność
在る - być, istnieć
地 - podłoże, ziemia, grunt, obszar, terytorium
地下鉄 - metro
地図 - mapa
ブルターニュ地域圏 - Bretania
カルスト地形 - kras
地方分権 - decentralizacja
地獄 - piekło
地球 - Ziemia, kula ziemska
地理 - geografia
地界 - granica
地質学 - geologia
地階 - piwnica
地震 - trzęsienie ziemi
地面 - ziemia, grunt, podłoże
型 - forma, model, sposób wykonania - określenie używane w sztukach walki
アルツハイマー型認知症 - choroba Alzheimera
垢 - brud
堂 - świątynia, sala, hol, hala, izba przyjęć
報 - wiadomość, sprawozdanie, nagroda, むくいる informować, むくいる odpłacać, むくいる wynagradzać, むくいる rekompensować
報告書 - raport
塁 - fort, wał (obronny), mur, baseball
塚 - kopiec, mogiła
塩 - sól
塩素 - chlor
増える - wzrastać, mnożyć się
増加 - wzrost
増加する - powiększyć, pomnożyć, wzrosnąć
墺太利 - Austria
士 - samuraj, dżentelmen
声 - głos
壱 - いち, jeden, 1
売 - sprzedawać
売る - sprzedać
売掛金 - należność
変える - zmieniać, zmienić
変数 - zmienna
夏 - lato
夕 - wieczór
夕日 - zachodzące słońce
夕立 - padający wieczorem gwałtowny deszcz
夕食 - kolacja
外国 - zagranica, obcy kraj
外国人 - obcokrajowiec
外国語 - język obcy
多 - liczny, dużo, wiele
夜 - noc, wieczór
夢 - sen, marzenie
夢想家 - marzyciel, fantasta, wizjoner
大 - duży, wielki
大丈夫 - w porządku, OK
大人 - おとな, dorosły
大分 - dość, całkiem, znacznie
大勢 - tłum, dużo ludzi, powszechny trend, ogólny kierunek
大変 - straszny, strasznie trudny, bardzo, ekstremalnie
大学 - uniwersytet, szkoła wyższa, akademia
大学生 - student
大洋 - ocean
大統領 - prezydent
大脳皮質 - kora mózgu
大臣 - minister
大豆 - soja
大逆罪 - zdrada stanu
大阪 - Osaka
大阪市 - Osaka
大陸 - kontynent
ユーラシア大陸 - Eurazja
バルティカ大陸 - Bałtyka
天体物理学 - astrofizyka
天使 - anioł
天の川 - Droga Mleczna
天文学 - astronomia
天気 - pogoda
天気予報 - prognoza pogody
天王星 - Uran
太平洋 - Ocean Spokojny
太陽 - słońce
夫 - żona, współmałżonka, mąż, współmałżonek
夫人 - pani, dama, małżonka
夫婦 - małżeństwo, para małżonków
失望 - rozczarowanie, zawód, rozpacz, utrata nadziei
失礼 - nietakt, niegrzeczność, grubiaństwo, niegrzeczny, nietaktowny, grubiański, nieprzyzwoity
奇麗 - ładny, piękny, czysty
奥さん - 奥さん (おくさん) - żona, twoja żona, jego żona, zamężna kobieta, pani
女 - kobieta, dziewczyna
女の人 - kobieta, osoba płci żeńskiej
女医 - lekarka, lekarka zajmująca się położnictwem, chirurgią, akupunkturą, ignipunkturą
女の子 - dziewczyna, dziewczynka
女性 - kobieta, dziewczyna
女王 - królowa
好き - kochany, bardzo lubiany, uwielbiany
好機 - dobra okazja, pomyślna sposobność
妥協 - kompromis
妹 - いもうと młodsza siostra
妻 - żona
姉 - starsza siostra
お姉さん - starsza siostra
姉妹 - siostry
始めまして - miło mi (Pana/Panią poznać)
姐 - starsza siostra, pokojówka
姓 - nazwisko
姥 - stara kobieta
姫 - księżniczka
姶 - cichy
娃 - piękny
娘 - córka
娩 - rodzić dzieci
お婆さん - babcia, starsza kobieta
婦人科学 - ginekologia
嫁ぎ先 - rodzina męża, rodzina, w którą wżeniła się panna młoda
子 - dziecko, szczur
みにくいアヒルの子 - brzydkie kaczątko
子ども - 子ども (こども) - dziecko
子供 - dziecko
子宮 - macica
子羊 - jagnię, owieczka, baranek
子音 - spółgłoska
孔 - wgłębienie, jama, dziura, szczelina
字 - słowo, litera, znak (pisma), dzielnica, przezwisko, pseudonim
ローマ字 - alfabet łaciński, rōmaji
字画 - kreski i kropki w znaku kanji, liczba kresek i kropek w znaku kanji
存在 - egzystencja
存在論 - ontologia
季刊雑誌 - kwartalnik
季節 - pora roku
学 - nauka
学校 - szkoła
学生 - uczeń, student
学生証 - legitymacja studencka (lub dokument potwierdzający status studenta)
孵る - 孵る (かえる) - wyklucie, wykluć się
宇 - niebo, kosmos
宇宙 - kosmos
宇宙進化論 - kosmogonia
安 - tani, niedrogi
安全 - bezpieczeństwo, bezpieczny
安定 - równowaga, stabilność, stabilizacja
安定する - ustabilizować się
安定版 - wersja stabilna
安心 - ulga, ukojenie, spokój, poczucie bezpieczeństwa, osiągnięcie stanu spokoju umysłu (najwyższego skupienia) poprzez wiarę lub ascezę
安心する - uspokoić się
安楽 - spokojny
安楽死 - eutanazja
安芸 - dawna nazwa prefektury Hiroshimy
宏 - szeroki, wielki, przestronny, obszerny
官 - rząd, urząd, biurokrata, urzędnik państwowy
官尊民卑 - szanuj urzędników, gardź zwykłymi ludźmi
官庁 - agenda rządowa
定期券 - bilet okresowy
定義 - definicja
宝くじ - loteria
実 - prawda, rzeczywistość
実在 - rzeczywistość
客 - gość, odwiedzający, pasażer, klient, nabywca, kupujący
宣教師 - misjonarz
室 - pokój (w znaczeniu pomieszczenie), izba, mieszkanie, szklarnia, cieplarnia
家 - dom, dom rodzinny, rodzina, dom ( własny), ekspert, profesjonalista
家内 - żona
家屋 - dom, budynek mieszkalny
家族 - rodzina
家鴨 - kaczka
宿 - kwatera, gospoda, hotel, nocleg
密度 - gęstość
富士山 - Góra Fudżi
富貴を浮雲にたとふ - pieniądze szczęścia nie dają
寒 - zimny
寛い - 寛い (ひろい, hiroi) - tolerancyjny
寝る - spać, kłaść się spać, leżeć w łóżku (z powodu choroby), kłaść się, leżeć
寝かす - usypiać (kogoś), kłaść
寝かせる - kłaść spać
寝不足 - brak snu
寝台 - łóżko, kozetka, prycza, leżak, miejsce do spania
寝台車 - wagon sypialny
寝坊 - spanie do późna, człowiek lubiący spać do późna
寝室 - sypialnia
寝巻 - piżama, koszula nocna, bielizna nocna
寝巻き - piżama, koszula nocna, bielizna nocna
寝相 - pozycja w jakiej się śpi
寝間着 - piżama, koszula nocna, bielizna nocna
寺 - buddyjska, świątynia
対義語 - antonim
対辺 - przeciwległy bok
寿司 - sushi
寿司屋 - restauracja, sklep z sushi
射る - 射る (いる) - strzelić, strzelać
射精 - ejakulacja, wytrysk, mieć wytrysk, ejakulować
将軍 - generał
小 - małość, skromność, drobność, mały, drobny
小人 - dziecko, mała osoba, krasnal, krasnolud, pigmej, osoba ograniczona umysłowo, małostkowa, zaściankowa, przeciętna osoba, japoński tytuł opery  Alexandra Zemlinsky
小児科学 - pediatria
小切手 - czek
小山 - pagórek, górka
小母さん - pani, kobieta
小父さん - wuj, stryj, mężczyzna w średnim wieku
小羊 - jagnię, owieczka, baranek
小説 - powieść
ホラー小説 - horror
小説家 - pisarz
少年 - chłopiec
少数 - mniejszość
尻 - pośladki, pupa
尾 - ogon
居る - 居る (いる, iru; おる, oru) - być, przebywać, istnieć
居間 - duży pokój, salon
屋 - sklep, zakład usługowy, kupiec
屋根 - dach
山 - góra
山羊 - koza
ピレネー山脈 - Pireneje
山葵 - wasabi
山頂 - szczyt góry
岩 - głaz, skała, klif
岸 - plaża, brzeg
島 - wyspa
サルデーニャ島 - Sardynia
セントヘレナ島 - Wyspa Świętej Heleny
コルシカ島 - Korsyka
クレタ島 - Kreta
崇める - czcić
川 - rzeka
ヴィスワ川 - Wisła
ナイル川 - Nil
川口 - ujście rzeki
川岸 - brzeg rzeki
州 - mielizna
カタルーニャ州 - Katalonia
アラスカ州 - Alaska
イリノイ州 - Illinois
巡礼 - pielgrzymka
工 - rzemiosło, konstrukcja
工兵 - inżynier
工場 - fabryka
工学 - inżynieria
工業 - przemysł
左 - lewy
左利き - leworęczność, leworęczny
巨い - 巨い (おおきい, ookii) - wielki, duży, ogromny
巳年 - rok Węża
巽 - południowy wschód
市 - miasto, rynek, targ, jarmark, bazar
サンパウロ市 - São Paulo, Sao Paulo
ヴァチカン市国 - Watykan, Stolica Apostolska
市場経済 - gospodarka rynkowa
希望 - nadzieja, chęć, pragnienie, aspiracja, pragnąć czegoś
帰 - powrót, wracać (do domu), odsyłać, wysyłać z powrotem
帳 - księga, rejestr, kurtyna
平 - pokój, płaski, równy
平仮名 - hiragana
平和 - pokój, spokój, harmonia
年 - rok
年齢 - wiek
幸福 - szczęście, szczęśliwy
幹 - pień
幾ら - ile, jak wiele
幾つ - ile, jak wiele
広 - szeroki, rozległy, przestrzenny
広い - 広い (ひろい) - szeroki, obszerny, rozległy
広告 - reklama
庖 - kuchnia
店 - sklep
度胸 - odwaga, śmiałość
座る - siedzieć, siadać, usiąść, zajmować miejsce
座布団 - zabuton, poduszka do siedzenia
座席 - miejsce (siedzące), siedzenie, krzesło
座敷 - pokój, pomieszczenie, salon
座標 - współrzędna
庫 - magazyn, skład, elewator, arsenał, skarbiec, piwnica, loch
庭 - ogród, podwórze, dziedziniec
建てる - budować
建立 - budowanie, wznoszenie
建築 - architektura
建築家 - architekt
お弁当 - pudełko z drugim śniadaniem, lunchem
弁理 - zarząd, kierownictwo
弁護士 - adwokat
弓 - łuk
引き伸ばし機 - powiększalnik
引き起こす - spowodować, dać początek, wywołać, doprowadzić do, podnieść
弟 - młodszy brat
弱い - 弱い (よわい, yowai) - słaby, delikatny
強勢 - akcent, pomyślność, wspaniałość, nadmiar czegoś, luksus, ekstrawagancja, duży zapał, wigor, duża żywotność, pomyślny, wspaniały, luksusowy, ekstrawagancki, żywotny, bardzo, dużo, strasznie
強硬 - mocny, twardy, sztywny
形 - forma, kształt, figura
形態素 - morfem
形而上学 - metafizyka
役 - urząd, stanowisko, posada, rola, partia, funkcja, obowiązki, użytek, pożytek, pomoc, przydatność
役目 - funkcja, zadanie
役に立つ - być pożytecznym, przydatnym
役立つ - być pożytecznym, przydatnym
役者 - aktor, aktorka
彼 - tamten, tamta, tamto
彼の - tamten
彼処 - tam, genitalia
彼女 - 彼女 (かのじょ) - kochanie, dziewczyna, narzeczona
彼方 - inny, drugi, tam
待機 - stan gotowości, oczekiwanie
後 - tył, z tyłu, za, później, potem, po, reszta, pozostałość, pozostały, spóźniać się, być spóźnionym
従兄弟 - kuzyn
得る - 得る (うる, uru) - nabyć, otrzymać, zdobyć, 得る (える, eru) - dostać, zyskać, łapać
御 - お, godny, szanowny, honorowy, przezacny, rządzić, zarządzać
御兄さん - starszy brat
御免 - wybaczenie
御姉さん - 御姉さん (おねえさん) - starsza siostra
御婆さん - 御婆さん (おばあさん) - babcia, starsza kobieta
御手洗い - 御手洗い (おてあらい) - toaleta
御母さん - 御母さん (おかあさん) -  matka, mama
御父さん - 御父さん (おとうさん) -  ojciec
御爺さん - 御爺さん (おじいさん) - dziadek, obcy starszy mężczyzna
御祖母さん - 御祖母さん (おばあさん) - babcia, starsza kobieta
御祖父さん - 御祖父さん (おじいさん) - dziadek, obcy starszy mężczyzna
御腹 - brzuch
御茶 - herbata (w szczególności zielona), お茶
御菓子 - słodycze, ciastko, krakers, cukierek
御酒 - 御酒 (おさけ, osake) - alkohol, sake, wódka, likier, wino ryżowe
御金 - pieniądze
御飯 - 御飯 (ごはん) - ryż, posiłek
復活 - odrodzenie, zmartwychwstanie, odżycie, odbudowa
復活祭 - Wielkanoc
復習 - powtórzenie materiału, przerobienie
復習する - powtarzać materiał lekcji
復讐 - zemsta, odwet
復讐する - zemścić się
微生物学 - mikrobiologia
心 - duch, umysł, serce, uczucie
心理学 - psychologia
心臓 - serce (organ), mięsień sercowy
忌み - 忌み (いみ) - wstrzemięźliwość, abstynencja, tabu
忍術 - ninjutsu
忘 - zapominać, zapominalski, łatwo zapominający
忙 - zajęty, niespokojny
忙しい - 忙 - zajęty, zapracowany, zalatany, zabiegany
忽 - natychmiast, od razu, momentalnie, migiem, nagle, znienacka
怒り - gniew
思い - myśl, pomysł, idea, uczucie, miłość, wola, zmartwienie, wyobrażenie
思う - myśleć, sądzić, mniemać, przypuszczać, założyć, że…, uważać, czuć, wierzyć, uwierzyć, spodziewać się, oczekiwać, wyobrażać sobie, życzyć sobie, pragnąć, chcieć, zamierzać, planować, mieć zamiar, kochać, tęsknić za…
思わず - mimo woli, odruchowo, niezależnie od swej woli, nieświadomie, bezwiednie, instynktownie, machinalnie, spontanicznie
思いつく - wymyślić, przypomnieć sobie, wpaść na pomysł (myśl), przyjść do głowy (o myśli)
思いがけない - niespodziewany, nieoczekiwany, nieprzewidziany, przypadkowy
思い付く - wymyślić, przypomnieć sobie, wpaść na pomysł (myśl), przyjść do głowy (o myśli)
思い付き - pomysł
思い出 - wspomnienie, pamięć (o)
思い出す - wspominać, przypominać sobie, przywodzić na pamięć, pojawiać się w pamięci
思い切り - ze wszystkich sił, rezygnacja
思想 - całokształt poglądów, idea, myśl, pomysł, pogląd, ideologia
思想家 - myśliciel, umysł twórczy (o człowieku)
思い掛けない - niespodziewany, nieoczekiwany, nieprzewidziany, przypadkowy
思い掛け無い - niespodziewany, nieoczekiwany, nieprzewidziany, przypadkowy
思考 - myślenie, rozważanie, myśl, rozwaga, wzgląd
思考力 - zdolność myślenia
思い込む - być przekonanym, że…
急 - nagły, pospieszny, szybki, stromy, spieszyć się
急行電車 - pociąg pospieszny
恋 - miłość romantyczna, zakochanie
恋人 - ukochany, ukochana
恐竜 - dinozaur
恒星 - gwiazda
恒星進化論 - ewolucja gwiazd
恩赦 - amnestia
悪 - zło, wada, występek, łotr, diabeł
悪し - 悪し (あし) - zło
悪い - 悪い (わるい, warui) - zły, 悪い (にくい, nikui) - znienawidzony, wstrętny, obrzydliwy, 悪い (にくい, nikui) -  cudownie, nieźle (itp.), 悪い (にくい, nikui) - trudny
悪夢 - zły sen, koszmar nocny
悪循環 - błędne koło
悪戯 - żart, figiel, psota
悪魔 - diabeł, szatan, demon, zły duch
悲 - かな.しみ, smutek, ból, żal, smucić się, opłakiwać, smutny
ギリシア悲劇 - tragedia
情報 - informacje, wiadomości
情報工学 - informatyka
情夫 - kochanek
惑星 - planeta
想い - 想い (おもい) - myśl, serce, uczucie, emocje, sentyment, miłość, pożądanie, nadzieja, wyobraźnia, doświadczenie
愉しい - 愉しい (たのしい, tanoshii) - fajny, zabawny
意 - myśl, uwaga, wola, idea, serce
意味 - znaczenie
意味する - znaczyć (mieć znaczenie)
意思 - intencja, myśl, cel
意見 - opinia, zdanie, pogląd, punkt widzenia
意識 - świadomość
愛 - miłość
愛する - kochać
愛嬢 - czyjaś ukochana córka
愛孃 - czyjaś ukochana córka
愛情 - miłość
愛撫 - pieszczota
愛撫する - 愛撫
感 - wrażenie, uczucie, odczucie, かん.じる, czuć, odczuwać, doświadczać
慰藉 - 慰藉 (いしゃ) - pociecha, pocieszenie
慰謝 - pociecha, pocieszenie
憎い - 憎い (にくい, nikui) - znienawidzony, wstrętny, obrzydliwy, 憎い (にくい, nikui) -  cudownie, nieźle (itp)
憎悪 - nienawiść
憐愍 - współczucie
憲法 - konstytucja
憶える - 憶える (おぼえる) - pamiętać, przypomnieć
戌 - jedenasty znak w chińskim zodiaku, wrzesień, godziny od 19:00 - 21:00, zachód - północny zachód
成人映画 - film dla dorosłych
成虫 - imago
我々 - my
或 - pewny, jakiś
或る - pewny, jakiś
戦争 - wojna
戦争映画 - film wojenny
戸 - drzwi
房 - kiść, pęczek, frędzel
所 - miejsce, lokalizacja
扁桃炎 - angina
手 - ręka, dłoń, wskazuje wykonawcę czynności
お手洗い - toaleta
手相 - wróżenie z dłoni
手紙 - list
手術 - operacja
手語 - język migowy
扱 - traktowanie, maniery, traktować, zajmować się, こ.く, młócić, plewić, surowo ćwiczyć, musztrować
批准 - ratyfikacja
承認 - akceptacja, uznanie, potwierdzenie
技術者 - inżynier
抜け - idiota, nieuk, głupek, jełop, zakuty łeb
抵当権 - hipoteka
押す - pchać, odcisnąć, stawiać pieczątkę
押さえる - przyciskać, tłumić, powstrzymywać, łapać, trzymać
押付ける - wciskać, wpychać, łączyć przy użyciu siły, zmusić kogoś do zrobienia czegoś
押し入る - wtargnąć, włamać się do czyjegoś domu, wepchnąć z użyciem siły
押入れ - szafka ścienna, schowek, skrytka
押印 - przykładanie pieczęci
押込む - wepchnąć coś do czegoś, wtargnąć
拍子 - metrum
拭く - wycierać
指 - palec
オブジェクト指向 - "orientacja obiektowa" ( object-orientation)
指恋 - romans, który zapoczątkowała wymiana SMSów
挙げる - podnosić, dawać, przedstawiać (przykłady), odprawiać (ceremonię)
挨拶 - pozdrowienie
振り仮名 - zapis wymowy, znaki hiragana pisane nad znakami kanji, a w przypadku tekstów dla dzieci także nad znakami katakana
振幅 - amplituda
振り返る - odwrócić się, spojrzeć w tył
捕虜 - jeniec, więzień wojenny
授業料 - czesne
排卵 - owulacja, jajeczkowanie
排卵痛 - ból owulacyjny
掛かる - 掛かる (かかる) - zawiesić, 掛かる (かかる) - wziąć, zająć, kosztować, 掛かる (かかる) - nałożyć, 掛かる (かかる) - zależeć od, 掛かる (かかる) - zacząć działać, 掛かる - konsultować (z doktorem) (医者に)
接尾辞 - sufiks, przyrostek
推す - 推す (おす) - dedukować, wyciągać wnioski, wnioskować, wspierać
推論 - rozumowanie
措く - 措く (おく) - poddać się
描写 - opis
揚げる - 揚げる (あげる) - podciągnąć, udźwignąć, smażyć
揚げ物 - jedzenie smażone na głębokim tłuszczu
換える - 換える (かえる) - zmienić, zamienić, przestawić
握手 - uścisk
握手する - uścisnąć
携帯電話 - telefon komórkowy
撞着語法 - oksymoron
擬人化 - personifikacja
改める - zmienić, poprawić, ulepszyć, nowelizować
政府 - rząd
政権 - reżim
政治 - polityka
政治学 - politologia
救急車 - karetka
敗れる - przegrać, być pokonanym
ヒンドゥー教 - hinduizm
イスラム教 - islam
キリスト教 - chrześcijaństwo
ユダヤ教 - judaizm
シク教 - sikhizm
教会 - kościół
教会法 - prawo kanoniczne
教師 - nauczyciel, nauczycielka, wykładowca, wykładowczyni, pedagog
教授学 - dydaktyka
教皇 - papież
教義 - dogmat
散文 - proza
散歩 - spacer, spacerować
数 - liczba, ilość, liczyć
数える - liczyć, obliczać
数字 - cyfra, liczba, numer
数学 - matematyka
数学者 - matematyk
数詞 - liczebnik
敵 - てき, wróg, nieprzyjaciel
文 - list, pismo, literatura, tekst literacki, wypracowanie, styl, zdanie, wzór, plan, metafora, notatka
文化 - kultura
文字 - pismo
メタ文字 - znak specjalny
文字列 - łańcuch tekstowy, łańcuch znaków
文学 - literatura
文房具屋 - sklep papierniczy
文書 - dokument
文楽 - bunraku (tradycyjny, japoński teatr lalek)
文法 - gramatyka
文献学 - filologia
文芸学 - literaturoznawstwo
文部省 - Ministerstwo Edukacji
料 - opłata, należność, materiał
サービス料 - opłata za serwis (obsługę)
料理 - potrawa, danie, menu, jedzenie, gotowanie
フランス料理 - kuchnia francuska, potrawy francuskie
レバノン料理 - kuchnia libańska, potrawy libańskie
料理人 - kucharz, kucharka
斜面 - równia pochyła
新 - nowość, bycie nowym, nowy, od nowa, na nowo
新しい - nowy
新幹線 - shinkansen, japońska sieć kolejowa
新聞 - gazeta
方 - kierunek, strona, droga, część, osoba, właśnie, sposób
方向指示器 - kierunkowskaz, migacz
方法 - sposób, metoda
方法論 - metodologia
方言 - dialekt
於乎 - 於乎 - ach!! och!!
於戯 - 於戯 - ach!! och!!
旅行 - podróż
日 - じつ, dzień, słońce, Japonia, data, czas
日和見主義 - oportunizm
日曜日 - niedziela
日本 - Japonia
日本人 - Japończyk, Japończycy
日本料理 - kuchnia japońska, potrawy japońskie
日本語 - język japoński
日本語版 - japońska wersja językowa
日没 - zachód słońca
お早う - cześć, dzień dobry
早い - 早い (はやい, hayai) - wczesny, wcześnie
早起き - wczesne wstawanie z łóżka
早起きは三文の徳 - kto rano wstaje, temu Pan Bóg daje, wczesne wstawanie to zysk trzech mon
早速 - natychmiast, zaraz, niezwłocznie, od razu
昆虫学 - entomologia
明き - pokój, pustka, wolne miejsce, czas wolny
明かり - światło
明らか - jasny, oczywisty
明るい - jasny
明ける - rozjaśniać się, świtać, zaczynać się
明実理 - Amiri (japońskie imię żeńskie)
明後日 - あさって, pojutrze
明日 - あした, あす, jutro
明暗境界線 - terminator
明白 - jasny, wyraźny
易い - 易い (やすい, yasui) - łatwy
易しい - 易しい (やさしい, yasashii) - łatwy, prosty
星 - gwiazda
星座 - gwiazdozbiór, konstelacja
映る - być wyświetlanym (w kinie, w telewizji), być odbitym, odbijać się (np. w lustrze), współgrać, harmonizować (o kolorach, rzeczach), pasować do (np. krawat  do garnituru), padać (o cieniu)
映す - odbić, wyświetlić, przeglądać się (np. w lustrze), odzwierciedlać
映える - lśnić, błyszczeć (w świetle), wyglądać atrakcyjnie, ładnie, harmonizować, pasować do (np. krawat  do garnituru)
映像 - obraz, odbicie
映写 - projekcja
映画 - film, obraz filmowy
ちゃんばら映画 - film o samurajach
ニュース映画 - kronika filmowa
スリラー映画 - dreszczowiec (film)
ギャング映画 - film gangsterski
ポルノ映画 - film pornograficzny
映画俳優 - aktor filmowy
映画化 - ekranizacja, tworzenie filmu na podstawie książki
映画女優 - aktorka filmowa
映画界 - świat filmu
映画監督 - reżyser filmowy
映画祭 - festiwal filmowy
映画音楽 - muzyka filmowa
映画館 - kino
春 - wiosna, zrobić się wiosennie
昨日 - きのう, wczoraj
昼 - południe, część dnia od wschodu do zachodu
昼寝 - drzemka (w ciągu dnia), sjesta
昼御飯 - lunch, obiad
昼ご飯 - 昼ご飯 (ひるごはん) - lunch, drugie śniadanie
時 - czas
時代 - era, epoka, okres
時計 - zegar, zegarek
時間 - じかん - czas, じかん - godzina, じかん - czas lekcji w szkole
晩御飯 - kolacja
晩ご飯 - 晩ご飯 (ばんごはん) - obiad, kolacja
普及 - rozprzestrzenianie się, rozpowszechnienie się
普及する - szerzyć, propagować, rozpowszechniać
普段 - zazwyczaj
普段の - zwyczajny, zwykły
普段着 - zwykłe, codzienne ubranie
普遍的 - powszechny, ogólny, uniwersalny
景色 - widok, krajobraz
晴 - wypogadzanie, wypogadzać się
暁 - świt, Satoru
暑 - gorąc, upał, gorący, parny, duszny, narzekać na upał, cierpieć z powodu upału
暖い - ciepły, łagodny, życzliwy
暖かい - ciepły, łagodny, życzliwy
暗然 - 暗然 (あんぜん) - zniechęcony, rozczarowany, zdziwiony
暴れる - あばれる - szaleć, być w amoku
曜 - dzień tygodnia
曲線 - krzywa
更改 - nowacja
書 - pismo odręczne, dokument, pisać
ト書 - didaskalia
替える - 替える (かえる) - zmienić, zamienić, przestawić
月 - つき księżyc
月刊雑誌 - miesięcznik
月曜日 - poniedziałek
有る - być, mieć, wydarzyć się
有機化学 - chemia organiczna
有り難う - 有り難う (ありがとう) - dziękuję
有難う - 有難う (ありがとう) - dziękuję
服 - ubranie
服用する - przyjmować lekarstwo
服装 - ubranie, strój
朝 - rano, ranek, dynastia, rządy, epoka, okres, Korea (Północna)
朝寝坊 - śpioch
朝御飯 - śniadanie
朝ご飯 - 朝ご飯 (あさごはん) - śniadanie
朝鮮語 - język koreański
木 - drzewo, drewno
コーヒーの木 - kawowiec
木星 - Jowisz
木曜日 - czwartek
木版画 - drzeworyt
木苺 - malina
未来 - przyszłość, czas przyszły
未来派 - futuryzm
本 - książka, podstawa, ten, ten sam, główny, rzeczywisty, prawdziwy, klasyfikator podłużnych, cylindrycznych przedmiotów, np. butelek, długopisów, ołówków, puszek, parasoli, drzew, bananów, papierosów, jak również mieczy, filmów oraz sztuk walki
本屋 - księgarnia
本州 - Honsiu
本能 - instynkt
本音 - prawdziwa barwa dźwięku, prawdziwy zamiar, prawdziwa intencja, to, co się naprawdę myśli
札 - etykieta, karta
杏子 - morela
材 - drewno, surowy materiał
材料 - materiał, surowiec, składnik, element, czynnik, dane
材木 - drewno, budulec drewniany
村 - wieś, wioska
村落 - wioska, małe miasto
来る - くる (kuru) - wracać, przychodzić
来世 - przyszłe życie, przyszłe wcielenie
東 - wschód
東ティモール - Timor Wschodni
東京 - Tokio
東シナ海 - Morze Wschodniochińskie
林 - はやし las
林檎 - jabłko
果実食主義 - frutarianizm
果物 - owoc
架かる - 架かる (かかる) - bdować
柔軟 - elastyczny, giętki, łatwo dostosowujący się do warunków zewnętrznych
柔道 - judo
柳 - wierzba
柿 - hurma wschodnia, persymona, kaki
栄華 - chwała, splendor, majestat, przepych
栄養失調 - niedożywienie
栄養学 - dietetyka
校 - dokładne badanie czegoś, szkoła, druk, dowódca
デオキシリボ核酸 - kwas deoksyrybonukleinowy, DNA
桃色 - kolor różowy
案 - propozycja, plan, sugestia, pomysł, opinia, oczekiwanie, strach, troska
案内 - prowadzenie, oprowadzanie, informacja
案内する - prowadzić, oprowadzać
案内人 - przewodnik
案内所 - biuro informacyjne
案外 - nieoczekiwanie, wbrew oczekiwaniom, nieoczekiwany, niespodziewany, zaskakujący
桑 - drzewo morwowe
桑苺 - morwa
桜 - wiśnia, kwiat wiśni
カティンの森事件 - zbrodnia katyńska
森林 - las
椅子 - krzesło
植物 - roślina, roślinność
植物学 - botanika
植物油 - olej roślinny
植生 - roślinność
検疫 - kwarantanna
楽 - spokój, wygoda, przyjemność, łatwość, łagodny, uśmierzony, złagodzony, nie bolący, wygodny, dostatni, łatwy, prosty
楽しみ - przyjemność, uciecha, to, co cieszy, zabawa, rozrywka, hobby, zamiłowanie, radość, szczęście
楽しい - przyjemny, wesoły, rozkoszny, miły, radosny, zachwycający
楽しむ - cieszyć się, radować się, rozkoszować się, znajdować upodobanie, bogacić się
楽器 - instrument (muzyczny)
楽園 - raj
楽天主義 - optymizm
楽観 - optymizm
楽譜 - nuty
アジール権 - azyl
権利 - prawo, przywilej
権力 - władza
横溢 - obfitość, bogactwo
橋 - most
橋脚 - filar
機 - krosno, okazja, maszyna, urządzenie, samolot
機会 - okazja, szansa, sposobność
機内 - wewnątrz samolotu
機密 - tajemnica, tajne, poufne, zastrzeżone informacje
機械 - maszyna
機械油 - olej maszynowy
機構学 - mechanizm
機能 - funkcja, operacja, działanie
機関 - silnik, maszyna, instytucja, organizacja, organ
機関士 - maszynista
機関車 - lokomotywa
機関銃 - karabin maszynowy
欧 - Europa
欧亜 - Europa i Azja, Eurazja
欧印語 - języki indoeuropejskie
欧州 - Europa
欧州連合 - Unia Europejska
欧米 - Europa i Ameryka, Zachód, Okcydent
歌 - piosenka, wiersz, pieśń, śpiew, śpiewać piosenkę
歌う - śpiewać
歌唱 - śpiew
歌手 - śpiewak, wokalista, piosenkarz
歌曲 - melodia, piosenka
歌舞伎 - kabuki
正 - 10 do potęgi 40 (10⁴⁰), dodatni
正八面体 - ośmiościan
正六面体 - sześcian
正座 - seiza (tradycyjny sposób siedzenia w Japonii)
正義 - sprawiedliwość
正規表現 - 正規表現 (せいきひょうげん) - wyrażenie regularne
武士 - samuraj, wojownik
歩 - krok, pionek, klasyfikator kroków
歩く - iść, chodzić
歯 - ząb, kieł
歯医者 - dentysta
死 - śmierć, koniec, umierać
死ぬ - umrzeć
死刑 - kara śmierci
死者の日 - Zaduszki
残念 - niestety, szkoda, godne pożałowania
毅 - siła, silny
母 - mama, matka
お母さん - お母さん (おかあさん) -  matka, mama
母音 - samogłoska
毛 - włos, futro
毛布 - koc
氏名 - nazwisko, godność
民主 - demokratyczność, głowa państwa
民主主義 - demokracja
民主化 - demokratyzacja
民宿 - pensjonat, niedrogi hotel w stylu japońskim
気 - duch, stan, nastrój
ステップ気候 - półpustynia
気楽 - wyluzowany, beztroski, optymistyczny
気流 - prąd powietrza
気立て - natura, dyspozycja
気管 - tchawica
気管支喘息 - astma oskrzelowa, dychawica oskrzelowa
気象学 - meteorologia
水 - woda
水分 - wilgoć
水彩画 - akwarela (obraz), malowanie akwarelami
水星 - Merkury
水曜日 - środa
水瓜 - arbuz
水素 - wodór
水色 - kolor jasnoniebieski
水銀 - rtęć
氷雨 - grad
永い - długi
永久 - wieczność, nieskończoność, nieśmiertelność
汗 - pot
汚 - brud, zabrudzenie (fizyczne), zbrukanie, brak czystości, zabrudzić, ubrudzić, hańbić, zbezcześcić, gwałcić, zabrudzić się, ubrudzić się, tracić cnotę, tracić czystość, brudny, nieczysty, zabrudzony, plugawy, zhańbiony, splugawiony
汚い - 汚い (きたない, kitanai) - brudny, nieczysty
池 - staw, cysterna, zbiornik, basen
決定論 - determinizm
汽車 - pociąg parowy
油 - olej, tłuszcz, oliwa, smar
オリーブ油 - oliwa z oliwek
サラダ油 - olej sałatkowy
法域 - jurysdykcja
泣き喚く - 喚く
泳 - pływanie, płynąć, pływać
泳ぐ - pływać
洗う - myć, prać
洗熊 - szop pracz
津波 - tsunami
洪水 - powódź
活 - żywy, reanimacja, żywotny
活用 - koniugacja
ストア派 - stoicyzm
流罪 - banicja
浅い - płytki
浅さ - płytkość
浅ましい - niegodziwy, podły, haniebny
浅学 - powierzchowna wiedza
浅薄 - płytkość, powierzchowność, płytki, powierzchowny
浅見 - powierzchowny pogląd
浅黒い - przyciemniony, opalony
浦 - zatoka, wybrzeże, plaża
浴びる - 浴びる (あびる) - kąpać się, brać kąpiel, oblewać się, nurzać się, wygrzewać się na słońcu, brać prysznic
海 - morze, ocean
海猫 - mewa japońska
海王星 - Neptun
海老 - krewetka
海豹 - foka
海賊 - pirat
海賊船 - statek piracki
涅槃 - nirwana
消しゴム - gumka do ścierania
涙 - łza, łzy, współczucie
深さ - głębokość
深い - głęboki
深く - głęboko
深める - pogłębiać
深まる - pogłębiać się
深浅 - głębokość, odcień
清貧 - ubóstwo
渦 - wir wodny, odmęt
温かい - ciepły, łagodny, życzliwy
温厚 - delikatny, wrażliwy
温度 - temperatura
温度計 - termometr
温泉 - onsen, japońskie gorące źródło
湖 - jezioro
湿潤療法 - opatrunek
源 - źródło, pochodzenie
溢れる - przelewać się, występować z brzegów
漁業 - rybołówstwo
演劇 - teatr
漢 - sino-, Chiny, chłopak, chłop, człowiek
漢字 - kanji, znaki chińskie używane do zapisu języka japońskiego
漫画 - komiks, komiks japoński, manga, zbiór szkiców autorstwa Hokusaia, gatunek malarstwa satyrycznego, humorystycznego, nonsensownego, także obraz tego typu
漫画家 - twórca komiksów
濃い - ciemny, intensywny, mocny, gęsty, bliski, intymny
濃度 - gęstość, stężenie
火 - ひ ogień
火事 - pożar
火口 - krater wulkaniczny
火山 - wulkan
火打石 - krzemień, każdy inny kamień wykorzystywany do krzesania iskier
火星 - Mars
火曜日 - wtorek
火災 - pożar
火炎 - płomienie
火花 - iskra
灰 - prochy, kremacja
灰汁 - ług
灰皿 - popielniczka
灰色 - kolor szary
災害 - katastrofa
災害救助犬 - pies ratowniczy (さいがいきゅうじょけん), pies-ratownik
炒る - 炒る (いる) - spiec, przypiekać, prażyć, smażyć, palić, piec
炙る - smażyć, piec
炭素 - węgiel
焙る - あぶる - smażyć, piec
無声映画 - film niemy
無機化学 - chemia nieorganiczna
無神論 - ateizm
無神論者 - ateista
無菌操作 - aseptyka
無限ループ - pętla nieskończona
焼く - palić, zapalić, smażyć, piec, opiekać
焼ける - palić się, płonąć, być pieczonym (zapiekanym, opiekanym, przypiekanym), opalać się
煎る - 煎る (いる) - spiec, przypiekać, prażyć, smażyć, palić, piec
煙 - dym, dymić, być zamglonym, być mglistym, zadymiony
煙突 - komin
煙草 - tytoń
煙雨 - mżawka
煥 - brylant, błyszczący
熊 - niedźwiedź
熬る - 熬る (いる) - spiec, przypiekać, prażyć, smażyć, palić, piec
熱 - ciepło, temperatura, gorączka, entuzjazm, zapał, mania, pasja, gniew
熱い - 熱い - gorące (rzecz)
熱力学 - termodynamika
燃料 - paliwo
爆弾 - bomba
爪 - paznokieć
お父さん - おとうさん -  ojciec
父兄 - opiekunowie, ojciec i brat
父母 - rodzice, ojciec i matka
お爺さん - お爺さん (おじいさん) - dziadek, obcy starszy mężczyzna
片仮名 - katakana
版画 - odbitka, technika tworzenia odbitek
牛乳 - mleko (krowie)
物 - rzecz, obiekt
物品税 - akcyza
物色 - wyszukiwanie jednej konkretnej osoby lub rzeczy spośród wielu możliwych, kolor, kształt itp. (danej rzeczy)
物語 - opowieść, historia, baśń, narracja
物音 - dźwięk, hałas, szum
特急電車 - pociąg ekspresowy
特色 - cecha charakterystyczna, wyróżniająca
犬 - pies
犬歯 - kieł
犯罪 - przestępstwo, zbrodnia
狐 - lis
独り - sam, samotny
独占 - monopol
独特 - specyficzny, unikalny
独立 - niepodległość, niezależność
独立する - uniezależnić się, uzyskać niepodległość
独自 - oryginalny, wyjątkowy, charakterystyczny
独裁 - tyrania, dyktatura
独裁政治 - dyktatura
独り言 - mówienie do siebie
独語 - język niemiecki
独身 - wolny, nieżonaty, kawaler, wolna, niezamężna, panna
狭山市 - Sayama
狼 - wilk
猫 - kot
獲る - 獲る (とる, toru) - brać, złapać ( rybę), zrobić, 獲る (える, eru) - dostać, zyskać, łapać
玉 - biżuteria, klejnot, kula, sfera
王 - król, władca, monarcha
王位 - tron, korona, panowanie
王女 - księżniczka
王宮 - pałac królewski
王政 - królewskie rządy, monarchia
王朝 - dynastia
王水 - woda królewska
玩具 - zabawka
玩具屋 - sklep z zabawkami
現れる - pojawić się, ukazać się
現世 - to życie, to wcielenie
現象 - zjawisko, fenomen
現象学 - fenomenologia
理 - powód
理工学部 - politechnika
理解 - zrozumienie, pojmowanie, rozumienie
理論 - teoria
甘い - słodki, apetyczny, smakowity, zręczny, mądry, pomyślny, szczęśliwy, fortunny, wspaniały, genialny, obiecujący
生 - życie, istnienie, narodziny
生う - 生う (おう) - rosnąć, wyrwać (ząb)
生み - 生み (うみ) - narodziny (w sensie fizycznym), wytworzenie (czegoś)
生れる - 生れる (うまれる) - urodzić się, przyjść na świat, ukazać się, zaistnieć
生きる - żyć, istnieć
生まれる - 生まれる (うまれる) - urodzić się, przyjść na świat, ukazać się, zaistnieć
生体物質 - biocząsteczka
生い先 - przyszłość, przyszłe lata, pozostałe lata
生き写し - wierna kopia (kiedy oryginał i kopia są podobne "jak dwie krople wody")
生化学 - biochemia
生姜 - imbir
生年月日 - data urodzenia
生態学 - ekologia
生殖腺 - gonada, gruczoł płciowy
生活 - życie, istnienie, byt, sposób życia, żyć
生物 - organizm, stworzenie, istota żywa
生物地理学 - biogeografia
産み - 産み (うみ) - narodziny (w sensie fizycznym), wytworzenie (czegoś)
産業 - przemysł
産科学 - położnictwo
甥 - siostrzeniec, bratanek
用 - interes, sprawa, funkcja, służba, użytek, zaangażowanie, używać, wykorzystywać
用意 - przygotowanie, przygotowywanie (się)
用水路 - akwedukt
田舎 - wieś
男 - mężczyzna, klasyfikator do liczenia synów
男の児 - 男の児 (おとこのこ) - chłopczyk, chłopiec
男の子 - chłopczyk, chłopiec
男性 - mężczyzna, chłopak
町 - miasto
画 - え, szkic, zarys (obrazu), malowanie obrazu, film, obraz telewizyjny, zdjęcie, kreska lub punkt (w znaku kanji), kreska mająca symboliczne znaczenie we wróżbiarstwie, linia ukazująca różnicę lub podział, klasyfikator do liczenia kresek i punktów w znaku kanji, tworzy nazwy technik malarskich
画家 - malarz (artysta)
画数 - liczba kresek i kropek w znaku kanji
画架 - sztaluga
画面 - ekran, powierzchnia obrazu (namalowanego), obraz na taśmie filmowej lub wywołany na papierze fotograficznym, obraz (np. w telewizorze)
界 - królestwo
界隈 - sąsiedztwo, okolica
畏懼 - 畏懼 (いく) - cześć, trwoga, strach
番 - numer, kolej (w grach)
番号 - liczba, numer
番組 - program, audycja
スポーツ番組 - audycja sportowa
ラジオ番組 - program radiowy
テレビ番組 - program w telewizji
異体 - いたい, inne ciało, inna forma znaku chińskiego
異端 - herezja
疑似科学 - pseudonauka, kryptonauka
疼痛 - ból
ハンセン病 - trąd
ライム病 - borelioza
病気 - choroba
病院 - szpital
症 - choroba, dolegliwość
症候群 - syndrom, zespół
痛い - 痛い (いたい, itai) - bolący, bolesny, przykry
痴人 - 痴人 (ちじん) - idiota, głupek
発熱 - gorączka
発電所 - elektrownia
発音 - wymowa
白 - biel
白い - 白い (しろい) - biały, czysty (papier, prześcieradło)
白人 - człowiek białej rasy
白夜 - białe noce
白昼 - dzień, okres od świtu do zmierzchu, biały dzień, pełnia dnia, środek dnia
白状 - przyznanie się, wyznanie, spowiedź
白色 - kolor biały
白血球 - leukocyt, krwinka biała
白金 - platyna, srebro, srebrna moneta
白髪 - siwe włosy
白鳥 - łabędź
白黒 - czerń i biel, czarno-biały
百 - sto, 100
百合 - lilia
百日咳 - krztusiec
皇帝 - cesarz, 皇帝破陣楽
皮膚 - skóra
皮膚科学 - dermatologia
お皿 - お皿 (おさら) - talerz
盗む - kraść
盛り上がる - rozkręcać się, być w rozkwicie
目 - punkt, klasa, pozycja, め oko
目印 - znak, punkt orientacyjny
目玉 - gałka oczna
目立つ - być wyraźnym, widocznym, wybitnym, wyróżniać się, rzucać się w oczy, zwracać uwagę
目蓋 - powieka
目覚し時計 - budzik
直す - leczyć, naprawiać
直径 - średnica
相 - wzajemnie, razem, aspekt, faza, minister, radca
相対主義 - relatywizm
相手 - partner, przeciwna (druga) strona
相棒 - kolega
省く - opuszczać, pomijać
省みる - zastanawiać się nad własnym postępowaniem, prowadzić samoobserwację, rozmyślać, rozważać
省令 - zarządzenie ministerialne
省略 - skrót, skrócenie, opuszczenie, ograniczenie
眉毛 - brew, brwi
県 - prefektura
真 - prawda, rzeczywistość, autentyczność, uczciwy, prawidłowy, czysty, rzeczywisty, prawdziwy, szczery, aktualny, odpowiedni, taki, jaki być powinien
真上 - dokładnie ponad
真下 - dokładnie pod, sam dół
真ん中 - sam środek
真っ二つ - dwie równe części
真っ先 - sam początek
真ん前 - sam przód
真剣 - powaga, prawdziwy miecz, poważny, gorliwy, chętny, głęboko pragnący, na serio
真実 - prawda, rzeczywistość, fakt
真っ暗 - całkowita ciemność, bardzo ciemny, zupełnie ciemny, całkiem czarny
真理 - prawda
真っ白 - całkowita biel, śnieżna biel, bardzo biały, śnieżnobiały
真っ白い - bardzo biały, śnieżnobiały
真相 - prawda, realna sytuacja
真空 - próżnia
真っ赤 - purpurowy, szkarłatny, intensywnie czerwony
真っ黒 - całkiem czarny, kruczoczarny
着床 - implantacja
着物 - tradycyjny strój japoński
着色 - kolorowanie, barwienie
睡眠時遊行症 - somnambulizm
睫毛 - rzęsy
瞑想 - medytacja
瞳 - źrenica, Hitomi
瞼 - powieka
矢 - strzała
知 - wiedza, mądrość
知人 - znajomy
知り合い - znajomy, kolega, grono znajomych
知識 - wiedza
短 - wada, krótki, zwięzły
短い - krótki
石 - kamień, skała
石油 - ropa naftowa
石炭 - węgiel
石鹸 - mydło
砂 - piasek, żwir
砂場 - piaskownica
砂時計 - klepsydra
砂浜 - piaszczysta plaża
砂糖 - cukier
研究資料 - materiał badawczy
破る - podrzeć, poszarpać, zniszczyć, złamać, przerwać, nie dotrzymać, pokonać, pobić
破れる - zniszczyć się, połamać się, rozerwać się, podrzeć się
破落戸 - żul, łajdak
硝酸 - kwas azotowy
硫黄 - siarka
硬い - twardy
硬さ - twardość
硬度 - twardość
硬貨 - moneta
碧い - niebieski, zielony, niedojrzały, niedoświadczony
確率 - prawdopodobieństwo
磁石 - magnes, kamień magnetyczny
社 - firma, biuro, stowarzyszenie, chram (sintoistyczny)
社会 - społeczeństwo
社会主義 - socjalizm
社会主義思想 - myśl socjalistyczna
社会学 - socjologia
祈り - modlitwa
お祖母さん - お祖母さん (おばあさん) - babcia, starsza kobieta
お祖父さん - お祖父さん (おじいさん) - dziadek, obcy starszy mężczyzna
神 - bóg, duch, dusza, każda rzecz, zjawisko lub osoba, godna najwyższego szacunku lub budząca strach
神学 - teologia
神秘主義 - mistyka
神経 - nerw, wrażliwość, nerwy, opanowanie
神経症 - nerwica
神話 - mit, legenda
神話学 - mitologia
禀 - petycja, składać petycję
禁煙 - zakaz palenia
福祉 - dobrobyt
私立 - prywatny (niepaństwowy)
私立大学 - prywatny uniwersytet
私立学校 - szkoła prywatna
私鉄 - koleje prywatne
秋 - jesień
科 - oddział, sekcja, dział
ハス科 - lotos
科学 - nauka
科学技術 - technologia
移植 - przesianie, przeszczep
税金 - podatek
穎悟 - 穎悟 (えいご) - inteligentny, bystry, przenikliwy
穴 - dziura, otwór, zagłębienie, dołek, tyłek
空 - niebo
空き - pusty …, wolny …
空く - być pustym, być wolnym, być mniej zatłoczonym
空ける - zwolnić, zarezerwować
空きびん - pusta butelka
空き家 - pusty dom
空手 - karate ( "pusta ręka")
空気 - powietrze, atmosfera, nastrój
空港 - lotnisko
空き箱 - puste pudełko
窃盗症 - kleptomania
窒素 - azot
窓 - okno
立 - stać, wstawać
立つ - stać, wstać, powstać, podnieść się, być postawionym, być rozgniewanym (rozzłoszczonym), wyjść z siebie, odejść, odjechać, wyruszyć, być na nogach
立てる - wznieść, postawić, ustawić, stworzyć plan, ustanowić, założyć, wydać głos (dźwięk), być rozzłoszczonym, wzburzonym, nadstawiać (uszu)
立たない - nie móc się równać
立ち上がる - wstać, stanąć (na nogi), wstać (z krzesła)
立体 - bryła, ciało stałe, trójwymiarowy obiekt
立体映画 - film trójwymiarowy
立ち回り先 - miejsce pobytu (aktualne)
立場 - stanowisko, punkt widzenia, sytuacja, położenie, pozycja
立方 - sześcienny
立方メートル - metr sześcienny
立ち止まる - stanąć, zatrzymać się
竜頭蛇尾 - słomiany zapał, słomiany ogień
競技 - konkurencja
笑い - śmiech
笛 - flet
符号 - oznaczenie, symbol
第一次世界大戦 - pierwsza wojna światowa
第二次世界大戦 - druga wojna światowa
筆 - pędzel, pióro
筆入れ - piórnik, opakowanie na pędzel
筆箱 - piórnik, pudełko na pędzle, etui
筋肉 - mięsień, mięśnie
箱 - skrzynka, pudełko
篤い - 篤い - poważnie, ciepło, serdecznie
簡単 - prostota, prosty, łatwy, nieskomplikowany
米 - Ameryka, 88 lat, metr
米国 - Stany Zjednoczone, USA
米穀 - ryż
粘土 - glina
精子 - plemnik
精神病 - psychoza
糖尿病 - cukrzyca
糸 - nić, nitka
系 - system, grupa, środowisko
約束手形 - weksel
紅茶 - 紅茶 (こうちゃ) czarna herbata
紋章学 - heraldyka
紙 - papier
紙巻きタバコ - papieros
級 - poziom, klasa, pozycja
紛争 - spór, dyskusja
紛争する - spierać się
ホウ素 - bor
ヨウ素 - jod
フッ素 - fluor
ケイ素 - krzem
ヒ素 - arsen
紫 - purpura, fiolet
紫色 - kolor purpurowy
細 - drobny, wąski
紺 - granatowy
終 - koniec, zakończenie
終る - 終る (おわる) - skończyć, minąć, zamknąć
終わる - 終わる (おわる) - skończyć, minąć, zamknąć
終活 - przygotowania do zakończenia życia (planowanie własnego pogrzebu, szukanie miejsca pochówku itp.)
組 - klasa (szkolna itp.), grupa, zespół, komplet, zestaw
組む - krzyżować, splatać, zakładać (nogę na nogę), połączyć siły, tworzyć grupę
組合 - związek, związek zawodowy, stowarzyszenie
組み合わせ - dobór, zestaw
組み合わせる - łączyć, dobierać
組合員 - członek związku (zawodowego), spółdzielni
組み立てる - składać, montować, zestawiać (razem)
組織 - organizacja, system, struktura, skład, tkanka (ciała)
組み込む - włączać (w obręb czegoś)
組込む - włączać (w obręb czegoś)
経済 - ekonomia, gospodarka
結婚式 - ślub
結晶化 - krystalizacja
絵画 - malarstwo, obraz
絵筆 - pędzel
絶対 - absolutnie, bezwarunkowo, zdecydowanie
絶望 - rozpacz
継承 - następstwo, dziedziczenie
続ける - kontynuować
綺麗 - ładny, piękny, czysty
緑 - zieleń
緑色 - kolor zielony
緑茶 - zielona herbata
緒 - sznur, sznurek
線 - linia (kolejowa, telefoniczna)
編む - 編む (あむ) - szydełkować, robić na drutach, tkać, wyplatać, 編む (あむ) - opracować, 編む (あむ) - edytować, redagować
縁 - brzeg, krawędź
織物 - tkanina
罔 - sieć
置く - 置く (おく) - umieścić, położyć, postawić, zostawić
罹る - 罹る (かかる) - paść ofiarą (choroby), cierpieć
美 - piękny
美しい - piękny, śliczny
美味しい - 美味しい (おいしい) - smaczny, pyszny
美大 - Akademia Sztuk Pięknych
美学 - estetyka
美術大学 - Akademia Sztuk Pięknych
習 - uczyć się
習慣 - zwyczaj, obyczaj, przyzwyczajenie
翼 - skrzydło
老ける - starzeć się
老い先 - pozostałe lata (życia)
考える - myśleć, przemyśleć, rozważać
者 - ktoś, osoba
耳輪 - kolczyk(i)
聖歌 - hymn
聖霊 - Duch Święty
聞 - słuchać, pytać, słyszeć
聞く - słuchać
肉 - mięso, ciało
肋 - あばら żebro
肋骨 - あばらぼね - żebro, wręg
肌 - skóra
肘 - łokieć
肛門 - odbyt
肥満 - otyłość
肺 - płuco
肺気腫 - rozedma płuc
肺炎 - zapalenie płuc
胃 - brzuch, duży brzuch, wole, żołądek
背中 - plecy
背教 - apostazja (はいきょう)
背筋 - krzyż, kręgosłup
胡麻油 - olej sezamowy
胸 - pierś, biust
脂っこい - tłusty, oleisty
脚 - równia, noga, podwozie samolotu
脳 - 脳 - mózg, pamięć
腐敗 - gnicie, zepsucie
腐敗する - gnić, psuć się
腕 - ramię, zdolność, umiejętność, talent
腕時計 - zegarek na rękę
腕立て伏せ - pompka (ćwiczenie gimnastyczne)
お腹 - brzuch
腹痛 - ból brzucha
腹黒い - przebiegły, podstępny, chytry
膀胱 - pęcherz moczowy
膨らむ - puchnąć, nabrzmiewać
膿 - ropa, ropniak, zajad
臍 - pępek
自動 - rzeczy, urządzenia poruszające się bez lub z niewielkim udziałem człowieka, automatyczny
自動販売機 - urządzenia lub automat do sprzedaży
自動車 - samochód, auto, pojazd mechaniczny
自殺 - samobójstwo
自治権 - autonomia
自然 - natura
自由の女神像 - Statua Wolności
自画自賛 - wychwalanie samego siebie
自転車 - rower
臭素 - brom
臼歯 - ząb trzonowy
舌 - język
航空工学 - aeronautyka
航空郵便 - poczta lotnicza
船 - statek, łódź
船便 - poczta morska
船酔い - choroba morska
良い - dobry, świetny, odpowiedni
色 - kolor, barwa, zmysłowość, pożądanie
オレンジ色 - kolor pomarańczowy
色々 - różny, rozmaity
色彩 - kolor, barwa, zabarwienie, koloryt
色気 - seksapil, żądza, pożądanie (w stosunku do płci przeciwnej), odcień (koloru)
色紙 - kolorowy papier, kwadratowy elegancki papier kolorowy, wykorzystywany przy kaligrafii, do zapisywania poezji japońskiej, haiku itp.
色色 - różny, rozmaity
花婿 - pan młody
花屋 - kwiaciarnia
花火 - sztuczne ognie
芸術 - sztuka (działalność artystyczna)
若い - 若い (わかい, wakai)- młody
苦痛 - męczarnia, cierpienie, udręka, gorycz, rozgoryczenie
英 - uzdolniony, utalentowany, Anglia, angielski
英国 - Wielka Brytania, Zjednoczone Królestwo
英語 - język angielski
英語版 - angielska wersja językowa
苺 - truskawka
茎 - łodyga
茶 - herbata, liście herbaty
お茶 - herbata (w szczególności zielona)
茶色 - kolor jasnobrązowy, brąz, żółty
草 - trawa, chwasty, zioła, szkic, brulion.
荒い - wzburzony, niespokojny, brutalny, nieokrzesany
荒れ - sztorm, nawałnica
荷 - bagaż, ładunek, fracht
荷物 - bagaż, ładunek, obciążenie
莢 - skorupka, łupina, strąk, strączek
お菓子 - słodycze, ciastko, krakers, cukierek
菓子屋 - sklep cukierniczy, cukiernia
菜食主義 - wegetarianizm
葉酸 - kwas foliowy
葦 - trzcina, sitowie
葵 - prawoślaz ogrodowy
蒸気 - para, para wodna
蒼い - niebieski, zielony, niedojrzały, niedoświadczony
蓋 - ふた, pokrywa, powłoka, pokrywka, nakrętka, zakrętka
薄 - blady, słaby, brak, niedostatek, niedobór czegoś
薄い - cienki, słaby, wątły, lekki, blady, mały
薄さ - cienkość
薄める - rozcieńczać, robić cienkim
薄らぐ - chudnąć, blednąć
薄れる - chudnąć, blednąć
薄まる - stawać się cienkim, słabym, rzadkim, rozcieńczonym
薄情 - zimny, okrutny, bezwzględny, nieuprzejmy
薄暗い - przyćmiony, ciemnawy
薄笑い - delikatny śmiech
藁 - słoma
藍 - krzew indygo, Polygonum tinctorium, indygo, niebieski
藍色 - indygo
蘆 - trzcina, sitowie
虎 - tygrys
虫 - owad, robak, entuzjasta, wielbiciel, natura, charakter
虹 - tęcza
蛇 - wąż
蛍光 - fluorescencja
蛾 - ćma
蜂 - osa
蜂蜜 - miód
ワルシャワ蜂起 - powstanie warszawskie
蜘蛛 - pająk
蝶 - motyl
蟻 - mrówka
血 - krew
血尿 - krwiomocz
血液 - krew
血液学 - hematologia
血漿 - osocze krwi
行 - linijka (np. tekstu), wers, rząd
行く - 行く (いく, iku; ゆく, yuku) - iść, jechać
行き先 - cel podróży, ostatnia stacja
行列 - parada, procesja, macierz
行動 - zachowanie, prowadzenie, sprawowanie, kierowanie
行動主義心理学 - behawioryzm
行楽 - piknik
衣 - ubranie, garderoba
衣帯 - 衣帯 (いたい) - ubrania i obi
衣料 - ubranie
表情 - wyraz twarzy, mina
表皮 - naskórek
表着 - 表着 (うわぎ) - wierzchni ubiór, marynarka, mundur, bluza, żakiet, płaszcz
表面 - powierzchnia
袋 - torba, worek
被い - 被い (おおい) - pokrycie, pokrywa, narzuta, przesłona
被服 - odzież, ubrania
袱紗 - serwetka
複写 - kopia, przedruk, duplikat, faksymile, reprodukcja
複数 - liczba mnoga
複雑 - skomplikowany
襲う - 襲う (おそう) - atakować
西 - zachód, Hiszpania (hiszpański)
要る - 要る (いる) - potrzebować
覆い - 覆い (おおい) - pokrycie, pokrywa, narzuta, przesłona
見 - けん opinia
見る - widzieć, patrzeć, oglądać
覚える - 覚える (おぼえる) - pamiętać, przypomnieć
観覧車 - diabelski młyn
解糖系 - glikoliza
触れる - dotknąć, poruszyć, doświadczyć
言 - い.う, mówić, powiedzieć, opowiadać
言う - mówić, powiedzieć, opisać
言葉 - słowo, wyraz
言語 - język programowania lub naturalny, język oryginalny, wyjściowy wyraz
メタ言語 - metajęzyk
言語人類学 - antropolingwistyka
言語学 - lingwistyka, językoznawstwo
計 - plan, pomiar,　liczenie, rachowanie, kalkulowanie, urządzenie mierzące, suma
計画 - plan, projekt, program, zamiar
計画経済 - gospodarka planowa
計画者 - planista, projektodawca
計算機 - maszyna obliczeniowa, kalkulator, komputer
訓える - 訓える (おしえる) - uczyć, dawać lekcje informować, instruować
訓読み - japoński sposób odczytywania kanji, czytanie japońskie
記入 - zapis, wpis, włączenie, wniesienie, zapisać, wpisać, wnieść
記録映画 - film dokumentalny
証 - świadectwo, dowód, certyfikat
詞 - słowa, części mowy, poezja
試験 - egzamin, test
かん詰め - konserwa w puszce, zapuszkowany
びん詰め - przetwory w słoikach, butelkowany
話 - rozmowa, czat, konwersacja, przemowa, opowiadanie
話す - mówić, rozmawiać, konwersować, wyjaśniać, tłumaczyć, wspominać, opisywać, opowiadać, mówić w danym języku
認知的不協和 - dysonans poznawczy
認識論 - epistemologia
誓 - przysięgać, przysięga
誓い - 誓い (ちかい) - przysięga, ślubowanie
語 - jidysz
アフリカーンス語 - język afrykanerski
フィンランド語 - język fiński
アイルランド語 - język irlandzki
アイスランド語 - język islandzki
スウェーデン語 - szwedzki
リトアニア語 - litewski
ルーマニア語 - rumuński
エストニア語 - język estoński
ノルウェー語 - język norweski
リンブルフ語 - limburski
ポーランド語 - język polski
ポルトガル語 - język portugalski
スロバキア語 - język słowacki
デンマーク語 - język duński
ラトビア語 - łotewski
スペイン語 - hiszpański
ギリシア語 - język grecki
ペルシア語 - język perski
イタリア語 - język włoski
オランダ語 - język holenderski
フランス語 - język francuski
モンゴル語 - mongolski
アラビア語 - język arabski
ドイツ語 - język niemiecki
ラーオ語 - laotański
マレー語 - malajski
ロシア語 - język rosyjski
マルタ語 - maltański
ラテン語 - łacina
パーリ語 - pali
語源 - etymologia
説教 - kazanie
説明 - wyjaśnienie, objaśnienie, tłumaczenie, wyjaśniać, objaśniać, tłumaczyć
読む - czytać
論理学 - logika
マーシャル諸島 - Wyspy Marshalla
カナリア諸島 - Wyspy Kanaryjskie
諸聖人の日 - Wszystkich Świętych
謂う - być nazywanym
講壇 - ambona, katedra
謡う - 謡う (うたう) - śpiewać
謳う - 謳う (うたう) - wyrazić, wypowiadać, nalegać, żądać
識別子 - identyfikator
警官 - policjant
警察 - policja
警察官 - policjant
議会 - parlament
讐 - wróg, zemsta
谷 - dolina
豆乳 - mleko sojowe (とうにゅう)
豆腐 - tofu
豚 - świnia
象 - słoń, zjawisko
豪州 - Australia
貝 - muszla, skorupiak
負 - ujemny, przegrywać, zostać pokonanym, pokonać, dźwigać, nieść na plecach, objąć, wziąć na siebie, wziąć odpowiedzialność za coś, doznać, obciążyć kogoś czymś, zadawać
負う - 負う (おう) - zawdzięczać, być odpowiedzialnym, 負う (おう) - ponieść (szkodę), nosić na plecach
財産 - majątek, fortuna
財産家 - bogacz
財産税 - podatek od bogactwa
貧 - ubóstwo
貧しい - biedny, ubogi, nędzny
貧しさ - bieda, ubóstwo
貧乏 - bieda, biedny
貧困 - bieda, ubóstwo, niedostatek, nędza, biedny, ubogi, nędzny
貧富 - bogaci i biedni
貧弱 - biedny, mizerny, skromny, niewielka
貧民 - biedni ludzie
貧相 - biednie, ubogo wyglądający
貧血 - niedokrwistość, anemia
貴女 - ty, pani
貴方 - kochanie
買 - kupować
買う - 買う (かう) - kupić, kupować
買物 - 買物 (かいもの) - zakupy
買い物 - 買い物 (かいもの) - zakupy
賄賂 - łapówka
資料 - materiały, dokumenty, dane
資本主義 - kapitalizm
質量 - masa
赤 - czerwień, karmazyn, szkarłat
赤い - czerwony
赤らむ - czerwienić się, stawać się czerwonym, rumienić się
赤らめる - czerwienić, rumienić
赤ちゃん - niemowlę, małe dziecko
赤十字 - Czerwony Krzyż
赤十字社 - Organizacja Czerwonego Krzyża
赤ん坊 - niemowlę, małe dziecko
赤字 - deficyt
赤色 - kolor czerwony, czerwony
赤血球 - erytrocyt, krwinka czerwona, czerwone ciałko krwi
赤道 - równik
赤道ギニア - Gwinea Równikowa
走 - biec, biegać
走る - biec, podróżować, pędzić, spieszyć się
赴任する - objąć obowiązki, być delegowanym
起きる - wstawać z łóżka (po obudzeniu się), budzić się, być na nogach, nie spać, czuwać, nie kłaść się, mieć miejsce, zajść, wydarzyć się, przytrafić się
起こす - budzić (kogoś), postawić na nogi, podnieść, wywołać, spowodować, zaczynać, otwierać, inaugurować, zaprojektować, zapoczątkować, wystąpić z inicjatywą, założyć, ustanowić, zorganizować
起こる - zdarzyć się, mieć miejsce, wydarzyć się, wyniknąć, zrodzić się, przytrafić się
起床 - wstawanie z łóżka (po obudzeniu się)
起点 - punkt wyjścia, początek (w szczególności początek drogi lub linii kolejowej)
起立 - wstawanie
足 - noga, stopa, chód, sposób chodzenia, klasyfikator par obuwia
足袋 - tabi
足音 - odgłos kroków, symptom zbliżania się czegoś
跡 - ślad, odcisk
踏む - deptać, stanąć na…
踵 - pięta
車 - samochód, pojazd, wóz, klasyfikator dla pojazdów kołowych, skrót nazwy wieży w shōgi, urządzenie, którego ośrodek stanowi oś, na której coś się obraca
車庫 - garaż
軍人 - żołnierz
軟らか - miękki
軟らかい - miękki
軟弱 - słaby, miękki, sfeminizowany, skobieciały
転機 - punkt zwrotny
転生 - てんせい, transmigracja dusz, reinkarnacja
軽油 - olej lekki
辞典 - słownik
辞書 - słownik, leksykon
農協 - 農業協同組合
農村 - wieś rolnicza
農業 - rolnictwo
農業協同組合 - Stowarzyszenie Spółdzielni Rolniczych
近い - 近 - w pobliżu, niedaleko, krótki
返す - 返す (かえす) - zwrócić coś, oddać
返る - wracać, zawracać
迷走神経 - nerw błędny
追う - 追う (おう) - gonić, wypędzić, 追う (おう) - ubiegać się
送り先 - adres, miejsce docelowe
送料 - opłata za przesyłkę
通 - biegły, znawca, ekspert
通信 - komunikacja
速い - 速い (はやい, hayai) - szybki, szybko
逢う - 逢う (あう, au) -  spotkać, zobaczyć się, widzieć się
連係 - połączenie, związek
ヨーロッパ連合 - Unia Europejska
連絡 - kontakt, korespondencja, połączenie
逮捕 - areszt
週 - tydzień
週刊雑誌 - tygodnik
週間 - tydzień, okres jednego tygodnia
遅い - 遅い (おそい) - późny, spóźniony, wolny, powolny
遇う - 遇う (あう, au) - spotkać, zobaczyć się
遊ぶ - bawić się, grać, zabawiać się, nic nie robić
遊び - zabawa, luz
遊園地 - wesołe miasteczko
遊女 - kurtyzana
遊歩道 - promenada
遊牧 - nomadyzm
遊牧民 - nomadzi
運 - przeznaczenie, szczęście, los, transport, transportować, ładować, nosić
運転 - ruch, obrót (ciał niebieskich, czasu itp.), wprawianie w ruch (dużych maszyn), prowadzenie pojazdów mechanicznych
運転免許 - prawo jazdy
過去 - przeszłość
過去分詞 - imiesłów
道 - droga
道具 - narzędzie
道徳 - moralność
道徳劇 - moralitet
道路 - droga
遠 - odległy, daleki, daleko
遠い - 遠 odległy
遠近法 - perspektywa
遥 - dal, odległość, dystans
遭う - 遭う (あう, au) - spotkać, zobaczyć się, starcie
遺体 - 遺体 (いたい) - resztki, pozostałości
遺言 - testament
避雷針 - piorunochron, instalacja odgromowa
部屋 - pokój (w mieszkaniu)
郵便 - poczta, usługi pocztowe
郵便局 - poczta, urząd pocztowy
郵便配達 - roznoszenie poczty, listonosz, doręczyciel
郵政省 - Ministerstwo Poczty
郵送 - wysyłka pocztą
都市 - miasto
都市伝説 - miejska legenda
都市計画 - urbanistyka
酉 - naczynie na wino
配列 - 配列 (はいれつ) - tablica
酒 - sake, alkohol, wódka
お酒 - お酒 (おさけ, osake) - alkohol, sake, wódka, likier, wino ryżowe
酒屋 - sklep monopolowy
酵母 - drożdże
酸素 - 酸素 (さんそ) - tlen
醤油 - sos sojowy
醤蝦 - 醤蝦 - krewetka
里 - wieś, rodzinne strony (w odniesieniu do miejsca urodzenia)
重い - 重い (おもい, omoi) - ciężki, masywny, 重い (おもい, omoi) - poważny, ważny
重力子 - grawiton
重合反応 - polimeryzacja
重油 - olej ciężki
野菜 - warzywo
金 - metal, pieniądze
お金 - pieniądz, pieniądze
金属 - metal
金星 - Wenus
金曜日 - piątek
金色 - kolor złoty
鉄 - żelazo, Fe (pierwiastek), stal
鉄道 - kolej
鉛 - ołów
鉛筆 - 鉛筆 (えんぴつ) - ołówek
鉱業 - górnictwo, kopalnictwo
銀坑 - 銀坑 (ぎんこう)- kopalnia srebra, złoże, ruda metalu
銀河 - galaktyka
銀河系 - Droga Mleczna
銀色 - kolor srebrny
銀行 - 銀行 (ぎんこう) - bank
銀鉱 - 銀鉱 (ぎんこう)- kopalnia srebra, złoże, ruda metalu
鋳る - 鋳る (いる) - bić, zbić
録音 - nagrywanie (dźwięku)
鍵 - klucz, zamknięcie, zamek
鑄る - 鑄る (いる) - bić, zbić
長 - szef, długość, zaleta
長い - 長い (ながい, nagai) - długi
長子相続制 - primogenitura
長居 - 長居 (ながい, nagai) - długa wizyta, przedłużająca się wizyta
門 - drzwi, wejście, かど, brama
開く - otwierać się, być otwartym, otwierać ( konto w banku, festiwal )
開ける - otworzyć, otwierać, stać się cywilizowanym, być nowoczesnym
開発版 - wersja rozwojowa
閑 - czas wolny
間 - przestrzeń (fizyczna), odstęp (między dwiema rzeczami), przestrzeń, miejsce, pomiędzy
間奏曲 - intermezzo
関係 - związek, stosunek, relacja, powiązanie
関数 - funkcja
闇市 - czarny rynek
阿 - Afryka, podlizywać się
阿呆 - głupek, idiota, głupi
阿字 - litera A (w buddyzmie)
阿房 - 阿呆
降 - schodzić z…, wysiadać z, padać, schodzić, zmniejszać się, lać jak z cebra, padać nieustannie
限界 - limit, ograniczenie
陸軍 - armia, wojsko
陽電子 - pozyton
階段 - schody
雀蜂 - zwierzę z podrodziny szerszeniowych
雄 - samiec, męski, bohater, bohaterski
集 - zbiór, kolekcja, zebranie, spotkanie, zbierać się, gromadzić się, spotykać się, zbierać, gromadzić, zwoływać
雑誌 - czasopismo
離婚 - rozwód
難 - trudności, kłopoty
雨 - deszcz
雨水 - うすい, deszczówka, woda deszczowa
雪 - śnieg, wyprać, wypłukać
雰囲気 - atmosfera, nastrój
雲 - chmura
零 - zero, rozlewać, rozlewać się
雷 - piorun, błyskawica
電 - elektryczność, prąd
電卓 - kalkulator
電子 - elektron
電子メール - e-mail, poczta elektroniczna
電子レンジ - kuchenka mikrofalowa, mikrofalówka
電極 - elektroda
電気 - elektryczność, elektryczny, światło
電気化学 - elektrochemia
電流 - prąd elektryczny
電話 - telefon
電話帳 - książka telefoniczna
電話料 - opłata (należność) za telefon
電車 - pociąg
震 - trząść się, drżeć, drżący
霊魂 - dusza
青 - zieleń, niebieskość, błękit
青い - niebieski, zielony, blady, mizerny
青信号 - zielone światło
青白い - blady
青色 - kolor zielony, kolor niebieski, 青色の袍
静 - cichy, spokojny, ucichnąć, uspokoić się, uciszyć, uspokoić
静脈 - żyła
非常に - niezwykle, bardzo, nadzwyczaj
非常口 - wyjście bezpieczeństwa, wyjście pożarowe
面 - twarz, maska, fasada
面白 - coś interesującego, ciekawostka
面白い - zabawny, pełen uciechy, wesoły, miły, przyjemny, ciekawy, interesujący
革命 - rewolucja
靴 - くつ obuwie buty
鞍 - siodło
鞠 - piłka
韓 - koreański, Korea
韓国 - Korea Południowa
音 - おと, dźwięk, hałas
音声学 - fonetyka
音楽 - muzyka
音楽家 - おんがくか, muzyk
音楽映画 - musical (film)
音色 - barwa dźwięku, tembr
音読 - czytanie na głos, sinojapońskie odczytywanie znaku kanji
音読み - japońska wymowa kanji najbliższa chińskiej wymowie, czytanie sinojapońskie
音階 - skala
音韻論 - fonologia
音響学 - akustyka
頌歌 - oda
預言者 - prorok
頑張って - powodzenia! trzymam kciuki! daj z siebie wszystko!
頤 - szczęka, podbródek
頬 - ほほ, policzek
頭 - głowa, szef, lider, klasyfikator dużych zwierząt
頭脳 - mózg, głowa, intelekt, osoba bardzo inteligentna, lider, naczelnik, kierownik (organizacji, firmy itp.)
頭蓋骨 - czaszka
頭骨 - czaszka
頻繁 - częsty
題 - temat, sprawa, przedmiot, tytuł, nagłówek, czoło
額 - czoło, kwota pieniędzy
顎 - szczęka, podbródek
顔 - twarz, wyraz twarzy, mina, honor, dobre imię
類 - たぐ.い, rodzaj, typ
風 - wiatr, powietrze, metoda, sposób, styl, wygląd
風景 - krajobraz, sceneria
風景画 - pejzaż
風邪 - przeziębienie
飛行機 - samolot
食 - jedzenie
食べる - jeść, utrzymywać się (z czegoś)
食料 - żywność, pożywienie, prowiant, artykuły żywnościowe, aprowizacja
食べ物 - jedzenie
食用油 - olej spożywczy
飢 - głód, głodować, cierpieć głód
飯 - posiłek, gotowany ryż
ご飯 - ごはん - ryż, ごはん - posiłek
飲む - pić, palić tytoń
飲物 - napój
飲み物 - napój
飴 - cukierek, słodycze
飼 - karmić, hodować (zwierzę), trzymać (zwierzę)
飽きる - być w pełni usatysfakcjonowanym, uprzykrzyć sobie, znudzić się, stracić zainteresowanie
養子縁組 - adopcja
餡子 - anko
饗 - uczta, biesiada
首 - głowa, szef, lider, szyja
首相 - premier, prezes rady ministrów
首都 - stolica, metropolia
首長 - burmistrz
首長国連邦 - Zjednoczone Emiraty Arabskie
馬 - koń
馬鹿 - głupek, idiota, głupota, głupi
馬鹿野郎 - głupek, idiota
駅 - stacja, dworzec
騎士 - rycerz
騎士道 - rycerstwo
骨 - kość, ość, technika, zasady, trik
骨盤 - miednica
高 - ilość, liczba, suma
高い - wysoki, duży, drogi, kosztowny, głośny, podniesiony, podwyższony, wysoko postawiony
高さ - wysokość, wzrost, drożyzna, wysokie ceny
高校生 - uczeń szkoły średniej (liceum, technikum)
髪 - włos, włosy
髭 - broda, zarost, wąsy
魚 - さかな, ryba
魚屋 - sklep rybny
魚油 - tran
鯵 - ostrobok
鰺 - ostrobok
鰻 - węgorz
鳥 - ptak, kura, kurczak
鳳 - mityczny ptak (samiec)
鵜 - kormoran
鵬 - feniks
鶏 - kura
鶚 - rybołów
鶩 - kaczka
鷄 - kura, kurczak
鷓 - kuropatwa, przepiórka
鷲 - orzeł
鷹 - jastrząb, sokół
鹵 - sól
鹹 - słony
鹿 - sarna, jeleń
麒麟 - qilin
麓 - podnóże góry
麦 - pszenica, jęczmień
麦酒 - ビール, piwo
麻 - konopie, len
黄 - kolor żółty
黄色 - kolor żółty
黒 - czerń
黒い - czarny, ciemny, śniady, smagły
黒人 - Murzyn
黒字 - zysk, dochód
黒文字 - wykałaczka zrobiona z drewna
黒板 - tablica (szkolna)
黒色 - kolor czarny
黒苺 - jeżyna
鼠 - ねずみ, szczur, mysz, ciemnoszary
鼻 - nos, ryj
齢 - wiek, lata
齶 - szczęka
