abecadło - alfabet
abò - albo, czy, czyli, lub
absolwent - absolwent
abstrakcëjô - abstrakcja
achtnąc - uszanować
adnotacjô - adnotacja
Adóm - Adam
adresa - adres
Adriatik - Adriatyk
Afrika - Afryka
ãgrest - agrest
aka - motyka
akcëjô - akcja
aksamińt - aksamit
akùratno - dokładnie, akurat
akùsticzny - akustyczny
akùstika - akustyka
akùzatiw - biernik
albańsczi - albański
Albańskô - Albania
albatros - albatros
ale - ale
aléj - aleja
alfabét - alfabet
algòritm - algorytm
Alicjô - Alicja
Andorra - Andora
Andrzéj - Andrzej
ani - ani
anielsczi - angielski
ãniół - anioł
antipapiéż - antypapież
apfelzyna - pomarańcza
apfelzynowi - pomarańczowy
arabsczi - arabski
arbata - herbata
archeòlogijô - archeologia
architekta - architekt
armijô - armia, wojsko
artikel - artykuł
artikùlacjô - artykulacja, wymowa
artista - artysta
artistka - artystka
astronóma - astronom
Aùstralëjô - Australia
aùstralëjsczi - australijski
Aùstrëjackô - Austria
aùto - samochód
aùtoł - samochód
Azëjô - Azja
Azerbejdżan - Azerbejdżan
bãbòruszk - wiaderko
baczëc - uważać, baczyć
bączk - chrząszcz
badérowac - badać
bakarat - bakarat, bakarat (rodzaj szkła)
balëjô - wanna
balika - wanna
ban - pociąg, kolej
bana - pociąg, kolej
bania - dynia, duża głowa, szczególnie łysa
Banino - Banino (wieś w województwie pomorskim)
banowi - kolejarz
banowiszcze - dworzec kolejowy, stacja
barch - kołowacizna - choroba owiec, obłęd, głupota
barchniec - szaleć
barda - broda
barń - broń
barna - brona
barnic - bronić
baro - bardzo
barzda - bruzda
barzëchno - bardzo
barzëczkò - bardzo
barżilkò - bardzo
barzo - bardzo
baskijsczi - baskijski
bë - by, żeby
bëc - być
bédowac - proponować
bédowanié - propozycja
Belgijskô - Belgia
bëlno - porządnie, dobrze, pięknie, dzielnie
bëlnota - cnota, cnotliwość, dzielność
bëlny - zacny, dobry, szlachetny, doskonały, piękny
bënë - wewnątrz, do środka
bes - bez (krzew)
bestri - pstry, srokaty
bëstri - bystry, wartki, gwałtowny, nagły
Bëtowò - Bytów
bez - bez, przez
bezòsobòwi - bezosobowy
bezszëk - nonszalancja
bezzmiłkòwi - poprawny
białeczka - kobietka, żonka
białka - kobieta, białogłowa, żona
bibloteka - biblioteka
bic sã - mocować się, bić się
biéda - bieda
biédny - biedny, ubogi
bielëzna - bielizna
biôłi - biały
Biôłorëskô - Białoruś
biôłorusczi - białoruski
biôtkòwac - mocować się, bić się
bitka - bitka, bójka, ząb mleczny, kotlet bity, uderzenie, cios
biuletin - biuletyn
blësniec - szaleć
blisczi - bliski
bliza - latarnia morska
blóna - chmura
bò - bo, gdyż
bóg - bóg
bòhater - bohater
bòjec sã - bać się
bôl - bal, kloc drewna, duży, walcowaty przedmiot z drewna
bòlesc - ból
Bòlesłôw - Bolesław
Bôłt - Bałtyk, Morze Bałtyckie
bòski - boski
bòsniany - bośniacki
Bòsnijô ë Hercegòwina - Bośnia i Hercegowina
bót - but
bôt - łódź
bówka - chłopak, zawadiaka
bóżk - bożek, idol, bałwan
bracyna - brat
brat - brat
bratulka - bratanica
brëdny - brudny
brëkòwnik - użytkownik
brële - okulary
brëslëjący - wzburzony, szumiący
bridż - brydż
bridżowi - brydżowy
bridżownik - brydżysta
bróma - brama
bróna - brona
brónic - bronić
bruny - brunatny, brązowy
brzëch - brzuch
brzëchòwina - wnętrzności
brzôd - owoc
bùdink - budynek
bùjón - piwonia
bùksë - spodnie
bùlgarsczi - bułgarski
Bùlgarskô - Bułgaria
bùrméster - burmistrz
bùten - zewnątrz (na), na dwór, na dworze
bùzer - łobuz
cąc - ciąć
całi - cały
cãżczi - ciężki
cãżkò - ciężko
cëc - sutek
cëcac - ssać
cecewiô - drabina
cekawi - ciekawy
celëczëzna - cielęcina
cemnica - ciemność
cemnoczerwiony - ciemnoczerwony, pąsowy
cemnomòdri - ciemnoniebieski, granatowy
cemny - ciemny, mroczny, głupi, durny
cenczi - cienki
cepłi - ciepły
cërëlicã - cyrylica
cerkwiô - cerkiew
cerkwiowi - cerkiewny
cëskac - rzucać, ciskać
cëszkò - cichutko
chãc - chęć, zapał
chaja - snieżyca, burza morska, huragan
chëcz - dom, budynek mieszkalny, mieszkanie
chińsczi - chiński
chiże - szybko
chléb - chleb
chłop - mężczyzna, chłop, mąż
chmùra - chmura
chòc - choć
chójka - młoda sosna
chòrwacczi - chorwacki
Chòrwackô - Chorwacja
chróst - chrust
chrzept - grzbiet
chrzeptowina - polędwica
chto - kto
chùtczi - prędki, szybki, zwinny, ochoczy, wcześniej, taniec wirowy, polka
chùtkò - prędko, szybko, żwawo, ochoczo
chùtuszkò - szybko
chwôlëc - chwalić
ciéj ni môsz kraba, to dobrô i żaba - gdy nie masz kraba, to dobra i żaba
cknąc - wąchać, węszyć, czuć węchem
cłowi - celny
cłowi ùrząd - urząd celny
cnik - nos
copac - cofać
cuch - pociąg
cwëk - sens, cel
cygnąc - ciągnąć
cytrónszpëjza - rodzaj leguminy przygotowywany na Kaszubach i Kociewiu na specjalne uroczystości (komunie, wesela )
cządnik - czasopismo
czas - czas, okres
czë - czy
czëc - słyszeć, czuć
czedë - kiedy
czej - kiedy, gdy
czejbë - gdyby, jeśliby
czełkòwac - kiełkować
czemù - czemu
czerwińc - czerwiec
czerwiony - czerwony
czerwòny - czerwony
czerz - krzew
czesczi - czeski
Czeskô - Czechy
Czeskô Repùblika - Republika Czeska
czësto - czysto, zupełnie, całkiem
czëtińc - czytelnik
czij - kij, laska, czyj
człowiek - człowiek
Czôrnô Góra - Czarnogóra
czôrny - czarny, ciemny, eufemistyczna nazwa diabła
czosnik - czosnek, grzebień
czwiôrti - czwarty
czwôrtk - czwartek
daleczi - daleki
dalek - daleko
dama - tama
Damroka - Damroka
danka - choinka
darga - droga
darmôk - darmowy, gratisowy
darżëszcze - droga
datiw - celownik
dëcht - całkiem, całkowicie, zupełnie
dëdac - myśleć
dëfelka - mały drewniak, chodaczek drewniany
dëfla - drewniak, chodak drewniany
dél - deska, bal, kloc drewna, duży, walcowaty przedmiot z drewna
dënsczi - duński
Dëńskô - Dania
dërdes - rdest
dësza - duch, dusza
deszcz - deszcz
deszczomiérz - deszczomierz, pluwiometr
deszczownik - parasol
diamańt - diament
dic - dąć
dieta - dieta
dim - dym
dinamiczni - dynamiczny
dlô - dla
dłóń - dłoń
dłudżi - długi
dług - dług
długo - długo
długòta - długość
do - do (przeznaczenia), do (momentu czasu)
dobri - dobry
dobri dzéń - dzień dobry
dobri nocë - dobranoc
dobri wieczór - dobry wieczór
doch - przecież
do czësta - zupełnie, mocno
dodôwk - dodatek, załącznik
dogmat - dogmat
dojinka - nocnik
dôka - mgła
dołgòterminowi - długoterminowy
dólnica - miejsce do składowania ziemniaków, marchwi itp. znajdujące się blisko zabudowań gospodarskich
dolnosorbsczi - dolnołużycki
dóm - dom, sień
doma - w domu
domôcy - domowy, swojski, ojczysty, rodzimy
dopiérze - dopiero
dorôdca - doradca
dorsz - dorsz
dôwac - dawać
dôwôcz - celownik
drãdżi - ciężki, trudny
drãgò - ciężko, trudno
drapac - drapać
drëch - przyjaciel
drzéwiã - drzewo
drzéwò - drzewo
Dw. - celownik
dwa - dwa, 2
dze - gdzie
dzeckò - dziecko
dzéń - dzień
dzesãc - 10
dzewiãc - nazwa liczby 9
dźuma - dżuma
dżungla - dżungla
dzurkôcz - dziurkacz (biurowy), dziurkacz (biletowy)
dzys - dziś, dzisiaj
dzysô - dzisiaj
ë - i
edicjô - edycja, wydanie
edikt - edykt
Édmùnd - Edmund
egipsczi - egipski
ekwipùnk - ekwipunek
ekzemplôrz - egzemplarz
elektron - elektron
erba - dziedzictwo
erbòwac - dziedziczyć
estóńsczi - estoński
Estóńskô - Estonia
Eùropa - Europa
eùropejsczi - europejski
Eùropejskô Ùnijô - Unia Europejska
Éwa - Ewa
ewòlucjô - ewolucja
ewòlucjonizm - ewolucjonizm
ewòlucyjny - ewolucyjny
ëż - iż
fagas - łotr
familëjô - rodzina
faraón - faraon
farwa - kolor, barwa
farwarstwò - farbiarstwo - barwienie tkanin
farwny - kolorowy, barwny
farwôrz - farbiarz - nazwa zawodu
farwòwac - farbować, barwić
fëszbin - fiszbin
filharmóniô - filharmonia
film - film
filmòwac - filmować
filozófa - filozof
fińsczi - fiński
Fińskô - Finlandia
fizjologiczny - fizjologiczny
flaba - morda, brzydka gęba, pysk
flaczi - flaki, wnętrzności
fòlklor - folklor
fòntana - fontanna
fòrmùlôrz - formularz
fòtokòpiô - fotokopia
Francëjô - Francja
francësczi - francuski
Francjô - Francja
frizëjsczi - fryzyjski
fùl - pełny
fùlprawny - pełnoprawny
fùturista - futurysta
fùturisticzny - futurystyczny
fùturizm - futuryzm
gãba - usta, jama ustna, gęba
gabardina - gabardyna
gadac - mówić
galerëjã - galeria
gard - miasto
gãs - gęś
gãsti - gęsty
gazétnictwò - dziennikarstwo
gbur - gospodarz, rolnik
gbùr - rolnik, chłop
gbùrka - gospodyni, chłopka
gbùrstwò - folwark
gbùrzëna - rolnictwo
Gdiniô - Gdynia
gdińsczi - gdyński
Gduńsk - Gdańsk
Gduńskô Hôwinga - Zatoka Gdańska
gdze - gdzie
genytiw - dopełniacz
geògrafijô - geografia
głëpiec - szaleć, głupieć
głôdczi - gładki
głodni - głodny
głos - głos
głosowac - głosować
głowa - głowa
gnãbic - gnębić (ktoś), gnębić (coś)
gnãbicél - gnębiciel
gnôt - kość, gnat
gôdac - mówić
Gòdë - Boże Narodzenie, Święta, Święta Bożego Narodzenia
gòdnik - grudzień
gòłąb - gołąb
gòłąbczëna - gołębica
gòłąbk - gołąb
gòlôrz - fryzjer
gòlôrzka - fryzjerka
gôłwa - głowa
góra - góra
gòrączka - gorączka
górnosorbsczi - górnołużycki
gòsc - gość
gòscyńc - hotel, gospoda
gòscynnosc - gościnność
gòwniôrz - gówniarz, skarabeusz
grac - grać
grajny - namiętny, pożądliwy
grajny dóm - dom publiczny
gramatika - gramatyka
granatny - granatowy, ciemnoniebieski
grecczi - grecki
Greckô - Grecja
Grégór - Grzegorz
gregorijansczi - gregoriański
grëzc - gryźć
Grëzëjô - Gruzja
grëzóńsczi - gruziński
grëzypiórk - gryzipiórek
gromicznik - luty
gromisto - gromiście, bardzo
grónk - dzban
grôp - garnek
grosz - grosz
grzëmòt - grzmot
gùz - guzik
gwës - niewątpliwie, na pewno, pewny (przekonany o czymś)
gwësno - oczywiście
gwiôzda - gwiazda
habit - habit
hańdlowi - handlowy
hebrajsczi - hebrajski
hëta - huta
hëtnictwò - hutnictwo
hëtnik - hutnik, hucianin (mieszkaniec Huty)
hëtny - hutniczy
héwò - oto
hibrida - hybryda
hibridowi - hybrydowy
himn - hymn
historëjô - historia
hòlandzczi - holenderski
i - i
indonezëjsczi - indonezyjski
infòrmatika - informatyka
inżeniéra - inżynier
irlandczi - irlandzki
Irlandëjô - Irlandia
Islandëjô - Islandia
italsczi - włoski
Italskô - Włochy
jachac - jechać
jachta - polowanie
jãczm - jęczmień
jadro - sieć
jagòda - jagoda
jajco - jajko
jak - jak, jakim sposobem
Jakùb - Jakub
janiół - anioł
jantôr - bursztyn
japòńsczi - japoński
Japòńskô - Japonia
jasnomòdri - jasnoniebieski
jasnowida - jasnowidz, jasnowidzący
jasny - jasny, pogodny, bezchmurny
Jastarniô - Jastarnia
Jastrë - Wielkanoc
jãzëk - język: mięsień znajdujący się w jamie ustnej lub gębowej, pełniący funkcję narządu smaku, ułatwiający jedzenie, a u ludzi także mówienie, język: zbiór słów, reguł gramatycznych, alfabetu, zasad wymowy, umożliwiający porozumiewanie się osób znających ten zbiór
jeden - nazwa liczby 1, pewien, niejaki, jakiś
jedwôb - jedwab
jeléń - jeleń
jelenica - łania
jesc - jeść
jeséń - jesień
jesz - jeszcze
jeżlë - jeśli, jeżeli
jezoro - jezioro
jibis - ibis
jic - iść
jichtiolog - ichtiolog
jichtiologiô - ichtiologia
jic pòd wòdã - zanurzyć się
jidisz - jidysz
jigò - jarzmo
jigrzëska - igrzyska
jimieninë - imieniny
jimperium - imperium
jinstrumenta - instrument
jinstrumental - narzędnik
jinszi - inny
jiny - inny
jistnik - rzeczownik
Jizrael - Izrael
jo - tak (odpowiedź na pytanie)
jô - ja, jaźń, ego
Józk - Józek
jugò - jarzmo
Jugòsławijô - Jugosławia
kabôt - kurtka, marynarka
kadril - kadryl
kalãdôrz - kalendarz
Kaliningradzkô Òbéńda - Obwód kaliningradzki
kam - kamień
kandidat - kandydat
kąpielnica - wanna
Karolëna - Karolina
Kartuzë - Kartuzy
karwa - krowa
Kaszëba - Kaszub, Kaszuba
Kaszëbë - Kaszuby
kaszëbsczi - kaszubski
Kaszëbskô - Kaszuby
katédra - katedra
kąter - ropucha
Kirgistan - Kirgistan
kléwer - koniczyna
klin - macica
klôsztór - klasztor
knéga - książka
knéra - nos
knéżka - książka
kò - przecież, wszak, jednak
kòchac - kochać
kòl - koło, obok, przy
kòlano - kolano
kòloseùm - koloseum
kôłp - łabędź
kómbinérczi - kombinerki
kòmùnikacjowi - komunikacyjny
kòmùnizm - komunizm
kóń - koń
kònfrateriô - konfrateria
kòniczëna - koniczyna
kòntakt - kontakt
kòntinent - kontynent
kòpac - kopać
kòper - miedź
kóra - kora
kòrejańsczi - koreański
kôrmic - karmić
kòrzéń - korzeń
kòsa - kosa
Kòscan - Kościan
Kòscérzëna - Kościerzyna
Kòscérzna - Kościerzyna
kòscół - kościół
kòsztowac - kosztować
kòt - kot
kòza - koza
kòżdi - każdy
kòzer - nos
krabë to dlô nas jak żabë - krab jest dla nas jak żaba
Krësztof - Krzysztof
krëzbùla - agrest
krôj - kraj
króm - sklep, kram, oprócz
krôsniã - krasnoludek, karzełek
krótczi - krótki
krzëwi - krzywy
krzëżacczi - krzyżacki
Krzëżôk - Krzyżak
kùch - ciasto
kùla - miejsce do składowania ziemniaków, marchwi itp. znajdujące się blisko zabudowań gospodarskich
kulôk - hulajnoga
kùltura - kultura
kùm - żłób
kùna - kuna
kùńszt - sztuka
kùpic kòta w miechu - kupić kota w worku
kùrdyjsczi - kurdyjski
kùrdzel - korzeń
kùrz - kurz
kùsznąc - pocałować
kwiat - kwiat
kwietnik - kwiecień
labòratorëjô - laboratorium
łacëzna - łacina, język łaciński
łãka - zatoka
łapczëwi - łapczywy
łapczëwòsc - łapczywość
las - las
latawiskò - lotnisko
lato - lato
le - ale, tylko
lëchi - zły, lichy
łëczk - szczypior, szczypiorek
lëdztwò - ludność
lëft - powietrze
lëmic - bić, uderzać, kleić
Leòn - Leon
lëpë - warga
lëpin - łubin
lëpinc - lipiec
lës - lis
lëst - liść, list
lëstopadnik - listopad
lëteracczi - literacki
lëtewsczi - litewski
Lëtewskô - Litwa
letkò - lekko, łatwo
lewi - lewy
leżec - leżeć
łëzgówc - łuskowiec
leżnosc - możliwość
Lichtenstein - Liechtenstein
lilewi - liliowy, fioletowy
liwk - kamizelka, stanik, gorset
lód - lód
lokatiw - miejscownik
łokc - łokieć
lôtac - latać
łotewsczi - łotewski
Łotewskô - Łotwa
łóżkò - łóżko
Łukôsz - Łukasz
Luksembùrskô - Luksemburg
łżëkwiôt - kwiecień
ma - my
macedońsczi - macedoński
Macedońskô - Macedonia
madraca - materac
mądrzela - mądrala
madżarsczi - węgierski
Madżarskô - Węgry
makroskòpòwi - makroskopowy
malëna - malina
Małgòrzata - Małgorzata
malôrz - malarz
malownik - malarz
Malta - Malta
Mark - Marek
maroczec - myśleć
maszoperëjô - spółdzielnia rybacka
Mateùsz - Mateusz
Matéùsz - Mateusz
Matka Bòskô - Matka Boska
më - my
mëc - myć
medicyna - medycyna
mëga - komar
melizmat - melizmat
melizmaticzny - melizmatyczny
melizmatika - melizmatyka
mëma - matka, mama, żona
mënuta - minuta
mënutny - minutowy
mërk - znak
Mesjôsz - Mesjasz
mëslëc - myśleć
mësz - mysz
meteór - meteor
miarznąc - marznąć
miãso - mięso
Michôł - Michał
midzënôrodni - międzynarodowy
miec - mieć
miedzwiédz - niedźwiedź
mieło - miło
miemiecczëzna - niemczyzna, język niemiecki
miemiecczi - niemiecki
Miemieckô - Niemcy
miesąc - miesiąc
miesãcznik - miesięcznik
miesądz - księżyc
miono - imię, nazwisko
mita - miejsce do składowania ziemniaków, marchwi itp. znajdujące się blisko zabudowań gospodarskich.
Ml. - miejscownik
mlékò - mleko
młënôrz - młynarz
młin - młyn
młoc - mleć
młody - młody
młoleczka - wiatrak
mòdlëtwa - modlitwa
mòdri - niebieski, modry - nazwa koloru, figlarnie: o jałowym mleku (bez tłuszczu)
mòdrôk - chaber, bławat
mòdrôkòwi - chabrowy, bławatny
mòdżiła - mogiła, grób
mòdżilny - mogilny
môj - maj
mòkri - mokry
môl - miejsce
Mòłdawskô - Mołdawia
môłi - mały
môlnik - miejscownik
Mònakò - Monako
Môrcën - Marcin
mòrës - kawka
mòrze - morze
mòrzé - morze
mòst - most
mòtto - motto
mòzdrëch - musztarda
mróz - mróz
mrozëc - mrozić
mrozny - mroźny
na - na, weź, ona
nalezc - znaleźć
nałożëc - przyzwyczajać się, przywyknąć
narajic - wyswatać
narzãdzôcz - narzędnik
nawetka - nawet
nazéwôcz - mianownik
ne - one
Néderlandzkô - Holandia
ni - oni
nic - nic
nick - nic
nié - nie
niebò - niebo
niedoczinnosc - niedoczynność
niedzela - niedziela, tydzień
niemiecczi - niemiecki
nierôd - niechętnie
nieszczestlëwi - nieszczęśliwy
niezabôtka - niezapominajka
nigdë - nigdy
nigdze - nigdzie
nimò - mimo, pomimo
niszrëch - ciekawy, interesujący (o człowieku)
no - ono, to
noc - noc
nòcnik - gość nocny
nôdzeja - nadzieja
noga - stopa
nokc - paznokieć
nominatiw - mianownik
norda - północ (strona świata)
Nordowô Amerika - Ameryka Północna
Nordowô Irlandëjô - Irlandia Północna
nórt - kąt, kraniec
norwesczi - norweski
Norweskô - Norwegia
nos - nos
nôtëra - natura
nowi - nowy
nôzwëskò - nazwisko
Nrz. - narzędnik
Nz. - mianownik
òbierzka - kromka, pajda
òbjëmac - zawierać
òbôczëc - widzieć
òbszcządny - oszczędny
òbzerac - oglądać
òbzérac - oglądać
òbzerac sã - wahać się, oglądać się
òct - ocet
òddichac - oddychać
òdjimk - fotografia
òdmrozëc - odmrozić
Òdora - Odra
òdroda - odrodzenie
òdżin - ogień
ògadòwac - grodzić, ogrodzić, bronić
ògard - ogród
òglowò - ogólnie
ògniôrz - strażak
ògón - ogon
ògrôdzac - ogrodzić, bronić
òjc - ojciec
òkno - okno
òkò - oko
òkòlnik - okolicznik
òkrãgłi - okrągły
òkrãtowniô - stocznia
òkreslenié - określenie
Òlandijô - Holandia
òliwa - oliwa
òn - on
òna - ona
òne - one
òni - oni
òno - ono
òpùblikòwac - opublikować
òrzéł - orzeł
òska - osika
òsmë - nazwa liczby 8
òsoblëwò - zwłaszcza, szczególnie, przede wszystkim
òstawic - zostawić
òstri - ostry
ostrowina - archipelag
òtaksowanié - ocena, określenie
Òwczé Òstrowë - Wyspy Owcze
òwôd - owad
paczét - pakiet
pãczk - pąk
pajk - pająk
palecznik - naparstek
państwòwi - państwowy
papiéż - papież
papla - topola
paralusz - paraliż
parłãczëc - jednoczyć, kojarzyć, łączyć, wiązać, konsolidować, skupiać, jednoczyć się, łączyć się, wiązać się
parmiéń - promień
parôt - papuga
parpac - paproć
paruka - peruka
parukôrz - perukarz
pasowac - pasować
paznokc - paznokieć
pchac - pchać
pchnąc - pchnąć
pełnic - pełnić
pënka - penis
persczi - perski
perturbacjô - perturbacja
pëszny - piękny, wspaniały
pëtac - pytać, pytać się
pëtanié - pytanie
piãc - nazwa cyfry 5
piãcgwiôzdkòwi - pięciogwiazdkowy
piątk - piątek
pich - kurz
piéck - piec
piers - pierś
piérwi - pierwszy
piesniô - pieśń
Pilëce - Jastrzębia Góra
piôsk - piasek
pismiono - czasopismo, magazyn
pisôrka - pisarka
pisôrz - pisarz
piwò - piwo
planéta - planeta
płëc - płuco
plecë - plecy
plecónka - ul
płënąc - płynąć
plëta - kałuża
plëwac - pluć
płëwac - pływać
płôchta - prześcieradło
płom - płomień
płôtnosc - ważność
pluna - szmata
pò - po
pòcãgla - pociąg
pòczątkòwi - początkowy
pòd - pod
pôda - kum
pòdatk - podatek
pòdług - według, wedle, podług
pògańsczi - pogański
pògón - poganin
pòlaszëzna - polszczyzna, język polski
pôlc - palec
pôlëc - palić
pòlitikôrz - polityk
półkùgla - półkula
pôłnié - południe (strona świata), południe (pora dnia), obiad
pôłniowi - południowy
Pòlôch - Polak
pòlonistika - polonistyka
pòłożenié - położenie, lokalizacja
pòlsczi - polski
Pòlskô - Polska
półtora - półtora
pòmòrsczi - pomorski
Pòmòrskô - Pomorze
pòmùchla - dorsz bałtycki, pomuchla
pòniedzôłk - poniedziałek
pòniesc - ponieść
pònosëc - ponosić
pòpiół - popiół
pò prôwdze - naprawdę
pòrénk - poranek, wschód (strona świata)
pòrt - port
pòrtret - portret
pòrtugalsczi - portugalski
Pòrtugalskô - Portugalia
pòsélc - poseł, posłaniec
pòszczesnik - życica
pòtemu - potem
pòtkanié - spotkanie
pòtrôwnica - truskawka
pòtrus - muchomor, muchomór
prastark - pradziadek
prawi - prawy
prażnica - jajecznica, upał
priza - więzienie
prorok - prorok
prosba - prośba
prosti - prosty, równy, niewykształcony, nieobyty, zwykły, zwyczajny, pojedynczy, skromny
przë - przy, obok, podczas
przebicé - przebitka
przebòj - przebój, hit
przebòjowi - przebojowy, hitowy
przëchilnosc - uprzejmość, życzliwość
przedmiasté - przedmieście
przédnik - prezes, przewodniczący
przëdownik - przymiotnik
przedrowié - przedpole
przedzëma - przedzimie
przëłączëc - przyłączyć
przëpôdk - przypadek
przijachac - przyjechać
przińc - przyjść
psyczka - suka
pszéńca - pszenica
ptôch - ptak
ptôstwò - ptactwo
ptôszëna - ptaszyna, mięso drobiu
pùchnąc - puchnąć
pùjk - kot
pupa - lalka
pùrga - narta
pùrgôcz - narciarz
pùrgowizna - narciarstwo
pùrpùrny - purpurowy
pùrpùrowi - purpurowy
R. - dopełniacz
rabarber - rabarbar
rabarberowi - rabarbarowy
radiska - rzodkiewka
radzëzna - rada
rajic - swatać
rãka - ręka
razã - razem
rëba - ryba
rëbôk - rybak
rëcëna - rycina
rëchli - prędzej, wcześniej, raczej
rechòwac - liczyć
Réda - Reda
rëda - błoto
redakcëjô - redakcja
réga - rząd, szereg
regùlamin - regulamin
rek - rak
religijô - religia
Rëmiô - Rumia
renic - ranić
rewòlucjô - rewolucja
réżka - rządek, linijka, wers, werset
Ribno - Rybno
ricérz - rycerz
Riszard - Ryszard
riwal - rywal
robic - robić
robôk - robak
robòta - robota, praca
rôczba - zaproszenie
roda - przyroda, natura
rodzôcz - dopełniacz
róg - róg
rok - rok
romańsczi - romański
ropa - para (substancja w postaci gazowej)
roscëna - roślina
równak - ale, jednakże
róża - róża
rozdzél - rozdział
rozdzelac - rozdzielać
rozebrac - rozebrać
różewi - różowy
rozgòrzony - oburzony, rozzłoszczony
rujan - październik
rumùńsczi - rumuński
Rumùńskô - Rumunia
rusczi - rosyjski
Ruskô - Rosja
ruta - szyba
rzëc - dupa, rzyć
rzéka - rzeka
rzeszëc - rzucać
sã - się
sadac - siadać
sadło - sadło
samòrządzënowi - samorządowy
samòstójnota - niepodległość
San Marino - San Marino
sarcësto - siarczyście, bardzo
sarna - sarna
sãzabicé - samobójstwo
scana - ściana
scëskac - ściskać
scygôcz - hamulec
sëchi - suchy
sedzec - siedzieć
sekac - siekać
sëknia - suknia, ubiór
sekretno - sekretnie, bardzo
sëma - kwota
semiã - nasiono, siemię
semiónkò - nasionko
sër - ser
serbsczi - serbski
Serbskô - Serbia
Serbskô ë Czôrnô Góra - Serbia i Czarnogóra
sëri - gburowaty
sétmë - nazwa liczby 7
séwnik - wrzesień
Singapùr - Singapur
skąks - skunks
skaszëbic - przetłumaczyć na (język) kaszubski, skaszubić
sklep - piwnica znajdująca się w obrębie domu, miejsce do składowania ziemniaków, marchwi itp. znajdujące się blisko zabudowań gospodarskich
skòwrónk - modrzew, skowronek
skra - iskra
skrãcac - skręcać
skrobac - skrobać
skrzeczk - chomik
skrzëpczi - skrzypce
skrzidło - skrzydło
skwarka - skwarek, drobny mężczyzna
słabizna - pachwina
slëbnô - żona, ślubna
slëbny - mąż, ślubny
slënowi - ślinowy
slënowô gargula - ślinianka, gruczoł ślinowy
słëpsczi - słupski
Słëpsk - Słupsk
Słëpskò - Słupsk
słóń - słoń
słowacczi - słowacki
Słowackô - Słowacja
sloweńsczi - słoweński
Sloweńskô - Słowenia
słowiańsczima? Słowianizna - słowiańszczyzna
słowińsczi - słowiński
słowo - słowo
słowò - słowo
słowôrz - słownik
słuńce - słońce
Słuńce - Słońce
smaczka - specjał
smacznik - używka
smiac sã - śmiać się
smierc - śmierć
smòła - smoła
smùtan - listopad
snieg - śnieg
sniég - śnieg
snôżi - piękny, śliczny
so - się
sobòta - sobota
sodlarzczi - rymarski
sodlarztwo - rymarstwo
sodlôrz - rymarz
Sopòt - Sopot
sôrën - samiec sarny
sostra - siostra
spac - spać
sparłãczëc - połączyć
spiéwac - śpiewać
spisënk - spis
spòczëwac - spoczywać
spùscëc sã - zaufać, zdać się
Sri Lanka - Sri Lanka
srodze - srodze, bardzo, wiele, nader
srom - wstyd
Stanisłôw - Stanisław
starna - strona
stëcznik - styczeń
stolëca - stolica
stôłp - słup
stołpny - słupski
stołpsczi - słupski
Stołpsk - Słupsk
stón - stan
stôri - stary
stôrocerkwiowòsłowiańsczi - staro-cerkiewno-słowiański
strëmiannik - marzec
strojic - stroić
strumiannik - marzec
strzébny - srebrny
strzébro - srebro
strzébrzny - srebrny
strzédnowiek - średniowiecze
strzëna - trzcina
strzërzënë - ścinki
strzoda - środa
stwòrzëc - stworzyć, utworzyć
swiãto - święto
swiéca - świeca
swiéczka - świeczka
swójny - swoisty
Sybirëjô - Syberia
szari - szary
szãtopiérz - nietoperz
szchanie - koromysło
szczëka - szczupak
szczëpa - łapa, garść
szczestlëwi - szczęśliwy
szëc - szyć
szëja - szyja
Szëmón - Szymon
szemroch - osoba mówiąca szeptem
szept - szept
szeroczi - szeroki
szerok - szeroko
szérzô - szerokość
szesc - nazwa liczby 6
szinszila - szynszyla
szkólnô - nauczycielka
szkólny - nauczyciel
szlabiza - sylaba
szlach - szlak
szląsczi - śląski
Szląsk - Śląsk
Szlązôk - Ślązak
szmërgac - rzucać
sznëpa - katar
szôlec - szaleć
szorm - parasol
szpańsczi - hiszpański
Szpańskô - Hiszpania
szpiek - szynka
szpòrtówca - sportowiec
szrëca - łyżwa
sztatus - status
szterë - cztery, 4
sztërë - cztery
Sztetëno - Szczecin
sztrajk - strajk
sztudéra - student
sztudérowac - studiować
Szwajcarskô - Szwajcaria
szwédzczi - szwedzki
Szwedzkô - Szwecja
tajsczi - tajski
tãpi - tępy
tatczëzna - ojczyzna
tatk - tata
tãź - rtęć
të - ty
teatrownica - aktorka
teatrownik - aktor
telewizëjô - telewizja
tëlpa - tulipan
tenys - tenis
tenysôrz - tenisista
teoreta - teoretyk
Tëreckô - Turcja
terô - teraz
terôzkù - teraz
terôzniészi - teraźniejszy
tësąclatni - tysiącletni
tetczëzna - ojczyzna
tidzéń - tydzień (okres od poniedziałku do niedzieli), siedem dni
tiłk - pośladki, tyłek
titułowac - tytułować
tłëst - tłuszcz
tobak - tytoń
tobaka - tytoń
tôflôk - obrus
Tomôsz - Tomasz
tósz - pies
towarzëstwò - towarzystwo
towôrz - kolega
tradycëjô - tradycja
tramwaj - tramwaj
trëma - trumna
trëpa - ogon
trib - tryb
Trójgard - Trójmiasto
trôwa - trawa
trus - królik
trzë - nazwa liczby 3
trzéc - trzeć
trzëmac - trzymać
tśirožk - trójkąt
tusk - pies
tuwò - tutaj, tu
ù - u
ùchò - ucho
ùchwalënk - uchwała
ùczestnienié - gratulacja
ùderzëc - uderzać
ùjny - bujny, hojny
ùkôzac - ukazać, ukazać się
Ùkrajina - Ukraina
ùkrajińsczi - ukraiński
ulizac - ulizać
ùmierac - umierać
ùnijô - unia
ùrząd - urząd
ùrzas - strach, przestrach, przerażenie, zgroza
ùrzasnąc sã - przeląc się, przelęknąć się, przerazić się, przestraszyć się, zląc się, zlęknąć się
w - trzydziesta pierwsza litera kaszubskiego alfabetu, w, we
wa - wy
wãbórk - wiadro, żartobliwie instrument muzyczny: bęben, neosemantyzm określający samochód marki Wartburg
wanoga - podróż
warbel - wróbel
warna - wrona
warszawsczi - warszawski
wąsczi - wąski
Watikan - Watykan
wątpia - wnętrzności
wcyg - wciąż
wë - Pan, Pani, Państwo
wëbaczic - wybaczyć
wëcerac - wycierać
wëcérôcz - wycior
wëdanié - wydanie, edycja
wëdłëbnik - wykałaczka
wëdôwanié - edytorstwo
wëdôwca - wydawca
wëdôwk - edycja, wydanie
wëgódny - wygodny
wëjimk - wyjątek
wejle - oto
Wejrowò - Wejherowo
wëkôrmic - wykarmić
wëmòwa - wymowa
wëmówka - wymówka
wëmrozëc - wymrozić
wënëkanié - zesłanie
wëpłënac - wypłynąć
wëpòżëczëc - wypożyczyć
wersëjô - wersja
wësłac - wysłać
wësok - wysoko
wespółdzejanié - współdziałanie
wespółrobòta - współpraca
wësztôłcenié - wykształcenie
wëzgódka - zagadka
wiater - wiatr
wiążëna - spójnik
wid - światło, wzrok
widzec - widzieć
wiéchrzëzna - powierzchnia
wiedzec - wiedzieć
wieprz - wieprz
wieszczórka - jaszczurka
wieszczówka - jaszczurka
wietnamsczi - wietnamski
Wikipedijô - Wikipedia
wilamòwsczi - wilamowski
winowôcz - biernik
wiodro - pogoda
wiôldżi - wielki
Wiôlgô Britanijô - Wielka Brytania
witro - jutro
Wł. - wołacz
włosë - włosy
wmurowac - wmurować
Wn. - biernik
w noce są wszëtczié kòtë szaré - w nocy wszystkie koty są szare
wòda - woda
Wòjcech - Wojciech
wòjewództwò - województwo
wòjna - wojna
wòjnowi - wojenny
wòjnowi stón - stan wojenny
wòjskò - wojsko
wójt - wójt
wòkatiw - wołacz
wòłiwôcz - wołacz
wôłna - wełna
wonôtowac - wymiotować
wôżni - ważny
wrëk - karpiel, brukiew
wsebët - jaźń
wspólnik - wspólnik
wstawac - wstawać
wtórk - wtorek
wùja - wujek
ząb - ząb
żaba - żaba
zabijac - zabijać
zabùdowa - zabudowa
zachrapiałosc - chrypka
zagrozëc - zagrozić
zakòchac sã - zakochać się
zakôzac - zabronić
zamrozëc - zamrozić
zarząd - zarząd
zastôwiac sã - zastawiać, grodzić, ogrodzić, bronić
zaszifrowac - zaszyfrować
zatôrczac sã - zastawiać, grodzić, ogrodzić, bronić
zbiérk - zbiór
zdrzódło - źródło
zdżinąc - zniknąć
żebë - żeby
zëbnąc - marznąć
żëc - żyć
żëcé - życie
żëczba - życzenie
żelë - jeśli, jeżeli
zélnik - sierpień
zelony - zielony
zëma - zima
zemia - Ziemia, trzecia planeta Układu Słonecznego, kraj, kraina geograficzna, grunt
zëmny - zimny
żeniały - żonaty
zesel - fotel
żëwotnik - żywotnik, tuja
żgaga - zgaga
zgniłim miãsã òbrosłi - leniwy
zgniti - zgniły
zjôzd - zjazd
zlepszëc - doskonalić, ulepszać
złi - zły
złoti - złoty, złotówka
złoto - złoto
zmerkac - spostrzegać
znit - znicz
zóda - soda
żôłniérz - żołnierz
żôłti - żółty
zôpôd - zachód (strona świata)
żot - brzuch
zrzesz - związek
zrzeszëc - związać
zrzeszenié - zrzeszenie
żuber - żubr
Żukòwò - Żukòwò, Żukòwa
żwac - żuć
zwëk - zwyczaj
zwiérz - zwierzę, zwierz
zybówka - huśtawka
zylcowina - galantyna
zymk - wiosna
