estetika - estetyka
абайлау - uważać | być ostrożnym
абайсыздық - nieuwaga | nieostrożność
абыз - żerca | mędrzec
Австралия - Australia
автобус - autobus
аға - starszy brat | starszy krewny po mieczu | starszy po stanowisku
ағартушы - oświeciciel | krzewiciel oświaty
ағаш - drzewo | drewno
ағылшын - Anglik | angielski
адажио - adagio
адам - człowiek
адамзат - ludzkość | ludzie
ажал - śmierć | zguba
ажалсыз - nieśmiertelny
ажалсыздық - nieśmiertelność
аз - mało | niewiele
азаматтық - obywatelstwo | obywatelski
азат - wolny | swobodny | Azat
азаткер - oswobodziciel | wyzwoliciel
азаттық - wolność | swoboda
Азия - Azja
азот - azot
азшылық - mniejszość
азық-түлік - żywność
азырақ - mniej | аз
ай - miesiąc | Księżyc
Айгүл - Ajgul
айна - lustro
ақ - biały
ақбалық - białorybica
ақгүл - jaśmin
ақжелкек - chrzan
ақиқат - prawda
ақиқатшыл - zwolennik prawdy
ақкөз - klepiec | sapa
аққу - łabędź
ақпан - luty
ақпарат - informacja
ақсақал - starzec | senior | nestor
а құдай - o Boże! | ojej!
акционер - akcjonariusz
акция - akcja
АҚШ - Stany Zjednoczone
ақша - pieniądze
ақшасыздық - brak pieniędzy
ақын - poeta
ақырғы - ostatni
алабұға - okoń
алақан - dłoń
аластау - usunąć
Албания - Albania
алғашқы - początkowy | pierwotny
алгоритм - algorytm
алдаушы - oszust
алма - jabłko
Алматы - Ałmaty | Ałma-Ata
алмұрт - gruszka
алпыс - sześćdziesiąt
алты - sześć
алтын - złoto | złoty
Алтынай - Ałtynaj
алтыншы - szósty | poszukiwacz złota
алу - brać | wziąć | otrzymywać | kupować
алушы - odbiorca | nabywca
ам - pizda
Америка Құрама Штаттары - Stany Zjednoczone
аң - zwierzę (dzikie) | zwierz
ана - matka
ант - przysięga | zaklinanie się
антрацит - antracyt
аңшы - myśliwy
апа - starsza siostra | ciocia | matka | teściowa
апта - tydzień
ара - pszczoła | osa | piła | interwał | dystans | odległość
арақ - wódka
арал - wyspa
арамшөп - chwast
аргон - argon
арзан - tani
арман - marzenie | Arman
Армения - Armenia
арсылдау - szczekać
арт - tył | koniec
аруақ - duch przodka
арыстан - lew | odważny | śmiały
ас - jedzenie
асқабақ - dynia
асқазан - żołądek
аскөк - koper
аспаз - kucharz
аспан - niebo
аспап - narzędzie | przyrząd | instrument
астана - stolica
асхана - jadalnia
ат - imię | nazwa | koń
ата - dziadek
атақты - słynny | sławny
аталық - ojcowski | męski | ojcostwo | pręcik
атау септік - mianownik
атом - atom
ау - sieć | niewód
Ауғанстан - Afganistan
аударма - przekład | tłumaczenie
аудармашы - tłumacz | przekładowca
ауру - choroba | ból
аурухана - szpital
Аустралия - Australia
ауыл - wieś | wioska
Афина - Ateny
ахинса - ahinsa | ahimsa
аш - głodny
аштық - głód
ашу - otwierać
ашық - otwarty
аю - niedźwiedź
аяз - mróz
аязды - mroźny
аяқ - noga | łapa | nóżka | koniec | czarka | naczynie
аяқдоп - piłka nożna
аяқ киім - obuwie
аяусыздық - bezlitosność | okrucieństwo
бағбан - ogrodnik
бағдарлама - program
бағдарламашы - programista
бағдаршам - światło sygnalizacyjne na skrzyżowaniu
Бағдат - Bagdad
бағынушы - podwładny
бай - bogaty
байланыс - więź | łączność | stosunki
байрақ - flaga | sztandar
бақа - żaba
бақажапырақ - babka
бақбақ - mniszek lekarski | dmuchawiec
бақталастық - konkurencja | rywalizacja
бақташы - pastuch
бақша - sad | ogród
бақшашы - sadownik | ogrodnik
бақыт - szczęście | pomyślność
бақытсыз - nieszczęśliwy
бақытсыздық - nieszczęście
бақытты - szczęśliwy
бал - miód | wróżba
бала - dziecko
балабақша - przedszkole
балалық - dzieciństwo
балапан - pisklę
бал ара - pszczoła
балға - młotek
балиғат - pełnoletność | dojrzałość
балиғатқа - pełnoletni | dorosły
балмұздақ - lody
балта - siekiera
балташы - cieśla
балық - ryba
балықшы - rybak
банан - banan
банк - bank
барлаушы - zwiadowca
барлық - wszystek | cały | wszyscy | wszystkie
бармақ - kciuk
бару - iść
барыс - irbis
бас - głowa | początek
басқа - inny
басқыншы - najeźdźca | okupant
баспахана - drukarnia
баспашы - drukarz | nakładca
бастық - naczelnik | kierownik | naczelnictwo
батпақ - bagno | trzęsawisko
бауырмалдық - dobroć | serdeczność | rodzinność
бауырсақ - ciastka (z mąki lekko słodzonej, smażone w oleju)
Бахрейн - Bahrajn
башқұрт - Baszkir | baszkirski
баяғыда - dawno
беде - koniczyna
бәдірен - ogórek
бейсенбі - czwartek
бәліш - pieróg (pieczony)
бәрбі - wiertło | wiertarka
берілу - być dawanym | dawać się | oddawać się
беру - dawać
бес - pięć | 5
бәсеке - współzawodnictwo | rywalizacja | konkurencja
бәсекелес - współzawodnik | rywal | konkurent
бесік - kolebka
бесінші - piąty
бет - twarz | strona
бидай - pszenica
биік - wysoki | podniosły | wzniosły
биосинтез - biosynteza
бит - wesz
биші - tancerz
біз - my
білім - wiedza
білімділік - znawstwo | erudycja | wykształcenie
білімпаз - naukowiec | znawca
білу - wiedzieć | umieć
бір - jeden | 1
бірақ - lecz | jednak
бір-бір - nawzajem
Біріккен Ұлттар Ұйымы - Organizacja Narodów Zjednoczonych
бірінші - pierwszy
бірқазан - pelikan
бірлік - jedność
бөбек - niemowlę
бөбекжай - żłobek
бөдене - przepiórka
бозторғай - skowronek
боқ - kał | odchody | gówno
болашақ - przyszłość | przyszły
бөлік - część
бөлме - pokój
бөлтірік - wilczek
болу - być | bywać
бөлшек - część | szczegół | ułamek | cząsteczka
бор - kreda | kredowy
бөрі - wilk
бөрік - czapka
борсық - borsuk
бостандық - swoboda | wolność
бота - wielbłądzię
бөтен - cudzy | obcy | inny
бөтендік - oziębienie stosunków
ботқа - kasza (potrawa)
бруксизм - bruksizm
бу - para wodna
бүгін - dzisiaj
бүгінгі - dzisiejszy | teraźniejszy | współczesny
бұғы - jeleń
бұзау - cielę (do 6 miesięcy)
бүйрек - nerka
бұқа - byk | buhaj (samiec rozpłodowy)
бұл - ten | ta | to
бұлақ - źródło
бұлан - łoś
бұлбұл - słowik | słowik (śpiewak o pięknym głosie)
бұлт - obłok | chmura
бұлтсыз - bezchmurny
бұрау - wiercić | wwiercać | kręcić
бұрауыш - śrubokręt
бүрге - pchła
бүрген - kalina
бүркіт - orzeł przedni
бүршік - pąk
бұрым - warkocz
бұта - krzew
бұтақ - gałąź
бүтін - cały | zupełny | jednolity | całkowity | nie uszkodzony
БҰҰ - ONZ | Organizacja Narodów Zjednoczonych
буын - staw | człon | kolano | ogniwo | część | pokolenie | sylaba
Варшава - Warszawa
велосипед - rower
ғажайып - dziwny | zadziwiający | cudowny
Гаити - Haiti
ғаламат - niezwykły | cudowny
ғаламшар - planeta
ғалым - naukowiec
Гана - Ghana
ғана - dopiero
ғанибет - zadowolenie | radość
ғарыш - kosmos | wszechświat
ғарышкер - kosmonauta
ғасыр - wiek | stulecie
гедонизм - hedonizm
гематурия - hematuria | krwiomocz
Германия - Niemcy
ғибадат - nabożeństwo
ғибадатхана - świątynia | sanktuarium
ғимарат - budynek | gmach
Грекия - Grecja
гүл - kwiat
ғылым - nauka
дағдарыс - kryzys
дағдарыссыз - bezkryzysowy
дағдарысты - kryzysowy
дала - step | pole | dwór
даршын - cynamon
дауыл - wichura | huragan
дауыс - głos | dźwięk
даяшы - podczaszy | podstoli | kelner
дәм - smak | strawa
демалу - wypoczywać | odpoczywać
демалыс - odpoczynek | wakacje | urlop
дәмді - smaczny | treściwy
демеуші - mecenas | sponsor | ktoś wspierający
демікпе - astma
дәмқосар - przyprawa
демократизация - demokratyzacja
демократиялық - demokratyczny
дәмхана - kawiarnia
дән - ziarno
дәнекерлеуші - spawacz
денсаулық - zdrowie
дәптер - zeszyt
дәрі - lek | proch strzelniczy
дәрігер - lekarz
дәрігерлік - lekarski
дәрісхана - audytorium (sala)
дәріхана - apteka
дәріханашы - aptekarz
дәстүр - zwyczaj | obyczaj | tradycja
дәуір - epoka
дәуіт - modliszka
диірмен - młyn
диірменші - młynarz
динозавр - dinozaur
дін - religia | wiara
дің - pień
дінаралық - międzyreligijny
діндес - współwyznawca
дінсіздік - bezbożność | niewiara
дінтану - religioznawstwo
дінтанушы - religioznawca
діншіл - pobożny | wierzący | religijny
діншілдік - religijność
долана - głóg
дөң - wzgórze | wzniesienie
дөңгелек - koło | okrąg
дөңді - pagórkowaty
доңыз - dzik | świnia (wyzwisko)
доп - piłka
дос - przyjaciel
достық - przyjaźń | przyjacielski
ДСҰ - Światowa Organizacja Handlu
Дублин - Dublin
дұға - modlitwa
дүйсенбі - poniedziałek
дүкен - sklep
дүние - świat
дүниежүзілік - światowy | ogólnoświatowy
дүниетаным - światopogląd
дұрыс - prawidłowy | poprawny | prawidłowo
дұрысырақ - prawidłowiej | дұрыс
дұшпан - wróg
дыбыс - dźwięk | głos
дыбыссыздық - bezdźwięczność
әбжылан - kobra | najbardziej nienawistny wróg
егемендік - suwerenność | niezależność
егер - jeśli | jeżeli | gdyby
егінші - rolnik
егіншілік - rolnictwo | rolniczy
әдебиет - literatura
әдебиеттану - literaturoznawstwo
әдебиеттанушы - literaturoznawca
әдебиетші - literat
әдемі - piękny
әдемілік - piękno | elegancja
әділ - sprawiedliwy | Adil
әділдік - sprawiedliwość
әділетсіздік - niesprawiedliwość
әже - babcia
ежелгі - starożytny | prastary | pradawny
әжетхана - toaleta | ubikacja
әзіл - żart | kawał
әйел - kobieta | żona | małżonka
әйнек - szkło
әйнекші - szklarz
әке - ojciec
екі - dwa
екінші - drugi
ел - kraj | ojczyzna | ludność
елбелек - motyl
елдес - rodak | ziomek
әлем - świat
әлемдік - światowy
әлеумет - ludzie | społeczeństwo | społeczność
әлеуметтік - społeczny | socjalny
елтаңба - godło państwowe
елу - pięćdziesiąt
елуінші - pięćdziesiąty
елші - ambasador
елшілік - ambasada
емделуші - pacjent | leczony
емдеу - leczyć | uzdrawiać | leczenie | uzdrawianie
емдік - leczniczy | terapeutyczny | uzdrowicielski
емен - dąb
емле - ortografia
емтихан - egzamin
емхана - przychodnia | klinika
емші - uzdrowiciel
емшілік - uzdrowicielstwo | znachorstwo
ән - melodia | muzyka | piosenka | pieśń
еңбек - trud | praca | dzieło | dotyczący trudu | pracy
еңбекақы - pensja | płaca
еңбек кітапшасы - historia zatrudnienia | [http://en.wikipedia.org/wiki/Employment_Record_Book Employment Record Book w Wikipedii]
еңбектес - współpracownik | kolega
еңбектестік - współpraca
еңбекші - człowiek trudu | pracownik
әңгімеші - opowiadacz
әнұран - hymn
әнші - piosenkarz | pieśniarz
әр - każdy | wszelki
Ереван - Erywań
ереже - prawidło | zasada
әрекет - czyn | postępek
әрекетсіз - bezczynny
әрекетсіздік - bezczynność
әрекеттес - wspólnik | współsprawca
әрекетті - czynny | aktywny
ерін - warga
еріндік - labializacja
әріп - litera
әріптес - kolega | partner
әріптестік - koleżeństwo | partnerstwo
әрқашан - zawsze | każdy raz
әркім - dowolny | wszelki | każdy
еркін - wolny | swobodnie | Jerkin
еркіндік - wolność
ермен - bylica piołun
Әрменстан - Armenia
ертек - bajka | baśń
ертекші - bajarz
ертең - jutro
ертеңгі - jutrzejszy | przyszły
Ертіс - Irtysz
есек - osioł
есептеу - liczyć | uważać
есік - drzwi
есімдік - zaimek
әсіресе - zwłaszcza
ескек - wiosło
әскер - armia | wojsko | żołnierz | wojownik
әскери - wojskowy
ескерткіш - pomnik | zabytek
ескі - stary (o rzeczy)
естелік - wspomnienie
ет - mięso
әтеш - kogut
етік - but z cholewą
етікші - szewc
етістік - czasownik
әуежай - lotnisko
әулиелік - świętość
Еуразия - Eurazja
еуразиялық - eurazjatycki
Еуропа - Europa
ешқандай - nijaki | żaden
ешқашан - nigdy | ani razu
ешкі - koza
ешкім - nikt
жаға - brzeg | kołnierz
жағымпаздық - pochlebstwo
жаз - lato
жаза - kara
жазасыздық - bezkarność
жазба - pismo | zapis
жазу - pisać | napisać
жазушы - pisarz
жақсы - dobry | korzystny | szlachetny
жақсылық - dobro
жақсырақ - lepiej | жақсы
жақтаушы - stronnik | zwolennik
жалақы - pensja | płaca
жалаңаш - nagi | goły | pustynny | niezalesiony
жалбыз - mięta
жалғыздық - samotność
жалпы - wspólny | powszechny | ogólnie
жаман - zły | kiepski | niepoprawny | źle
жамандық - zło
жаманырақ - gorzej | жаман
жан - dusza
жаңа - nowy
жаңалық - nowina | nowość | innowacja
жаңбыр - deszcz
жаңбырлы - deszczowy
жансыздық - nieżywotność | martwość
жантану - psychologia
жантанушы - psycholog
жаңылу - mylić się | błądzić
жапалақ - sowa
Жапония - Japonia
жапырақ - liść
жара - rana | wrzód | bolesne wspomnienie | uraza
жаралы - ranny
жарқанат - nietoperz
жарлылық - ubóstwo
жарнама - reklama | afisz
жарты - połowa
жарық - światło | jasny
жасыл - zielony
жасыру - chować | ukrywać
жасырушы - ukrywacz | ktoś | kto coś chowa | ukrywa
жатақхана - bursa | internat
жаттықтырушы - trener | treser
жау - wróg | nieprzyjaciel
жауап - odpowiedź
жауапкершілік - odpowiedzialność
жауын - deszcz
жауынгер - wojownik | żołnierz
жауырын - łopatka
жаһаннам - piekło
жебе - strzała
жебіршөп - tymianek | macierzanka
жедел - pilny | niezwłoczny
жейде - koszula
жексенбі - niedziela
жел - wiatr
желдеткіш - wentylator | lufcik
желім - klej
желсіз - bezwietrzny
желсіздік - bezwietrze
желтоқсан - grudzień
жеміс - owoc | wynik | skutek
жеміссіз - bezowocowy | bezowocny
жемісті - owocny
жәндік - owad
және - i
жеңіліс - porażka
жеңімпаз - zwycięzca
жеңіс - zwycięstwo
жеңіскер - zwycięzca
жеңу - zwyciężać | wygrywać
жеңуші - zwycięzca
жер - ziemia
жәрдем - pomoc
жәрдемақы - zapomoga
жәрдемші - pomocnik
жерлес - rodak | ziomek
жеті - siedem
Жетіқарақшы - Wielka Niedźwiedzica
жетінші - siódmy
жетістік - osiągnięcie | sukces
жетпіс - siedemdziesiąt
жетпісінші - siedemdziesiąty
жеу - jeść
жидек - jagoda
жинау - zbierać
жинаушы - zbieracz | poborca
жиһаз - mebel
жиырма - dwadzieścia
жібек - jedwab (przędza) | jedwab (tkanina) | jedwabny | jedwabisty
жігіт - chłopak | młodzieniec
жоғалту - tracić | stracić
жоқ - nie | nie ma | brak
жол - droga | szlak | sposób | metoda | rozwiązanie
жолаушы - podróżnik | pasażer
жолбарыс - tygrys
жөндеуші - remontowiec | naprawiacz
жүген - uzda
жүгіру - biec | biegać
жүгіруші - biegacz
жұдырық - pięść
жүз - sto | twarz | lico | ostrze | żuz | jeden z trzech działów związku plemiennego Kazachów
жүзім - winorośl | winogrono
жүзінші - setny
жүзу - pływać
жүзуші - pływak
жүк - ładunek
жүкқұжат - list przewozowy
жүксалғыш - bagażnik
жүктеу - ładować
жүкті - obciążony | ciężarny
жүктілік - ciąża
жүкші - ładowacz
жұлдыз - gwiazda | Żułdyz
жұлдызаралық - międzygwiezdny
жұлдызқұрт - gąsienica
жұлдызша - gwiazdeczka | жұлдыз
жұма - piątek | tydzień
жұмбақ - zagadka
жұмылдырушы - organizator
жұмыртқа - jajo | jajko
жұмыс - praca | robota | trud
жұмыскер - pracownik
жұмыссыз - bezrobotny
жұмыссыздық - bezrobocie
жұмыстас - współpracownik
жүрек - serce
жүрексіздік - tchórzostwo | lękliwość
жүректілік - śmiałość
жұрнақ - przyrostek
жусан - bylica
жусау - mdleć | być spokojnym
жұту - łykać | przełykać
жуу - myć | prać
жуушы - pomywacz
жуырда - niedawno
жыл - rok
жылан - wąż
жылау - płakać
жылдық - rocznica
жылнама - latopis | kronika
жылнамашы - annalista | kronikarz
жын - dżin
жыр - pieśń | piosenka
жыртқыш - drapieżnik
заман - epoka | era | czas | okres
заң - prawo | ustawa
заңгер - prawnik
заңды - prawny | zgodny z prawem | legalny
заңдылық - legalność | praworządność
заңсыз - nielegalny | nielegalnie
заңсыздық - bezprawie
заңтанушы - ustawoznawca
зардұштшылық - zaratusztrianizm
зат есім - rzeczownik
зауыт - zakład | fabryka
зейнетақы - emerytura (płaca)
зейнеткер - emeryt
зейнеткерлік - emerytura | emerytalny
зергер - jubiler
зерттеу - badać
зерттеуші - badacz
зертхана - laboratorium
зертханалық - laboratoryjny
зертханашы - laborant
зоо- - zoo-
зоопланктон - zooplankton
иә - tak
иек - podbródek
иеленуші - właściciel | posiadacz
импрессионизм - impresjonizm
индий - ind
ине - igła
инелік - ważka
Ирак - Irak
Иран - Iran
Ирландия - Irlandia
ит - pies
із - ślad | trop
іздеу - szukać | poszukiwać | poszukiwanie
іздеуші - poszukiwacz
ізші - tropiciel
іні - młodszy brat
іңір - zmierzch
іс - sprawa | praca | robota | czynność | sprawa sądowa | rozprawa
іскер - przedsiębiorczy | zaradny | pracowity | przedsiębiorca | biznesmen
іссіздік - nieróbstwo
істеу - robić | działać
іш - wnętrze | środek | brzuch | żołądek
ішкі - wewnętrzny
ішу - pić
йогурт - jogurt
қабан - dzik
қабат - warstwa | piętro
қабатаралық - międzywarstwowy | międzypiętrowy
қабық - kora | łupina | skorupa | łuska | powłoka
қабыр - grób
қабыршы - grabarz
қағаз - papier | dokument
қажет - potrzeba
қажетсіздік - brak potrzeby | zbędność
қажы - pielgrzym
қаз - gęś
қазақ - Kazach | kazachski
Қазақстан - Kazachstan
қазақ тілі - język kazachski | kazachski
қазан - kocioł | październik
қазір - teraz
қазіргі - teraźniejszy | współczesny
қазу - ryć
қаймақ - śmietana | śmietanka | najlepsza część
қайнар - źródło | zdrój
қайраткер - działacz
қайшы - nożyce
қайық - łódź
қайықша - łódeczka | қайық | jak łódź
қайықшы - łódkarz
қайың - brzoza
қайыршы - żebrak
қала - miasto
қалааралық - międzymiastowy
қалайы - cyna
қалақай - pokrzywa
қалалық - miejski | mieszczanin
қалам - pióro | długopis
калий - potas
қалта - kieszeń
кальмар - kalmar
қамал - twierdza
Камбоджа - Kambodża
қамқор - opiekun | kurator
Камчатка - Kamczatka
қан - krew
қанат - skrzydło
қанатсыз - bezskrzydły
қандай - jaki
қандала - pluskwiak
қанішер - krwiopijca | okrutnik
қант - cukier
қаңтар - styczeń
канцлер - kanclerz
қанша - ile
қар - śnieg
қара - czarny
қарағай - sosna
қараңғы - ciemność | mrok | ciemny | ignorancki | ciemno
қарасөз - proza
қарау - patrzeć | oglądać | obserwować
қараушы - dozorca | hodowca
қараша - listopad
қарашық - źrenica
қарбыз - arbuz
қарға - wrona
қарғыс - przekleństwo
қаржыгер - finansista
қарлы - śnieżny
қарлығаш - jaskółka | Karłygasz
қармақ - wędka | haczyk
қарсаң - przeddzień
картоп - ziemniak
қаршыға - jastrząb
қарым-қатынас - stosunek
қасапшы - rzeźnik
қасқыр - wilk
қасық - łyżka
қате - błąd | pomyłka | błędny | nieprawidłowy
қателесу - błądzić | mylić się
қатерсіздік - bezpieczeństwo
қатесіз - bezbłędny | bezbłędnie
қатесіздік - bezbłędność
қатын - baba | żona
қатысу - uczestniczyć
қатысушы - uczestnik
қауіп - zagrożenie
қауіпсіз - bezpieczny
қауіпсіздік - bezpieczeństwo
қауын - melon
қауырсын - pióro
қаһарман - bohater
қаһармандық - bohaterstwo | odwaga
қашан - kiedy
кедейлік - ubóstwo
кеденші - celnik
кездесу - spotykać się | spotkać się
кек - zemsta
кекіребалық - różanka
кекіру - odbijać się (po jedzeniu lub piciu) | odbijanie się (po jedzeniu lub piciu)
кекшілдік - mściwość
келесі - następny
келін - synowa | bratowa (żona młodszego brata) | żona młodszego krewnego
келісім - zgoda | porozumienie | umowa
келу - przychodzić | przybywać | przyjeżdżać
кеме - statek | okręt
кәмпит - cukierek
кемпірқосақ - tęcza
кең - szeroki | szeroko
кене - kleszcz
кенепшөп - konopie
кеңес - rada | narada | rozmowa | sowiet
кеңесші - doradca
кеңірек - szerzej | кең
кенші - górnik
керемет - cud | świetny | cudowny
кәрілік - starość
кәсіп - rzemiosło | fach | zawód
кәсіподақ - związek zawodowy
кесіртке - jaszczurka
кеспе - domowy makaron
кету - odchodzić | odjeżdżać | pójść | wychodzić (zwłaszcza o cieczach) | wypływać | odejść | umrzeć
кеш - wieczór
кеше - wczoraj
кешірім - przebaczenie
киім - ubranie | odzież
қияр - ogórek
кілт - klucz
кім - kto
кіндік - pępek | pępowina | oś | środek
кір - brud | bielizna
кірпі - jeż
кірпік - rzęsa
кірпіш - cegła
кіру - wchodzić (do środka) | wchodzić (np. w palec) | wstępować | wchodzenie | wstępowanie | wejście
кіс - gronostaj
кісі - człowiek | osoba
кітап - książka
кітапхана - biblioteka
кітапханашы - bibliotekarz
кітапша - książeczka | broszura
кішкентай - mały
классицизм - klasycyzm
көбелек - motyl
көбірек - więcej | көп
қобыз - kobza
қоғам - społeczeństwo
қоғамдастық - wspólnota
қоғамтанушы - socjolog
көгершін - gołąb
көгілдір - niebieski
көжек - zajączek | króliczek
көз - oko
көзәйнек - okulary
көзілдірік - okulary
қозы - jagnię
қой - owca | baran | owczy
көйлек - suknia | koszula
қойшы - hodowca owiec
көк - niebo | niebieski | błękitny
көке - ojciec
көкек - kukułka | kwiecień
қоқиқаз - flaming różowy
көкөніс - warzywo
көктем - wiosna
көл - jezioro
қол - ręka | dłoń
қолдану - używać
қолданушы - użytkownik
қолданушылық - wykorzystanie
көлеңке - cień
қолжазба - rękopis
көлік - wierzchowiec | zwierzę juczne | podwoda | pojazd (zwłaszcza komunikacji publicznej)
қолтырауын - krokodyl
қолшатыр - parasol
көмей - krtań
көмек - pomoc
көмектес септік - narzędnik (instrumentalis)
көмекші - pomocnik
көмір - węgiel
көң - nawóz
қонақ - gość
қонақ үй - hotel | gościnny dom
қонақшылау - gościć
көне - starożytny | prastary
қонжық - niedźwiedziątko
көңіл - nastrój
қоңыз - chrząszcz | żuk
қоңыр - brązowy
көп - dużo | wiele
көпбұрыш - wielokąt
көпір - most
көпқұдайшылық - wielobóstwo | politeizm
көпшілік - większość | publika | ogół | masowy
қораз - kogut
қорап - pudło | paczka | opakowanie | nadwozie | obudowa
қорапша - pudełko | қорап | koszyk | koszyczek | koszyczek (kwiatu)
қорғасын - ołów
қорғау - bronić
қорғаушы - obrońca | adwokat
Корея - Korea
қорқақтық - tchórzostwo
қорқу - lękać się
көрме - wystawa
көрпе - kołdra
көрсеткіш - wskaźnik
қорсылдау - chrząkać | szlochać
көру - widzieć | patrzeć
қорытпа - stop
Косово - Kosowo
қосымша - dodatek | zrostek | formant | afiks
көт - odbyt | dupa
қотақ - chuj
көтеріліс - powstanie
көтерілісші - powstaniec
көтеру - podnosić
көше - ulica
қошқар - tryk
қоян - zając
қуану - radować się | cieszyć się
қуаныш - radość | Kuanysz
қуанышты - radosny
қуат - siła | energia | kaloria
Куба - Kuba
Кувейт - Kuwejt
құдай - bóg
құдайсыз - bezbożny | ateista
құдайсыздық - bezbożność | ateizm
құдық - studnia
куәгер - świadek
куәландырушы - poświadczający
куәлік - świadectwo | dowód
құжат - dokument
құжаттама - dokumentacja
күз - jesień
құзғын - kruk
күзен - norka | tchórz
күзет - ochrona
күзету - ochraniać
күзетші - ochroniarz
күйе - mól | sadza
күйзеліс - cierpienie | smutek | trudne położenie | kryzys
құйрық - ogon | zad | tyłek
құйрықсыз - bezogonowy
құйрықты - ogoniasty
күйсандық - pianino
күкірт - siarka
құқық - prawo (system prawny)
құқықсыздық - bezprawie | nieprawomocność
құқықтану - prawoznawstwo
құқықтанушы - prawoznawca
құқық тәртібі - praworządność
күл - popiół
құл - niewolnik
құлақ - ucho
құлақшын - uszanka
құлама - wodospad
күлгін - fioletowy
құлданушы - ciemiężyciel
құлдық - niewola
күлкі - śmiech
құлмақ - chmiel
құлпынай - truskawka
күлу - śmiać się
құлын - źrebię
құм - piasek
күмән - wątpliwość
күмәнсіз - niewątpliwy | niewątpliwie
күміс - srebro | srebrny
құмырсқа - mrówka
күн - słońce | dzień | pogoda
күң - niewolnica | służąca
күнделік - dziennik | dzienniczek
құндыз - bóbr
күнә - grzech
күнәһар - grzesznik
күнтізбе - kalendarz
құнтсыздық - niestaranność | niedbałość
құну - rosomak
құрам - skład
құрама - zjednoczony | złożony
Құрама Патшалық - Zjednoczone Królestwo
Құран - Koran
құрбақа - ropucha | żaba
құрбан - ofiara | obiata | żertwa
күрек - łopata
күрес - walka | bój | zapasy
күресу - walczyć
күресуші - bojownik
күріш - ryż
құрметті - szanowny | honorowy
құрт - robak | dżdżownica | glista | suszony ser (wyrób z białego suszonego sera w postaci kulek wielkości czereśni, w solonej otoczce)
күртік - zaspa
құршаян - skorpion
құрылыс - budownictwo | budowa | budowlany
құрылысшы - budowlaniec
күс - nagniotek
құс - ptak
құтан - czapla
құтқарушы - ratownik | zbawca
құтылыс - ocalenie | wybawienie
қуу - gnać | wyganiać | przeganać | doganiać | ścigać | puszczać się w pogoń | gnanie | wyganianie | przeganianie | doganianie | ściganie
күш - siła | moc
күшік - szczenię
күшсіздік - bezsilność | słabość
қуыру - smażyć
қыз - dziewczyna | dziewczynka | córka
қызанақ - pomidor
қызмет - służba | praca | stanowisko | usługa
қызметкер - pracownik
қызметтес - kolega | współpracownik
қызметтестік - współpraca
қызыл - czerwony
қызылша - burak
қылмыс - przestępstwo
қылмыскер - przestępca
қылмыстық - przestępczość
қылыш - miecz | szabla
қымбат - drogi | kosztowny
қынжыгүл - konwalia
қыран - ogólna nazwa ptaków drapieżnych | takich jak orły | sokoły | jastrzębie itd.
қырау - szron
қырғауыл - bażant
қырғыз - Kirgiz
Қырғызстан - Kirgistan
қыркүйек - wrzesień
қырық - czterdzieści
қырықаяқ - stonoga
қырыққабат - kapusta
қыс - zima
қысқа - krótki
қыстау - zimować | spędzać zimę | nalegać | zmuszać | zimowanie | zimowisko | naleganie | zmuszanie
Қытай - Chiny
қытайтанушы - sinolog
қыша - gorczyca | musztarda
қышқыл - kwas | kwaśny
лақ - koźlątko
ластау - brudzić | zanieczyszczać
ләйлек - bocian
Ливан - Liban
Литва - Litwa
ма - czy
мавритан - mauretański
мағлұмат - wiadomość | dane | informacja
магний - magnez
мағына - sens | znaczenie
мазмұн - treść | zawartość | spis treści
май - tłuszcz | masło | olej
майдан - pole bitwy | front | arena
майдандық - frontowy
майлылық - tłustość
маймыл - małpa
май ұлпасы - tkanka tłuszczowa
мақсат - cel | zamiar
мақта - bawełna | wata
мал - bydło | bydlak | dureń | bogactwo | majątek
малшы - hodowca bydła | pasterz
маман - specjalista | fachowiec
мамандық - specjalność | fach | zawód
мамыр - maj
маңдай - czoło
мануфактура - manufaktura
маңызды - ważny | ważki | istotny
маңыздылық - ważność | ważkość | istotność
маса - komar
масахана - moskitiera
маскүнемдік - pijaństwo
Маугли - Mowgli
маусым - czerwiec
махаббат - miłość | kochanie
Махмұд - Mahmud | imię męskie
мәдени - kulturowy
мәдениет - kultura
мәдениеттану - kulturoznawstwo
мәдениеттанушы - kulturoznawca
мәжуси - barbarzyńca | poganin
мәйітхана - kostnica
мейман - gość
мейманхана - hotel
мейрам - święto
мейрамхана - restauracja
мекемеаралық - międzyresortowy
мектеп - szkoła
мемлекет - państwo
мемлекеттік - państwowy
мен - ja | i
мән - znaczenie | sens | sedno | istota
меңгеру - kierować
меңгеруші - kierownik
меніңше - według mnie
мәнсіздік - bezsensowność
мереке - święto
меруерт - perła
меруертгүл - konwalia
мәселе - kwestia | problem | zagadnienie
Мәскеу - Moskwa
мәслихат - odprawa | narada | rada | porada | sejmik | rada (szczebla terenowego)
мәтін - tekst
метрополия - metropolia
мәулен - kocię
мешіт - meczet
ми - mózg
мирас - spadek | dziedzictwo
мирасқор - spadkobierca | następca
мияулау - miauczeć
мойын - szyja
Монако - Monako
Моңғолия - Mongolia
мөңіреу - muczeć
мөңке - karaś
монша - łaźnia
мөр - pieczęć
мұғалім - nauczyciel
мүгедек - inwalida | kaleka
мұз - lód
мұздатқыш - zamrażarka | chłodziarka
мұздықаралық - międzylodowcowy
мұзжарғыш - lodołamacz
мүйіз - róg | nagniotek
мүйізсіз - bezrogi
мүйізтұмсық - nosorożec
мүк - mech
мүкжидек - żurawina | owoc żurawiny
мұқтаж - potrzeba
мүмкіндік - możliwość | ewentualność | szansa
мүмкінсіздік - niemożliwość
мұнай - ropa naftowa
мұнайшы - naftowiec
мұнар - mgła
мұнда - tu | tutaj
мұра - dziedzictwo | spadek
мұрағат - archiwum
мұрагер - spadkobierca | następca
мұражай - muzeum
мүрде - grób
мүрдеші - grabarz
мұрын - nos
мүсінше - posążek  od: мүсін
мүсінші - rzeźbiarz
мұсылман - muzułmanin
мұхит - ocean
мұхиттану - oceanografia
мұхиттанушы - oceanograf
мүшелік - członkostwo
мың - tysiąc | 1000
мыңжапырақ - krwawnik
мыңжылдық - tysiąclecie
мыңыншы - tysięczny
мырыш - cynk
мыс - miedź
мысал - przykład
мысық - kot | kotka
мысыртану - egiptologia
мысыртанушы - egiptolog
надандық - niewiedza | ciemnota | nieuctwo
найза - dzida | oszczep | kopia
найзағай - błyskawica
нан - chleb
нанғысыз - niewiarygodny
насихат - rada | porada | propaganda
насихаттық - propagandowy
насихатшы - propagandzista
наубайхана - piekarnia
наубайшы - piekarz
наурыз - marzec | Nouruz
нашақор - narkoman
нашақорлық - narkomania
не - co
негізсіздік - bezzasadność | bezpodstawność
немесе - lub | albo
неміс - Niemiec | niemiecki
неолит - neolit
Непал - Nepal
непотизм - nepotyzm
нәресте - niemowlę
несеп - mocz
нәсілшіл - rasista
нәсілшілдік - rasizm
нәтиже - skutek
нәтижелі - skuteczny
нәтижелілік - skuteczność
нәтижесіздік - nieskuteczność | bezskuteczność
неше - ile
Никарагуа - Nikaragua
нозология - nozologia
Норвегия - Norwegia
ноябрь - listopad
нүкте - kropka
Нұрсұлтан - Nursułtan
облыс - obwód
объект - obiekt
овуляция - owulacja | jajeczkowanie
өгіз - wół
одағай - wykrzyknik
одақ - związek | stowarzyszenie | wspólnota
ожау - chochla
өзара - wzajemny | nawzajem
Өзбекстан - Uzbekistan
өзен - rzeka
өзімшіл - samolub | egoista
ойлау - myśleć
ойлаушы - myśliciel
ойнау - grać
ойнаушы - gracz
ойпат - nizina
ойын - gra
ойыншы - gracz
ойыншық - zabawka
оқиға - zajście | wydarzenie | przygoda
оккультизм - okultyzm
оқу - czytać | uczyć się
оқулық - podręcznik
оқушы - uczeń | czytelnik
өкше - pięta | obcas
оқырман - czytelnik
оқытушы - nauczyciel | wykładowca
ол - on | ona | ono
олар - oni | one
өлі - martwy
өлік - nieboszczyk | trup
өлікхана - kostnica
өлім - śmierć
өлімсіз - nieśmiertelny
өлмейтіндік - nieśmiertelność
өлтіру - zabić
өлтіруші - zabójca
өлу - umrzeć | umierać
омарта - pasieka
омарташы - pasiecznik
өмір - życie
өмірбаян - życiorys
өмірбаяншы - biograf
өмірнама - życiorys
он - dziesięć
өң - jawa | rzeczywistość
өңдеу - obrabiać | edytować | redagować
өндіру - wytwarzać | wyrabiać | produkować | wytwarzanie | wyrabianie | produkowanie
өндіруші - producent
ондық - dziesiątka | dziesiętny | dziesiątkowy
өнер - sztuka | rzemiosło | umiejętność
өнеркәсіпші - przemysłowiec
өнертану - historia sztuki
өнертанушы - historyk sztuki
өнертапқыш - wynalazca
өңеш - przełyk
өнім - wyrób | produkt | urodzaj
онкология - onkologia
оңтүстік - południe | południowy
Оңтүстік Корея - Korea Południowa
оныншы - dziesiąty
опасыздық - zdrada | niewierność | nielojalność
орақ - sierp
орақшы - żniwiarz
орман - las | leśny
орманшы - leśniczy
орманшылық - leśnictwo
өрмекші - pająk | tkaczka
өрт - pożar
орта - środek | centrum | środkowy | centralny
орталық - centralny | środkowy
өртеуші - podpalacz
өртші - strażak
орушы - żniwiarz
орын - miejsce
орындаушы - wykonawca
орындық - krzesło
орыс - Rosjanin | rosyjski
өсек - plotka
өсекші - plotkarz
өсекшілдік - plotkarstwo
өсиет - testament | nakaz
өсиетші - mentor
өсім - wzrost | przyrost
өсімдік - roślina
өсімдіктану - botanika
өсу - rosnąć | rozwijać się
от - ogień | trawa
отан - ojczyzna
отандас - współziomek
отаншыл - patriota
отаншылдық - patriotyzm
отаршы - kolonizator
отбасы - rodzina
өте - bardzo
өтініш - prośba | podanie | petycja
өтірікші - oszust | kłamca
өткел - bród | przeprawa
өткен - przeszły | miniony
от сөндіргіш - gaśnica
оттегі - tlen
отыз - trzydzieści
отызыншы - trzydziesty
отыру - siedzieć | siadać
ояту - budzić
пайғамбар - prorok
пайда - korzyść | zysk
пайдалану - korzystać | używać | korzystanie | użytkowanie
пайдаланушы - konsument | użytkownik
пайдалы - korzystny | zyskowny | pożyteczny
пайдасыз - bezużyteczny
пайдасыздық - bezużyteczność
палау - pilaw
Памир - Pamir
пантеизм - panteizm
пара - łapówka
парақор - łapówkarz
парақорлық - łapownictwo
парламент - parlament
Пәкістан - Pakistan
пәлсапа - filozofia
пен - i
пәтер - mieszkanie
пияз - cebula
піл - słoń
пойыз - pociąg
Польша - Polska
популизм - populizm
Портуғалия - Portugalia
президент - prezydent
пұтқа табынушы - poganin
пырылдау - chrapać (o zwierzętach) | mruczeć
пышақ - nóż
рақат - radość | przyjemność
рауан - świt | światło
Рейн - Ren
рәміз - symbol | znak
Ресей - Rosja
ресми - oficjalny | urzędowy
республика - republika
ру - ród
Руанда - Rwanda
рұқсат - pozwolenie | zgoda
рұқсатсыз - niemający pozwolenia | zgody | niedozwolony
рулас - rodak | członek tego samego rodu
рухани - duchowy
рухтандырушы - inspirator
сабын - mydło
сағат - godzina | zegar | zegarek
сағатшы - zegarmistrz
садақ - łuk | kołczan
садақшы - łucznik
сазгер - kompozytor | melodysta
сайлаушы - wyborca
сайман - sprzęt
сақал - broda | zarost
сақалды - brodaty
сақалсыз - bezbrody
сақтаушы - opiekun | stróż | kustosz
салқын - chłód | chłodny | zimny
салық - podatek | danina | podatkowy
салық төлеуші - podatnik
сан - biodro | liczba | ilość
сандық - skrzynia | kufer
сандықша - kuferek | сандық
сан есім - liczebnik
Сансызбай - Sansyzbaj
сансыздық - niezliczoność | niezliczona liczba
саңырау - głuchy
саңырауқұлақ - grzyb
саңыраулық - głuchota
сапа - jakość
сапар - wizyta | podróż
сарай - pałac
саратан - chrabąszcz majowy
сарғылт - pomarańczowy
сарқырама - wodospad
сары - żółty
сарымсақ - czosnek
сасық - śmierdzący
сатқын - zdrajca
сатқындық - zdrada
сату - sprzedawać
сатушы - sprzedawca
Сауд Арабиясы - Arabia Saudyjska
саусақ - palec
сауыншы - dojarz | dojarka
сауысқан - sroka
сахна - scena
саясат - polityka
саясаткер - polityk
саясаттану - politologia
саясаттанушы - politolog
саяхат - podróż
саяхатшы - podróżnik
себебі - ponieważ | bo
сәбихана - żłobek
сәбіз - marchew
сегіз - osiem
сегізаяқ - ośmiornica
сегізінші - ósmy
сейсенбі - wtorek
сексен - osiemdziesiąt
сексенінші - osiemdziesiąty
секунд - sekunda
сен - ty
сең - kra
сенбі - sobota
сенім - zaufanie | pewność
сенімхат - pełnomocnictwo
сепаратизм - separatyzm
Сербия - Serbia
сәрсенбі - środa
серуен - spacer
сәуір - kwiecień
сиқыр - czary | magia
сиқыршы - czarownik
Сирия - Syria
сиыр - krowa
сілеусін - ryś
сіреспе - tężec
скептицизм - sceptycyzm
соғыс - wojna
соғысаралық - międzywojenny
соғысу - wojować
сөз - słowo | mowa | wyraz
сөздік - słownik
сөйлем - zdanie
сөйлеу - mówić
сөйлеуші - mówca
соқашы - oracz
соқпақ - ścieżka
сол - tamten | lewy
сөл - sok z rośliny
солтүстік - północ | północny
сөмке - torba
соң - koniec | ukończenie | po
сондықтан - dlatego
сорпа - bulion | zupa
сот - sąd
спорт - sport
спортшы - sportowiec
Стамбұл - Stambuł
су - woda | wodny | mokry | wilgotny
сужылан - zaskroniec
сүзбе - twaróg
сүйек - kość | przodek
сүйелшөп - glistnik jaskółcze ziele
сүйкімсіздік - niesympatyczność
сұйықтық - ciecz
сүлік - pijawka
сұлу - piękny
сұлулық - piękno
сұңқар - sokół
сұр - szary
сұрақ - pytanie
сұрау - pytać | prosić
сүре - sura
сурет - malowidło | rysunek | obraz
суретші - malarz (artysta)
сусабын - szampon
сусамыр - cukrzyca
сусиыр - hipopotam
сусын - napój
сүт - mleko
сутек - wodór
суық - zimny | zimno
сызғыш - linijka
сыйлау - obdarowywać | nagradzać | częstować
сылақтау - tynkować | obmazywać
сылақшы - tynkarz
сынап - rtęć
сындыру - łamać
сындырушы - łamacz
сын есім - przymiotnik
сынып - klasa (grupa dzieci) | klasa (pomieszczenie w szkole)
сыныптас - kolega z klasy
сыра - piwo
сырахана - piwiarnia
сырашы - piwowar | sprzedawca piwa
сырлау - malować
сырлаушы - malarz (który maluje ściany)
Сырпыстан - Serbia | Сербия
сыртқы - zewnętrzny
таба - patelnia
табан - stopa | stopa (miara) | pięta | spód | podeszwa | płoza
табиғат - przyroda
табу - znajdować
табыну - czcić | oddawać cześć | ubóstwiać
табынушы - wyznawca | czciciel
табыс - zarobek | dochód | powodzenie | sukces
табыс септік - biernik
табыт - trumna
табытшы - trumniarz
таза - czysty
тазалау - czyścić
тазалаушы - czyściciel | sprzątacz
тазалық - czystość
тайпа - plemię
тайпалас - współplemieniec
тақта - tablica
тақтай - deska
тал - iwa | wierzba
талақ - śledziona | rozwód
тамшы - kropla
тамыз - sierpień
тамыр - korzeń | żyła | bliski | ziomek
тамырдәрі - ciemiężyca
таңдай - podniebienie
таңдау - wybierać | wybór | wybieranie
таңдаушы - wyborca
Танзания - Tanzania
тану - poznawać | badać | studiować | wiedza | poznanie | uznanie
тар - wąski | ciasny
тарақ - grzebień
тарих - historia | opowieść
тарихи - historyczny
тарихшы - historyk
тары - proso
тас - kamień | kamienny
тасбақа - żółw
тау - góra
тауар - towar
тауартану - towaroznawstwo
тауартанушы - towaroznawca
тауқұдірет - bekas
таулы - górski | górzysty
таулық - góral
тауық - kura
тауыс - paw
Ташкент - Taszkent
тәж - korona
тежегіш - hamulec
Тәжікстан - Tadżykistan
тек - pochodzenie | rodzaj | rasa | nazwisko
тексеру - sprawdzać | kontrolować
темір - żelazo
Темірқазық - Gwiazda Polarna
тең - równy | para
теңге - tenge
теңдеме - równanie
теңдік - równość | równanie
теңіз - morze
теңізші - marynarz
теңсіздік - nierówność
тер - pot
тәрбие - wychowanie
тәрбиеші - wychowawca
тергеуші - śledczy
терезе - okno
терезеші - szklarz
терек - topola
терең - głęboki
тері - skóra | skórzany | skórkowy
терлеу - pocić się
терлі - potny
термодинамика - termodynamika
тәуелсіз - niezależny | niepodległy
тәуелсіздік - niepodległość
Тибет - Tybet
тиін - wiewiórka
тігінші - krawiec | krawcowa
тігу - szyć
тізбе - lista
тізе - kolano
тікұшақ - śmigłowiec
тіл - język | mowa
тілашар - rozmówki
тілмаш - tłumacz
тілтанушы - językoznawca
тіс - ząb
тістеу - kąsać | gryźć
төбе - pagórek | wzgórze | wierzch | ciemię | dach | sufit
төбелес - bójka
төбелескер - zawadiaka | zabijaka
төбелесу - bić się
төбелі - pagórkowaty
тоғай - las | leśny
тоғыз - dziewięć
тоғызыншы - dziewiąty
Токио - Tokio
тоқсан - dziewięćdziesiąt
тоқсаныншы - dziewięćdziesiąty
тоқылдақ - dzięcioł
төлеу - płacić | wypłacać
төлеусіз - bezpłatny | bezpłatnie | za darmo
төлеуші - płatnik
тоң - zmarzlina | zmarzły | zamrożony
тоңазытқыш - lodówka | chłodziarka
тонау - rabować
тонаушы - grabieżca | rabuś
тонаушылық - łupiestwo | grabież
тоңу - marznąć
торай - prosię
торап - skrzyżowanie
торғай - wróbel
төрт - cztery
төртінші - czwarty
төс - pierś | kowadło
төсек - łóżko
Тоскана - Toskania
ту - flaga | sztandar
тұз - sól
тұздау - solić
түйе - wielbłąd
түйеқұс - struś
түйетауық - indyk
түймедақ - rumianek
түлкі - lis
тұман - mgła
тұмсық - pysk | ryj | dziób | nos | występ
түн - noc
тұрақ - miejsce zamieszkania | postój
түркітану - turkologia
түркітанушы - turkolog
түрлі - różny
түрме - więzienie
түс - kolor
түсініспеушілік - nieporozumienie
түсіну - rozumieć | mieć świadomość
түссіз - bezbarwny
түссіздік - bezbarwność
түтін - dym
түтіндік - dymnik
түтінсіз - bezdymny
тұтынушы - konsument | użytkownik
туыстық - pokrewieństwo | bliskość
тұяқ - kopyto
тұяқты - kopytny
тыңдау - słuchać
тыңдаушы - słuchacz
тыныш - spokojny | spokojnie
тыныштық - cisza | spokój | milczenie
тырна - żuraw
тырнақ - paznokieć | pazur
тышқан - mysz
у - trucizna
уақыт - czas
үбір - wielość | mnogość
үзеңгі - strzemię
ұзын - długi
ұзындық - długość
үй - dom | domowy
ұйғыр - Ujgur
үйеңкі - klon
ұйқысыздық - bezsenność
ұйқышыл - lubiący spać | śpioch
ұйқышылдық - senność
үйрек - kaczka
үйрету - uczyć | tresować
үйретуші - nauczyciel | trener | treser
ұйықтау - spać | spanie
ұйым - organizacja | stowarzyszenie
ұйымдастыру - organizować | organizowanie
ұйымдастырушы - organizator
үкі - sowa | puchacz | przerębel
үкімет - rząd
үкіметаралық - międzyrządowy
ұқыпсыздық - niestaranność | niedbałość | brak uwagi
ұл - syn | chłopiec
үлгі - wzór
үлкен - duży | wielki | starszy | dorosły
ұлт - naród | narodowość
ұлтаралық - międzyetniczny | międzynarodowy
ұлттас - człowiek tej samej narodowości
ұлттық - narodowy | nacjonalny
ұлтшыл - narodowiec | nacjonalista
ұлтшылдық - nacjonalizm
улы - trujący | jadowity
ұлы - wielki
үміт - nadzieja
үмітсіздік - beznadziejność | desperacja
үн - dźwięk | głos
ұн - mąka
ұнау - podobać się | podobanie się
үңгір - jaskinia | pieczara
үңгуші - rębacz
үндемеу - milczeć
Үндінезия - Indonezja
Үндістан - Indie
университет - uniwersytet
ұрлау - kraść | kradnięcie
ұрлық - kradzież | złodziejstwo
ұрлықшы - złodziej
ұрт - policzek
ұры - złodziej
ұрық - nasienie | embrion | płód
ұстаз - nauczyciel | profesor | mistrz
үстел - stół
ұсыну - wręczać | częstować | oferować | proponować | wręczanie | częstowanie | oferowanie | proponowanie
ұсыныс - wręczenie | poczęstunek | oferta | propozycja
үтік - żelazko
үтір - przecinek
үш - trzy
ұшақ - samolot
үшбұрыш - trójkąt
үшін - dla | gwoli | żeby (po formach czasownikowych)
үшінші - trzeci
ұшқыш - lotnik | pilot
ұшу - lecieć | latać
ұя - gniazdo
ұят - wstyd
ұятсыздық - bezwstydność
фабрика - fabryka
философия - filozofia
Финляндия - Finlandia
фирма - firma
Франция - Francja
фруктоза - fruktoza
хабар - wiadomość | wieść | nowina
хабарлау - powiadomić
хабаршы - zwiastun | informator
хайуан - zwierzę | zwierz
халық - lud | ludność | naród
халықаралық - międzynarodowy
хат - list
хаттама - protokół
хатшы - sekretarz
хром - chrom
шабдалы - brzoskwinia
шағала - mewa
шаған - jesion
шағыстырушы - podżegacz | jątrzyciel
шай - herbata
шайқас - bitwa | starcie
шайхана - herbaciarnia
шақ - czas | pora | okres | w sam raz | ledwo
шақыру - wołać | zapraszać | piać
шалбар - spodnie
шалғам - rzodkiewka
шалғышы - żniwiarz
шалшық - kałuża
шам - świeca | lampa | wstyd
шаң - kurz
шана - sanie
шанашы - sankarz | saneczkarz
шаңғы - narty | narciarski
шаңғышы - narciarz
шаңсорғыш - odkurzacz
шаншар - żądło
шанышқы - widelec
шарап - wino
шарбақ - płot
шаршаған - zmęczony
шаш - włosy
шаштараз - zakład fryzjerski
Швеция - Szwecja
шеберхана - warsztat
шегіртке - konik polny | szarańcza
шәйнек - czajnik
шекаралық - pograniczny
шекарашы - wopista
шекер - cukier
Шәңғаң - Hongkong
шетсіз - bezgraniczny | bezkresny
шетсіздік - bezgraniczność
шеше - matka
шие - wiśnia
шиқан - wrzód | czyrak
шілде - lipiec
шіркеу - cerkiew | kościół | woalka
шөл - pustynia | żądza | pragnienie
шолғыншы - zwiadowca
шөлмек - butelka
Шолпан - Wenus | Szołpan
шөнжік - tygrysiątko
шөп - trawa | siano
шопан - owczarz
шортан - szczupak
шошқа - świnia
шүбә - wątpliwość
шүйде - potylica | obuch siekiery
шыбық - młody pęd drzewa | rózga | kość promieniowa
шыбын - mucha
шығанақ - zatoka | zalew
шығарма - utwór | dzieło | wypracowanie
шығармашылық - twórczość
шығарушы - wydawca
шығу - wychodzić | podnosić się | wzrastać | wschodzić | pojawiać się | wychodzenie | wyjeżdżanie | wyłażenie | wchodzenie (na górę) | wschodzenie (słońca, księżyca)
шығыс - wschód | wydatek | wschodni | wyjściowy
шығыс септік - ablatyw
шығыстану - wschodoznawstwo | orientalistyka
шығыстанушы - wschodoznawca | orientalista
шық - rosa
шылау - przysłówek
шын - prawda | prawdziwy
шынашақ - mały palec
шынжыр - łańcuch
шынжырлы - łańcuchowy
шынтақ - łokieć
шырша - świerk
шырын - sok (owocowy)
шырындылық - soczystość
ыдыс - naczynia
ықпал - wpływ | akcent
ылғи - zawsze
ым - znak | gest
ынтымақ - solidarność | zgoda
ынтымақсыздық - rozbieżność | brak zgodności
ысқыру - gwizdać
экономика - gospodarka
элемент - element | pierwiastek
энергия - energia
я - albo | lub
яғни - czyli | to znaczy | to jest
ядролық - jądrowy | atomowy
яки - albo też | lub też
яқут - Jakut | Jakutka
яқутша - jakucki | po jakucku
