빗 - grzebień
입 - buzia, usta
굉 - szeroki, wielki, przestronny, obszerny
위 - – ㅟ
초 - sekunda, sekunda kątowa, świeca, początkowa część odcinka czasu, wczesny okres
붓 - pędzel
딸 - córka
얘 - – ㅒ
토 - ziemia
방 - pokój
돌 - kamień, pierwsze urodziny dziecka
말 - język, mowa, słowo, termin, koń, koniec, końcówka, (jednostka objętości)
금 - złoto
사 - cztery, 4
들 - służy do tworzenia liczby mnogiej, głównie rzeczowników żywotnych
섬 - wyspa
아 - – ㅏ
뭐 - co
의 - – ㅢ
넷 - cztery, 4
회 - zebranie, zgromadzenie
곰 - niedźwiedź
녹 - rdza
병 - butelka
수 - woda
개 - pies
삯 - zarobki za pracę fizyczną wykonywaną ręcznie, opłata za przejazd
와 - – ㅘ, i
천 - tysiąc, 1000
네 - tak, cztery, 4
목 - drzewo
벽 - mur
물 - woda, wodny
톤 - tona (jednostka masy), ton dźwięku, odcień koloru
여 - – ㅕ
저 - tamto, ja
하 - lato
화 - ogień
십 - dziesięć, 10
산 - góra, kwas, produkcja
숲 - las
불 - ogień
이 - to, – ㅣ, dwa, 2
뱀 - wąż
춘 - wiosna
예 - – ㅖ, tak
밤 - kasztan jadalny
윈 - Wiedeń
댐 - tama
밥 - ryż (gotowany)
어 - – ㅓ, język, słowo
꽃 - kwiat
책 - książka
만 - dziesięć tysięcy, 10 000, tylko, jedynie
열 - dziesięć, 10
두 - dwa, 2
왜 - – ㅙ, dlaczego
남 - mężczyzna, syn, południe, inni ludzie, obcy
새 - ptak, nowy
팔 - osiem, 8
셈 - obliczenia, kalkulacje, suma, wynik
귀 - ucho, kosztowność, wartościowy przedmiot
북 - północ, północna część, bęben
팩 - opakowanie, paczka, płyn do demakijażu
견 - pies
우 - – ㅜ
국 - zupa
문 - drzwi
피 - krew
구 - dawny, były, dziewięć, 9
것 - rzecz, przedmiot
오 - – ㅗ, pięć, 5
차 - auto (samochód), herbata
앎 - mądrość, wiedza
집 - dom
둘 - dwa, 2
달 - miesiąc
팬 - fan, kibic, miłośnik, entuzjasta
쪽 - kierunek, strona (na przykład świata), strona w książce, kok (sposób ułożenia włosów), twarz, gęba, chochla
쥐 - mysz
코 - nos
닭 - kurczak, kogut
셋 - trzy, 3
쇠 - złoto, metal
빵 - chleb
술 - alkohol
빈 - Wiedeń
침 - ślina
외 - – ㅚ
흙 - ziemia
팀 - drużyna, zespół
뼈 - kość
햄 - szynka
소 - krowa, bydło
강 - rzeka
추 - jesień
감 - persymona
배 - gruszka
칼 - nóż, pręgierz
나 - ja
워 - – ㅝ
세 - trzy, 3
애 - – ㅐ
백 - sto, 100
도 - też, również, także
혀 - język
발 - stopa
동 - zima
육 - sześć, 6
뇌 - mózg
님 - pan, pani ←
과 - i
값 - cena, wartość
유 - – ㅠ
년 - rok
창 - okno
비 - deszcz
요 - dzień roboczy, – ㅛ
월 - miesiąc, księżyc
원 - won koreański
씨 - pan, pani
꽤 - dość, raczej (na przykład )
형 - starszy brat lub kolega dla mężczyzny, model, wzór, kara, wyrok
손 - ręka, palec, potomek, prawnuk, szkoda, uszkodzenie
그 - to, tamto, on
삼 - trzy, 3
별 - gwiazda
웨 - – ㅞ
봄 - wiosna
해 - Słońce, blask Słońca, rok, morze, rana, uraz, liczba, wartość, liczba o wartości 100.000.000.000.000.000.000 = 10²⁰
분 - osoba
귤 - mandarynka
쇼 - show, pokaz, przedstawienie
양 - owca
너 - ty
으 - – ㅡ
답 - odpowiedź
일 - praca, dzień, słońce, jeden
에 - – ㅔ, do, w
눈 - oko, oczy, wzrok, śnieg, stopień, stopniowanie, pęk, pączek (kwiatu)
칠 - siedem, 7
한 - jeden, 1
흰 - kolor biały
야 - – ㅑ
돈 - pieniądz, pieniądze, waluta
맨 섬 - Wyspa Man
맨 맨어 - język manx
낱말 - słowo, wyraz
토고 - Togo
싸다 - tani
앨범 - album
친밀 - bliskość, zażyłość, przyjaźń
시즌 - sezon, okres, pora, sezon rozgrywek
몽골 - Mongolia
지구 - Ziemia
칠판 - tablica
초딩 - szkoła podstawowa
식구 - rodzina
응답 - odpowiedź
건강 - zdrowie
자신 - sam (osobiście), się, siebie, sobie, pewność siebie
치약 - pasta do zębów
한국 - Korea (półwysep), Korea Południowa
언덕 - pagórek
고기 - mięso, ryba, historyczny (dawny) dokument
에취 - apsik!, a psik!
행복 - szczęście, dobrobyt
직장 - praca, miejsce pracy
이솝 - Ezop
대만 - Tajwan
말리 - Mali
전투 - bitwa, walka
버마 - Birma
허기 - głód
말레 - Male
가야 - Kaya - dawna konfederacja państw z doliny rzeki Nakdong w południowej Korei
누나 - starsza siostra lub koleżanka dla mężczyzny
택시 - taksówka
매너 - maniery, obyczaje, zwyczaje, sposób zachowania
케첩 - keczup
독립 - niepodległość
우리 - my
왕국 - królestwo, imperium
다카 - Dhaka
언니 - starsza siostra lub koleżanka dla kobiety
탈린 - Tallinn
동쪽 - wschód, wschodnia strona
코너 - róg, kąt
알다 - wiedzieć
자살 - samobójstwo
도로 - droga
오이 - ogórek
코트 - płaszcz, palto, kort (np. tenisowy), boisko (np. do koszykówki)
논문 - praca dyplomowa, esej
그림 - obrazek, rysunek
치읓 - – ㅊ
와인 - wino
손님 - gość, klient
그릇 - talerz, naczynie, miska
누이 - młodsza siostra dla mężczyzny
차주 - przyszły tydzień, następny tydzień, właściciel samochodu
트럭 - ciężarówka
활용 - odmiana, koniugacja, deklinacja, użycie
사진 - zdjęcie, fotografia
경찰 - policja
읽다 - czytać
또고 - Togo
중딩 - gimnazjum
은유 - metafora, przenośnia
쉽다 - łatwy, prosty
리듬 - rytm
음절 - sylaba
칠레 - Chile
사전 - słownik
가위 - nożyczki
테러 - terror, terroryzm
그룹 - grupa ludzi
한글 - hangul
북한 - Korea Północna
품삯 - pensja, zarobki
가을 - jesień
지금 - teraz
까벨 - kabel
킬로 - pierwszy człon wyrazów złożonych oznaczający jednostki miary tysiąc razy większe od podstawowych, kilogram
답변 - odpowiedź
구수 - wróg
샤워 - prysznic
일찍 - wcześnie
임금 - pensja, zarobki, monarcha, władca
일곱 - siedem, 7
양말 - skarpetki
헬륨 - hel
키읔 - – ㅋ
여덟 - osiem, 8
디귿 - – ㄷ
결말 - zakończenie, epilog, konkluzja, podsumowanie, efekt, rezultat
히읗 - – ㅎ
의도 - intencja, zamiar
형제 - brat
화학 - chemia
여행 - podróż
마을 - wieś, wioska
코드 - kod, hasło, kod postępowania, zachowania, przewód elektryczny
팬티 - majtki, figi, slipy
아우 - młodszy brat lub kolega dla mężczyzny, młodsza siostra lub koleżanka dla mężczyzny
급료 - pensja, wypłata, zarobki, stypendium
팀부 - Thimphu
가수 - piosenkarz, piosenkarka
군주 - monarcha, suweren, władca
나라 - kraj
먄마 - Myanmar
소년 - chłopiec
공항 - lotnisko
여기 - tu
기역 - ㄱ
라면 - zupa błyskawiczna
생활 - życie, życie codzienne, styl życia
은색 - kolor srebrny
전혀 - w ogóle, wcale
명일 - jutro, święto narodowe, dzień świąteczny, rocznica czyjejś śmierci
사기 - kłamstwo, oszustwo
병원 - szpital
시계 - zegarek
의학 - medycyna
전화 - telefon
여름 - lato
잡지 - czasopismo
윁남 - Wietnam
료금 - opłata
두부 - tofu
시간 - czas
신문 - gazeta
어부 - rybak
이월 - luty
아이 - dziecko
서양 - Zachód, cywilizacja zachodnia
감염 - zakażenie
부분 - część, fragment
관심 - zainteresowanie
딜리 - Dili
날개 - skrzydło
사촌 - kuzyn
이응 - – ㅇ
감옥 - więzienie
발음 - wymowa
패션 - moda
악어 - krokodyl, aligator
동굴 - jaskinia
쿠바 - Kuba
키스 - pocałunek, całus
노력 - wysiłek, praca
대답 - odpowiedź
참새 - wróbel
선생 - nauczyciel
있다 - być, znajdować się, mieć
터널 - tunel
비읍 - – ㅂ
냉면 - naengmyeon
맥주 - piwo
로메 - Lomé
가스 - benzyna, gaz
소파 - kanapa, sofa, skrobanie
호수 - jezioro
물가 - cena, brzeg
설탕 - cukier
채널 - kanał (np. telewizyjny)
비유 - przysłowie, przykład, metafora
도벽 - kleptomania
많다 - wiele, dużo
작일 - wczoraj
치수 - rozmiar, wielkość, wymiar
기름 - olej
기린 - żyrafa
볼펜 - długopis
리터 - litr (jednostka objętości)
자연 - natura
낙타 - wielbłąd
튤립 - tulipan
거기 - tam
파리 - Paryż
구월 - wrzesień
이웃 - sąsiad, sąsiedztwo
산소 - tlen
감자 - ziemniak
오월 - maj
농업 - rolnictwo
담배 - tytoń, papieros
사과 - jabłko
외국 - zagranica, inny kraj
회사 - firma
축구 - piłka nożna
감정 - emocje, odczucia, uczucia, urazy, animozje, ocena, ewaluacja
음식 - jedzenie, potrawa
노화 - starzenie się
부탄 - Bhutan
처자 - panna, młoda kobieta stanu wolnego, żona
누구 - kto
간통 - cudzołóstwo
콜라 - cola
회색 - kolor szary
받다 - dostać
런던 - Londyn
가게 - sklep
하늘 - niebo
암만 - Amman
가격 - cena
미학 - estetyka
철학 - filozofia
유언 - testament, wola
얼음 - lód
엄청 - bardzo, ogromnie, okropnie, strasznie
나물 - namul
나무 - drzewo
도덕 - moralność
이란 - Iran
열쇠 - klucz
벨트 - pas, pasek
저녁 - kolacja, wieczór
평화 - pokój, harmonia, spokój
휴지 - papier toaletowy
오전 - rano, poranek
가구 - rodzina, mebel
수성 - Merkury
공룡 - dinozaur
양파 - cebula
달걀 - jajo
남편 - mąż, małżonek
일월 - styczeń
파란 - kolor niebieski
대륙 - kontynent
구주 - Europa
버터 - masło
류량 - płynność, potok, strumień
수소 - byk, wół, wodór
암유 - metafora, przenośnia
사실 - prawda, fakt
노래 - piosenka
치과 - dentysta
지읒 - – ㅈ
국제 - międzynarodowy
론문 - praca dyplomowa, esej
머슴 - parobek, robotnik rolny, najstarszy syn z rodzeństwa, najstarszy syn w rodzinie (, kor. 제주도 사투리)
아주 - Azja, bardzo, ogromnie, okropnie, strasznie
센티 - centymetr (jednostka długości)
자주 - często, wiele razy, wielokrotnie, autonomia, niepodległość, niezależność, bordowy, śliwkowy, kolor wina
역시 - nareszcie, ostatecznie, zgodnie z przewidywaniami, tak samo, tak jak przedtem, również, także, też
가치 - wartość
모자 - czapka
미래 - przyszłość
한자 - hanja
마늘 - czosnek
어느 - który, jaki
하나 - jeden, 1
맏딸 - najstarsza córka z rodzeństwa, najstarsza córka w rodzinie
팩스 - faks
보라 - kolor fioletowy
남한 - Korea Południowa
그녀 - ona
조선 - Korea (półwysep), Korea Północna
개미 - mrówka
그네 - huśtawka
서쪽 - zachód, zachodnia strona
치즈 - ser
바다 - morze
예문 - przykład, zdanie ilustrujące
군인 - żołnierz
전력 - elektryczność, prąd, całkowita siła, pełna siła, siła militarna, historia, kariera, przebieg kariery, przeszłość
사람 - człowiek, osoba, ludzie, 사람들
얼굴 - twarz
터키 - Turcja
필름 - film (światłoczuła taśma filmowa lub fotograficzna)
창문 - okno
류학 - studia za granicą, studia zagraniczne
당근 - marchew
티읕 - – ㅌ
사랑 - miłość
학년 - rok szkolny, rok akademicki
동생 - młodsze rodzeństwo
해변 - brzeg morza, wybrzeże, plaża
계단 - schody
유월 - czerwiec
오만 - Oman
불교 - buddyzm
봉급 - pensja, zarobki
박학 - erudycja, uczoność
동사 - czasownik
여섯 - sześć, 6
여성 - kobieta
대딩 - uniwersytet
결혼 - małżeństwo
그램 - gram
글피 - za trzy dni
건물 - budynek
우표 - znaczek pocztowy
호주 - Australia
기니 - Gwinea
대학 - uniwersytet, uczelnia wyższa, college
에서 - z, w
가족 - rodzina, domownicy, gospodarstwo domowe
여우 - lis, aktorka
아까 - przed chwilą
롼다 - Rwanda
아침 - śniadanie, ranek, poranek
날씨 - pogoda
혼인 - małżeństwo
노트 - zeszyt, węzeł (jednostka prędkości)
파티 - impreza, party, przyjęcie
미터 - metr (jednostka długości)
아기 - dziecko
적도 - równik
듣다 - słuchać
믿다 - wierzyć, ufać
겨울 - zima
공병 - inżynier
주스 - sok
여자 - kobieta
나비 - motyl
수업 - zajęcia, wykłady
검정 - kolor czarny
밀리 - milimetr (jednostka długości)
분홍 - kolor różowy
사월 - kwiecień
클럽 - klub, stowarzyszenie
찾다 - znaleźć, odnaleźć, szukać, polować, odwiedzać
국가 - państwo, kraj, naród
농구 - koszykówka
거의 - tuż, blisko, prawie
보도 - wiadomości, chodnik
집중 - skupienie, koncentracja
배우 - aktor, aktorka
시장 - bazar, rynek, burmistrz, głód
어디 - gdzie
수영 - pływanie
거위 - gęś
방콕 - Bangkok
주다 - dawać
다섯 - pięć, 5
메일 - mejl, wiadomość e-mailowa, adres e-mail
영화 - film
과학 - nauka
국경 - granica państwa
색시 - panna, młoda kobieta, żona
계란 - jajo
동양 - Orient, Wschód, cywilizacja wschodnia
려행 - podróż
같이 - razem z
누님 - starsza siostra lub koleżanka dla mężczyzny
교복 - mundurek szkolny
방기 - Bangi
세트 - zestaw, komplet
도하 - Ad-Dauha
뷰티 - piękno
몹시 - bardzo, ogromnie, okropnie, strasznie
보다 - widzieć, oglądać, niż od
시월 - październik
인도 - Indie
마차 - karoca
흔히 - często
행동 - zachowanie, zachowywanie się
훨씬 - bardzo, dużo, wiele
딸기 - truskawki, jagody
푼샬 - Funchal (stolica Madery)
지식 - wiedza
음악 - muzyka
기네 - Gwinea
부엌 - kuchnia
거울 - lustro
어제 - wczoraj, dzieło sztuki, przedmiot lub budynek stworzony przez króla
슬픔 - smutek
로화 - starzenie się
은행 - bank, owoce miłorzębu dwuklapowego
자다 - spać
전통 - tradycja
라켓 - rakieta (np. tenisowa)
개성 - Kaesong - miasto w Korei Północnej, dawna stolica
큰딸 - najstarsza córka z rodzeństwa, najstarsza córka w rodzinie
동물 - zwierzę
헌법 - konstytucja
미국 - Stany Zjednoczone
목성 - Jowisz
연필 - ołówek
부정 - negacja, odmowa, przeczenie, sprzeciw, zaprzeczenie, błąd, niesprawiedliwość, nieuczciwość, niewłaściwy czyn, nieokreśloność, niestałość, zmienność, niewierność, brak cnoty
의사 - lekarz
박쥐 - nietoperz
렌즈 - soczewka, obiektyw
연합 - organizacja
종종 - czasami, okazjonalnie, od czasu do czasu, często
주민 - mieszkaniec (miasta, dzielnicy, osiedla), obywatel
금주 - ten tydzień, bieżący tydzień, przestać pić alkohol, rzucić picie alkoholu
갈색 - kolor brązowy
거리 - ulica, droga
물론 - oczywiście
머리 - głowa
교실 - sala wykładowa
게임 - gra
엄마 - mama
없다 - nie być, nie ma, nie mieć
작년 - zeszły rok, w minionym roku
리을 - – ㄹ
먹다 - jeść
무엇 - co
안경 - okulary
지방 - rejon geograficzny, rejony wiejskie, wieś
세계 - świat
친구 - przyjaciel, kolega, przyjaciółka, koleżanka
팔월 - sierpień
쎈터 - centrum (na przykład kultury albo handlowe)
막내 - najmłodsze dziecko z rodzeństwa, najmłodsze dziecko w rodzinie
까치 - sroka
요일 - dzień tygodnia
홍콩 - Hongkong
삼월 - marzec
한복 - hanbok
교수 - profesor, wykładowca
사자 - lew
예수 - Jezus
해안 - brzeg morza, wybrzeże
침대 - łóżko
체코 - Czechy
질문 - pytanie
단어 - słowo, wyraz
코스 - kurs (np. języka obcego), kurs, kierunek ruchu
심장 - serce
시민 - obywatel miasta
천사 - anioł
남자 - mężczyzna
카드 - karta
숙부 - wujek, młodszy brat ojca
작다 - mały, niewielki
많이 - dużo
정의 - definicja, znaczenie, sprawiedliwość
거미 - pająk
기차 - pociąg
사막 - pustynia
백부 - wujek, starszy brat ojca
질소 - azot
윤회 - reinkarnacja
장녀 - najstarsza córka z rodzeństwa, najstarsza córka w rodzinie
태국 - Tajlandia
장남 - najstarszy syn z rodzeństwa, najstarszy syn w rodzinie
련합 - organizacja
비닐 - plastik, winyl
피자 - pizza
마크 - logo, znak
메모 - notatka, wiadomość na kartce, memorandum
조금 - trochę
조급 - niecierpliwość, impulsywność
교사 - nauczyciel, nauczycielka, instruktor, instruktorka
오다 - przychodzić, przybywać, pochodzić
일본 - Japonia
피륙 - ubranie
상어 - rekin
이다 - być (czymś)
비누 - mydło
크다 - duży, wielki, rosnąć, stawać się większym
피읖 - – ㅍ
그제 - przedwczoraj
살다 - żyć, mieszkać
기구 - organizacja
투자 - inwestycja
생일 - urodziny
싸움 - walka
투쟁 - walka, strajk
참다 - dławić, tłumić, wytrzymywać, znosić, tolerować
가끔 - czasami, okazjonalnie, od czasu do czasu
수박 - arbuz
백묵 - kreda
늑대 - wilk
토론 - debata, dyskusja
아홉 - dziewięć, 9
오리 - kaczka
베른 - Berno
가난 - bieda
레몬 - cytryna (owoc), cytryna, drzewo cytrynowe
학급 - klasa szkolna, poziom (rok) nauki
화성 - Mars
몰타 - Malta
교육 - edukacja
새벽 - świt, brzask, rano
학기 - semestr szkolny, semestr akademicki
크기 - rozmiar, wielkość, wymiar
효과 - efekt, rezultat, skutek
청년 - nastolatek, młodzieniec, młodzież, nastolatkowie
구두 - but
종교 - religia
말따 - Malta
권고 - rekomendacja
남쪽 - południe, południowa strona
출산 - poród
네팔 - Nepal
도쿄 - Tokio
하다 - robić
아흔 - dziewięćdziesiąt, 90
숙모 - ciocia, żona młodszego brata ojca
번호 - numer
영국 - Zjednoczone Królestwo
카페 - kafejka, kawiarenka
책상 - biurko
주먹 - pięść
집단 - grupa ludzi
알제 - Algier
모레 - pojutrze
칠월 - lipiec
옷감 - ubranie
백모 - ciocia, żona starszego brata ojca
호텔 - hotel
다리 - most
매우 - bardzo, ogromnie, okropnie, strasznie
아들 - syn
저기 - tam (dalej)
이십 - dwadzieścia, 20
무식 - głupota, ignorancja
내일 - jutro
피시 - komputer osobisty, pecet
아아 - aha
총각 - kawaler, młody mężczyzna stanu wolnego
타이 - Tajlandia
하마 - hipopotam
제도 - archipelag
언어 - język, zbiór słów, reguł gramatycznych, alfabetu, zasad wymowy, umożliwiający porozumiewanie się osób znających ten zbiór
점심 - obiad, lunch
형님 - starszy brat lub kolega dla mężczyzny
가다 - iść
하고 - i
소스 - sos, przyprawa, źródło (wiedzy, informacji)
반쥴 - Bandżul
문법 - gramatyka
공원 - park
유머 - humor, poczucie humoru
이혼 - rozwód
염소 - koza, chlor
과거 - przeszłość
이제 - teraz
아하 - aha (wyrażenie potwierdzenia lub zrozumienia)
학교 - szkoła
의자 - krzesło
래일 - jutro
문신 - tatuaż
매일 - codziennie
아픔 - ból
크림 - krem
차드 - Czad
무척 - bardzo, ogromnie
라인 - linia
딸린 - Tallinn
서울 - Seul, stolica
가방 - torba
부산 - Pusan - miasto portowe w Korei Południowej
옛날 - przeszłości (w), kiedyś, dawno dawno temu
서론 - prolog, przedmowa w książce, wprowadzenie
답장 - odpowiedź
유학 - studia za granicą, studia zagraniczne, konfucjanizm
좋다 - dobry
도시 - miasto
이마 - brew
농민 - chłopi, chłopstwo, lud chłopski
우산 - parasol
팬츠 - majtki, figi, slipy
포크 - widelec
성냥 - zapałka
요금 - opłata
구름 - chmura
페루 - Peru
금색 - kolor złoty
불행 - nieszczęście
이름 - imię, nazwa
맏이 - najstarsze dziecko z rodzeństwa, najstarsze dziecko w rodzinie, dziecko pierworodne
구리 - miedź
뉴스 - wiadomości
가봉 - Gabon
커튼 - zasłona, kurtyna
반도 - półwysep
니은 - – ㄴ
반응 - odpowiedź organizmu na leki lub pożywienie, reakcja
센터 - centrum (na przykład kultury albo handlowe), center, środkowy
책장 - półka na książki
금성 - Wenus
고래 - waleń
박사 - doktor
파일 - plik komputerowy, akta
원수 - wróg
주황 - kolor pomarańczowy
버섯 - grzyb
입다 - ubrać, być ubranym, nosić, cierpieć (손해 • 피해 • 상쳐), doświadczyć, zranić
비행 - lot, latanie, wykroczenie, występek
된장 - doenjang, pasta sojowa
엔진 - silnik
제법 - dość, raczej (na przykład ), przebieg produkcji ręcznej
사다 - kupować
연방 - federacja, związek
챠드 - Czad
리가 - Ryga
태양 - Słońce
학생 - uczeń
버스 - autobus
만두 - rodzaj koreańskiego pieroga
프로 - profesjonalista, fachowiec, procent
련방 - federacja, związek
모래 - piasek
골프 - golf
학살 - masakra
매년 - każdego roku, co roku
평양 - Pjongjang
빠리 - Paryż
환자 - pacjent, chory
중국 - Chiny
유럽 - Europa
이민 - imigracja
미음 - – ㅁ
유량 - płynność, potok, strumień
미니 - minispódniczka
빌딩 - budynek
높다 - wysoki
탱크 - czołg
바지 - spodnie
포도 - winogrono
소설 - powieść
로봇 - robot
급여 - pensja, wypłata, zarobki
도서 - książka
자매 - siostra, siostry
약국 - apteka
박스 - pudło, pudełko
지혜 - mądrość, wiedza, bystrość, przenikliwość, inteligencja
메뉴 - menu (w restauracji), jadłospis, karta z nazwami potraw oferowanych w restauracji, menu (w komputerze), zestawienie funkcji programu
고딩 - liceum
가나 - Ghana
사나 - Sana
정치 - polityka
소금 - sól
랭면 - naengmyeon
카불 - Kabul
국민 - naród, lud, ludzie, obywatel kraju
리그 - liga sportowa, liga, stowarzyszenie
김치 - tradycyjna koreańska potrawa, ostro przyprawiona kiszonka z kapusty pekińskiej
칫솔 - szczoteczka do zębów
복부 - brzuch
조약 - pakt, traktat
시험 - egzamin
과자 - ciasto
말씀 - język, słowo
시디 - płyta kompaktowa, CD
바꾸 - Baku
과일 - owoc
대양 - ocean
토끼 - królik, zając
독일 - Niemcy
아빠 - tata
기술 - technologia
치마 - spódnica, spódnica od hanboku
민주 - demokracja
전쟁 - wojna
바쿠 - Baku
반줄 - Bandżul
편지 - list
거북 - żółw
북쪽 - północ, północna strona
별표 - asterysk
수학 - matematyka
보상 - rekompensata, wynagrodzenie
베냉 - Benin
빨강 - kolor czerwony
돼지 - świnia
전기 - elektryczność, prąd, biografia, historia życia, poprzednia część, poprzednia epoka, poprzednia połowa, punkt zwrotny
수프 - zupa
육십 - sześćdziesiąt, 60
학자 - uczony
무지 - głupota, ignorancja, bardzo, ogromnie, okropnie, strasznie
행성 - planeta
초조 - nerwowość, niecierpliwość, niepokój, porywczość
요즘 - ostatnio
영어 - język angielski
랩탑 - laptop
냄새 - zapach, odór, smród
사회 - społeczeństwo, moderacja dyskusji
예멘 - Jemen
재즈 - jazz
다툼 - walka
치료 - leczenie
시옷 - – ㅅ
케냐 - Kenia
환생 - reinkarnacja
공책 - zeszyt
문화 - kultura
상점 - sklep
배추 - kapusta właściwa pekińska, kapusta pekińska
여든 - 80, osiemdziesiąt
스타 - gwiazda (np. filmowa lub telewizyjna), gwiazda (ciało fizyczne)
로력 - wysiłek, praca
귀인 - atrybucja
레저 - czas wolny
숙녀 - panna, młoda kobieta stanu wolnego
스키 - narciarstwo, narty
대응 - odpowiedź, reakcja, relacja, korespondencja
카레 - curry
모델 - modelka, model, makieta, przykład
지도 - mapa
처녀 - panna, młoda kobieta stanu wolnego
커피 - kawa
코치 - trener
폐지 - abolicja, zniesienie
벤치 - ławka (np. w parku), ławka rezerwowych
노랑 - kolor żółty
남성 - mężczyzna, męski głos
어원 - etymologia
농부 - rolnik
문학 - literatura
오빠 - starszy brat lub kolega dla kobiety
배란 - owulacja, jajeczkowanie
전차 - tramwaj, czołg
베닌 - Benin
우유 - mleko
남색 - kolor granatowy
수라 - sura
종이 - papier
미스 - panna, młoda kobieta stanu wolnego, zwrot do młodej kobiety
애인 - sympatia, chłopak (czyjś), dziewczyna
금일 - dzisiaj, dziś
연못 - staw
오늘 - dzisiaj, dziś
오븐 - piec, piekarnik
군도 - archipelag
쇼핑 - zakupy
식당 - restauracja
공기 - powietrze, gonggi
천국 - raj, niebo
보수 - pensja, wynagrodzenie, zarobki, konserwatyzm, naprawiać
미술 - sztuka
수단 - Sudan
로마 - Rzym
녹색 - kolor zielony
이미 - już
부인 - żona
얼마 - ile, ilość
저지 섬 - Jersey
이번 주 - ten tydzień, bieżący tydzień
건지 섬 - Guernsey
다음 주 - przyszły tydzień, następny tydzień
페로 제도 - Wyspy Owcze
국제 연합 - Organizacja Narodów Zjednoczonych, ONZ
채널 제도 - Wyspy Normandzkie
대학 강사 - wykładowca wyższej uczelni
치과 의사 - dentysta
우리 은하 - Droga Mleczna
운동 선수 - sportowiec, zawodnik
유럽 연합 - Unia Europejska
독립 국가 연합 - Wspólnota Niepodległych Państw, WNP
페로 페로어 - język farerski
택시 운전사 - taksówkarz
체코 공화국 - Republika Czeska
워드 프로세서 - elektroniczny przetwarzacz tekstów, word processor
하라레 - Harare
차림표 - menu (w restauracji), jadłospis, karta z nazwami potraw oferowanych w restauracji
대학교 - uniwersytet, uczelnia wyższa, college
예레반 - Erywań
개고기 - mięso z psa
레바논 - Liban
전통적 - tradycyjny
지난주 - zeszły tydzień, poprzedni tydzień
일본어 - język japoński
베이징 - Pekin
배우다 - uczyć się
메시지 - wiadomość, wieść
테이블 - stół, biurko
피아노 - pianino, fortepian
프랑스 - Francja
여학생 - uczennica
견디다 - wytrzymywać, znosić, tolerować
보내다 - wysyłać, słać, spędzać czas
티브이 - telewizja, telewizor
만나다 - spotkać
타이어 - język tajski
알제리 - Algieria
부룬디 - Burundi
온라인 - online, w sieci, internetowy, sieciowy
어저께 - wczoraj
인내력 - cierpliwość, wytrwałość, wytrzymałość
꼬모르 - Komory
천문학 - astronomia
참고서 - podręcznik
물고기 - ryba
보너스 - bonus, bonifikata
적갈색 - kolor bordowy
챔피언 - mistrz, czempion
몰디브 - Malediwy
무신론 - ateizm
바닷가 - brzeg morza, wybrzeże, plaża
말라위 - Malawi
안테나 - antena
프린터 - drukarka
파나마 - Dominika
아이구 - a, ojej
삼작일 - trzy dni temu, przedprzedwczoraj
사냥꾼 - myśliwy
기관병 - strażak
클래식 - klasyka, klasyczny
바두쯔 - Vaduz
사회적 - społeczny
녀대생 - studentka uniwersytetu, kobieta podejmująca studia na uczelni wyższej
때때로 - czasami, okazjonalnie, od czasu do czasu
비디오 - wideo, magnetowid
가깝다 - bliski, nieodległy
니제르 - Niger
대서양 - Ocean Atlantycki, Atlantyk
두샨베 - Duszanbe
더블린 - Dublin
오슬로 - Oslo
토요일 - sobota
모로니 - Moroni
강아지 - szczenię, szczeniak
인터넷 - internet
알자스 - Alzacja
화요일 - wtorek
가톨릭 - katolicyzm, religia rzymskokatolicka, katolik, wyznawca katolicyzmu
불고기 - bulgogi
일하다 - pracować
햄버거 - hamburger
외우다 - uczyć się na pamięć, znać na pamięć
우체국 - poczta, urząd pocztowy
비둘기 - gołąb
코모로 - Komory
몽골어 - język mongolski
쌍기역 - – ㄲ
감정적 - emocjonalny, uczuciowy
요르단 - Jordania
자장면 - jajangmyeon
케니아 - Kenia
스코페 - Skopje
외국인 - obcokrajowiec
고맙다 - dziękować
계시다 - być, znajdować się, mieć
이집트 - Egipt
포인트 - punkt, wynik punktowy, punkt (na przykład w meczu sportowym), ważna kwestia
버티다 - wytrzymywać, znosić, tolerować
지리학 - geografia
탤런트 - talent, zdolność, aktor, aktorka, osobowość telewizyjna
다까르 - Dakar
양봉가 - pszczelarz
전환점 - punkt zwrotny
워크맨 - walkman
감비아 - Gambia
스위스 - Szwajcaria
카이로 - Kair
영양학 - dietetyka
가볍다 - lekki
베를린 - Berlin
베이지 - kolor beżowy
발티카 - Bałtyka
어머니 - matka
발명가 - wynalazca
머리말 - prolog, przedmowa w książce
아테네 - Ateny
까메룬 - Kamerun
앙골라 - Angola
수리남 - Surinam
포스터 - plakat
라디오 - radio
동양인 - człowiek Wschodu, mieszkaniec cywilizacji wschodniej
집단적 - kolektywny, grupowy, zbiorowy
에뛰드 - etiuda
연꽃과 - lotos
벨기에 - Belgia
여대생 - studentka uniwersytetu, kobieta podejmująca studia na uczelni wyższej
티라나 - Tirana
중학생 - uczeń gimnazjum
매스컴 - media, mass media, środki masowego przekazu
코뿔소 - nosorożec
넥타이 - krawat
까타르 - Katar
시리즈 - seria, cykl
루안다 - Luanda
레이저 - laser
디자인 - projektowanie, projekt, szkic
아니다 - nie być (czymś)
바다가 - brzeg morza, wybrzeże, plaża
잠비아 - Zambia
마세루 - Maseru
쌍비읍 - – ㅃ
노트북 - notebook
맏아들 - najstarszy syn z rodzeństwa, najstarszy syn w rodzinie
목요일 - czwartek
간호사 - pielęgniarka
유학생 - student z zagranicy, student zagraniczny
힘쓰다 - podejmować wysiłek
카메라 - aparat fotograficzny
관광객 - turysta, podróżnik, zwiedzający
려행자 - podróżnik
아크라 - Akra
고양이 - kot
월요일 - poniedziałek
아시아 - Azja
사이즈 - rozmiar, wielkość, wymiar
성급함 - niecierpliwość, impulsywność
비빔밥 - bibimbap
도서관 - biblioteka
빠르다 - szybki
부정적 - negatywny, pesymistyczny
씨디롬 - CD-ROM
프라하 - Praga
돌고래 - delfin
형용사 - przymiotnik
자주색 - kolor purpurowy
식생활 - dieta, nawyki żywieniowe
대통령 - prezydent
라운드 - runda (np. w boksie lub w golfie)
배고픔 - głód
테니스 - tenis
자동차 - samochód
스위치 - przełącznik, zwrotnica
브류쎌 - Bruksela
니아메 - Niamey
레소토 - Lesotho
앙까라 - Ankara
인디아 - Indie
모르다 - nie wiedzieć, nie znać
수상자 - zdobywca nagrody, laureat nagrody, zwycięzca
마로끄 - Maroko
쏘피아 - Sofia
퍼센트 - procent
쌍지읒 - – ㅉ
다투다 - kłócić się, spierać się, walczyć, konkurować, walczyć o zwycięstwo
벨리즈 - Belize
파두츠 - Vaduz
바마코 - Bamako
그리핀 - gryf
오페라 - opera
캐릭터 - charakter, osobowość
에너지 - energia
국민적 - narodowy
덴마크 - Dania
미얀마 - Myanmar
남학생 - uczeń płci męskiej
소고기 - wołowina, mięso wołowe
개구리 - żaba
무지개 - tęcza
토론회 - klub dyskusyjny
중학교 - gimnazjum, liceum, szkoła średnia
왈레따 - Valletta
컨디션 - kondycja (fizyczna lub psychiczna)
그저께 - przedwczoraj
마닐라 - Manila
바나나 - banan
여행사 - biuro podróży, agencja turystyczna
대학원 - wydział uczelni oferujący studia magisterskie i kursy podyplomowe (ang. )
디스크 - twardy dysk, płyta, album, dysk, część kręgosłupa łącząca dwa kręgi
테이프 - taśma magnetyczna
발레타 - Valletta
네팔어 - język nepalski
시리아 - Syria
서양인 - człowiek Zachodu, mieszkaniec cywilizacji zachodniej
막내딸 - najmłodsza córka z rodzeństwa, najmłodsza córka w rodzinie
키갈리 - Kigali
월드컵 - Puchar Świata, Mistrzostwa Świata
핀란드 - Finlandia
여동생 - młodsza siostra
리야드 - Rijad
어둡다 - ciemny, ponury
나쁘다 - zły, niedobry
비싸다 - drogi
태국어 - język tajski
말하다 - mówić, opowiadać, powiedzieć
마카오 - Makau
코소보 - Kosowo
세네갈 - Senegal
여행자 - podróżnik
회사원 - pracownik firmy
브랜드 - marka produktu
사회자 - przewodniczący organizacji społecznej lub społeczności, moderator dyskusji
비사우 - Bissau
갑자기 - nagle, niespodziewanie
맺음말 - zakończenie książki lub listu, epilog, podsumowanie
뽈스까 - Polska
공화국 - republika
미술가 - artysta
리비아 - Libia
대학생 - student, studentka
캐나다 - Kanada
앙카라 - Ankara
힌디어 - język hindi
페인트 - farba, zwód
결혼식 - wesele, ślub, ceremonia ślubna
오렌지 - pomarańcza
바하마 - Bahamy
시디롬 - płyta CD, dysk kompaktowy
그끄제 - trzy dni temu, przedprzedwczoraj
간호원 - pielęgniarka
윌뉴스 - Wilno
어렵다 - trudny
남동생 - młodszy brat
컴퓨터 - komputer
캄보쟈 - Kambodża
마요트 - Majotta
만두국 - manduguk
당기다 - ciągnąć, wyciągać, szarpać, odrywać, napinać, naprężać, chodzić, uczęszczać
샐러드 - sałatka
릴롱궤 - Lilongwe
터키어 - język turecki
아부쟈 - Abudża
려행사 - biuro podróży, agencja turystyczna
쌍시옷 - – ㅆ
필리핀 - Filipiny
아부자 - Abudża
헬싱키 - Helsinki
통사론 - syntaktyka, składnia
르완다 - Rwanda
로터리 - rondo, skrzyżowanie o ruchu okrężnym
생활적 - życiowy, dotyczący życia
인터뷰 - wywiad, rozmowa kwalifikacyjna
대부분 - większość
라오스 - Laos
부분적 - częściowy, fragmentaryczny
프놈펜 - Phnom Penh
만년필 - wieczne pióro
삼명일 - za trzy dni
스웨터 - sweter
고인돌 - dolmen
헝가리 - Węgry
오늘날 - dzisiaj, dziś
그리스 - Grecja
라바트 - Rabat
지부티 - Dżibuti
댕기다 - zapalić ogień, wzniecić ogień, zająć się ogniem, ciągnąć, szarpać, chodzić, uczęszczać, wiązać, związywać
올슈틴 - Olsztyn
웨일스 - Walia
밤하늘 - nocne niebo, wieczorne niebo
고프다 - być pustym, głodnym
코끼리 - słoń
야운데 - Jaunde
소학교 - szkoła podstawowa
소설가 - powieściopisarz, powieściopisarka
고구마 - słodki ziemniak, batat, patat
거짓말 - kłamstwo
스케줄 - harmonogram
금요일 - piątek
바레인 - Bahrajn
녀동생 - młodsza siostra
체스꼬 - Czechy
박물관 - muzeum
예쁘다 - ładny, piękny
아가씨 - panna, młoda kobieta stanu wolnego, zwrot do młodej kobiety
냉장고 - lodówka
캠퍼스 - kampus uniwersytecki
스웨덴 - Szwecja
영화관 - kino
마나마 - Manama
소피아 - Sofia
쿠데타 - zamach stanu
카루툼 - Chartum
일요일 - niedziela
답하다 - odpowiadać, udzielać odpowiedzi
다카르 - Dakar
그리고 - i
전투력 - siła militarna, zdolność do walki
하르툼 - Chartum
튀니스 - Tunis
안락사 - eutanazja
표준어 - standardowy język koreański w Korei Południowej
인도양 - Ocean Indyjski
구라파 - Europa
우라늄 - uran
태평양 - Ocean Spokojny, Pacyfik
지우개 - gumka
수리아 - Syria
유제품 - nabiał
얼룩말 - zebra
뜌니지 - Tunezja
한국어 - język koreański
케이크 - ciasto
미디어 - media
그래픽 - grafika
리롱웨 - Lilongwe
테헤란 - Teheran
라이벌 - rywal, konkurent
베트남 - Wietnam
마쟈르 - Węgry
마뿌또 - Maputo
디스켓 - dyskietka
시멘트 - cement
사람들 - ludzie
안도라 - Andora (państwo)
아버지 - ojciec
토마토 - pomidor
핸드백 - torebka
새롭다 - nowy, świeży
문화어 - standardowy język koreański w Korei Północnej
부럽다 - zazdrosny
자신감 - poczucie pewności siebie
웨이터 - kelner, kelnerka
위스키 - whisky
방코크 - Bangkok
골프장 - pole golfowe
손가락 - palec
카톨릭 - katolicyzm, religia rzymskokatolicka, katolik, wyznawca katolicyzmu
태양계 - Układ Słoneczny
떠나다 - wyruszyć, opuścić miejsce, pójść, pojechać, odejść, odjechać, wyjechać
올림픽 - olimpiada, igrzyska olimpijskie
아세아 - Azja
입천장 - podniebienie
뉴델리 - Nowe Delhi
로씨야 - Rosja
비타민 - witamina
비첸차 - Vicenza (miasto)
멜리야 - Melilla
알파벳 - alfabet
비행기 - samolot, statek powietrzny
학생증 - legitymacja uczniowska, legitymacja studencka
세미나 - seminarium
끼예브 - Kijów
브뤼셀 - Bruksela
사나이 - mężczyzna
브라질 - Brazylia
식단표 - menu (w restauracji), jadłospis, karta z nazwami potraw oferowanych w restauracji
상당히 - dużo, sporo, znacznie
중국어 - język chiński
캠페인 - kampania (np. wyborcza lub wojenna)
라이터 - zapalniczka
고질라 - Godzilla
승강기 - winda
도도마 - Dodoma
문화재 - dobra kultury, skarby kultury
십일월 - listopad
빈번히 - często
콤퓨터 - komputer
세우타 - Ceuta
언어학 - językoznawstwo, lingwistyka
유니콘 - jednorożec
미사일 - pocisk, rakieta
아랍어 - język arabski
몰타어 - język maltański
꼬쏘보 - Kosowo
아파트 - blok mieszkalny, apartamentowiec, apartament, mieszkanie
튀니지 - Tunezja
말디브 - Malediwy
비싸우 - Bissau
원피스 - jednoczęściowa sukienka
까마귀 - kruk, wrona
민주화 - demokratyzacja
가솔린 - benzyna
복사기 - kserokopiarka
몰도바 - Mołdawia
오라비 - starszy brat lub kolega dla kobiety
옥수수 - kukurydza
모니터 - monitor
쓰레기 - śmieci
국가적 - narodowy
류학생 - student z zagranicy, student zagraniczny
문화적 - kulturalny, kulturowy
스포츠 - sport
하노이 - Hanoi
다람쥐 - wiewiórka
교과서 - podręcznik
멧되지 - dzik
십이월 - grudzień
자전거 - rower
텍스트 - tekst, podręcznik
드라마 - dramat, opera mydlana
버마어 - język birmański
생활비 - koszty życia
두려움 - strach, lęk, przerażenie
닭고기 - mięso z kurczaka
말라보 - Malabo
큰아들 - najstarszy syn z rodzeństwa, najstarszy syn w rodzinie
참을성 - cierpliwość, wytrwałość, wytrzymałość
포도주 - wino
되찾다 - odnaleźć, odzyskać zagubioną rzecz
이라크 - Irak
물리학 - fizyka
토론자 - uczestnik debaty, dyskutant
스페인 - Hiszpania
대단히 - bardzo, ogromnie, wielce
라오어 - język laotański
세탁기 - pralka
케이블 - kabel
오라범 - starszy brat lub kolega dla kobiety
배부름 - sytość, uczucie sytości
멕시코 - Meksyk
원숭이 - małpa
해부학 - anatomia
핸드폰 - telefon komórkowy, przenośny telefon
리스본 - Lizbona
스타일 - styl
에르븀 - erb
윗사람 - osoba o wyższym (od mówiącego) statusie społecznym, majątkowym lub zawodowym
단고기 - mięso z psa
루사카 - Lusaka
동성애 - homoseksualizm
쌍디귿 - – ㄸ
무겁다 - ciężki
인내심 - cierpliwość, wytrwałość, wytrzymałość
스키장 - miejscowość narciarska
가이드 - przewodnik (np. wycieczki)
끝맺음 - zakończenie listu, epilog
시금치 - szpinak
이야기 - opowieść, przypowieść, anegdota, historia
카타르 - Katar
독수리 - orzeł
아프다 - bolesny, boleć
놓치다 - przegapić, przeoczyć, stracić (na przykład okazję, szansę), chybić, spóźnić się
우간다 - Uganda
다리미 - żelazko
독일어 - język niemiecki
윤리학 - etyka
가부키 - kabuki
민주적 - demokratyczny
이따가 - później
숟가락 - łyżka
애쓰다 - czynić wysiłek dla osiągnięcia jakiegoś celu, wysilać się, wytężyć siły
광천수 - woda mineralna
서비스 - serwis, usługa
키예프 - Kijów
시스템 - system
녀학생 - uczennica
수요일 - środa
킨샤사 - Kinszasa
러시아 - Rosja
열심히 - pilnie
주차장 - parking
복부의 - brzuszny
조선어 - język koreański
체코어 - język czeski
프놈뻰 - Phnom Penh
카운터 - kasa, licznik
사생활 - życie prywatne
벨지끄 - Belgia
에어컨 - klimatyzacja
소시지 - kiełbasa
화장실 - toaleta
캄팔라 - Kampala
커피숍 - kawiarnia ( coffee shop)
세이쉘 - Seszele
아이티 - Haiti
쇠고기 - wołowina, mięso wołowe
빌뉴스 - Wilno
나폴리 - Neapol
바티칸 - Watykan
해마다 - co roku, każdego roku
터미널 - terminal (na przykład autobusowy, lotniczy)
네피도 - Naypyidaw
이따금 - czasami, okazjonalnie, od czasu do czasu
초콜릿 - czekolada
테스트 - test, egzamin, badanie, eksperyment
포즈난 - Poznań
할머니 - babcia, zwrot do starej kobiety
스스로 - sam, siebie
호랑이 - tygrys
민스크 - Mińsk
자르다 - ciąć, kroić
모로코 - Maroko
에짚트 - Egipt
삼각형 - trójkąt
복숭아 - brzoskwinia (owoc)
데이트 - randka
세이셸 - Seszele
카메룬 - Kamerun
에이레 - Irlandia
기계공 - mechanik
모나꼬 - Monako
청소부 - sprzątacz, sprzątaczka
콘서트 - koncert
마푸투 - Maputo
생물학 - biologia
뜌니스 - Tunis
마시다 - pić
리뜨바 - Litwa
모나코 - Monako
티베트 - Tybet
아니요 - nie
티셔츠 - koszulka, podkoszulek, t-shirt
사회학 - socjologia, nauka o społeczeństwie
폴란드 - Polska
영화제 - festiwal filmowy
끼갈리 - Kigali
마이크 - mikrofon
얀마옌 섬 - Jan Mayen
다다음 주 - za dwa tygodnie
비스와 강 - Wisła
러시아 연방 - Federacja Rosyjska
하와이 제도 - Hawaje
올란드 제도 - Wyspy Alandzkie
상대성 이론 - teoria względności
유치원 교사 - przedszkolanka
그래픽 카드 - karta graficzna
안녕히 계세요 - do widzenia (w stosunku do osoby zostającej,  pozostań w spokoju)
콤팩트 디스크 - płyta kompaktowa, CD
안녕히 가세요 - do widzenia (w stosunku do osoby idącej,  idź w spokoju)
플로피 디스크 - dyskietka
영국령 인도양 지역 - Brytyjskie Terytorium Oceanu Indyjskiego
플로피 디스크 드라이브 - stacja dyskietek
토론되다 - debatować, dyskutować, podejmować dyskusję, odbyć się
베트남어 - język wietnamski
자카르타 - Dżakarta
스트레스 - stres
싱가포르 - Singapur
민주꽁고 - Demokratyczna Republika Konga
아나운서 - prezenter (radiowy lub telewizyjny), spiker
프리타운 - Freetown
스웨덴어 - język szwedzki
응답하다 - odpowiadać, udzielać odpowiedzi
벨라루씨 - Białoruś
비슈께크 - Biszkek
모리셔스 - Mauritius
누악쇼뜨 - Nawakszut
아메라카 - Ameryka
브라자빌 - Brazzaville
아부다비 - Abu Zabi
헝가리어 - język węgierski
쾨뻰하븐 - Kopenhaga
류블랴나 - Lublana
기니피그 - świnka morska
은자메나 - Ndżamena
키시너우 - Kiszyniów
이혼하다 - rozwieść się, wziąć rozwód
외할머니 - babcia od strony matki, matka matki
학교생활 - życie szkolne, życie szkoły
전통문화 - kultura tradycyjna
자메이카 - Jamajka
알바니아 - Albania
브르네이 - Brunei
배고프다 - głodny
라트비아 - Łotwa
해외려행 - podróż zagraniczna
불가리아 - Bułgaria
보츠와나 - Botswana
로력하다 - czynić wysiłek dla osiągnięcia jakiegoś celu, podejmować wysiłek, wytężyć siły, pracować
인내하다 - cierpliwy, wytrwały, wytrzymały
짐바브웨 - Zimbabwe
필리핀어 - język filipino
타슈켄트 - Taszkent
스튜디오 - studio
비슈케크 - Biszkek
피곤하다 - zmęczony, wyczerpany, znużony
바그다드 - Bagdad
따슈껜뜨 - Taszkent
컨버터블 - kabriolet
지브롤터 - Gibraltar
누악쇼트 - Nawakszut
투자하다 - inwestować
가이아나 - Gujana
노른자위 - żółtko
폴란드어 - język polski
영화배우 - aktor, aktorka
잉글랜드 - Anglia
손윗사람 - osoba o wyższym (od mówiącego) statusie społecznym, majątkowym lub zawodowym
메커니즘 - mechanizm
기다리다 - czekać
가난하다 - biedny, ubogi
그레나다 - Grenada
헤리콥터 - helikopter
자그레브 - Zagrzeb
크메르어 - język khmerski
에스빠냐 - Hiszpania
빅토리아 - Victoria
에네르기 - energia
우루과이 - Urugwaj
로므니아 - Rumunia
바이올린 - skrzypce
스톡홀름 - Sztokholm
벨라루스 - Białoruś
뜨빌리씨 - Tbilisi
핀란드어 - język fiński
시작하다 - zaczynać, rozpoczynać
대중문화 - kultura popularna
오토바이 - motor
프라이아 - Praia
그리스어 - język grecki
공부하다 - uczyć się
샌드위치 - kanapka, sandwich
콤플렉스 - kompleks (np. niższości)
유명하다 - sławny, znany
파라과이 - Paragwaj
빈번하다 - częsty, być częstym
베수비오 - Wezuwiusz
텔레비죤 - telewizja
나미비아 - Namibia
신경과학 - neurobiologia
대답하다 - odpowiadać, udzielać odpowiedzi
브루나이 - Brunei
루마니아 - Rumunia
센티미터 - centymetr (jednostka długości)
프로그램 - program komputerowy, program telewizyjny, program edukacyjny, plan
아스타나 - Astana
타이베이 - Tajpej
텔레비전 - telewizja
찾아오다 - odwiedzać, składać wizytę, wpadać do kogoś
압하지야 - Abchazja
디마스끄 - Damaszek
캄보디아 - Kambodża
감사하다 - dziękować
신혼려행 - podróż poślubna
이탈리아 - Włochy
모가디슈 - Mogadiszu
모터찌클 - motor
재미있다 - interesujący
쿠웨이트 - Kuwejt
전화번호 - numer (telefonu)
작아지다 - stać się małym, zmniejszyć się (dot. wzrostu)
사회생활 - życie społeczne, życie w społeczeństwie
모가디쇼 - Mogadiszu
시오니즘 - syjonizm
부정하다 - negować, zaprzeczać, niesprawiedliwy, nieuczciwy, niewierny
모스크바 - Moskwa
가마우지 - kormoran
에스파냐 - Hiszpania
과식주의 - frutarianizm
생활수준 - poziom życia, standard życia
베이루트 - Bejrut
밀리그램 - miligram
큰어머니 - żona starszego brata ojca
여행하다 - podróżować
꼬나크리 - Konakry
티베트어 - język tybetański
바이루트 - Bejrut
찾아내다 - odkryć, odnaleźć, wynaleźć
모잠비크 - Mozambik (państwo)
모잠비끄 - Mozambik (państwo)
포르투갈 - Portugalia
초조하다 - nerwowy, niecierpliwy, niespokojny, porywczy
적도기네 - Gwinea Równikowa
끼쉬뇨브 - Kiszyniów
노력하다 - czynić wysiłek dla osiągnięcia jakiegoś celu, podejmować wysiłek, wytężyć siły, pracować
채식주의 - wegetarianizm
네덜란드 - Holandia (Niderlandy)
불행하다 - nieszczęśliwy
플라스틱 - plastik
일상생활 - życie codzienne
여보세요 - halo
에든버러 - Edynburg
아일랜드 - Irlandia
리베리아 - Liberia
와르샤와 - Warszawa
트리폴리 - Trypolis
우르두어 - język urdu
성급하다 - impulsywny, niecierpliwy, nierozważny, pochopny, zawadiacki
킬로미터 - kilometr
킬로그램 - kilogram
전화하다 - dzwonić, telefonować
카자흐어 - język kazachski
소말리아 - Somalia
사회주의 - socjalizm, ideologia socjalistyczna
스웨리예 - Szwecja
밀리미터 - milimetr (jednostka długości)
아이디어 - idea, myśl, pomysł
오피스텔 - mały apartament
니카라과 - Nikaragua
부줌부라 - Bużumbura
이슬란드 - Islandia
따사롭다 - ciepły
대단하다 - ogromny, wielki, poważny (w znaczeniu: )
모리타니 - Mauretania
스꼬삐에 - Skopje
드문드문 - czasami, okazjonalnie, od czasu do czasu, cienko, niegęsto, rzadko
치료하다 - leczyć
해외여행 - podróż zagraniczna
사회복지 - opieka społeczna
생활용품 - przedmioty codziennego użytku
와가두구 - Wagadugu
프랑스어 - język francuski
좋아지다 - polepszyć się, poprawić się, stać się dobrym, polubić
보쯔와나 - Botswana
볼리비아 - Boliwia
니코시아 - Nikozja
요구르트 - jogurt
덴마크어 - język duński
아스마라 - Asmara
막내아들 - najmłodszy syn z rodzeństwa, najmłodszy syn w rodzinie
바이러스 - wirus
탄자니아 - Tanzania
토론하다 - debatować, dyskutować
과테말라 - Gwatemala
뛰르끼예 - Turcja
좋아하다 - lubić
고등학교 - liceum
쟈까르따 - Dżakarta
민주주의 - demokracja, ideologia demokratyczna
펀자브어 - język pendżabski
리브르빌 - Libreville
동티모르 - Timor Wschodni
할아버지 - dziadek, zwrot do starego mężczyzny
스리랑카 - Sri Lanka
찾아보다 - szukać, próbować znaleźć, odkryć, wynaleźć
피츠버그 - Pittsburgh (stolica Allegheny)
위키백과 - Wikipedia
뉴질랜드 - Nowa Zelandia
이딸리아 - Włochy
산마리노 - San Marino (państwo), San Marino (miasto)
알까히라 - Kair
고슴도치 - jeż
전화카드 - karta telefoniczna
콜롬비아 - Kolumbia
사라예보 - Sarajewo
대한민국 - Republika Korei
벨파스트 - Belfast
싸라예보 - Sarajewo
홈페이지 - strona główna (w internecie)
레스토랑 - restauracja
배부르다 - najedzony, syty, ciężarna, będąca w ciąży
라뜨비야 - Łotwa
비엔티안 - Wientian
건강하다 - zdrowy
결혼하다 - wziąć ślub, ożenić się, wyjść za mąż
찾아가다 - odwiedzać, złożyć wizytę
무지무지 - bardzo, ogromnie, okropnie, strasznie
윈드후크 - Windhuk
모리따니 - Mauretania
신혼여행 - podróż poślubna
돼지고기 - wieprzowina, mięso ze świni
번거롭다 - nieporęczny, niewygodny, uciążliwy
비거니즘 - weganizm
모래상자 - piaskownica
히브리어 - język hebrajski
몰도바어 - język mołdawski
몬로비아 - Monrovia
온두라스 - Honduras
시나리오 - scenariusz
타지크어 - język tadżycki
인민학교 - szkoła podstawowa
빈트후크 - Windhuk
무스카트 - Maskat
벌가리아 - Bułgaria
프럭토스 - fruktoza
초등학교 - szkoła podstawowa
그루지야 - Gruzja
중화민국 - Republika Chińska
러시아어 - język rosyjski
가보로네 - Gaborone
오라버님 - starszy brat lub kolega dla kobiety
오라버니 - starszy brat lub kolega dla kobiety
방문하다 - odwiedzać, składać wizytę
다이어트 - dieta, odżywianie
노르웨이 - Norwegia
샤머니즘 - szamanizm
그만하다 - przestać, zakończyć, rzucić
코펜하겐 - Kopenhaga
려행하다 - podróżować
쇼비니즘 - szowinizm
질문하다 - pytać
아스팔트 - asfalt
노래하다 - śpiewać
쓰레기통 - śmietnik, kosz na śmieci
일석이조 - upiec dwie pieczenie na jednym ogniu
아프리카 - Afryka
생활환경 - środowisko życia, otoczenie życiowe
생각하다 - myśleć
와이셔츠 - koszula do smokingu
단마르크 - Dania
스케이트 - łyżwiarstwo, łyżwy, wrotki
키프로스 - Cypr
느쟈메나 - Ndżamena
세르비아 - Serbia
가져오다 - przynieść
도전하다 - podejmować wyzwanie
아랫사람 - podwładny, osoba o niższym statusie społecznym, majątkowym lub zawodowym
초등학생 - uczeń szkoły podstawowej
스페인어 - język hiszpański
큰아버지 - wujek, starszy brat ojca
알루미늄 - glin
바르샤바 - Warszawa
까뜨만두 - Katmandu
말레이어 - język malajski
행복하다 - szczęśliwy
예루살렘 - Jerozolima
코스모스 - kosmos
트빌리시 - Tbilisi
나이로비 - Nairobi
타라불스 - Trypolis
뽀르뚜갈 - Portugalia
파키스탄 - Pakistan
글리세롤 - glicerol, gliceryna
조급하다 - niecierpliwy
끼쁘로스 - Cypr
팩시밀리 - faks
이스라엘 - Izrael
사회하다 - przewodniczyć organizacji społecznej lub społeczności, moderować dyskusję
전투하다 - toczyć bitwę, walczyć
갑작변이 - mutacja
그끄저께 - trzy dni temu, przedprzedwczoraj
레프코샤 - Nikozja
번역하다 - tłumaczyć (pisemnie), przekładać z jednego języka na drugi
하드웨어 - sprzęt komputerowy, materialna część komputera
마리에함 - Maarianhamina
마요네즈 - majonez
사랑하다 - kochać
음바바네 - Mbabane
서사하라 - Sahara Zachodnia
막내둥이 - najmłodsze dziecko z rodzeństwa, najmłodsze dziecko w rodzinie
부드럽다 - miękki, łagodny
지지난주 - dwa tygodnie temu
마드리드 - Madryt
미안하다 - przepraszać
레위니옹 - Reunion
대학교수 - profesor uniwersytetu, wykładowca akademicki
적도기니 - Gwinea Równikowa
생활하다 - żyć
대학원생 - student, studentka studiów magisterskich lub podyplomowych
고등학생 - uczeń liceum
코나크리 - Konakry
카트만두 - Katmandu
쎄르비야 - Serbia
대브리텐 및 북아일랜드 련합왕국 - Zjednoczone Królestwo Wielkiej Brytanii i Irlandii Północnej
스발바르 제도 - Svalbard
카나리아 제도 - Wyspy Kanaryjskie
아소르스 제도 - Azory
카탈루냐 지방 - Katalonia
마데이라 제도 - Madera
아조레스 제도 - Azory
북대서양 조약 기구 - Organizacja Traktatu Północnoatlantyckiego, NATO
그레이트 브리튼 북아일랜드 연합 왕국 - Zjednoczone Królestwo Wielkiej Brytanii i Irlandii Północnej
원숭이도 나무에서 떨어질 때가 있다 - nawet małpy czasami spadają z drzewa
보스니아 헤르체고비나 - Bośnia i Hercegowina
보스니아 헤르쩨고비나 - Bośnia i Hercegowina
벨라루스어 - język białoruski
아시가바트 - Aszchabad
쯔르나고라 - Czarnogóra
오스트리아 - Austria
토르스하운 - Thorshavn
슬로베니아 - Słowenia
아브하지야 - Abchazja
찾아다니다 - odwiedzać, składać wizytę, szukać
보스니아어 - język bośniacki
룩셈부르크 - Luksemburg (państwo), Luksemburg (miasto)
알바니아어 - język albański
에리트레아 - Erytrea
나이제리아 - Nigeria
포트루이스 - Port Louis
손아랫사람 - podwładny, osoba o niższym statusie społecznym, majątkowym lub zawodowym
아르헨티나 - Argentyna
말레이시아 - Malezja
베네수엘라 - Wenezuela
인도네시아 - Indonezja
모터사이클 - motor
타지키스탄 - Tadżykistan
서부사하라 - Sahara Zachodnia
따쥐끼스딴 - Tadżykistan
키르기스어 - język kirgiski
부꾸레슈띠 - Bukareszt
부다페스트 - Budapeszt
쎈트헬레나 - Święta Helena
우크라이나 - Ukraina
아이스크림 - lody
베오그라드 - Belgrad
기네비싸우 - Gwinea Bissau
크리스마스 - Boże Narodzenie
카보베르데 - Republika Zielonego Przylądka
세르비아어 - język serbski
에티오피아 - Etiopia
카자흐스탄 - Kazachstan
기니비사우 - Gwinea Bissau
포르투갈어 - język portugalski
울란바따르 - Ułan Bator
암스테르담 - Amsterdam
그루지야어 - język gruziński
스코트런드 - Szkocja
남아메리카 - Ameryka Południowa
에스또니야 - Estonia
아랍추장국 - Zjednoczone Emiraty Arabskie
엘살바도르 - Salwador
고맙습니다 - dziękuję
동부띠모르 - Timor Wschodni
가무이야기 - musical
슬로벤스꼬 - Słowacja
레프코시아 - Nikozja
네데를란드 - Holandia (Niderlandy)
프레토레아 - Pretoria
시에라리온 - Sierra Leone
작은아버지 - wujek, młodszy brat ojca
도이췰란드 - Niemcy
아르메니야 - Armenia
아르메니아 - Armenia
아이소포스 - Ezop
작은어머니 - ciocia, żona młodszego brata ojca
천체물리학 - astrofizyka
다마스쿠스 - Damaszek
바베이도스 - Barbados
소프트웨어 - oprogramowanie
루마니아어 - język rumuński
미안합니다 - przepraszam
우즈베크어 - język uzbecki
불가리아어 - język bułgarski
로씨야련방 - Federacja Rosyjska
흐르바쯔까 - Chorwacja
페르시아어 - język perski
울란바타르 - Ułan Bator
방글라데슈 - Bangladesz
방글라데시 - Bangladesz
웨이트리스 - kelnerka
마께도니아 - Macedonia
시에라레온 - Sierra Leone
남오세티아 - Osetia Południowa
크로아티아 - Chorwacja
북아메리카 - Ameryka Północna
콩고공화국 - Kongo (Republika Konga)
포드고리차 - Podgorica
알좌자이르 - Algier
아라비아인 - Arab
나이지리아 - Nigeria
프리토리아 - Pretoria
수리부엉이 - puchacz
다문화주의 - wielokulturowość
리투아니아 - Litwa
꼬뜨디봐르 - Wybrzeże Kości Słoniowej
야무쑤끄로 - Jamusukro
프리슈티나 - Prisztina
북키프로스 - Cypr Północny
슬로바키아 - Słowacja
까자흐스딴 - Kazachstan
스와질란드 - Suazi
꽁고공화국 - Kongo (Republika Konga)
북아일랜드 - Irlandia Północna
부다뻬슈뜨 - Budapeszt
코스타라카 - Kostaryka
아이슬란드 - Islandia
안녕하세요 - dzień dobry, czy czujesz się dobrze?
부쿠레슈티 - Bukareszt
에스파냐어 - język hiszpański
라이베리아 - Liberia
에스토니아 - Estonia
야무수크로 - Jamusukro
네덜란드어 - język holenderski
몬테네그로 - Czarnogóra
레이캬비크 - Reykjavík
포르토노보 - Porto-Novo
아일랜드어 - język irlandzki
투르크멘어 - język turkmeński
산타클로스 - święty mikołaj
노르웨이어 - język norweski
외할아버지 - dziadek od strony matki, ojciec matki
이탈리아어 - język włoski
스코틀랜드 - Szkocja
뽀르또노보 - Porto-Novo
엘리베이터 - winda
스와질랜드 - Suazi
꼬부랑국수 - zupa błyskawiczna, zupka chińska
마케도니아 - Macedonia
라트비아어 - język łotewski
아르바이트 - praca w niepełnym wymiarze czasowym
마케도니아 구 유고슬라비아 공화국 - Była Jugosłowiańska Republika Macedonii
북키프로스 터키 공화국 - Turecka Republika Cypru Północnego
슬로바키아 공화국 - Republika Słowacka
에스토니아어 - język estoński
슬로베니아어 - język słoweński
부르끼나빠소 - Burkina Faso
마다가스까르 - Madagaskar
인도네시아어 - język indonezyjski
아이슬란드어 - język islandzki
안따나나리부 - Antananarywa
쿠알라룸푸르 - Kuala Lumpur
브라찌슬라바 - Bratysława
몬테네그로어 - język czarnogórski
브라티슬라바 - Bratysława
아프가니스탄 - Afganistan
마케도니아어 - język macedoński
키르기스스탄 - Kirgistan
라쓰베이거쓰 - Las Vegas
안도라라벨랴 - Andora (miasto)
우즈베키스탄 - Uzbekistan
케이프베르데 - Republika Zielonego Przylądka
세인트헬리어 - Saint Helier
크로아티아어 - język chorwacki
남부오쎄찌야 - Osetia Południowa
꾸알라룸뿌르 - Kuala Lumpur
세인트루시아 - Saint Lucia
아랍에미리트 - Zjednoczone Emiraty Arabskie
아르메니아어 - język ormiański
이슬라마바드 - Islamabad
세인트헬레나 - Święta Helena
마다가스카르 - Madagaskar
부르키나파소 - Burkina Faso
끼르기즈스딴 - Kirgistan
슬로바키아어 - język słowacki
우즈베끼스딴 - Uzbekistan
안타나나리보 - Antananarywa
라스베이거스 - Las Vegas
리투아니아어 - język litewski
우크라이나어 - język ukraiński
아디스아바바 - Addis Abeba
아제르바이잔 - Azerbejdżan
아제르바이쟌 - Azerbejdżan
아프리칸스어 - język afrykanerski
위키낱말사전 - Wikisłownik
코트디부아르 - Wybrzeże Kości Słoniowej
룩셈부르크어 - język luksemburski
리히텐슈타인 - Liechtenstein
스핏스베르겐 섬 - Spitsbergen
세인트빈센트 그레나딘 - Saint Vincent i Grenadyny
콩고민주공화국 - Demokratyczna Republika Konga
사우디아라비아 - Arabia Saudyjska
상투메프린시페 - Wyspy Świętego Tomasza i Książęca
투르크메니스탄 - Turkmenistan
롱위에아르뷔엔 - Longyearbyen
중화인민공화국 - Chińska Republika Ludowa
스테파나케르트 - Stepanakert
아제르바이잔어 - język azerski
오스트레일리아 - Australia
세인트피터포트 - Saint Peter Port
뚜르크메니스딴 - Turkmenistan
산토메프린시페 - Wyspy Świętego Tomasza i Książęca
도미니카공화국 - Dominikana
남아프리카공화국 - Republika Południowej Afryki
나고르노카라바흐 - Górski Karabach
반다르스리브가완 - Bandar Seri Begawan
트란스니스트리아 - Naddniestrze
중앙아프리카공화국 - Republika Środkowoafrykańska
조선민주주의인민공화국 - Koreańska Republika Ludowo-Demokratyczna
스리자야와르데네푸라코테 - Sri Dźajawardanapura Kotte
一 - 일 (jeden, 1)
一月 - 일월 (styczeń)
七 - 칠
七月 - 칠월 (lipiec)
三 - 삼 (trzy, 3)
三月 - 삼월 (marzec)
中國 - 중국 (Chiny)
中國語 - 중국어 (język chiński)
中華人民共和國 - 중화인민공화국 (Chińska Republika Ludowa)
中華民國 - 중화민국 (Republika Chińska)
九 - 구 (dziewięć, 9)
九月 - 구월 (wrzesień)
乳製品 - 유제품 (nabiał)
二 - 이 (dwa, 2)
二月 - 이월 (luty)
五 - 오 (pięć, 5)
五月 - 오월 (maj)
伽倻 - 가야 (Kaya)
佛敎 - 불교 (buddyzm)
來日 - 내일 (jutro)
健康 - 건강 (zdrowie)
八 - 팔 (osiem, 8)
八月 - 팔월 (sierpień)
公園 - 공원 (park)
六 - 육 (sześć, 6)
六月 - 유월 (czerwiec)
共和國 - 공화국 (republika)
冊 - 책 (książka)
冊床 - 책상 (biurko)
冊欌 - 책장 (półka na książki)
冬 - 동 (zima)
冷麵 - 냉면 (naengmyeon)
勸告 - 권고 (rekomendacja)
化粧室 - 화장실 (toaleta)
北 - 북 (północ)
北大西洋條約機構 - 북대서양 조약 기구 (Organizacja Traktatu Północnoatlantyckiego, NATO)
十 - 십 (dziesięć, 10)
十一月 - 십일월 (listopad)
十二月 - 십이월 (grudzień)
十月 - 시월 (październik)
千 - 천
印度 - 인도 (Indie)
台灣 - 대만 (Tajwan)
合 - 합하다 (łączyć, zjednoczyć)
同生 - 동생 (młodsze rodzeństwo)
和 - 화할 (harmonia, pokój), 화할 (spokojny, łagodny)
四 - 사 (cztery, 4)
四寸 - 사촌 (kuzyn)
四月 - 사월 (kwiecień)
國 - 국 (kraj)
國境 - 국경 (granica państwa)
國家 - 국가 (państwo, kraj, naród)
國際 - 국제 (międzynarodowy)
國際聯合 - 국제 연합 (Organizacja Narodów Zjednoczonych)
圖書館 - 도서관 (biblioteka)
土 - 토 (ziemia)
土曜日 - 토요일 (sobota)
地圖 - 지도 (mapa)
夏 - 하 (lato)
大西洋 - 대서양 (Ocean Atlantycki)
大韓民國 - 대한민국 (Republika Korei)
天體物理學 - 천체물리학 (astrofizyka)
学生 - 학생 (uczeń)
學校 - 학교 (szkoła)
學者 - 학자 (uczony)
安樂死 - 안락사 (eutanazja)
宏 - szeroki, wielki, przestronny, obszerny
定義 - 정의 (definicja)
屑糖 - 설탕 (cukier)
帽子 - 모자 (czapka)
平壤 - 평양 (Pjongjang)
幼稚園敎唆 - 유치원 교사 (przedszkolanka)
憲法 - 헌법 (konstytucja)
戰車 - 전차 (czołg)
房 - 방 (pokój)
授業 - 수업 (zajęcia, wykłady)
敎室 - 교실 (sala wykładowa)
文化語 - 문화어 (standardowy język koreański w Korei Północnej)
新聞 - gazeta
日 - 일 (dzień), 일 (słońce)
日曜日 - 일요일 (niedziela)
日本 - 일본 (Japonia)
日本語 - 일본어 (język japoński)
春 - 춘 (wiosna)
時計 - 시계 (zegarek)
時間 - 시간 (czas)
曜 - 요 (dzień roboczy)
曜日 - 요일
會社 - 회사 (firma)
月 - 월 (miesiąc), 월 (księżyc)
月曜日 - 월요일 (poniedziałek)
朝鮮 - 조선 (Korea Północna)
朝鮮民主主義人民共和國 - 조선민주주의인민공화국 (Koreańska Republika Ludowo-Demokratyczna)
朝鮮語 - 조선어 (język koreański)
木 - 목 (drzewo)
木曜日 - 목요일 (czwartek)
條約 - 조약 (traktat)
椅子 - 의자 (krzesło)
標準語 - 표준어 (standardowy język koreański w Korei Południowej)
橘 - 귤 (mandarynka)
機構 - 기구 (organizacja)
歌舞伎 - 가부키 (kabuki)
歐洲 - 구주 (Europa)
正義 - 정의 (sprawiedliwość)
氏 - 씨 (pan, pani)
水 - 수 (woda)
水曜日 - 수요일 (środa)
汽車 - 기차 (pociąg)
沙果 - 사과 (jabłko)
泰國 - 태국 (Tajlandia)
泰國語 - 태국어 (język tajski)
海洋 - 해양 (morze, ocean)
湖水 - 호수 (jezioro)
漢字 - 한자 (hanja)
火 - 화, 불 (ogień)
火曜日 - 화요일 (wtorek)
炸醬麵 - 자장면 (jajangmyeon)
營養學 - 영양학 (dietetyka)
物理學 - 물리학 (fizyka)
犬 - 견 (pies)
獅子 - 사자 (lew)
獨 - 독 (sam, osobny)
獨立 - 독립 (niepodległość)
獨立國家聯合 - 독립 국가 연합 (Wspólnota Niepodległych Państw)
獨逸 - 독일 (Niemcy)
獨逸語 - 독일어 (język niemiecki)
發音 - 발음 (wymowa)
百 - 백 (sto, 100)
看護師 - 간호사 (pielęgniarka)
眼鏡 - 안경 (okulary)
秋 - 추 (jesień)
空冊 - 공책 (zeszyt)
窓門 - 창문 (okno)
統詞論 - 통사론 (składnia)
聯 - 연 (przyłączyć się)
聯合 - 연합 (organizacja)
自動車 - 자동차 (samochód)
自轉車 - 자전거 (rower)
臺北 - 타이베이 (Tajpej)
英國 - 영국 (Zjednoczone Królestwo)
英語 - 영어 (język angielski)
菓子 - 과자 (ciasto)
菜食主義 - 채식주의 (wegetarianizm)
萬 - 만 (dziesięć tysięcy, 10 000)
萬年筆 - 만년필 (wieczne pióro)
複寫機 - 복사기 (kserokopiarka)
親舊 - 친구 (przyjaciel, przyjaciółka)
語 - 어 (słowo, język)
諸島 - 제도, 군도 (archipelag)
赤道 - 적도 (równik)
辭典 - 사전 (słownik)
道德 - 도덕 (moralność)
道路 - 도로 (droga)
還生 - 환생 (reinkarnacja)
醫師 - 의사 (lekarz)
金 - 금 (złoto)
金曜日 - 금요일 (piątek)
釜山 - 부산 (Pusan)
鉛筆 - 연필 (ołówek)
門 - 문 (drzwi)
開城 - 개성 (Kaesong)
際 - 제 (granica)
雨傘 - 우산 (parasol)
電話 - 전화 (telefon)
電車 - 전차 (tramwaj)
韓國 - 한국 (Korea Południowa)
韓國語 - 한국어 (język koreański)
食堂 - 식당 (restauracja)
饅頭 - 만두 (pierogi)
馬車 - 마차 (karoca)
鷄卵 - 계란 (jajo)
麥酒 - 맥주 (piwo)
