abaks - abakus
abandons - zaniechanie
abats - opat
abažūrs - abażur
abdikācija - abdykacja
abdomens - jama brzuszna, brzuch
abdomināls - brzuszny
abduktors - odwodziciel
ābele - jabłoń
aberācija - aberracja
abioģenēze - abiogeneza
abiotisks - nieożywiony, abiotyczny
abioze - abioza
ablācija - ablacja
ablaktācija - odstawienie dziecka od piersi
abnormāli - anormalnie
abolīcija - abolicja
abolicionisms - abolicjonizm
abolicionists - abolicjonista
ābols - jabłko
aborts - aborcja
absints - absynt, bylica piołun
absolūcija - absolucja
absolūti - absolutnie
absolvēt - ukończyć szkołę
absorbēt - absorbować
abstrakcija - abstrakcja
abstrakcionisms - abstrakcjonizm
abstrakcionists - abstrakcjonista
abstrakts - abstrakcyjny
absurdi - absurdalnie
absurds - absurd
Abū Dabī - Abu Zabi
acs - oko
Adrijas jūra - Morze Adriatyckie
aerobika - aerobik
Afganistāna - Afganistan
Āfrika - Afryka
agresija - agresja
airis - wiosło
aita - owca
aizmirst - zapomnieć
akadēmisks - akademicki
akadēmisms - akademizm
akmens - kamień
aktīnijs - aktyn
aktīvs - aktyw, aktywny
akvedukts - akwedukt
alabastrs - alabaster
alpīnisms - alpinizm
alumīnijs - glin, aluminium
alus - piwo
alva - cyna
Alžīrija - Algieria
amerīcijs - ameryk
anāls - analny
Andora - Andora
Andris - Andrzej
Anita - Anita
Antarktīda - Antarktyda
antimons - antymon
apmainīt - zamieniać
aprikoze - morela
aprīlis - kwiecień
Apvienotā Karaliste - Zjednoczone Królestwo
apziņa - świadomość
ar - z, wraz
argons - argon
Aristotelis - Arystoteles
arsēns - arsen
ārsts - lekarz
aseksualitāte - aseksualność
asinis - krew
aspirīns - aspiryna
astats - astat
astoņi - osiem, 8
astotais - ósmy
atā - do widzenia
Atlantijas okeāns - Ocean Atlantycki
atmosfēra - atmosfera
atomskaitlis - liczba atomowa
atpakaļ - z powrotem, wstecz, nazad, wcześniej, trzy dni temu)
atrast - znaleźć
atvērt - otworzyć
audzināt - kształcić, edukować, wychowywać
auglis - owoc
augusts - sierpień
Auns - Baran
auss - ucho
Austrālija - Australia
Āzija - Azja
badmintons - badminton
bagātība - bogactwo
bagāža - bagaż
bakteriāls - bakteryjny
baktērija - bakteria
bakteriofāgs - bakteriofag
balerīna - balerina
balets - balet
balodis - gołąb
balsene - krtań
Baltijas jūra - Morze Bałtyckie
Baltkrievija - Białoruś
balts - biały
Bangladeša - Bangladesz
Barbadosa - Barbados
bārda - broda
bārijs - bar
baznīca - kościół, świątynia
bēdrozis - sójka syberyjska, sójka złowroga
Beļģija - Belgia
Beliza - Belize
Benina - Benin
berilijs - beryl
berklijs - berkel
bērns - dziecko
bērnudārzs - przedszkole
bērzs - brzoza
bez - bez
bibliotēka - biblioteka
biļete - bilet
biogrāfija - biografia
bioķīmija - biochemia
bioloģija - biologia
biosfēra - biosfera
biseksualitāte - biseksualizm
bismuts - bizmut
bīstams - niebezpieczny
bite - pszczoła
blusa - pchła
bors - bor
botānika - botanika
Botsvāna - Botswana
brālis - brat
brīvība - wolność
brīvs - wolny, swobodny
broms - brom
bruņurupucis - żółw
burkāns - marchew
burts - litera
būt - być
Čada - Czad
caurs - dziurawy
Čehija - Czechy
cēlgāze - gaz szlachetny
ceļš - droga
celt - wznosić, budować, konstruować
cena - cena
centrs - centrum
cepure - czapka
cerēt - mieć nadzieję, ufać
cērijs - cer
ceturtais - czwarty
ceturtdiena - czwartek
cēzijs - cez
ciemiņš - gość
ciems - wieś
cietoksnis - forteca
ciets - twardy
cilts - plemię
cilvēks - człowiek
cimds - rękawiczka
cinks - cynk
cirkonijs - cyrkon
cīrulis - skowronek
cirvis - topór, siekiera
citrons - cytryna
civilizācija - cywilizacja
civilizēt - cywilizować
civils - cywilny
cūka - świnia
cukurs - cukier
daba - przyroda, natura
dabisks - naturalny
dabūt - wziąć, dostać, dobyć
dadaisms - dadaizm
dadzītis - szczygieł
dalīt - dzielić
darbības vārds - czasownik
darīt - robić
dārzs - ogród
dators - komputer
daudz - dużo, wiele
debesis - niebo
decembris - grudzień
dejot - tańczyć
dēls - syn
dēmons - demon
desa - kiełbasa
desmitais - dziesiąty
devītais - dziewiąty
diena - dzień
Dienvidāfrika - Republika Południowej Afryki
dievināt - czcić
Dievs - Bóg
dīķis - staw, sadzawka
dinamika - dynamika
dinamisks - dynamiczny
diskutēt - dyskutować
disprozijs - dysproz
divdesmit - dwadzieścia
divi - dwa
divpadsmitais - dwunasty
divvalodība - dwujęzyczność
dogmatiķis - dogmatyczny
doktors - doktor, lekarz
doktrīna - doktryna
Dominika - Dominika
Dominikāna - Dominikana
Dominikānas Republika - Dominikana
dramaturģija - dramaturgia
draudzība - przyjaźń
dūkuris - perkoz
dūmi - dym
dusēt - spać
dvēsele - dusza
Dvīņi - Bliźnięta
dzeguze - kukułka
dzejnieks - poeta
dzeltens - żółty
dzelzs - żelazo
dzenis - dzięcioł
dzert - pić
dzērve - żuraw
džezs - jazz
Džibutija - Dżibuti
dziedāt - śpiewać
dziesma - piosenka
dzimta - rodzina, ród
dzimumloceklis - penis
dzinējs - silnik
dzintars - bursztyn
dzirdēt - słyszeć
dzirnavas - młyn, żarna
dzīvība - życie
dzīvnieks - zwierzę
dzīvsudrabs - rtęć
einšteinijs - einstein
Eirāzija - Eurazja
Eiropa - Europa
Eiropas Savienība - Unia Europejska
eiropijs - europ
ejakulācija - ejakulacja
ejakulēt - mieć wytrysk
ekoloģija - ekologia
ekosistēma - ekosystem
Ekvatoriālā Gvineja - Gwinea Równikowa
elements - pierwiastek chemiczny
eļļa - olej
Emīlija - Emilia
enciklopēdija - encyklopedia
enerģija - energia
enerģisks - energiczny
eņģelis - anioł
erbijs - erb
ērglis - orzeł
es - ja
ES - Unia Europejska
ēst - jeść
estētika - estetyka
ēterisks - eteryczny
etimoloģija - etymologia
Etiopija - Etiopia
etnogrāfija - etnografia
etnogrāfs - etnograf
etnoloģija - etnologia
etoloģija - etologia
euharistija - eucharystia
evakuācija - ewakuacja
evakuēt - ewakuować
eventuāls - ewentualny
evolūcija - ewolucja
ezers - jezioro
ezoterisks - ezoteryczny
fabrika - fabryka
farmācija - farmacja
februāris - luty
fermijs - ferm
fizika - fizyka
fluors - fluor
fosfors - fosfor
fotosintēze - fotosynteza
francijs - frans
gadolīnijs - gadolin
gads - rok
gaisma - światło
gaiss - powietrze
gaļa - mięso
galds - stół
gallijs - gal
galva - głowa
galvaspilsēta - stolica
Gargantija - Gargantua
gatavot - przygotowywać
gāze - gaz
ģenealoģija - genealogia
ģenētika - genetyka
ģeogrāfija - geografia
ģeoloģija - geologia
gepards - gepard
germānijs - german
Gibraltārs - Gibraltar
ģimene - rodzina
ģipsis - gips
ģitāra - gitara
glābt - ocalić
glāze - szklanka
govs - krowa
grafisks - graficzny
grafīts - grafit
grafoloģija - grafologia
grāmata - książka
gramatika - gramatyka
gramatisks - gramatyczny
grāmatnīca - księgarnia
grauzējs - gryzoń
Grenāda - Grenada
gribēt - chcieć
Grieķija - Grecja
guba - sterta
gudrs - mądry, rozsądny
gulags - gułag
guļamistaba - sypialnia
gulbis - łabędź
gulēt - spać
gulta - siano, łóżko
gurķis - ogórek
Gvatemala - Gwatemala
hafnijs - hafn
Haiti - Haiti
hedonisms - hedonizm
hēlijs - hel
hematūrija - hematuria, krwiomocz
heteroseksualitāte - heteroseksualizm
hidroloģija - hydrologia
hlors - chlor
holmijs - holm
homoseksuālisms - homoseksualizm
homoseksualitāte - homoseksualizm
homoseksuāls - homoseksualny
Hondurasa - Honduras
horizonts - horyzont
Horvātija - Chorwacja
hroms - chrom
iela - ulica
iesākums - początek
iespējams - możliwy, prawdopodobny, ewentualny
Ieva - Ewa
Igaunija - Estonia
igauņu valoda - język estoński
imunoloģija - immunologia
imūnpatoloģija - immunopatologia
indijs - ind
Indonēzija - Indonezja
informācija - informacja
informātika - informatyka
informēt - informować, instruować
Irāka - Irak
Irāna - Iran
irīdijs - iryd
islāms - islam
istaba - pokój
īsts - prawdziwy
Itaka - Itaka
Itālija - Włochy
iterbijs - iterb
itrijs - itr
izotops - izotop
izruna - wymowa
jā - tak
Jamaika - Jamajka
janvāris - styczeń
Japāna - Japonia
Jaunzēlande - Nowa Zelandia
jeb - lub
jebkad - kiedykolwiek
jebkur - gdziekolwiek
Jemena - Jemen
Jeruzaleme - Jerozolima
jezuītisks - jezuicki
Jēzus - Jezus
Jēzus Kristus - Jezus Chrystus
jods - jod
jūgs - jarzmo
jūlijs - lipiec
jumts - dach
jūnijs - czerwiec
Jupiters - Jowisz, Jupiter
jūra - morze
jūrascūciņa - świnka morska
jūras gurķis - strzykwa
jūs - wy, pan, pani, państwo
just - czuć
kadmijs - kadm
kafejnīca - kawiarnia
kafija - kawa
kaija - mewa
kails - nagi, goły
Kaira - Kair
kaķis - kot
kaklarota - naszyjnik
kaklasaite - krawat
kaktuss - kaktus
kalcijs - wapń
kalifornijs - kaliforn
kālijs - potas
kalns - góra
Kambodža - Kambodża
Kamerūna - Kamerun
kamielis - wielbłąd
Kanāda - Kanada
kāpēc - dlaczego
karalis - król
Karību jūra - Morze Karaibskie
karš - wojna
kartupelis - ziemniak
kas - kto, co
kašalots - kaszalot
kataloniešu - kataloński, język kataloński
Katara - Katar
katastrofa - katastrofa
Katiņas - Katyń
kauls - kość
Kenija - Kenia
ķīmiski - chemicznie
ķīmisks - chemiczny
Ķīna - Chiny
Kirgizstāna - Kirgistan
kirijs - kiur
ķirurģija - chirurgia
klasifikācija - klasyfikacja
klasiķis - klasyczny
klauns - clown, klaun
klaustrofobija - klaustrofobia
kobalts - kobalt
koks - drzewo
kompjūters - komputer
komponents - składnik, komponent
kontinents - kontynent
Korāns - Koran
korozija - korozja
kost - gryźć
Kostarika - Kostaryka
kovārnis - kawka
krauķis - gawron
krauklis - kruk
kreiss - lewy, lewicowy
krēsls - krzesło
krevele - strup
krieviete - Rosjanka
Krievija - Rosja
krievisks - rosyjski
krievs - Rosjanin
krievu valoda - język rosyjski
kriptons - krypton
kristālisks - krystaliczny
kristāls - kryształ
krūms - krzak
krupis - ropucha
ksenons - ksenon
kubs - sześcian, kostka
kultūra - kultura
kur - gdzie
labdien - dzień dobry!
labējs - prawicowy
labs - dobry, prawy, po prawej
lācis - niedźwiedź
laiks - czas
laizīt - lizać
lantāns - lantan
lapsa - lis
lāpsta - łopata
lasīt - czytać
latviešu valoda - język łotewski
latvietis - Łotysz
Latvija - Łotwa
laukirbe - kuropatwa
ļauns - zły
lauva - lew
ledus - lód
lēkt - skoczyć
Lesba - Lesbos
Libāna - Liban
Lībija - Libia
lidmašīna - samolot
lidosta - lotnisko
lidot - lecieć, latać
liellopigovs - krowa
liels - duży
lieta - rzecz
lietus - deszcz
Lietuva - Litwa
līme - klej
limnoloģija - limnologia
literatūra - literatura
litijs - lit
logs - okno
Londona - Londyn
ļoti - bardzo
lutēcijs - lutet
mācīt - uczyć
magnijs - magnez
maijs - maj
maize - chleb
Maķedonija - Macedonia
mākonis - chmura
maksts - pochwa, wagina, pokrowiec
makulatūra - makulatura
Maldīvija - Malediwy
malt - mleć, siekać (mięso), mruczeć
Malta - Malta
mangāns - mangan
mans - ojciec
Marika - Marika
Maroka - Maroko
Marss - Mars
marts - marzec
māsa - siostra
Maskava - Moskwa
māte - matka
matemātiķis - matematyk
matemātisks - matematyczny
Mauritānija - Mauretania
mazs - mały
mednis - głuszec
medus - miód
meita - córka
meklēt - szukać
Meksika - Meksyk
Melnā jūra - Morze Czarne
melns - czarny
mendeļejevijs - mendelew
mēnesis - miesiąc
Mēness - Księżyc
Merkurs - Merkury
mest - rzucać
metabolisms - metabolizm
metāls - metal
mežs - las
miegs - sen, spanie
mieži - jęczmień
mikrobioloģija - mikrobiologia
mīksts - miękki
mīla - miłość
mīlestība - miłość
mīlēt - kochać
milti - mąka
mineraloģija - mineralogia
minerāls - minerał
modinātājpulkstenis - budzik
Moldova - Mołdawia
monarhija - monarchia
Mozambika - Mozambik
murgi - koszmar
nakts - noc
neatkarība - niezależność, niepodległość
nedēļa - tydzień
nekad - nigdy
nektārs - nektar
neons - neon
Neptūns - Neptun
Nigēra - rzeka Niger
Nigērija - Nigeria
nihilisms - nihilizm
niobijs - niob
nomirt - umrzeć
Nora - Nora
no rīta - rano
novembris - listopad
nulle - 0 (zero)
ogleklis - węgiel
Okeānija - Oceania
okeāns - ocean
oksīds - tlenek
oktobris - październik
okultisms - okultyzm
ola - jajko
Omāna - Oman
opera - opera
operācija - operacja
operete - operetka
orākuls - wyrocznia
oranžs - pomarańczowy
organisms - organizm
organizācija - organizacja
orgasms - orgazm
orientācija - orientacja
otrais - drugi
otrdiena - wtorek
ozols - dąb
Padomju Savienība - Związek Radziecki
paldies - dziękuję
palīdzēt - pomagać
panteisms - panteizm
papagailis - papuga
parks - park
pārstāvis - przedstawiciel
partija - partia
pavadonis - przewodnik, satelita
pavasaris - wiosna
pedagogs - pedagog
pele - mysz
pelēks - szary
peles - mysz
pelikāns - pelikan
persona - osoba
pērtiķis - małpa
piektais - piąty
piektdiena - piątek
piekūns - sokół
piemēram - na przykład
piemērs - przykład
piens - mleko
pīle - kaczka
pilnība - pełnia, kompletność
pilsēta - miasto
pingvīns - pingwin
pipari - pieprz
pirkt - kupować, nabywać
pirmais - pierwszy
pirmdiena - poniedziałek
Pitsburga - Pittsburgh (stolica Allegheny)
planēta - planeta
plastisks - plastyczny
pludmale - plaża
plutonijs - pluton
Polija - Polska
politiķis - polityk
pornogrāfija - pornografia
prast - wiedzieć
problēma - problem
process - proces
prokurors - prokurator
prostitūcija - prostytucja
protaktīnijs - protaktyn
prozaiķis - prozaik
publicistikā - publicystyka
publicists - publicysta
pūce - sowa
puķe - kwiat
pupuķis - dudek
puse - połowa
pūte - krosta
putns - ptak
radioaktīvs - radioaktywny
radons - radon
redzēt - widzieć
reinkarnācija - reinkarnacja
reliģija - religia
rēnijs - ren
republika - republika
rezultāts - rezultat, wynik
Rīga - Ryga
rodijs - rod
roka - ręka
rožains - różowy, różany
rūda - ruda
rudens - jesień
ruds - rudy
runāt - mówić, rozmawiać
sabrukšana - rozpad, rozkład
sacīt - mówić, powiedzieć
sadistisks - sadystyczny
sadists - sadysta
Saeima - Sejm
saimnieks - rolnik
sala - wyspa
salāti - sałata
salds - słodki
sālīt - solić
sāls - sól
sālstrauks - solniczka
samārijs - samar
Santome un Prinsipi - Wyspy Świętego Tomasza i Książęca
sapnis - sen
saprast - rozumieć
sarežģīts - trudny
sargāt - chronić, pilnować
sargs - obrońca
sarkanrīklīte - rudzik
sarkans - czerwony
sastāvs - skład
Saturns - Saturn
Saūda Arābija - Arabia Saudyjska
saule - słońce
Saule - Słońce
Saules sistēma - Układ Słoneczny
šeit - tu, tutaj
seksuālā orientācija - orientacja seksualna
seksualitāte - seksualność
sekunde - sekunda
sēne - grzyb
Senegāla - Senegal
sens - stary
separātisms - separatyzm
septembris - wrzesień
septītais - siódmy
sestais - szósty
sestdiena - sobota
sēt - siać
Sibīrija - Syberia
siers - ser
sieviete - kobieta
sikspārnis - nietoperz
sīlis - sójka
simbols - symbol
Singapūra - Singapur
sīpols - cebula
sirds - serce
Sīrija - Syria
sist - bić
sivēns - prosię
skābeklis - tlen
skaisti - ładnie
skaists - piękny, ładny
skaistums - piękno
šķidrums - płyn, ciecz
šķist - wydawać się
skola - szkoła
skudra - mrówka
slāpeklis - azot
slēpt - ukrywać
slieka - dżdżownica
smiltis - piasek
sniegs - śnieg
soda - soda
šokolāde - czekolada
Somālija - Somalia
Somija - Finlandia
somu valoda - język fiński
spārns - skrzydło, błotnik
sportisks - sportowy
sports - sport
Šrilanka - Sri Lanka
stārķis - bocian
strauss - struś
strazds - drozd, szpak
studēt - studiować
Sudāna - Sudan
sudrabbalts - srebrzystobiały
sudrabs - srebro
sūds - gówno
sūkt - ssać
suns - pies
šūt - szyć
svarīgs - ważny
sveiki - cześć
svētdiena - niedziela
svētīt - błogosławić
svilpis - gil
svins - ołów
tā - to, ta
Tadžikistāna - Tadżykistan
tagad - teraz
Tanzānija - Tanzania
tapt - stać się
tauriņš - motyl
tauta - naród
tavs - twój
tehnēcijs - radon
tēja - herbata
telts - namiot
teorētisks - teoretyczny
terapija - terapia
tērauds - stal
terbijs - terb
termoelektrisks - termoelektryczny
tēvs - ojciec
tīģeris - tygrys
tik - tak
tipisks - typowy
tīrs - czysty
toksisks - toksyczny, trujący
tomāts - pomidor
Tora - Tora
trešais - trzeci
trešdiena - środa
trusis - królik
tu - ty
tuberkuloze - gruźlica
tulkojums - tłumaczenie, przekład
tulkot - tłumaczyć
tulkotājs - tłumacz
tumšs - ciemny
Tunisija - Tunezja
tūplis - odbyt
tur - tam
Turcija - Turcja
turēt - trzymać
ubags - żebrak
ūdeņradis - wodór
ūdens - woda
uguns - ogień
ugunsturīgs - ognioodporny
un - i
upe - rzeka
Urāli - Ural
urāns - uran
Urāns - Uran, Uranos
Vācija - Niemcy
vācu valoda - język niemiecki
vairāk - więcej
vakars - wieczór
Valentina - Walentyna
valoda - język
valsts - państwo
vangas - jastrząb
varde - żaba
vardnica - słownik
vārdnīca - słownik
vārds - słowo
vārna - wrona
Varšava - Warszawa
vasara - lato
Vatikāns - Watykan (państwo)
veģetārisms - wegetarianizm
veidoties - tworzyć się, kształtować, powstawać
veids - forma, kształt, aspekt
vējš - wiatr
veksiloloģija - weksylologia
vēlējumies - życzenie, pragnienie, chęć
vēlēšanas - wybory
vēlēties - chcieć, życzyć sobie
Venēra - Wenus, Wenera
Veronika - Weronika
Vērsis - Byk
veselība - zdrowie
vest - prowadzić
Vēzis - Rak
Vičenca - Vicenza (miasto)
Vidusjūra - Morze Śródziemne
viegls - lekki
viela - substancja
vien - tylko
vienīgais - jedyny
vienīgs - jedyny
vienpadsmitais - jedenasty
viens - jeden
vieta - miejsce
Vikipēdija - Wikipedia
vilciens - pociąg
vīrs - mąż, mężczyzna
vīruss - wirus
viss - wszystkie, cały
visu labu - do widzenia
vītols - wierzba
vizualizācija - wizualizacja
Vjetnama - Wietnam
vulkāns - wulkan
žagata - sroka
zagt - kraść
zaķis - zając
zaļš - zielony
zem - pod
zeme - ziemia, grunt, kraj, państwo
Zeme - Ziemia
zīdaste - jemiołuszka
ziema - zima
ziemeļi - północ
Ziemeļjūra - Morze Północne
Ziemeļkipra - Cypr Północny
ziepes - mydło
zīlīte - sikora
zilonis - słoń
zils - niebieski
zināt - wiedzieć
zirgs - koń
zirneklis - pająk
zirnis - groch
Zita - Zyta
zivs - ryba
zobs - ząb
zoss - gęś
žubīte - zięba
žurka - szczur
žurnālists - dziennikarz
zust - zniknąć
zvaigzne - gwiazda
Zviedrija - Szwecja
zviedrs - szwedzki
zviedru valoda - język szwedzki
zvirbulis - wróbel
