abakas - abak, abakus
abatas - opat
abatija - opactwo
abažū̃ras - abażur
abchazas - Abchaz
abchazė - Abchazka
Abchazija - Abchazja
abchaziškas - abchaski
abchazų - abchaski (język), Abchazów, abchaski, abchazas
abdikacija - abdykacja
abdikuoti - abdykować
abėcėlė - abecadło, alfabet
abėcėliškas - alfabetyczny
abejaip - tak czy inaczej, tak czy owak, dwojako, na dwa sposoby
abejingai - obojętnie
abejingas - obojętny
abejingumas - obojętność
abejojimas - wątpliwość
abejonė - wątpliwość, rozterka
abejoti - wątpić, powątpiewać
abejotinas - wątpliwy
abi - obaj
Abidžanas - Abidżan
abiogenezė - abiogeneza, samorództwo
abipusiai - dwustronnie, obustronnie, wzajemnie
abipusiškai - dwustronnie, obustronnie, wzajemnie
abipusiškas - wzajemny
abipusiškumas - wzajemność
abisinas - Abisyńczyk
abitas - habit
abitūra - matura
abiturientas - abiturient
abiturientė - abiturientka
abolicija - abolicja
abonamentas - abonament
abonementas - abonament
abonementinis - abonamentowy
abonentas - abonent
abonentė - abonentka
abonentinis - abonencki
abortas - aborcja
abrikosas - morela
abscesas - ropień
abscisė - odcięta
absentas - absynt
absoliutinis - absolutny
absoliutizmas - absolutyzm
absoliutus - absolutny
absolventas - absolwent
absolventė - absolwentka
absorbcija - absorbcja
absorbuoti - absorbować
abstinencija - abstynencja
abstinentas - abstynent
abstinentė - abstynentka
abstrakcionizmas - abstrakcjonizm
abstraktus - abstrakcyjny
absurdas - absurd
absurdiškas - absurdalny
abu - oba, obaj, oboje
Abu Dabis - Abu Zabi
abulija - abulia
acetatas - octan
acetonas - aceton
Achenas - Akwizgran
ačiū - dziękuję
actas - ocet
Adamas - Adam
adaptacija - adaptacja
adaptacinis - adaptacyjny
adapteris - adapter
adaptuoti - adaptować
adaptuotis - adaptować
adata - igła
adekvatumas - adekwatność
adekvatus - adekwatny
Adelaidė - Adelajda
adjunktas - adiunkt
adjutantas - adiutant
adjutantė - adiutantka
administracija - administracja
administracinis - administracyjny
administratorė - administratorka
administratorius - administrator, recepcja
administravimas - administracja
administruoti - administrować
admirolas - admirał
Adolfas - Adolf
Adomas - Adam
adopcija - adopcja
adrenalinas - adrenalina
adresas - adres
adresatas - adresat
adresatė - adresatka
adresuoti - adresować
Adrija - Adriatyk, Adria
Adrijos jūra - Adriatyk, Morze Adriatyckie
adventas - adwent
adventinis - adwentowy
advokatas - adwokat
adyti - cerować
aerodinamika - aerodynamika
aerodromas - lotnisko
aeroklubas - aeroklub
aerouostas - lotnisko
afektas - afekt
afera - afera
aferistas - aferzysta
afganas - Afgańczyk
afganė - Afganka
afganiškas - afgański, afganistański
Afganistanas - Afganistan
afganistanietė - Afganka
afganistanietis - Afgańczyk
afiša - afisz
afišuoti - afiszować
aforizmas - aforyzm
Afrika - Afryka
afrikanų - afrykanerski (język), Afrykanerów, afrykanerski, afrikanas
afrikietė - Afrykanka
afrikietis - Afrykanin
afrikietiškas - afrykański
Afrikos - afrykański, Afryki
afroamerikietiškas - afroamerykański
Afroditė - Afrodyta
agatas - agat
agentas - agent
agentūra - agentura
agentūrinis - agenturowy
agitacija - agitacja
agitacinis - agitacyjny
agitatorius - agitator
agituoti - agitować
Agnė - Agnieszka, Jagna
agnosticizmas - agnostycyzm
agonija - agonia
agorafobija - agorafobia
agrarinis - agrarny
agrastas - agrest
agregatas - agregat
agresija - agresja
agresorius - agresor
agresyvumas - agresywność
agronomas - agronom
agronomija - agronomia
agrotechnika - agrotechnika
agrotechnikas - agrotechnik
agroturistinis - agroturystyczny
aguona - mak
aguonpienis - aguonpienis
agurkas - ogórek
aibė - zbiór, rzesza, masa
aidas - echo
aikštė - plac, boisko
aikštelė - boisko
aikštynas - boisko
aimanuoti - biadolić
airė - Irlandka
Airija - Irlandia
Airijos jūra - Morze Irlandzkie
airis - Irlandczyk
airiškai - po irlandzku
airiškas - irlandzki
Aischilas - Ajschylos
aiškiaregys - jasnowidz
aiškus - jasny, zrozumiały
aitvaras - latawiec
ajeras - tatarak
akacija - akacja
akademija - akademia – rodzaj uczelni wyższej
akademikas - akademik
akademinis - akademicki
akademizmas - akademizm
akcentas - akcent
akcentuoti - akcentować
akceptacija - akceptacja
akceptuoti - akceptować
akcija - akcja
akcininkas - akcjonariusz
akcinis - akcyjny
akcizas - akcyza
akėčios - brona
akėti - bronować
akibrokštas - bura
akiduobė - oczodół
akimirka - chwila
akiniai - okulary
akiniuotasis lokys - niedźwiedź andyjski
akiplėšiškas - bezczelny
akiratis - horyzont
akis - oko
akistata - konfrontacja
akis už akį, dantis už dantį - oko za oko, ząb za ząb
akių obuoliai - gałki
akivaizdžiai - widocznie, oczywiście
aklas - ślepy
aklumas - ślepota
Akmenė - Okmiany
akmeninis - kamienny
akmentašys - kamieniarz
akmenuotas - kamienisty
akmuo - kamień
akompaniatorius - akompaniator
akompanimentas - akompaniament
akompanuoti - akompaniować
akordas - akord
akordeonas - akordeon
akronimas - skrótowiec, akronim
akrosoma - akrosom
akstinas - cierń
aktinis - aktyn
aktinoidas - aktynowiec
aktorius - aktor
aktualizuoti - aktualizować
aktualus - aktualny
aktyvai - aktywa
akumuliatorius - akumulator
akupresūra - akupresura
akupunktūra - akupunktura
akvariumas - akwarium
akvedukas - akwedukt
alaus darykla - browar
alavas - cyna
alavinis - cynowany
albanas - Albańczyk
albanė - Albanka
albanietė - Albanka
albanietis - Albańczyk
Albanija - Albania
albaniškai - po albańsku
albaniškas - albański
albanų - albański (język), Albańczyków, albański, albanas
albatrosas - albatros
albinizmas - albinizm
albumas - album
alchemija - alchemia
alchemikas - alchemik
aldosteronas - aldosteron
alebastras - alabaster
alegorija - alegoria
alėja - aleja
Aleksandras - Aleksander
aleliuja - alleluja
Alepas - Aleppo
alergenas - alergen
alergija - alergia
alerginis - alergiczny
alfabetas - alfabet
alga - pensja, płaca
algebra - algebra
algebrinis - algebraiczny
Algirdas - Olgierd
algoritmas - algorytm
aliarmas - alarm
Aliaska - Alaska
aliejus - olej
aligatorius - aligator
alimentai - alimenty
alio - halo
aliteracija - aliteracja
aliumininis - aluminiowy
aliuminis - glin, aluminium
aliuzija - aluzja
aljansas - alians
alkanas - głodny
alkis - głód
alkoholikas - alkoholik
alkoholinis - alkoholowy
alkoholio tikrintuvas - alkomat
alkoholis - alkohol
alkoholizmas - alkoholizm
alksnis - olcha, olsza
alkūnė - łokieć
Alma Ata - Ałmaty, Ałma-Ata
almanachas - almanach
Alpės - Alpy
alpimas - omdlenie
alpinistas - alpinista
alpinizmas - alpinizm
alpulys - omdlenie
Altajus - Ałtaj
altas - alt
alternatyva - alternatywa
alternatyvinis - alternatywny
alternatyvus - alternatywny
altorius - ołtarz
altruistas - altruista
altruistinis - altruistyczny
altruizmas - altruizm
aludaris - piwowar
aludarys - browar
aludarystė - piwowarstwo
aludė - piwiarnia
alus - piwo
alyva - oliwa, olej techniczny
Alžyras - Algieria
alžyrietis - Algierczyk
Amanas - Amman
amatas - rękodzieło, rzemiosło
amatininkas - rzemieślnik
Amazonė - Amazonka
ambasada - ambasada
ambasadorius - ambasador
ambicija - ambicja
ambicingas - ambitny
ambona - ambona
ambulansas - ambulans
ambulatorija - ambulatorium
ambulatorinis - ambulatoryjny
ameba - ameba
amen - amen
americis - ameryk
Amerika - Ameryka
amerikiečių - amerykański, Amerykanów
amerikietė - Amerykanka
amerikietis - Amerykanin
amerikietiškas - amerykański
amerikonas - Amerykaniec
Amerikos - amerykański, Ameryki
ametistas - ametyst
amfetaminas - amfetamina
amfiteatras - amfiteatr
amiloidozė - amyloidoza, skrobiawica, betafibryloza
amnestija - amnestia
amoniakas - amoniak
amoralumas - amoralność
amoralus - amoralny
amortizatorius - amortyzator
amperas - amper
amplitudė - amplituda
ampulė - ampułka
amputacija - amputacja
amputuoti - amputować
Amsterdamas - Amsterdam
amunicija - amunicja
Amūras - Amur
amžinas - wieczny
amžinumas - wieczność
amžinybė - wieczność
amžius - wiek, stulecie, liczba lat
anagrama - anagram
anaiptol - bynajmniej
analfabetas - analfabeta
analfabetizmas - analfabetyzm
analinis - analny
analitikas - analityk
analitinis - analityczny
analizė - analiza
analizinis - analityczny
analizuoti - analizować
analogija - analogia
analoginis - analogiczny
analogiškas - analogiczny
anamnezė - anamneza
ananasas - ananas
anarchija - anarchia
anarchistas - anarchista
anarchizmas - anarchizm
anarchosindikalizmas - anarchosyndykalizm
anatomija - anatomia
ančiasnapis - dziobak
ančiukas - kaczątko
Andai - Andy
Andora - Andora
andorietė - Andorka
andorietis - Andorczyk
andorietiškas - andorski
Andrinės - Andrzejki
Andrius - Andrzej
Andrychuvas - Andrychów
anekdotas - anegdota
aneksija - aneksja
aneksuoti - anektować
anemija - anemia
anemiškas - anemiczny
anesteziologas - anestezjolog
angažuoti - angażować
angelas - anioł
Angelas Sargas - Anioł Stróż
angeliškas - anielski
Angilija - Anguilla
angina - angina
angis - żmija
anglakalbis - anglojęzyczny, angielskojęzyczny
anglas - Anglik
anglė - Angielka
angliavandenis - węglowodan
anglicizmas - anglicyzm
anglies rūgštis - kwas węglowy
Anglija - Anglia
anglikonas - anglikanin
anglikonų - anglikański
anglis - węgiel
angliškai - po angielsku
angliškas - angielski
anglosaksiškas - anglosaksoński
anglų - angielski, Anglików
Angola - Angola
animacija - animacja
animacinis - animowany
animatorius - animator
animizmas - animizm
anizocitozė - anizocytoza
Ankara - Ankara
anketa - ankieta
anketuoti - ankietować
ankštas - ciasny
ankstesnis - poprzedni
ankštybė - ciasnota
anomalija - anomalia
anonimas - anonim
anoniminis - anonimowy
anonimiškas - anonimowy
anotacija - adnotacja
ant - na
antagonizmas - antagonizm
antakis - brew
Antanas - Antoni
antausis - policzek, skroń
antena - antena
antidalelė - antycząstka
Antigva ir Barbuda - Antigua i Barbuda
antiklerikalizmas - antyklerykalizm
antikomunizmas - antykomunizm
antilopė - antylopa
antinas - kaczor
antinomija - antynomia
antis - kaczka
antisemitizmas - antysemityzm
antiteizmas - antyteizm
antiutopija - antyutopia
antklodė - kołdra
antologija - antologia
antonimas - antonim
antpirštis - naparstek
antpuolis - atak, napad
antradienis - wtorek
antras - drugi
antraštė - tytuł, nagłówek
antropologas - antropolog
antropologija - antropologia
antspaudas - stempel
Antverpenas - Antwerpia
anūkas - wnuk
anūkė - wnuczka
anuliuoti - anulować
anyta - teściowa
anyžinė ožiažolė - biedrzeniec anyż
aorta - aorta
aparatas - aparat
aparatūra - aparatura
apartamentas - apartament
apaštalas - apostoł
apaštalinis - apostolski
apaštališkas - apostolski
apatija - apatia
apatiškas - apatyczny
apeigos - ceremonia, obrządek, obrzędy
apeiti - obejść
apeliacija - apelacja
apeliacinis - apelacyjny
apeliuoti - apelować
apelsinas - pomarańcza
apelsininis - pomarańczowy (od pomarańczy)
apelsinų - pomarańczowy (od pomarańczy)
apendicitas - zapalenie wyrostka robaczkowego
aperityvas - aperitif
apėsti - objeść
apetitas - apetyt
apetitiškas - apetyczny
apgailestauti - żałować, ubolewać
apgamas - znamię
apgauti - zmylić, oszukać, omamić, uwieść
apgavystė - oszustwo, oszukaństwo, szalbierstwo
apginti - bronić
apibrėžimas - definicja
apibrėžti - definiować
apie - o, około, ze
apipjaustymas - obrzezanie
apipjaustyti - obrzezać
apkabinimas - objęcie, uścisk
apkalbėti - obmawiać, oczerniać
apkaltinti - obwiniać, oskarżać
apklausa - ankieta
apklotas - koc
apkūnus - otyły
aplinka - środowisko
aplinkinis - okoliczny, pobliski
aplinkybė - okoliczność
aplodismentai - aplauz
aplombas - pewność siebie
apmaudas - przykrość
apodiktiškas - apodyktyczny
apodiktiškumas - apodyktyczność
apofazė - apofaza
apogėjus - apogeum
apokalipsė - apokalipsa
apokaliptinis - apokaliptyczny
apolitinis - apolityczny
apolitiškumas - apolityczność
Apolonas - Apollo
apopleksija - apopleksja
aporija - aporia
apostrofas - apostrof
apraksija - apraksja
aprašymas - opis
aprašyti - opisać
apsakyti - opowiedzieć
apsauga - ochrona, zabezpieczenie
apsiaustas - płaszcz
apsinuodijimas - zatrucie
apskritimas - okrąg
aptarimas - dyskusja
apuokas - puchacz
apvadas - krawężnik
apvalus - okrągły
apyaušris - brzask
apybaltis - białawy
apynys - chmiel
apyrankė - bransoletka
apyvarpė - napletek
apžadas - przyrzeczenie
apžvalgininkas - ankieter
arabakalbis - arabskojęzyczny
arabas - Arab
arabė - Arabka
Arabijos jūra - Morze Arabskie
arabiškai - po arabsku
arabiškas - arabski
Aragonas - Aragonia
aranžuotė - aranżacja
aranžuoti - aranżować
aras - ar
arba - lub
arbaletas - kusza
arbata - herbata
arbitralus - arbitralny
arbitras - sędzia, arbiter
arbitražas - arbitraż
arbūzas - arbuz
archaizmas - archaizm
archajiškas - archaiczny
archeologas - archeolog
archeologija - archeologia
archeologinis - archeologiczny
archetipas - archetyp
architektas - architekt
architektūra - architektura
archontas - archont
archyvas - archiwum
ardyti - burzyć
ardytis - burzyć się
arealas - areał
Arėjas - Ares
arena - arena
areštas - areszt
areštinė - areszt
areštuoti - aresztować
arfa - harfa
Argentina - Argentyna
argentinietė - Argentynka
argentinietis - Argentyńczyk
argentiniškas - argentyński
argininas - arginina
argonas - argon
arija - aria
aristokratija - arystokracja
Aristotelis - Arystoteles
aritmetika - arytmetyka
aritmetinė progresija - ciąg arytmetyczny
aritmija - arytmia, zaburzenie rytmu serca
arka - łuk
arkangelas - archanioł
arkivyskupas - arcybiskup
arkliavagis - koniokrad
arklidė - stajnia
arklininkystė - hodowla koni
arklinis - koński, konny
arklys - koń
arklys turi keturias kojas ir tai kartais suklumpa - koń ma cztery nogi i też się potknie
arktinis - arktyczny
armėnas - Ormianin
armėnė - Ormianka
Armėnija - Armenia
Armėnijos Respublika - Republika Armenii
armėniškas - ormiański
armija - armia
arnika - arnika
aromaterapija - aromaterapia, aromatoterapia
arsenalas - arsenał
arsenas - arsen
Artemidė - Artemida
arterija - tętnica
arteriolė - arteriola, tętniczka
arti - orać
artilerija - artyleria
artimas - bliski
artistas - artysta
artojas - oracz
artumas - bliskość
Aruba - Aruba
aruodas - spichlerz
aš - ja
ašara - łza
asbestas - azbest
aseksualumas - aseksualizm
asfaltas - asfalt
asfiksija - asfiksja
ašigalis - biegun
asilas - osioł
asinchroninis - asynchroniczny
ašis - oś
asketizmas - ascetyzm
asmenavimas - koniugacja
asmeninis - osobisty, prywatny, osobowy
asmens kodas - pesel
asmenuotė - koniugacja
asmenybė - osobowość
asmuo - osoba, jednostka
ąsotis - dzban
aspirinas - aspiryna
astatinas - astat
astatis - astat
astenosfera - astenosfera
asteriskas - asterysk
astrofizika - astrofizyka
astrologija - astrologia
astrometrija - astrometria
astronautas - astronauta
astronomas - astronom
astronomija - astronomia
astronominis - astronomiczny
astronominis vienetas - jednostka astronomiczna
aštrus - ostry
aštuntas - ósmy
aštuonetas - ósemka
aštuoni - osiem
aštuoniasdešimt - osiemdziesiąt
aštuoniasdešimtas - osiemdziesiąty
aštuoniolika - osiemnaście (18)
aštuoniolikmetis - osiemnastolatek
aštuonioliktas - osiemnasty
aštuonkojis - ośmiornica
atabradas - mielizna
ataka - atak
atakuoti - atakować
atašė - attaché
atavizmas - atawizm
atbulinė eiga - bieg wsteczny
ateistas - ateista
ateistinis - ateistyczny
ateiti - przyjść, nadejść
ateizmas - ateizm
Atėnai - Ateny
atentatas - atak
atestacija - atestacja
atestatas - atestat
atestuoti - atestować
atgauti - odzyskać
atimtis - odejmowanie
atitvara - bariera
atkalbėti - odradzać
Atlantas - Atlantyk
atlantinis - atlantycki
atlasas - atlas, atłas
atletas - atleta
atletika - atletyka
atlikti sutvirtinimą - bierzmować
atminti - pamiętać
atmintinas - pamiętny, wiekopomny
atmintis - pamięć
atmosfera - atmosfera
atnešti - przynieść
atomas - atom
atominis - atomowy
atomo branduolys - jądro atomowe
atomo numeris - liczba atomowa
atostogos - urlop
atpildas - odkupienie
atranka - wybór, selekcja, dobór
atrasti - wynaleźć
atrodyti - wyglądać, wydawać się
atsakiklis - automatyczna sekretarka
atsakomybė - odpowiedzialność
atsakymas - odpowiedź
atsarginis - awaryjny
atsiminti - pamiętać
atsiprašau - przepraszam
atsiprašymas - przeprosiny
atsirasti - znaleźć się
atsirūgti - beknąć
atskaitomybė - sprawozdawczość
atspalvis - odcień, zabarwienie
atsparumas - odporność
atspaudas - odcisk
atstatyti - odbudować
atstovybė - zastępstwo
atstumas - odległość
atsuktuvas - śrubokręt, wkrętak
atvaizdas - obraz, odbicie
atvejis - przypadek, wypadek
atvykimas - przybycie, przyjazd
atžvilgis - wzgląd
audėjas - tkacz
audiencija - audiencja
audìnė - norka
audiovizualinis - audiowizualny
auditas - audyt
auditorija - audytorium, aula
auditorius - audytor
audituoti - audytować
audra - burza
audringas - burzliwy
augalas - roślina
augimas - wzrost, rozwój
augti - rosnąć
Augustavas - Augustów
auka - datek, ofiara
aukcionas - aukcja
auksakalys - złotnik
auksaplunksnis - złotopióry
auksas - złoto
aukščiau - wyżej, powyżej
aukščiausiasis laipsnis - stopień najwyższy
auksinis - złoty
aukso - złoty
aukštai - wysoko
aukštaitė - mieszkanka Auksztoty
Aukštaitija - Auksztota
Aukštaitijos - auksztocki
aukštaitis - mieszkaniec Auksztoty
aukštaitiškas - auksztocki
aukštas - wysoki, piętro
aukštesnysis laipsnis - stopień wyższy
aukštuma - wyżyna
aukštumas - wysokość
aukštyn - w górę, wzwyż
aureolė - aureola
ausis - ucho, słuch
auskaras - kolczyk
aušra - świt, zorza
austi - tkać
australas - Australijczyk
australė - Australijka
Australija - Australia
australiškas - australijski
australų - australijski, Australijczyków
austras - Austriak
austrė - Austriaczka
Austrija - Austria
Austrija-Vengrija - Austro-Węgry
austriškas - austriacki
autentiškas - autentyczny
autentiškumas - autentyczność
autoatsakiklis - automatyczna sekretarka
autobiografija - autobiografia
autobusas - autobus, autokar
autobusų - autobusowy, autobusas
autografas - autograf
autoklavas - autoklawa
autokomisas - autokomis
autokratija - autokracja, autokratyzm
autokratiškas - autokratyczny
automagistralė - autostrada
automatas - automat
automatinis - automatyczny
automatiškas - automatyczny
automobilis - samochód, automobil
automobilizmas - automobilizm
automorfinis skaičius - liczba automorficzna
autonomija - autonomia
autorė - autorka
autoritarizmas - autorytaryzm
autoritetingas - cieszący się autorytetem
autorius - autor
autostrada - autostrada
autoturizmas - turystyka samochodowa
avalynė - obuwie
avangardas - awangarda
avangardinis - awangardowy
avangardizmas - awangardyzm, awangarda
avantiūra - awantura
avantiūristas - awanturnik
avantiūristinis - awanturniczy
avarija - awaria
avaringumas - awaryjność
avarinis - awaryjny
aversas - awers
aviena - baranina
avietė - malina
avinas - baran
Avinas - Baran
Avinjonas - Awinion
avis - owca
avitaminozė - awitaminoza
avokadas - awokado
Azerbaidžanas - Azerbejdżan
azerbaidžanietė - Azerbejdżanka
azerbaidžanietiškas - azerbejdżański
Azerbaidžano Respublika - Republika Azerbejdżanu
azietė - Azjatka
azietis - Azjat
Azija - Azja
azijietė - Azjatka
azijietis - Azjata
Azijos - azjatycki, Azji
azimutas - azymut
Azorai - Azory
azotas - azot
azotinis - azotowy
azoto rūgštis - kwas azotowy
Azovo jūra - Morze Azowskie
ąžuolas - dąb
ąžuolinis - dębowy
ąžuolynas - dąbrowa
azuritas - azuryt
bachuras - bachor
bacila - bakcyl
badas - głód
badmintonas - badminton
bagažas - bagaż
bagažinė - bagażnik
Bagdadas - Bagdad
Bahamos - Bahamy
Bahreinas - Bahrajn
baidarė - kajak
baigti - kończyć
baikalinė kryklė - bajkałówka
baikštumas - bojaźliwość
baikštus - bojaźliwy
bailus - bojaźliwy
bailys - tchórz, bojaźliwiec
baimė - strach, lęk
baimingas - bojaźliwy
Baisogala - Bejsagoła
baisus - okropny, przeraźliwy
baitas - bajt
bajeris - bajer
bajoras - bojar
bajorija - bojarstwo
bajoriškas - bojarski
bajorystė - bojarstwo
Bakalariava - Bakałarzewo
bakalauro darbas - praca licencjacka
bakalėja - bakalia
bakas - bak
baklažanas - bakłażan
bakterija - bakteria
bakteriologija - bakteriologia
Baku - Baku
bala - bagno
baladė - ballada
balalaika - bałałajka
balandis - kwiecień
bala nematė - Do diabła z tym!
balansas - bilans
balansuoti - balansować
balastas - balast
Balbieriškis - Balwierzyszki
Balčiai - Bolcie
baldas - mebel
balerina - balerina
baletas - balet
baletmeisteris - baletmistrz
baleto - baletowy
balinti - bielić
balionas - balon
balius - bal
baliustrada - balustrada
Balkanai - Bałkany
balkonas - balkon
balnas - siodło
balneologija - balneologia
balsas - głos
balsavimo biuletenis - karta wyborcza
balsis - samogłoska
Balstogė - Białystok
Balstogės - białostocki
balstogietis - białostoczanin
balsuotojas - wyborca
balsvas - białawy
baltakaktė žąsis - gęś białoczelna
baltarusė - Białorusinka
Baltarusija - Białoruś
Baltarusijos - białoruski, Białorusi
Baltarusijos Respublika - Republika Białorusi
baltarusis - Białorusin
baltarusiškas - białoruski
baltarusių - białoruski, Białorusinów
baltas - biały
baltasis lokys - niedźwiedź polarny
baltaskruostė berniklė - bernikla białolica
balteglė - jodła
balti - blednąć
Baltica - Bałtyka
Baltieji Rūmai - Biały Dom
baltijietis - mieszkaniec państw nadbałtyckich
Baltijos - bałtycki
Baltijos jūra - Morze Bałtyckie, Bałtyk
Baltijskas - Bałtyjsk
baltiniai - bielizna
baltinti - bielić
baltistas - bałtysta
Baltoji jūra - Morze Białe
Baltupiai - Bołtupie
Bamakas - Bamako
bamblys - bobas
bambukas - bambus
banalus - banalny
banalybė - banał
bananas - banan
bananų - bananowy
banda - stado
bandelė - bułka
banderolė - banderola
banditas - bandyta
banditiškas - bandycki
banditizmas - bandytyzm
bandyti - próbować
Bandžulis - Bandżul
banga - fala
banginis - wieloryb
Banginis - Wieloryb
Bangis - Bangi
Bangladešas - Bangladesz
banka - mielizna
bankas - bank
banketas - bankiet
banketinis - bankietowy
bankininkas - bankier
bankininkystė - bankowość
banknotas - banknot
Bankokas - Bangkok
bankomatas - bankomat
bankrotas - bankrut
bankrutuoti - bankrutować
baobabas - baobab
barakas - barak
Baranovičiai - Baranowicze
baras - bar
baravykas - borowik
Barbadosas - Barbados
barbaras - barbarzyńca
barbariškas - barbarzyński
barbariškumas - barbarzyństwo
barbarizmas - barbaryzm
Barčianiai - Barciany
bardas - bard
barelis - baryłka
Barenco jūra - Morze Barentsa
barikada - barykada
barikaduoti - barykadować
barionas - barion
baris - bar
baritonas - baryton
barjeras - bariera
barokas - barok
barometras - barometr
baronas - baron
baronienė - baronowa
Barselona - Barcelona
barškuolė - grzechotnik
barštis - barszcz
Barštynas - Bartoszyce
barsukas - borsuk
barti - besztać
barzda - broda
barzdotas - brodaty
basas - bosy
baseinas - basen
basom - boso
bastionas - bastion
bastytis - błąkać się
batalija - batalia
batalionas - batalion
batas - but
batatas - batat
baterija - bateria
batonas - baton
batsiuvys - szewc
batuta - batuta
batvinis - burak
baubas - straszydło
baublys - bąk
Baucenas - Budziszyn
bauda - kara, grzywna, mandat
baudinys - rzut karny
baudos aikštelė - pole karne
bauginti - straszyć, zastraszać
bausmė - kara
bausti - karać
bavaras - Bawarczyk
Bavarija - Bawaria
bavarų - bawarski
bazaltas - bazalt
bazė - baza, zasada
Bazelis - Bazylea
bazilika - bazylika, rodzaj kościoła
bazilikas - bazylia
bažnyčia - kościół
be - bez, oprócz, poza
beasmenis - bezosobowy
beatodairiškas - bezwzględny
beatodairiškumas - bezwzględność
bebaimis - nieustraszony, nieulękły
bebras - bóbr
Beceilai - Becejły
bėda - bieda
bedantis - bezzębny
bedievis - bezbożnik
bedieviškas - bezbożny
bedievybė - bezbożnictwo
bedugnis - bezdenny
beformis - bezkształtny
begalis - bezkresny
be galo - bez końca, niezmiernie
begalvis - bezgłowy, bezmózgi, głupi, tępy
begalybė - bezkres
begarsis - bezdźwięczny
begemotas - hipopotam
bėgikas - biegacz, biegus
bėgimas - bieg
bėgimas su kliūtimis - bieg z przeszkodami
bėgimo takas - bieżnia
bėginėti - biegać
bėgioti - biegać
bėgis - bieg
bėgte - biegiem
bėgti - biec, biegać
bei - i, oraz
beicas - bejca
beicuoti - bejcować
Beirutas - Bejrut
beisbolas - baseball
bekonas - bekon
Belchatuvas - Bełchatów
Belcis - Bielce
beletristas - beletrysta
beletristika - beletrystyka
beletristinis - beletrystyczny
belgas - Belg
belgė - Belgijka
Belgija - Belgia
belgiškas - belgijski
Belgradas - Belgrad
belgų - belgijski, Belgów
Beliava - Bielawa
Belizas - Belize
Belmontas - Belmont
Belmopanas - Belmopan
Belskas - Bielsk Podlaski
Belsko-Biala - Bielsko-Biała
belsti - bębnić
bendradarbiauti - współpracować
bendrapilietis - współobywatel
bendras - całkowity
bendrasis vidaus produktas - produkt krajowy brutto
bendratis - bezokolicznik
bendravardis - imiennik
bendrovė - spółka
bendruomenė - społeczeństwo, wspólnota
bendvažygis - towarzysz podróży
Bendzinas - Będzin
benefisas - benefis
Bengalija - Bengal
bengališkas - bengalski
Beninas - Benin
benzinas - benzyna
benzolas - benzol
be reikalo - bez potrzeby, niepotrzebnie, zbytecznie
beretė - beret
bergždžiai - daremnie
bergždžias - daremny
berilas - beryl
berilis - beryl
berklis - berkel
Berlynas - Berlin
Berlyno - berliński
Bernas - Berno
berniklė - bernikla
berniukas - chłopiec
beržas - brzoza
Berzininkai - Berżniki
Berznykas - Berżniki
beržynas - brzozowisko
Beščiadai - Bieszczady
Beskidai - Beskidy
bet - byle
Betliejus - Betlejem
betonas - beton
betoninis - betonowy
betono maišytuvas - betoniarka
beveik - prawie, omal
bevėjis - bezwietrzny
bevertis - bezwartościowy
bevielis - bezprzewodowy
beviltis - beznadziejny
beviltiškas - beznadziejny
bevizis - bezwizowy
beždžionė - małpa
Bialogardas - Białogard
biatlonas - biathlon
Biblija - Biblia
bibliografija - bibliografia
biblioteka - biblioteka
bibliotekininkas - bibliotekarz
bibliotekininkė - bibliotekarka
bibliotekininkystė - bibliotekarstwo
bičiulė - przyjaciółka, koleżanka
bičiulis - przyjaciel, kumpel, kolega
bifštekas - befsztyk
bijoti - bać się
Bilbinavas - Bilwinowo
Bilgorajus - Biłgoraj
biliardas - bilard
bilietas - bilet
bimbalas - bąk
bimbti - brzęczeć
biochemija - biochemia
biofizika - biofizyka
biokibernetika - biocybernetyka
biologas - biolog
biologija - biologia
biologinis - biologiczny
biosfera - biosfera
Birma - Birma
birželis - czerwiec
Bisau Gvinėja - Gwinea Bissau
biseksualistas - biseksualista
Biškekas - Biszkek
bismutas - bizmut
bitas - bit
bitė - pszczoła
bitininkas - żołna zwyczajna, pszczelarz
biudžetas - budżet
biudžetinis - budżetowy
Bizantija - cesarstwo bizantyńskie, Bizancjum
bizantiškas - bizantyjski
biznierius - biznesmen
biznis - biznes
bizonas - bizon
bizūnas - bat
bižuterija - biżuteria
blakstiena - rzęsa
blankus - blady
blatas - blat
blauzda - goleń
blefuoti - blefować
blėsti - blaknąć
blevyzga - bluźnierstwo
blevyzgoti - bluźnić, bluzgać
blezdinga - jaskółka
bliauti - beczeć
blizgesys - blask
blogai - źle
blogas - zły, blog
blogėti - pogarszać się
blokšti - ciskać
blukti - blaknąć
blusa - pchła
blyškus - blady
boba - kobieta, staruszka, żona
bobteilas - owczarek staroangielski, bobtail
bobutė - babcia
Bogota - Bogota
boksas - boks
boksitas - boksyt
bokštas - baszta
Boleslavecas - Bolesławiec
Bolivija - Boliwia
bomba - bomba
bombonešis - bombowiec
bongas - bong, bongo, bongos
boras - bor
bordo - bordo
boris - bohr
boro rūgštis - kwas borowy, kwas borny
bortas - burta
boružė - biedronka
bosas - bas
bosinis - basowy
bosnė - Bośniaczka
Bosnija - Bośnia
Bosnija ir Hercegovina - Bośnia i Hercegowina
bosnis - Bośniak
bosniškas - bośniacki
botagas - bat
botanika - botanika
Botsvana - Botswana
bozonas - bozon
brahmanizmas - braminizm
Brandenburgas - Brandenburgia
brandus - dojrzały
brangakmenis - kamień szlachetny
brangenybės - kosztowności
brangiai - drogo
branginti - cenić
brangti - drożeć
braškė - truskawka
Bratislava - Bratysława
brazilas - Brazylijczyk
brazilė - Brazylijka
Brazilija - Brazylia
braziliškas - brazylijski
Brėmenas - Brema
bręsti - dojrzewać
brezentas - brezent
brėžinys - szkic, zarys
briedis - łoś
brigada - brygada, ekipa
brinkti - pęcznieć, nabrzmiewać
Briuselis - Bruksela
brokas - bubel
brolėčia - bratanica
brolėnas - bratanek
brolinė - bratowa
brolis - brat
broliškas - braterski
bromas - brom
bronchitas - zapalenie oskrzeli
bronza - brąz
bronzas - brązowy
bronzinis - brązowy
bruksizmas - bruksizm
Brunėjus - Brunei
bruožas - cecha
Bubeliai - Bubele
bubonas - dymienica
bučinys - buziak
bučiukas - całusek
bučiuoti - całować
bučiuotis - całować się
bučkis - całusek
Budapeštas - Budapeszt
budizmas - buddyzm
būdvardinis - przymiotnikowy
būdvardis - przymiotnik
Buenos Airės - Buenos Aires
Bugas - Bug
būgnas - bęben
būgnelis - bębenek
būgnininkas - dobosz, perkusista
būgnuoti - bębnić
būgštauti - lękać się
buhalteris - księgowy
builis - kur diabeł, trybula
buivolas - bawół
Bukareštas - Bukareszt
bukas - buk, tępy, rozwarty
bukletas - folder
buldogas - buldog
bulgaras - Bułgar
bulgarė - Bułgarka
Bulgarija - Bułgaria
Bulgarijos Respublika - Republika Bułgarii
bulgariškai - po bułgarsku
bulgariškas - bułgarski
bulmastifas - bulmastif
bulterjeras - bulterier
bulvė - ziemniak, kartofel
buomas - belka
buožgalvis - kijanka
būras - chłop, wieśniak
burbulas - bańka
burė - żagiel
Burkina Fasas - Burkina Faso
burna - usta
burti - wróżyć, czarować, podrywać
burtininkas - czarownik, czarodziej
Burundis - Burundi
buržuazija - burżuazja
būsimas - przyszły
butanas - butan
Butanas - Bhutan
butas - mieszkanie
butelis - butelka
būti - być
būtybė - stworzenie
buvoti - bywać
BVP - PKB, produkt krajowy brutto
bybis - bybys
bybys - chuj, kutas
Bydgoščius - Bydgoszcz
Bytomas - Bytom
Čadas - Czad
calūnas - całun
Čapelka - Czapelka
caraitis - carewicz
caras - car
carienė - caryca
carinis - carski
carizmas - carat
Čečėnija - Czeczenia
Cechanovas - Ciechanów
Cechanuvas - Ciechanów
čekas - Czech
čekė - Czeszka
Čekija - Czechy
Čèkijos Respùblika - Republika Czeska
čekiškai - po czesku
čekiškas - czeski
Čekoslovakija - Czechosłowacja
čekų - czeski (język), Czechów, czeski, čekas
celė - cela
celebruoti - celebrować
celibatas - celibat
celiuliozė - celuloza
celiuliozinis - celulozowy
celofanas - celofan
celofaninis - celofanowy
cementas - cement
cementuoti - cementować
čempionatas - mistrzostwo, mistrzostwa
Čenstakava - Częstochowa
centas - cent
centimetras - centymetr
centralizavimas - centralizacja
centralizuoti - centralizować
centras - centrum
Centrinė Europa - Europa Środkowa
Centrinės Afrikos Respublika - Republika Środkowoafrykańska
centrinis - centralny, środkowy
cenzūra - cenzura
ceremonija - ceremonia
ceris - cer
cerkvė - cerkiew
Černobylis - Czarnobyl
česnakas - czosnek (pospolity), rodzaj roślin z rodziny amarylkowatych
Cešynas - Cieszyn
cezis - cez
chameleonas - kameleon
chaosas - chaos
charakteristika - charakterystyka
Charkovas - Charków
Chartumas - Chartum
Chelmas - Chełm
chemija - chemia
chemikas - chemik
cheminis - chemiczny
chirurgas - chirurg
chirurgija - chirurgia
chloras - chlor
chlorofilas - chlorofil
choras - chór
choreografija - choreografia
Chožuvas - Chorzów
chrizantema - chryzantema
chromas - chrom
chromosoma - chromosom
chronometras - chronometr
Chšanuvas - Chrzanów
čia - tutaj
cianas - cyjanek
čiaudėti - kichać
čiaudulys - kichanie
Ciešynas - Cieszyn
ciferblatas - cyferblat
cigaras - cygaro
cigaretė - papieros
čigonas - Cygan
ciklas - cykl
ciklinis - cykliczny
cikliškai - cyklicznie
cikliškas - cykliczny
ciklonas - cyklon
cikorija - cykoria
ciksėti - cykać
Čilė - Chile
cilindras - cylinder
cilindrinis - cylindrowy
cimbolai - cymbały
cinamonas - cynamon
cinikas - cynik
ciniškai - cynicznie
ciniškas - cyniczny
cinkas - cynk
cirkas - cyrk
cirkinis - cyrkowy
cirkonis - cyrkon
cirkuliacija - cyrkulacja
cistinurija - cystynuria
citadelė - cytadela
citata - cytat
citologija - cytologia
citologinis - cytologiczny
citrina - cytryna
citrinukas - latolistek cytrynek
cituoti - cytować
čiulpti - ssać, cmokać, pykać fajkę
čiulpti bybį - ciągnąć druta
čiuožėjas - łyżwiarz
čiurlenti - ciurkać
čiurlys - jerzyk
civilizacija - cywilizacja
civilizuoti - cywilizować
čivylis - makolągwa
cokolis - cokół
colis - cal
cukrainė - cukiernia
cukraligė - cukrzyca
cukrinė - cukierniczka
cukrinis - cukrowy
cukrus - cukier
cunamis - tsunami
cyplė - świstun
CŽV - CIA
dabar - teraz, obecnie
daboklė - areszt
dačia - dacza
daiktas - rzecz
daiktavardis - rzeczownik
dailidė - cieśla
daina - pieśń, piosenka
dainavimas - śpiew
dainelė - piosenka, piosnka
dainininkas - piosenkarz, śpiewak
dainininkė - piosenkarka, śpiewaczka
dainuoti - śpiewać
Daka - Dhaka
daktaras - doktor
dalelytė - partykuła, cząsteczka
dalis - część
dalmatinas - dalmatyńczyk
daltonikas - daltonista
dalykas - sprawa, przedmiot
dalyvauti - uczestniczyć, brać udział, współdziałać
dalyvė - wspólniczka
dalyvis - wspólnik, uczestnik
dama - dama
Damaskas - Damaszek
danas - Duńczyk
danė - Dunka
dangiškas - niebieski, niebiański
dangoraižis - wieżowiec, drapacz chmur
dangus - niebo
Danija - Dania
Danijos Karalystė - Królestwo Danii
daniškas - duński
dantis - ząb
dantistas - dentysta
dantų gydytojas - dentysta, stomatolog
danų - duński (język), Duńczyków, duński, danas
daoizmas - taoizm, daoizm
dar - jeszcze
darbas - praca, zatrudnienie, czyn, uczynek, czynność
darbininkas - robotnik
darbuotis - męczyć się, trudzić się, porać się czymś
Darkiemis - Darkiejmy
darkytis - błaznować
darmštatis - darmsztadt
daryti - robić, czynić, wywierać (wpływ)
daryti neaktualų - deaktualizować
daržas - ogród
darželis - ogródek
daržovė - warzywo, jarzyna
data - data
daug - dużo
daugiakalbis - wielojęzyczny
daugiakampis - wielokąt
daugialypis - wieloczęściowy
daugiametis - wieloletni
daugiapusis - wielostronny
daugiaspalvis - wielokolorowy
daugiatautis - wielonarodowy
daugiažiedis - wielokwiatowy
daugiskaita - liczba mnoga
Dauguva - Dźwina
daugyba - mnożenie
daugybos lentelė - tabliczka mnożenia
davai - dawaj
davatka - dewotka
davėjas - dawca
davinėti - dawać
davinys - dawka
dažnai - często
dažykla - lakiernia
dažyti - kolorować, farbować, barwić, malować (pokój), różować (o twarzy) - nakładać róż
debatai - debata
debatuoti - debatować
debesis - chmura
debetas - debet
debilas - debil
debiliškas - debilny
debiutantas - debiutant
debiutas - debiut
debiutuoti - debiutować
dėdė - wujek
dėdienė - ciocia, ciotka - siostra matki lub ojca
definicija - definicja
degalinė - stacja benzynowa, stacja paliw
degeneracija - degeneracja
degeneratas - degenerat
degeneruoti - degenerować
degradacija - degradacja
degraduoti - degradować
degresinis - degresywny
degti - płonąć
degtinė - wódka, gorzałka
Degučiai - Degucie
deguonis - tlen
degustacija - degustacja
degustacinis - degustacyjny
deimantas - diament
deja - niestety
dejuoti - żalić się, biadolić, narzekać, użalać się, lamentować, jęczeć
dekanas - dziekan
dėkingas - wdzięczny
deklamatorius - recytator
dėkoju - dziękuję
dėkoti - dziękować
dėkui - dziękuję
dėl - z powodu, wskutek, na skutek, dzięki, o (kogo, co)
dėlė - pijawka
delegacija - delegacja
delegalizuoti - delegalizować
delegatas - delegat
deleguoti - delegować
delfinas - delfin
delikatesas - delikatesy
delikatumas - delikatność
delikatus - delikatny
delnas - dłoń
delta - delta
Dembica - Dębica
dėmė - plama
dėmesys - uwaga
demografija - demografia
demokratas - demokrata
demokratija - demokracja
demokratinis - demokratyczny
demonas - demon
denaras - denar
dendrochronologija - dendrochronologia
dendrologija - dendrologia, drzewoznawstwo
depresija - depresja
derintuvė - debugger
derlingas - żyzny, urodzajny
dešimt - dziesięć - 10
dešimtas - dziesiąty
dešimtinė - dziesięcina
dešimtis - dziesiątka
dešimtmetis - dziesięciolecie, dekada, dziesięcioletni
dešinys - prawostronny, prawy
dešra - kiełbasa
dėstytojas - wykładowca
detalė - detal, szczegół
dėti - kłaść, składać - gromadzić, nieść się
devalvacija - dewaluacja
devintas - dziewiąty
devynetas - dziewiątka
devyni - dziewięć, 9
devyniasdešimt - dziewięćdziesiąt
devyniasdešimtas - dziewięćdziesiąty
devyniasdešimtmetis - dziewięćdziesięciolecie
devyniolika - dziewiętnaście, 19
devyniolikmetis - dziewiętnastolatek
devynioliktas - dziewiętnasty
devynios auklės, vaikas be galvos - gdzie kucharek sześć, tam nie ma co jeść, dziewięć nauczycielek, a dziecko bez głowy
devynmetis - dziewięciolatek
dėžė - pudło, skrzynia
dezinformacija - dezinformacja
diabetas - cukrzyca
diabetikas - cukrzyk
diabetinis - cukrzycowy
dialektas - dialekt
dialektika - dialektyka
dializė - dializa
dialogas - dialog
didelis - duży
didvyris - bohater
didvyriškas - bohaterski, heroiczny
Didžioji Britanija - Wielka Brytania
diena - dzień
dievas - bóg
Dievas - Bóg
dieveris - szwagier
dievinti - uwielbiać, ubóstwiać
dieviškas - boski
dievotas - pobożny
dievybė - bóstwo
difuzija - dyfuzja
dilgėlė - pokrzywa
dimorfizmas - dymorfizm
dinamitas - dynamit
dinaras - dinar
dingti - znikać, zniknąć, przepaść, przepadać
dinozauras - dinozaur
dioskorėja - pochrzyn
diplomas - dyplom
diplomatija - dyplomacja
dirbti - pracować
direktorius - dyrektor
dirigentas - dyrygent
diržas - pas, pasek
diskas - dysk
disprozis - dysproz
distancija - dystans
Dniepras - Dniepr
Dniestras - Dniestr
dobermanas - doberman
dobilas - koniczyna
docentas - docent
doktrina - doktryna
dokumentacija - dokumentacja
doleris - dolar
Dominika - Dominika
Dominikos Respublika - Republika Dominikańska
dominti - budzić zamiłowanie, ciekawić, interesować
domofonas - domofon
Doneckas - Donieck
donoras - dawca
dopingas - środek dopingujący
Dotnuva - Datnów
dovana - dar
dovanojimas - darowizna
dovanoti - darować
dovanotojas - darczyńca
dozė - dawka
dozimetras - dozymetr
drabužis - ubranie, odzież
Dramblio Kaulo Krantas - Wybrzeże Kości Słoniowej
dramblys - słoń
drąsa - animusz
drąsus - odważny, śmiały
dratharas - wyżeł niemiecki szorstkowłosy
draugas - przyjaciel, towarzysz (w partii)
draugauti - przyjaźnić się
draugė - przyjaciółka
draugystė - przyjaźń
drausti - zabraniać, zakazywać, ubezpieczać
drebulė - osika
dresiruotojas - treser
dribt - bęc
driežas - jaszczurka
drožtukas - temperówka
drugelis - motylek
drugys - motyl, febra, malaria
drungnas - ciepławy
druska - sól
druskinė - solniczka
druskos rūgštis - kwas solny, kwas chlorowodorowy
Drvenca - Drwęca
du - dwa, 2
dublikatas - duplikat
Dublinas - Dublin
dubnis - dubn
dujinis - gazowy
dujos - gaz
dukra - córka
duktė - córka
dukterėčia - bratanica
dulkių siurblys - odkurzacz
dūmai - dym
dūmas - dym
dumblas - muł, szlam
dumblynas - bagnisko
dūminis - dymny
dumti - dąć
Dunajecas - Dunajec
Dunojus - Dunaj
duobės - wyboje
duobkasys - grabarz
duoklė - danina
duombazė - baza danych
duomenų bazė - baza danych
duona - chleb
duoti - dać, dawać
durijus - durian, zybuczkowiec
durniams sekasi - głupi ma zawsze szczęście
durpės - torf
durtuvas - bagnet
durys - drzwi
Dušanbė - Duszanbe
dušas - natrysk, prysznic
dvasia - duch
dvejaip - dwojako
dvejetas - dwójka
dvejoti - wątpić, powątpiewać
dvibalsis - dwugłoska
dvidešimt - dwadzieścia, 20
dvidešimtas - dwudziesty
dvigubai - podwójnie
dvimetis - dwuletni
dviratis - rower
dvokti - cuchnąć
dvylika - dwanaście, 12
dvyliktas - dwunasty
Dvyniai - Bliźnięta
dvynukai - bliźniaki
dvynukės - bliźniaczki
dyglys - kolec
dygti - kiełkować
dykaduonis - darmozjad
dykai - darmo
dykuma - pustynia
džemperis - bluza
Dzeržoniuvas - Dzierżoniów
Dzeusas - Zeus
Dzežbia - Dzierzbia
Dzialdovas - Działdowo
džiaugsmingai - radośnie
džiaugsmingas - wesoły, radosny
džiaugtis - cieszyć się
Džibutis - Dżibuti
džiūgauti - radować się, cieszyć się
Džordžija - Georgia
Dzūkija - Dzukia
ę - dziewiąta litera litewskiego alfabetu
Edinburgas - Edynburg
Egėjo jūra - Morze Egejskie
Egiptas - Egipt
eglė - świerk
egoistas - egoista
egoizmas - egoizm
egzaminas - egzamin
egzilis - banicja
egzistencializmas - egzystencjalizm
egzistencija - egzystencja
egzistuoti - egzystować, istnieć
egzotiškas - cytrusowy
eilė - kolejka sklepowa, wiersz, linia (w tekście)
einšteinis - einstein
eismas - ruch
eiti - iść, poruszać się z jednego miejsca w drugie, przemieszczać się, chodzić, wędrować, upływać, mijać (o czasie), postępować, nastąpić (o zdarzeniu)
ekologija - ekologia
ekonomika - gospodarka, ekonomika
ekonomistas - ekonomista
ekosistema - ekosystem
ekskavatorius - koparka
ekslibrisas - ekslibris
eksplozija - wybuch, eksplozja
Ekvadoras - Ekwador
Elbė - Łaba
Elbingas - Elbląg
elektrikas - elektryk
elektroferezė - elektroforeza
elektrolitas - elektrolit
elektronas - elektron
elektronika - elektronika
elektroninis - elektroniczny
elektroninis paštas - poczta elektroniczna
elementas - element
elgesys - postępowanie, zachowanie
elgeta - żebrak, żebraczka
elgetauti - żebrać
elgetavimas - żebractwo
elgetiškas - żebraczy, nędzny
elgetynas - przytułek dla żebraków
elgtis - zachowywać się, postępować
elnias - jeleń
elniena - dziczyzna
Elzasas - Alzacja
Elzė - Eliza
emancipacija - emancypacja
embolija - zator
embrionas - embrion, zarodek
emigracija - emigracja
Emilė - Emilia
Emilia - Emilia
Emilija - Emilia
emiratas - emirat
emocija - emocja
encefalitas - zapalenie mózgu
enciklopedija - encyklopedia
endokarditas - zapalenie wsierdzia
endokrininė sistema - układ hormonalny
endokrinologija - endokrynologia
energija - energia
entomologija - entomologia
entropija - entropia
epicentras - epicentrum
epidemija - epidemia
epocha - epoka
era - era
erbis - erb
erchercogas - arcyksiążę
erdvė - przestrzeń
erdvėlaikis - czasoprzestrzeń
erekcija - erekcja
erelis - orzeł
erezija - herezja
Eritrėja - Erytrea
ėriukas - baranek, jagnię
erkė - kleszcz
erogeninė zona - strefa erogenna
erotomanija - erotomania
eržilas - ogier
ešerys - okoń
esperanto - esperanto
estas - Estończyk
estė - Estonka
estetas - esteta
estetika - estetyka
estetinis - estetyczny
estetiškas - estetyczny
ėsti - żreć
Estija - Estonia
Estijos Respublika - Republika Estońska
estiškas - estoński
esybė - istota
etanas - etan
etanolis - etanol
etiketė - etykietka
Etiopija - Etiopia
etiopiškas - etiopski
etiškas - etyczny
eufemizmas - eufemizm
Eugenija - Eugenia
euras - euro
Eurazija - Eurazja
Euripidas - Eurypides
Europa - Europa
europarlamentaras - eurodeputowany, europoseł
europietė - Europejka
europietis - Europejczyk
europietiškas - europejski
europis - europ
Europos Sąjunga - Unia Europejska
evakuacija - ewakuacja
evangelija - ewangelia
ežeras - jezioro
Ezopas - Ezop
ežys - jeż
fabrikas - fabryka
fabrikinis - fabryczny
fagotas - fagot
failas - plik
faktas - fakt
faktorius - czynnik
falčionas - tasak
fanatikas - fanatyk
faradas - farad
farmacija - farmacja
farmacinis - farmaceutyczny
farmakologija - farmakologia
fašistas - faszysta
fašizmas - faszyzm
fazanas - bażant
federacija - federacja
felacija - fellatio
feljetonas - felieton
feminizmas - feminizm
fenilketonurija - fenyloketonuria, oligofrenia fenylopirogronowa
feodalinis - feudalny
feodalizmas - feudalizm
fermentas - enzym, ferment
fermionas - fermion
fermis - ferm
Fidžis - Fidżi
filharmonija - filharmonia
Filipinai - Filipiny
filmuoti - filmować
filologas - filolog
filologija - filologia
filosofas - filozof
filosofija - filozofia
finalas - finał
finalininkas - finalista
fisharmonija - fisharmonia
fistulė - przetoka
fizika - fizyka
fizioterapija - fizjoterapia
flamingas - flaming, czerwonak
fleita - flet
flerovis - flerow
flomasteris - flamaster
Florencija - Florencja
fluoras - fluor
fokusininkas - iluzjoner, sztukmistrz
fonas - tło
fondas - fundusz
fonema - fonem
fonetika - fonetyka
forintas - forint
fortepijonas - fortepian
fosfatas - fosforan
fosforas - fosfor
fosforo rūgštis - kwas fosforowy
fotelis - fotel
fotografas - fotograf
fotografija - fotografia
fotonas - foton
fotosintezė - fotosynteza
fovizmas - fowizm
frakcija - frakcja
francis - frans
frankas - frank
freska - fresk
fricų - szwabski, szkopski
funkcija - funkcja
futbolas - futbol, piłka nożna
futbolininkas - piłkarz
gabalas - kawał, kawałek
Gabonas - Gabon
gadolinis - gadolin
gadynė - epoka
gaidys - kogut, pietuch, ptak, fiut
gaigalas - kaczor
gailėjimas - żal
gailestis - żal, litość, współczucie
gailėti - żałować
gaisras - pożar
gaisrinė - straż pożarna
gaisrininkas - strażak
Gajana - Gujana
gal - może
galaktika - galaktyka
galas - koniec
galerija - galeria
galėti - móc, mieć możliwość zrobienia czegoś, mieć pozwolenie
galimybė - możliwość
galininkas - biernik
galis - gal
galva - głowa
galva sienos pramuši - głową muru nie przebijesz
galvoti - myśleć o
Gambija - Gambia
gaminti - produkować, wytwarzać
gamintojas - producent
gamta - przyroda
gamtinės dujos - gaz ziemny
gamybinis - produkcyjny, wytwórczy
Gana - Ghana
gandras - bocian
ganėtinas - wystarczający
ganyti - paść, wypasać
garai - para
garantinis - gwarancyjny
garas - para
garažas - garaż
garbė - cześć
garderobas - garderoba - miejsce (pomieszczenie) do przechowywania ubrań oraz do przebierania się, szatnia
Gargantiua - Gargantua
garnys - czapla
garsas - dźwięk
garstyčia - gorczyca
garsumas - głośność, sława
garsus - sławny, słynny
garšva - podagrycznik
gastritas - zapalenie żołądka
gatvė - ulica
gatvelė - uliczka
gauja - banda
gavėjas - beneficjent
gavialas - gawial
Gdanskas - Gdańsk
Gdynė - Gdynia
gebenė - bluszcz
gėda - wstyd, hańba
gegnė - krokiew
gegutė - kukułka
gegužė - maj, kukułka
gegužis - maj
geisti - pożądać, pragnąć
geizeris - gejzer
gėjus - gej
gelbėtojas - ratownik
gėlė - kwiat
gėlėtas - kwiecisty
geležinkelininkas - kolejarz
geležinkelis - kolej
geležis - żelazo
geltona kortelė - żółta kartka
geltonas - żółty
Geltonoji jūra - Morze Żółte
gemalas - zarodek
generacija - generacja
generolas - generał
genocidas - ludobójstwo
Genuja - Genua
genys - dzięcioł
geografija - geografia
geografinis - geograficzny
geoinformatika - geoinformatyka
geologas - geolog
geologija - geologia
geometrija - geometria
gepardas - gepard
gerai - dobrze
geras - dobry
gėrimas - napój
gerklė - gardło
germanas - Germanin
germanis - german
germanų - germański, germanas
gerti - pić
gerumas - dobro
gervė - żuraw
gesintuvas - gaśnica
gestapo - gestapowski
gestas - gest
getas - getto
Gibraltaras - Gibraltar
giesmininkas - piosenkarz
gilus - głęboki
gimda - macica
gimdos kaklelis - szyjka macicy
gimdymas - poród
gimdyti - rodzić
gimimas - narodziny, urodzenie
giminaitė - krewna
giminaitis - krewny
giminė - ród, rodzaj
gimtadienis - urodziny
gimtas - ojczysty
gimtinė - ojczyzna
ginekologas - ginekolog
ginekologija - ginekologia
gingivitas - zapalenie dziąseł
ginklas - broń
gintaras - bursztyn
girdėti - słyszeć
girgždėti - skrzypieć
giria - puszcza, las, pustkowie
girininkas - leśniczy
girna - kamień młyński
girnovė - warzęcha
girtas - pijany
girti - chwalić
gitara - gitara
glaciologija - glacjologia
glaukoma - jaskra
Glazgas - Glasgow
gliukozė - glukoza
gliuonas - gluon
globalizacija - globalizacja
glodė - osełka
Gloguvas - Głogów
glotnas - gładki
gluosnis - wierzba
Gnieznas - Gniezno
gnosticizmas - gnostycyzm
golfas - golf
Gožuvas - Gorzów Wielkopolski
grafystė - hrabstwo
graikakalbis - greckojęzyczny
graikas - Grek
graikė - Greczynka
Graikija - Grecja
Graikijos Respublika - Republika Grecka
graikiškas - grecki
gramas - gram
gramatika - gramatyka
gramofonas - gramofon
granatsvaidis - granatnik
grandinė - łańcuch
grašis - grosz
gravitacija - grawitacja
gražiai - pięknie
gražumas - piękno, uroda
gražus - piękny, ładny, przystojny, śliczny
greipfrutas - grejpfrut
greitai - szybko, prędko
greitas - szybki, prędki
Grenlandija - Grenlandia
gretutinis - przyległy, sąsiedni
griausmavaldis - gromowładca
grifas - sęp
grikis - gryka
grimas - szminka
grindys - podłoga
gripas - grypa
grivna - hrywna
grūdas - ziarno
Grudziondzas - Grudziądz
gruodis - grudzień
grupė - grupa
Gruzija - Gruzja
gruzinas - Gruzin
gruzinė - Gruzinka
gruziniškas - gruziński
grybas - grzyb
Gryficė - Gryfice
Gryfinas - Gryfino
grynasis vidaus produktas - produkt krajowy netto
Guamas - Guam
Gubinas - Gubin
gudas - Białorusin, mówiący innym dialektem/gwarą
Gudija - Białoruś
gulbė - łabędź, łabędzica, samica łabędzia
guldenas - gulden
gurkšnis - łyk
Gvadelupa - Gwadelupa
Gvatemala - Gwatemala
gvelbti - kraść, zagarniać
Gvinėja - Gwinea
GVP - PKN, produkt krajowy netto
gydykla - lecznica
gydyti - leczyć
gydytis - leczyć się
gydytoja - lekarka
gydytojas - lekarz
gynėjas - obrońca
gyvas - żywy
gyvatė - wąż
gyvenimas - życie, żywot
gyventi - żyć, mieszkać
gyventi kaip šuo su kate - żyć jak pies z kotem
gyventojas - mieszkaniec
gyvsidabris - rtęć
gyvulys - zwierzę, bydlę, zwierzę bydła domowego, bydlak
gyvūnas - zwierzę, stworzenie, istota
gyvybė - życie
hafnis - hafn
Haga - Haga
Haitis - Haiti
haliucinacija - halucynacja
halogenas - halogen
hamakas - hamak
hasis - has
haubica - haubica
Havajai - Hawaje
Havana - Hawana
hedonizmas - hedonizm
hegemonija - hegemonia
hegzametras - heksametr
Helas - Hel
helis - hel
Helsinkis - Helsinki
hematologija - hematologia
herbas - herb
Hercegovina - Hercegowina
heroinas - heroina
Hesenas - Hesja
heterogeniškas - heterogeniczny
hidrolizė - hydroliza
hiena - hiena
himnas - hymn
hiperbolė - hiperbola
hipnozė - hipnoza
hipopotamas - hipopotam
hipotermija - hipotermia
hipotezė - hipoteza
hobis - hobby
holmis - holm
homeopatija - homeopatia
homeostazė - homeostaza
Homeras - Homer
homoseksualas - homoseksualista
homoseksualinis - homoseksualny
homoseksualistas - homoseksualista
homoseksualizmas - homoseksualizm
homoseksualumas - homoseksualizm
Hondūras - Honduras
Honkongas - Hongkong
horizontas - horyzont
humanizmas - humanizm
humoras - humor
humoro jausmas - poczucie humoru
į - czternasta litera alfabetu litewskiego, w, przed, na, ku, do
įamžinti - uwieczniać
ichtiologija - ichtiologia
įdarbinti - zatrudnić
idealas - ideał
idealistas - idealista
ideologija - ideologia
įdomus - interesujący, ciekawy
įdukra - pasierbica
įeiti - wejść
ieškoti - szukać
Ieva - Ewa
įgaubtas - wklęsły
įkaitas - zakładnik
įkarštis - apogeum
iki - do, do zobaczenia
įkurtuvės - ceremonia otwarcia
įlanka - zatoka
ilgaamžiškumas - długowieczność
ilgas - długi
ilgėtis - tęsknić
iliuzija - iluzja
įmotė - macocha
impedansas - impedancja
imperatorius - cesarz, imperator
imperializmas - imperializm
imperija - imperium
impotencija - impotencja
įnagininkas - narzędnik
indas - naczynie, Hindus
indeksas - indeks
indėlis - lokata, wkład
Indija - Indie
indis - ind
indonezietė - Indonezyjka
indonezietis - Indonezyjczyk
Indonezija - Indonezja
indoneziškas - indonezyjski
induktyvumas - indukcyjność
industrija - przemysł
inercija - inercja
infekcija - zakażenie
infliacija - inflacja
informacija - informacja
informatika - informatyka
informatikas - informatyk
infrastruktūra - infrastruktura
inkaras - kotwica
inkstas - nerka
įnoringas - kapryśny, grymaśny
Inovroclavas - Inowrocław
instrukcija - instrukcja
instrumentas - instrument
insulinas - insulina
integralas - całka
integralinis - całkowy
intelektas - intelekt
inteligencija - inteligencja
interesas - interes
interviu - wywiad
inžinierius - inżynier
ir - i
Irakas - Irak
Iranas - Iran
įrankis - narzędzie
įrašas - wpis, zapis
iridis - iryd
irklas - wiosło
ironija - ironia
ir sienos turi ausis - ściany mają uszy
ir vilkas sotus, ir avis sveika - wilk syty i owca cała
išangė - odbyt
išbalęs - blady
išdavystė - zdrada
išeiti - wyjść
išėjimas - wyjście
išgaubtas - wypukły
išimtis patvirtina taisyklę - wyjątek potwierdza regułę
įsiskolinimas - zadłużenie
išlaidus - rozrzutny
Islamabadas - Islamabad
islamas - islam
islandas - Islandczyk
islandė - Islandka
Islandija - Islandia
islandiškas - islandzki
išmatos - kał, odchody, stolec
išminčius - mędrzec
išmintingas - mądry
išmintis - mądrość
išnaša - odnośnik, przypis, adnotacja, wyrwa
ispanas - Hiszpan
ispanė - Hiszpanka
Ispanija - Hiszpania
Ispanijos Karalystė - Królestwo Hiszpanii
ispaniškas - hiszpański
ispanų - hiszpański (język), Hiszpanów, hiszpański, ispanas
iš pasalų - znienacka, po kryjomu
išradėjas - wynalazca
išrinkimas - wybór
iššaukti - wywołać
įstabus - cudowny
įstaiga - instytucja
įstatymas - ustawa
įstatymdavystė - ustawodawstwo, władza ustawodawcza
įstatymleidis - ustawodawca
ištiktukas - wykrzyknik, wykrzyknienie, onomatopeja, wyraz dźwiękonaśladowczy
istorija - historia
istorikas - historyk
istorinis - historyczny
įsūnis - pasierb
išvaizda - wygląd
išvalyti - wyczyścić
į sveikatą - na zdrowie
italas - Włoch
italė - Włoszka
Italija - Włochy
Italijos Respublika - Republika Włoska
itališkas - włoski
italo - Włocha, włoski, italas
italų - włoski (język), Włochów, włoski, italas
įtarimas - podejrzenie
iterbis - iterb
įtėvis - ojczym
itris - itr
įvaikinimas - adopcja
įvaikinti - adoptować, usynowić, usynawiać
įvaikis - przybrane dziecko
įvairiaspalvis - różnokolorowy
Ivanas - Iwan
įvardis - zaimek
įvartis - gol, bramka
įvykis - wydarzenie, zdarzenie
Izaras - Izara
izoliatorius - izolator, izolatka
izotopas - izotop
izraelietė - Izraelka
izraelietis - Izraelczyk
izraelietiškas - izraelski
Izraelis - Izrael
jachta - jacht
jaguaras - jaguar
Jamaika - Jamajka
japonas - Japończyk
japonė - Japonka
Japonija - Japonia
japoniškas - japoński
Jaroslavas - Jarosław
Jastrovė - Jastrowie
jau - już
jaunas - młody
jaunas medis linksta, senas lūžta - czego Jaś się nie nauczy, tego Jan nie będzie umiał
jaunatis - nów
jaunimas - młodzież
jaunuolis - młodzieniec
jaunystė - młodość
jausmas - uczucie, poczucie
jausti - czuć
jaustukas - wykrzyknik
jautiena - wołowina
jautis - wół
JAV - USA
Javožnas - Jaworzno
Jedvabnas - Jedwabne
jei - jeśli, jeżeli, gdyby
jeigu - jeśli, jeżeli, gdyby
Jekaterinburgas - Jekaterynburg
Jemenas - Jemen
jena - jen
Jerevanas - Erywań
Jeruzalė - Jerozolima
Jėzus - Jezus
Jėzus Kristus - Jezus Chrystus
ji - ona
jie - oni/one
jis - on
jo - jego
jodas - jod
jog - że, iż
jogurtas - jogurt
jonas - jon
Jonijos jūra - Morze Jońskie
Joniškis - Janiszki
jonvabalis - świetlik
Jordanas - Jordan
Jordanija - Jordania
jos - jej
jų - ich
jubiliejus - jubileusz
judaizmas - judaizm
judinti - ruszać
Jugoslavija - Jugosławia
jungas - jarzmo
jungti - łączyć
Jungtinė Didžioji Didžiosios Britanijos ir Šiaurės Šiaurės Airijos Karalystė - Zjednoczone Królestwo Wielkiej Brytanii i Irlandii Północnej
Jungtinė Karalystė - Zjednoczone Królestwo
Jungtinės Amerikos Valstijos - Stany Zjednoczone Ameryki
Jungtiniai Arabų Emyratai - Zjednoczone Emiraty Arabskie
jungtinis - zjednoczony
Jungtinių Tautų Organizacija - Organizacja Narodów Zjednoczonych
jungtukas - spójnik
juodadėmė menkė - plamiak, łupacz, wątłusz srebrzysty
juodas - czarny
juodasis strazdas - kos
juodkalnietis - Czarnogórzec
Juodkalnija - Czarnogóra
Juodoji jūra - Morze Czarne
juokas - śmiech
juokas - geriausias vaistas - śmiech to zdrowie, śmiech - najlepsze lekarstwo
juokdarys - błazen
juokiasi tas, kas juokiasi paskutinis - ten się śmieje, kto się śmieje ostatni
juoktis - śmiać się
juosta - wstęga, taśma, talia, pas, strefa
Jupiteris - Jowisz, Jupiter
jūra - morze
jūreivis - marynarz
jurginas - dalia, georginia
juristas - prawnik
jūrų agurkas - strzykwa
jūs - wy, pan, pani
jūsų - wasz
juvelyras - jubiler
kabelis - kabel, przewód
kabinetas - gabinet
kablys - hak, haczyk
Kabulas - Kabul
kabutės - cudzysłów
kad - że, żeby, aby
kada - kiedy
kadagys - jałowiec
kadaise - dawniej
kadmis - kadm
kad prisivirei košės tai ir srėbk - jak masz problemy ze sobą, rozwiąż je
kai - gdy
kaimanas - kajman
kaimas - wieś, wioska
kaimietis - wieśniak
kaimiškas - rustykalny, wiejski
kaimynas - sąsiad
kaimynė - sąsiadka
kaimynystė - sąsiedztwo
kaina - koszt, cena
kainozojus - kenozoik
kainuoti - kosztować
kaip - jak
Kairas - Kair
kaitra - upał, skwar
kaklajuostė - smycz (na szyję)
kaklaraištis - krawat
kaklas - szyja
kakta - czoło
kaktusas - kaktus
kalakutas - indyk
kalambūras - kalambur
kalavijas - miecz
kalba - rozmowa, przemówienie, mowa, przemowa, oracja, język
kalbėti - mówić, rozmawiać
kalbotyra - językoznawstwo
kalcis - wapń
kalė - suka, suczka
kalėdinis - bożonarodzeniowy
Kalėdos - Boże Narodzenie
Kalėdų sala - Wyspa Bożego Narodzenia
kalendorius - kalendarz
kalifornis - kaliforn
Kaliopė - Kaliopa
kalis - potas
Kališas - Kalisz
kalk geležį, kol karšta - kuj żelazo, póki gorące
kalnas - góra, stos
kalnietis - góral
kalnuotas - górzysty
kalti - wykuwać
kaltinti - oskarżać, obwiniać
kalvis - kowal
kamanė - trzmiel
kambarinė - pokojówka
kambarys - pokój
Kambodža - Kambodża
Kamerūnas - Kamerun
kaminas - komin
kaminkrėtys - kominiarz
kampinis - kątowy, narożny
kampinis smūgis - rzut rożny
kamuolys - piłka, kłąb, kula
Kanada - Kanada
kanalizacija - kanalizacja
kanalizacinis - kanalizacyjny
kanarėlė - kanarek
Kanbera - Canberra
kanceliarija - kancelaria
kančia - męka
kankinimas - tortura
kanonizacija - kanonizacja
kapinės - cmentarz
kapitalas - kapitał
kapitalistas - kapitalista
kapitalizmas - kapitalizm
kapitonas - kapitan
kapšelis - moszna
Karakasas - Caracas
karalienė - królowa
karalius - król
karalystė - królestwo
karas - wojna
karbiuratorius - gaźnik
kareiva - wojak
kareivinės - koszary
kareivis - żołnierz
kareiviška lovelė - łóżko polowe
kareiviškas - żołnierski, wojskowy
Karibų jūra - Morze Karaibskie
kariūnas - kadet
kariuomenė - armia, wojsko
karklas - wierzba
karosas - karaś
karpis - karp
karšis - leszcz
karstas - trumna
karštas - gorący
kartais - czasami, niekiedy
kartas - raz
kartkartėmis - od czasu do czasu
kartoti - powtarzać
kartus - gorzki
karvė - krowa
karvedys - przywódca
karvelis - gołąb
karys - wojownik, żołnierz
kas - co
kasdien - codziennie
kasdieninis - codzienny
kasdienis - codzienny
kasdienybė - codzienność
kasininkas - kasjer
kasmėnesinis - comiesięczny
kasmetinis - coroczny
Kaspijos jūra - Morze Kaspijskie
kassavaitinis - cotygodniowy
kasykla - kopalnia
katalikas - katolik
katalikė - katoliczka
katalikiškas - katolicki
Katalonija - Katalonia
katalonų - kataloński, Katalończyków
Katanija - Katania
Kataras - Katar
katė - kot, samica kota, kotka
katedra - katedra
kategorija - kategoria
katinas - samiec kota, kocur
Katovicai - Katowice
Katovicų - katowicki
kaukė - maska
kaukolė - czaszka
kaulas - kość
kaulinis - kostny
kaulyti - błagać
Kaunas - Kowno
kava - kawa
kavinė - kawiarnia
kazachas - Kazach
kazachė - Kazaszka
Kazachija - Kazachstan
kazachiškas - kazachski
Kazachstanas - Kazachstan
Kazachstano Respublika - Republika Kazachstanu
kazino - kasyno
kėdė - krzesło
keiktis - bluzgać
Keiptaunas - Kapsztad
keistas - dziwny
keisti - zmieniać
keistis - zmieniać się
kekšė - kurwa, dziwka
kėkštas - sójka
keleivis - pasażer
kelias - droga
keliauti - podróżować
kelionė - podróż
kelis - kolano
Kelmė - Kielmy
kelnės - spodnie
keltas - prom, Celt
Kempnas - Kępno
kengūra - kangur
Kenija - Kenia
kentėjimas - cierpienie
kepėjas - piekarz
kepenys - wątroba
kepti - piec (placek, tort), smażyć (mięso)
kepurė - czapka
kepykla - piekarnia
keramika - ceramika
keras - krzew
kerštas - zemsta
kęsti - cierpieć
keturi - cztery
keturiasdešimt - czterdzieści, 40
keturiasdešimtas - czterdziesty
keturiolika - czternaście, 14
keturioliktas - czternasty
keturkampis - czworokąt
ketvertas - czwórka
ketvirtadienis - czwartek
ketvirtas - czwarty
ketvirtfinalis - ćwierćfinał
ketvirtis - ćwierć, ćwiartka, kwartał
ketvirtis valandos - kwadrans
keverzonė - bazgroł
keverzoti - bazgrać
kiaulė - świnia
kiaunė - kuna
kiaušialąstė - komórka jajowa
kiaušidė - jajnik
kiaušinis - jajo, jajko
kiaušintakis - jajowód
kibiras - wiadro
kibirkštis - iskra
kičas - kicz, tandeta
kiek - ile
kiekybinis - ilościowy
kiemas - podwórze, gospodarstwo, wieś
kietas - twardy
kietasis diskas - dysk twardy
Kijevas - Kijów
kikilis - zięba
kilmininkas - dopełniacz
kilogramas - kilogram
kilometras - kilometr
kilpa - pętla, pułapka, dziurka od guzika, strzemię, dulka, meander, zakole
kinas - Chińczyk, kino
kinė - Chinka
Kinija - Chiny
Kinijos Liaudies Respublika - Chińska Republika Ludowa
kiniškas - chiński
kinivarpa - kornik
Kipras - Cypr
kiprietė - Cypryjka
kiprietis - Cypryjczyk
kiprietiškas - cypryjski
Kirgizija - Kirgizja, Kirgistan
Kirgizstanas - Kirgistan, Kirgizja
Kiribatis - Kiribati
kirilica - cyrylica
kiriliškas - cyrylicki
kirmėlė - robak
kirminas - robak
kirmis - robak
kirpėjas - fryzjer
kirvis - siekiera, topór
kiškis - zając
kiuris - kiur
klaida - błąd, pomyłka
klaidingas - błędny, mylny
klaidžioti - błąkać się
Klaipėda - Kłajpeda
klajoti - błądzić
klarnetas - klarnet
klasicizmas - klasycyzm
klasifikacija - klasyfikacja
klasiokas - kolega ze szkoły
klausa - słuch
klausimas - pytanie
klausti - pytać
klaustukas - pytajnik, znak zapytania
klausyti - słuchać
klavesinas - klawesyn
klaviatūra - klawiatura
klavikordas - klawikord
klavišas - klawisz
klevas - klon
klimatas - klimat
klintis - wapień
klitoris - łechtaczka
Kliučborkas - Kluczbork
Klobuckas - Kłobuck
Klodava - Kłodawa
Klodzkas - Kłodzko
klykuolė - gągoł
klysti - błądzić
Knuruvas - Knurów
knyga - książka
knygynas - księgarnia
ko - kogo, czego
koala - koala
kobaltas - kobalt
Kobylka - Kobyłka
kodėl - dlaczego
koegzistuoti - koegzystować, współistnieć
kofeinas - kofeina
koja - noga
kokainas - kokaina
kokliušas - krztusiec, koklusz
kolagenas - kolagen
kolega - kolega z pracy
kolegiškas - koleżeński
Kolobžegas - Kołobrzeg
Kolumbija - Kolumbia
komanda - komenda, rozkaz, oddział, załoga, ekipa, drużyna
kombinatas - kombinat
komedija - komedia
komiksas - komiks
komisariatas - komisariat
Komorai - Komory
kompanija - kompania, towarzystwo
kompasas - kompas
kompiuterastas - komputerowiec
kompiuteris - komputer
kompiuterizacija - komputeryzacja
kompozitorius - kompozytor
komunistas - komunista
komunizmas - komunizm
konditerija - cukiernia
konditerijos - cukierniczy
koneveikti - besztać
konfucianizmas - konfucjanizm
Kongas - Kongo (rzeka), Kongo (państwo)
Kongo Demokratinė Respublika - Demokratyczna Republika Konga
Kongo Respublika - Republika Konga
Koninas - Konin
konkurentas - konkurent, rywal
konstitucija - konstytucja
konstrukcija - konstrukcja
konsulas - konsul
konsulatas - konsulat
kontinentas - kontynent
kontrabosas - kontrabas
kontrastas - kontrast
Kopenhaga - Kopenhaga
kopernikis - kopernik
koplyčia - kaplica
kopūstas - kapusta
koralas - koral, koralowiec
Koralų jūra - Morze Koralowe
Koranas - Koran
Korėja - Korea
korėjietiškas - koreański
Korėjos Respublika - Republika Korei
koridorius - korytarz
kormoranas - kormoran
korporacija - korporacja
Korsika - Korsyka
korta - karta
kortelė - kartka
Košalinas - Koszalin
Koscežyna - Kościerzyna
Koscianas - Kościan
kosėti - kaszleć
košmaras - koszmar
kosmetika - kosmetyka
kosmetinis - kosmetyczny
kosmonautas - kosmonauta
Kosovas - Kosowo
Kosta Rika - Kostaryka
kosulys - kaszel
kova - walka
kovas - marzec, gawron
kovoti - walczyć
krabas - krab
kranas - dźwig
kranklys - kruk
krantas - brzeg
krapas - koper
krapų - koperkowy, krapas
kraugerys - krwiopijca
kraujagyslė - naczynie krwionośne
kraujas - krew
kraujavimas - krwotok
kraujuoti - krwawić
krautuvė - sklepik, kram
kreditas - kredyt
kregždė - jaskółka
kregždėtas - piegowaty
kreivanosis - krzywonosy
kreivas - krzywy, skrzywiony, koślawy
kreivė - krzywa
kremzlė - chrząstka
krepšinis - koszykówka
krepšys - kosz, koszyk
krevetė - krewetka
kriaušė - grusza, gruszka
krikščionė - chrześcijanka
krikščionis - chrześcijanin
krikščionybė - chrześcijaństwo
krikštamotė - matka chrzestna
krikštas - chrzest
krikštasūnis - chrześniak, syn chrzestny
krikštatėvis - ojciec chrzestny
kriminalinis - kryminalny
krioklys - wodospad
krioterapija - krioterapia
kriptonas - krypton
kristalas - kryształ
kristi - spaść, upaść
kristologija - chrystologia
kritika - krytyka
kritikas - krytyk
kritinis - krytyczny
krizė - kryzys
Krkonošiai - Karkonosze
kroatas - Chorwat
kroatė - Chorwatka
Kroatija - Chorwacja
Kroatijos Respublika - Republika Chorwacji
kroatiškas - chorwacki
krokodilas - krokodyl
Krokuva - Kraków
krona - korona
kronika - kronika
Krotošynas - Krotoszyn
krūmas - krzak
kruša - grad
krūtinė - pierś, klatka piersiowa
krūtis - pierś
kryptis - kierunek
kryžius - krzyż
ksenofobija - ksenofobia
ksenonas - ksenon
ksilitas - ksylitol
kubas - sześcian
kubilas - beczka
kubilius - bednarz
kūdikis - niemowlę, niemowlak
kūdikystė - niemowlęctwo
kūdra - staw, sadzawka
kūgis - stożek
kuklus - skromny
kukutis - dudek
kulkosvaidis - karabin maszynowy, kaem
Kulmas - Chełmno
kulnas - pięta, obcas
kultūra - kultura
kultūrinis - kulturalny, kulturowy
kumelė - klacz
kumpis - szynka
kumštis - pięść
kūnas - ciało
kunigas - kapłan, duchowny
kuosa - kawka
kupra - garb
kupranugaris - wielbłąd
kuprinė - plecak
kur - gdzie
kurapka - kuropatwa
kurčias - głuchy
kūrikas - palacz (w kotłowni)
kūrinys - utwór, twór, dzieło
kuris - który
kurmis - kret
kurpė - but
kurpius - szewc
kursantas - kursant
kurti - kreować, tworzyć
kurtinys - głuszec
kurtizanė - kurtyzana
Kutnas - Kutno
Kuveitas - Kuwejt
kvadratinis - kwadratowy
kvailys - głupek, głupiec, dureń
kvapas - zapach, woń
kvarkas - kwark
Kvidzynas - Kwidzyn
kvorumas - kworum, quorum
kyšininkas - łapówkarz
kyšininkystė - łapówkarstwo
kyšis - łapówka
kyšulys - przylądek, cypel
laba diena - dzień dobry
labai - bardzo
labanakt - dobranoc
labas - wychodzić
labas rytas - dzień dobry
labas vakaras - dobry wieczór
labdara - dobroczynność
laborantas - laborant
laboratorija - laboratorium
laibas - szczupły, smukły
laidotuvės - pogrzeb
laidynė - żelazko
laikas - czas, pora, termin
laikraštis - gazeta
laikrodininkas - zegarmistrz
laikrodis - zegar, zegarek
Laima - Laima, Łajma
laimė - szczęście
laimingas - szczęśliwy
laiptai - schody
laiškanešys - listonosz
laiškas - list
laisvas - wolny, swobodny, luźny, biegły
laisvė - wolność, swoboda
laivas - okręt, statek
laižyti - lizać
lakštingala - słowik szary, bekwarek
lakūnas - lotnik
lakuotas - lakierowany
langas - okno
lankyti - odwiedzać
lantanas - lantan
Laosas - Laos
lapas - liść, arkusz (papieru, blachy itp.), kartka (papieru)
lapė - lis
lapinas - lis
lapkritis - listopad
laptopas - laptop
lašas - kropla
lašiša - łosoś
Lasosna - Łosośna
latas - łat
latvė - Łotyszka
Latvija - Łotwa
Latvijos Respublika - Republika Łotewska
latvis - Łotysz
latviškas - łotewski
laukimas - czekanie, oczekiwanie
laukti - czekać (na), oczekiwać, wyczekiwać
laumžirgis - ważka
laureatas - laureat
laurencis - lorens
lavonas - zwłoki, trup
lazda - kij, patyk
lazdynas - leszczyna
ledas - lód
Legionovas - Legionowo
leidybinis - wydawniczy
lėja - lej
lekas - lek
lėktuvas - samolot
lelija - lilia
Lemborkas - Lębork
lementi - bełkotać
lėnas - powolny
lengvas - lekki, łatwy
lengvumas - łatwość, lekkość
lenkaitė - młoda Polka
lenkakalbis - polskojęzyczny
lenkas - Polak
lenkė - Polka
Lenkija - Polska
Lenkijos Respublika - Rzeczpospolita Polska
lenkiškai - po polsku
lenkiškas - polski
lenkystė - polskość
lentelė - tabela, tabelka
leonbergeris - leonberger
leopardas - leopard
leptonas - lepton
lesbietė - lesbijka
Lešnas - Leszno
Lesotas - Lesotho
lėtai - wolno
lėtas - wolny, powolny
leukemija - białaczka, leukemia
liaudis - lud
liauka - gruczoł
liaupsė - apoteoza
Libanas - Liban
liberalas - liberał
liberalizmas - liberalizm
Liberija - Liberia
Libija - Libia
licencija - licencja
Lichtenšteinas - Liechtenstein
liemenėlė - biustonosz, stanik
liemuo - tułów, pień
liepa - lipiec
liepsna - płomień
liepsnelė - płomyk, rudzik, raszka
liesas - chudy
lietus - deszcz
Lietuva - Litwa
lietuvakalbis - litewskojęzyczny
lietuvė - Litwinka
lietuvis - Litwin
lietuviškas - litewski
lietuvių - litewski, Litwinów
Lietuvos - litewski, Litwy
Lietuvos Respublika - Republika Litewska
liežuvis - język, ozór zwierzęcy
liežuvi valdyti - trzymać język za zębami
liftas - winda
liga - choroba
ligonė - pacjentka
ligoninė - szpital
ligonis - pacjent, chory
limuzinas - limuzyna
linas - len
lingvistika - lingwistyka
liniuotė - linijka
linksnis - przypadek
Lionas - Lyon
Lipnas - Lipno
Lisabona - Lizbona
litas - lit
literatūra - literatura
litis - lit
litras - litr
liturgija - liturgia
Liubartuvas - Lubartów
Liubinas - Lubin
Liubliana - Lublana
Liublinas - Lublin
Liublinecas - Lubliniec
liūdesys - smutek, troska
Liuksemburgas - Luksemburg
liuksemburgietė - Luksemburka, luksemburka
liuksemburgietis - Luksemburczyk, luksemburczyk
liuksemburgietiškas - luksemburski
liūnas - bagno
liūtas - lew
Liūtas - Lew
liūtė - lwica
livermoris - liwermor
Liverpulis - Liverpool
lizdas - gniazdo
Lobezas - Łobez
Lodzė - Łódź
logaritmas - logarytm
lokė - niedźwiedzica
Lokis - Loki
lokys - niedźwiedź
lombardas - lombard
Londonas - Londyn
Los Andželas - Los Angeles
lotosas - lotos
lova - łóżko
Lubranecas - Lubraniec
Luiziana - Luizjana
Lukuvas - Łuków
lūpa - warga
lūšis - ryś
lutecis - lutet
Lvovas - Lwów
lydeka - szczupak
lygiagretainis - równoległobok
lygintuvas - żelazko
lyti - padać (o deszczu), dżdżyć
lytinis - seksualny, płciowy
Madagaskaras - Madagaskar
Madridas - Madryt
maginis mąstymas - myślenie magiczne
magnetas - magnes
magnetofonas - magnetofon
magnis - magnez
Mahometas - Mahomet
maistas - jedzenie, pożywienie, prowiant, żywność
maišytuvas - betoniarka
maitiakas - zasilacz
maitinimas - wyżywienie, zasilanie
maitinimo elementas - bateria
Majotas - Majotta
makaronai - makaron
makedonas - Macedończyk
makedonė - Macedonka
Makedonija - Macedonia
makedoniškas - macedoński
Malaizija - Malezja
Malavis - Malawi
Malborkas - Malbork
malda - modlitwa
Maldyvai - Malediwy
Malis - Mali
malnos - proso
malonus - miły, uprzejmy
Malta - Malta
maltietis - Maltańczyk
maltietiškas - maltański
malūnas - młyn
malūnininkas - młynarz
mama - mama
mamatė - mama
mamytė - mamusia
mandagus - uprzejmy, grzeczny
manganas - mangan
Manila - Manila
mano - mój
manometers - manometr
manyti - myśleć, sądzić
marihuana - marihuana
markė - marka
marksistas - marksista
marksizmas - marksizm
marmuras - marmur
Marokas - Maroko
Marsas - Mars
Marselis - Marsylia
marškiniai - koszula
marti - synowa - żona syna
Martinika - Martynika
Martyna - Martyna
masė - masa
mašina - maszyna
mašinistas - maszynista
Maskva - Moskwa
mastas - miara, rozmiar, zakres
masturbacija - masturbacja
mąstymas - myślenie, myśl
mąstyti - myśleć
matematika - matematyka
matematikas - matematyk
Matilda - Matylda
matlankis - kątomierz
matyti - widzeć, widać (forma bezosobowa)
maumedis - modrzew
Mauricijus - Mauritius
Mauritanija - Mauretania
mažakraujis - anemiczny
mažakraujystė - anemia
mažametis - małoletni
mažas - mały
maždaug - około, mniej więcej
mazgas - węzeł
Mažoji Azija - Azja Mniejsza
Mažoji Lietuva - Mała Litwa
mažylis - maleństwo, maluch
mečetė - meczet
mechanikas - mechanik
Mečislovas - Mieczysław
medicina - medycyna
medikamentas - medykament
medis - drzewo
medus - miód
medūza - meduza
Medūza - Meduza
medvilnė - bawełna
medvilninis - bawełniany
medžioklė - polowanie
medžioti - polować
medžiotojas - myśliwy
mėgti - lubić
meilė - miłość
meilės - miłosny
meilužis - kochanek
meitneris - meitner
Meka - Mekka
Meksika - Meksyk
melagis - kłamca, kłamczuch
melas - kłamstwo
Melecas - Mielec
melodingas - melodyjny
melo trumpos kojos - kłamstwo ma krótkie nogi
melstis - modlić się
meluoti - kłamać, łgać
mėlynas - niebieski
mėlynė - borówka czarna, czarna jagoda
melžti - doić
Menama - Manama
menas - sztuka
mendelevis - mendelew
Mendzyžečas - Międzyrzecz
mėnesiena - światło księżyca
meniškas - artystyczny
menk. - lekcew., lekceważąco
menkinti - bagatelizować, pomniejszać, lekceważyć
mėnraštis - miesięcznik
mėnulis - księżyc
Mėnulis - Księżyc
mėnuo - miesiąc
merga - dziewczyna, laska
mergaitė - dziewczyna, dziewczynka, dziewczę
Mergelė - Panna
mergina - dziewczyna
Merkurijus - Merkury
mes - my
mėsa - mięso
mėsininkas - rzeźnik
meška - miś
meškerė - wędka
mesti - rzucać
metabolizmas - metabolizm
metai - rok
metalas - metal
metalurgija - metalurgia
metanas - metan
metanolis - metanol
metas - okres, pora, czas
mėtas - rok
meteoras - meteor
meteoritas - meteoryt
metras - metr
metraštininkas - kronikarz
metropolitenas - metro
metų laikas - pora roku
Mianmaras - Mjanma
miegamasis - sypialny, sypialnia
miegas - sen
miegoti - spać
miestas - miasto
migla - mgła
Mikalojus - Mikołaj
mikrofonas - mikrofon
Mikronezija - Mikronezja
Mikronezijos Federacinės Valstijos - Sfederowane Stany Mikronezji
mikroskopas - mikroskop
Milanas - Mediolan
milisekundė - milisekunda
miltai - mąka
mineralas - minerał
mineralogas - mineralog
mineralogija - mineralogia
minia - tłum
ministerija - ministerstwo
ministras - minister
Minskas - Mińsk
mintis - myśl
minutė - minuta
mirti - umierać
mirtingumas - śmiertelność
mirtis - śmierć, zgon
miškas - las
mįslė - zagadka
mįslingas - enigmatyczny, zagadkowy
mitas - mit
mitochondrija - mitochondrium
mitologija - mitologia
mitozė - mitoza
Miunchenas - Monachium
miuonas - mion
Mlava - Mława
mobilus - mobilny
mobilusis telefonas - telefon komórkowy
močiutė - babcia, babka
modemas - modem
mokestis - opłata, podatek, składka
mokėti - płacić, potrafić, umieć
mokinė - uczennica
mokinys - uczeń
mokslas - nauka
mokslininkas - naukowiec
mokykla - szkoła, uczelnia
mokyklinis - szkolny
mokyti - uczyć, nauczać
mokytis - uczyć się
mokytoja - nauczycielka
mokytojas - nauczyciel
mokytojauti - uczyć, nauczać
molas - molo
moldavas - Mołdawianin
moldavė - Mołdawianka
Moldavija - Mołdawia
moldaviškas - mołdawski
Moldova - Mołdawia
molekulė - molekuła, cząsteczka
molibdenas - molibden
molis - glina
moliūgas - dynia
Monakas - Monako
monarchija - monarchia
moneta - moneta
Mongolija - Mongolia
monografija - monografia
monologas - monolog
monopolija - monopol
monoteizmas - monoteizm
monotonija - monotonia
Montseratas - Montserrat
mopsas - mops
moralinis - moralny
morka - marchew
moša - szwagierka (siostra męża)
motė - matka, żona
moteris - kobieta
moteriška giminė - rodzaj żeński
moteriškas - żeński, kobiecy, damski
motina - matka
motininė - płyta główna
motociklininkas - motocyklista
Mozambikas - Mozambik
muflonas - muflon
mugė - targi
muilas - mydło
muitininkas - celnik
multikas - bajka
multiplikacinis - animowany
mūrininkas - murarz
mūrinis - murowany
musė - mucha
mūšis - bitwa
mūsų - nasz
muziejus - muzeum
muzika - muzyka
muzikalus - muzykalny
muzikantas - muzykant
muzikas - muzyk
muzikologija - muzykologia
muzikuoti - muzykować
mylėti - kochać
Myslibužas - Myślibórz
myžti - szczać
nacionalizmas - nacjonalizm
nagas - paznokieć, pazur, szpon
Nairobis - Nairobi
naktis - noc
namas - dom (jako budynek), dom
Namibija - Namibia
Namysluvas - Namysłów
naras - nurek
narė - członkini
Narevas - Narew
narkolepsija - narkolepsja
narkomanas - narkoman
narkomanija - narkomania
našlė - wdowa
natris - sód
naudingas - pożyteczny, przydatny, użyteczny
naudininkas - celownik
naudotojas - użytkownik
naujagimis - noworodek
naujas - nowy, świeży, prekursorski
Naujasis Pietų Velsas - Nowa Południowa Walia
naujiena - nowina
Naujoji Gvinėja - Nowa Gwinea
Naujoji Meksika - Nowy Meksyk
Naujoji Zelandija - Nowa Zelandia
Ndžamena - Ndżamena
ne - nie
neaktualus - nieaktualny
Neapolis - Neapol
neapykanta - nienawiść
neatsakingas - nieodpowiedzialny
neatsargus - nieostrożny
neatšaukiamas - nieodwołalny
necenzūrinis - niecenzuralny
nedėkingas - niewdzięczny
neetiškas - nieetyczny
Nefertitė - Nefertiti
negausus - nieliczny
negeras - niedobry
negražus - nieładny
negyvas - nieżywy
Negyvoji jūra - Morze Martwe
neišmanėlis - tępak
neištikimas - niewierny
nekantrus - niecierpliwy
nekęsti - nienawidzić, nie znosić
nekrologas - nekrolog
nelaimėlis - nieudacznik
nelegalus - nielegalny
nemirtingas - nieśmiertelny
nemokamas - bezpłatny
neodimis - neodym
neonas - neon
nepageidaujamas - niechciany, niepożądany
nepaklusnus - niegrzeczny, nieposłuszny
Nepalas - Nepal
nepatogus - niewygodny
nepažįstamasis - nieznajomy
nepriklausomas - niezależny
nepriklausomumas - niezależność
nepriklausomybė - niepodległość, niezależność
neprotingas - niemądry, nierozsądny
Neptūnas - Neptun
neptūnis - neptun
nėra rožių be dyglių - nie ma róży bez kolców
nerealus - nierealny
nerija - mierzeja
Neris - Wilia
nerūpestingas - beztroski
nervas - nerw
nervingas - nerwowy
nes - bo
nesaugus - niebezpieczny
nešikas - bagażowy
nešnekus - małomówny
nėštumas - ciąża
nešulys - bagaż
nesutarimas - niedomówienie, niezgodność
nešvarus - nieczysty
ne šventieji puodus lipdo - nie święci garnki lepią
netikras zuikis - fałszywy zając
netvarka - bałagan, nieład, nieporządek
neutronas - neutron
neutroninė žvaigždė - gwiazda neutronowa
nevalyvas - niechlujny
Nica - Nicea
niekada - nigdy
Nigerija - Nigeria
Nigeris - Niger
nihilizmas - nihilizm
Nikaragva - Nikaragua
nikelis - nikiel
Nilas - Nil
niobis - niob
Niu Braunsvikas - Nowy Brunszwik
Niujorkas - Nowy Jork
nobelis - nobel
noragas - lemiesz
noras - chęć, ochota, życzenie
norėti - chcieć
norvegas - Norweg
norvegė - Norweżka
Norvegija - Norwegia
Norvegijos jūra - Morze Norweskie
norvegiškas - norweski
nosis - nos
notaras - notariusz
Notecė - Noteć
Novosibirskas - Nowosybirsk
nudistas - nudysta
nueiti - odejść
nugalėtojas - zwycięzca
nugara - plecy
nukandžioti - odgryzać
nukristi kaip iš dangaus - spaść z nieba
nulis - zero
nuodai - trucizna
nuodėmė - grzech
nuogas - nagi, goły
nuogumas - nagość
nuomonė - opinia
nuosaka - tryb
nuošalė - spalony
nuosavybė - własność
nuoseklus - konsekwentny
nuoširdus - szczery, serdeczny
nuostabus - cudowny
nuostolis - strata, szkoda, niekorzyść
nuotolis - odległość
nuotrauka - fotografia, zdjęcie
nuotykis - przygoda
nusidėti - grzeszyć
nusigerti - upić się
nutarimas - postanowienie, uchwała
Nužecas - Nurzec
Nyderlandai - Holandia, Niderlandy
Nyderlandų Antilai - Antyle Holenderskie
o - natomiast, o, och, ach
oazė - oaza
obelis - jabłoń
obeliskas - obelisk
objektas - obiekt
objektyvus - obiektywny
obligacija - obligacja
obojus - obój
observatorija - obserwatorium
obuolys - jabłko
Ochotsko jūra - Morze Ochockie
oda - skóra
Odinas - Odyn
odininkas - garbarz
oftalmologija - okulistyka, oftalmologia
okapija - okapi
okarina - okaryna
okeanas - ocean
Okeanija - Oceania
oksidatorius - utleniacz
okultizmas - okultyzm
okupacija - okupacja
ola - dziura, grota, jama, jaskinia, loch, nora, pieczara
Olandija - Holandia
olandiškas - holenderski
Olava - Oława
Olesnica - Oleśnica
oligarchas - oligarcha
Olštynas - Olsztyn
Omanas - Oman
omletas - omlet
onkologas - onkolog
onkologija - onkologia
onkologinis - onkologiczny
ontologija - ontologia
opalas - opal
operatyvioji atmintis - pamięć operacyjna (RAM)
opijus - opium
Opolė - Opole
oportunistas - oportunista
opozicionierius - opozycjonista
optimistas - optymista
optimistiškas - optymistyczny
oralinis - oralny
oralinis seksas - seks oralny
oranžinis - pomarańczowy (kolor)
oras - powietrze, pogoda, pole, podwórko
orchidėja - orchidea
oregano - oregano
organas - narząd, organ
organizacija - organizacja
orgazmas - orgazm
orgija - orgia
Orionas - Orion
ortopedija - ortopedia
Oslas - Oslo
osmis - osm
osteomaliacija - osteomalacja
Ostrolenka - Ostrołęka
Osvencimas - Oświęcim
Otvockas - Otwock
ovalus - owalny
ovuliacija - owulacja, jajeczkowanie
Ožiaragis - Koziorożec, Koziorożec - nazwa Znaku Zodiaku
ožka - koza
ožys - koza
paantraštė - podtytuł
paauglys - nastolatek
pabaiga - kres, ukończenie
pabaigtuvės - ceremonia pożegnalna
pabaisa - potwór
Pabaltijys - kraje bałtyckie
pacientas - pacjent
padaryti neaktualų - zdezaktualizować
padavėjas - kelner
padirbinys - podróbka
Padniestrė - Naddniestrze
pagal - według, wedle, zgodnie z
pagalba - pomoc
pagalbininkas - pomocnik
pagalvė - poduszka
pagarba - szacunek, respekt, poszanowanie, poważanie, uszanowanie
pagauti - złapać
pagrindinė mokykla - szkoła podstawowa (II etap)
pagrindinis - podstawowy, zasadniczy
pagrobėjas - porywacz
pakalnutė - konwalia
pakarti - powiesić
Pakistanas - Pakistan
paklodė - prześcieradło
paladis - pallad
palaidinė - bluza
palaidinukė - bluzka
palengva - powoli
Palestina - Palestyna
palestinietė - Palestynka
palestinietis - Palestyńczyk
palestiniškas - palestyński
palios - bagno, grzęzawisko
palydovas - towarzysz, konduktor, satelita
pamiršti - zapomnieć
pamoka - lekcja
pamotė - macocha
panacėja - panaceum
panaikinti - anulować
pandemija - pandemia
Pandora - Pandora
panelė - panna, panienka
panteizmas - panteizm
papartis - paproć
paplūdimys - plaża
paprastai - po prostu, zwyczajnie
paprastas - łatwy, prosty, zwykły
Papua Naujoji Gvinėja - Papua-Nowa Gwinea
papūga - papuga
papuošalai - biżuteria
papuošalas - ozdoba
para - doba
paradoksas - paradoks
Paragvajus - Paragwaj
parašiutininkas - spadochroniarz
pardavėjas - sprzedawca
parduoti - sprzedawać
parduotuvė - sklep
pareiga - obowiązek, powinność
pareiti - wrócić
parkas - park
partija - partia
Paryžius - Paryż
pasaka - bajka
pasakėčia - bajka
pasakininkas - bajarz
pasakiškas - bajkowy, bajeczny
pasas - paszport
pasaulis - świat
pasikarti - powiesić się
pasirinkti - wybrać
paskaita - wykład (na studiach wyższych)
paskirstymas - alokacja
paskirstyti - alokować
paslaptingas - tajemniczy
paslaptis - tajemnica
paštas - poczta (instytucja), poczta (korespondencja)
pastatas - budynek, gmach
pastatyti - ustawić, wybudować
pasvajoti - pomarzyć
patalpa - pomieszczenie
patarlė - przysłowie, powiedzenie, powiedzonko
patėvis - ojczym
pati - żona
patiekalas - danie
patiekalų knyga - książka kucharska
patikti - podobać się
patranka - armata, działo
patrauklus - atrakcyjny, pociągający
pats - mąż
Paukščių Takas - Droga Mleczna, ścieżka ptaków
paukštis - ptak
Paulius - Paweł
pavakarys - wieczór, czas wieczorny
pavardė - nazwisko
pavasaris - wiosna
pavasariškas - wiosenny
paveikslas - obraz
pavieniui - pojedynczo
pavietas - powiat
pavojingas - niebezpieczny
pavojus - niebezpieczeństwo
pavydėti - zazdrościć
pavyzdys - przykład, wzór, wzorzec
pažastis - pacha
pažįstamas - znajomy
pėda - stopa
pediatras - pediatra
pediatrija - pediatria
pedofilas - pedofil
peilis - nóż
peizažas - pejzaż
Pekinas - Pekin
Pelchuvka - Pełchówka
pelė - mysz
pelėda - sowa
pelenai - popiół
pelėsakalis - sokół pustułka
pelkė - bagno
pelkės - bagna
pelkėtas - bagnisty
pelkinis - bagienny
penalas - piórnik
penketas - piątka
penki - pięć
penkiasdešimt - pięćdziesiąt, 50
penkiasdešimtas - pięćdziesiąty
penkiolika - piętnaście, 15
penkioliktas - piętnasty
penktadienis - piątek
penktas - piąty
pereiti - przejść
pergalė - zwycięstwo
periodinė elementų lentelė - układ okresowy pierwiastków
per plauką - o mały włos
Persantė - Parsęta
persikas - brzoskwinia
personalas - personel
persti - pierdzieć
Peru - Peru
pervedimas - przelew, przekaz
pesimistas - pesymista
pesimistiškas - pesymistyczny
peteliškė - motyl
Petrakavas - Piotrków Trybunalski
petys - ramię, bark
pianinas - pianino
pianistas - pianista
piemuo - pasterz
pienas - mleko
Pieninai - Pieniny
pienininkas - mleczarz
piešas - pieg
pieštukas - ołówek
pietauti - jeść obiad
Pietų Afrikos Respublika - Republika Południowej Afryki
Pietų Amerika - Ameryka Południowa
Pietų Kinijos jūra - Morze Południowochińskie
Pietų Korėja - Korea Południowa
Pietų Osetija - Osetia Południowa
pietūs - południe, południe (pora dnia)
pigiai - tanio
pigti - tanieć
pigus - tani
piktas - zły
piktžodžiauti - bluźnić
piktžodžiautojas - bluźnierca
piktžodžiavimas - bluźnierstwo
pilietis - obywatel
pilietybė - obywatelstwo
pilis - zamek
pilkas - szary
pilnas - pełny, pełen, dostatni
pilnatis - pełnia
pilotas - pilot
pilvas - brzuch
Pinčuvas - Pińczów
pingvinas - pingwin
pinigai - pieniądze
pipirnė - pieprzyca
pirkti - kupić
pirmadienis - poniedziałek
pirmas - pierwszy
pirmenybės - mistrzostwo
pirštas - palec
pirštinė - rękawica, rękawiczka
pistoletas - pistolet
Pitsburgas - Pittsburgh (stolica Allegheny)
pjūklas - piła
placdarmas - baza
plakatas - plakat
plaktukas - młotek
planas - plan
planeta - planeta
plaštaka - dłoń
platina - platyna
platus - szeroki, rozległy, obszerny
plaukas - włos
plaukikas - pływak
plaukimas - pływanie
plaukti - pływać
plauti - myć, zmywać
pleneras - plener
plentas - szosa
pliaukšti - bajdurzyć
plienas - stal
plikas - łysy
plikimas - łysienie
Plockas - Płock
plokščias - płaski
plonas - cienki
Plonskas - Płońsk
Ploska - Płoska
plotas - obszar, powierzchnia
plūgas - pług
plunksna - pióro
plūsti - bluzgać
pluta - skórka, skorupa
Plutonas - Pluton
plutonis - pluton
plyta - cegła
plytinė - cegielnia
plytinis - ceglany
po - po
Podgorica - Podgorica
podukra - pasierbica
poetas - poeta
poezija - poezja
pokytis - zmiana
Polanecas - Połaniec
poliarizacija - polaryzacja
policija - policja
policininkas - policjant
Polinezija - Polinezja
politechnikumas - politechnika
politika - polityka
politikas - polityk
politinis - polityczny
politologas - politolog
polonis - polon
polonizacija - polonizacja
pomidoras - pomidor
ponas - pan
ponia - pani
popierius - papier
popietė - popołudnie
popiežius - papież
Popradas - Poprad
pornografija - pornografia
pornografinis - pornograficzny
pornografiškas - pornograficzny
portfelis - portfel
portretas - portret
portugalas - Portugalczyk
portugalė - Portugalka
Portugalija - Portugalia
portugališkas - portugalski
portugalų - portugalski (język), Portugalczyków, portugalski, portugalas
poryt - pojutrze, za dwa dni
posūnis - pasierb
potvynis - przypływ, powódź
povas - paw
Poznanė - Poznań
pradinė mokykla - szkoła podstawowa (I etap)
pradinis - początkowy
pradžia - początek
pragaras - piekło
pragmatikas - pragmatyk
pragula - odleżyna
Praha - Praga
prakaitas - pot
prakalba - przemowa, mowa, przemówienie, przedmowa, wstęp
prakeiksmas - przekleństwo
pramogauti - bawić się
pramonė - przemysł
pramoninis - przemysłowy
pranašas - prorok
Pranciškus - Franciszek
prancūzas - Francuz
prancūzė - Francuzka
Prancūzija - Francja
Prancūzijos Polinezija - Polinezja Francuska
Prancūzijos Respublika - Republika Francuska
prancūziškas - francuski
Prancūzų Gviana - Gujana Francuska
prasmė - sens, znaczenie
prašyti - prosić
pravoslavas - prawosławny
pražanga - faul
prazeodimis - prazeodym
prelatas - prałat
premjera - premiera
prezervatyvas - prezerwatywa
prezidentas - prezydent, prezes
priebalsis - spółgłoska
prieblanda - zmierzch (pora dnia), półmrok
priedas - aneks
prieiti - dojść
priekalas - kowadło
prielinksnis - przyimek
prieš - przed
priešas - wróg
priešininkas - przeciwnik
priešpiečiai - przedpołudnie
prietaras - przesąd, zabobon
prieveiksmis - przysłówek
priežastis - powód, przyczyna
priklausyti - należeć, zależeć
primatas - prymat
Pripetė - Prypeć
prispaudėjas - gnębiciel
pritarimas - akceptacja
procentas - procent
procesorius - procesor
profesoriauti - być profesorem
profesorius - profesor
progesteronas - progesteron
programuotojas - programista
prokuroras - prokurator
prometis - promet
propeleris - śmigło
proporcingas - proporcjonalny
prosenė - prababcia
prosenelė - prababcia, prababka
prosenis - pradziad
prostitucija - prostytucja
prostitutė - prostytutka
protaktinis - protaktyn
protestantizmas - protestantyzm
protėvis - pradziadek
protonas - proton
Pruškuvas - Pruszków
Pšasnyšas - Przasnysz
psichiatrija - psychiatria
psichoterapija - psychoterapia
psichozė - psychoza
Puckas - Puck
pudelis - pudel
pudra - puder
pudrinė - puderniczka
Puerto Rikas - Portoryko
pūga - zamieć, śnieżyca
puodas - garnek
puodelis - filiżanka
puodžius - garncarz
purpurinis - purpurowy
purvinas - brudny
pusbrolis - kuzyn
pusfinalininkas - półfinalista
pusfinalis - półfinał
pusiasalis - półwysep
pusiaudienis - południe (pora dnia)
pusiaujas - równik
Pusiaujo Gvinėja - Gwinea Równikowa
pusiaunaktis - północ (pora dnia/nocy)
pusiausvyra - równowaga
pušis - sosna
puslaidininkis - półprzewodnik
puslapis - stronica, strona
pusryčiai - śniadanie
pusseserė - kuzynka
pūsti - dąć
puta - piana
putpelė - przepiórka
pyktis - złość
pyplys - beksa
pyzda - pizda, cipa, cipka
Pžedzielna - Przedzielna
rabarbaras - rabarbar, rzewień
Rabatas - Rabat
rabinas - rabin
Racibužas - Racibórz
radijas - radio
radioastronomija - radioastronomia
radioterapija - radioterapia
radis - rad
Radkuvas - Radków
Radlinas - Radlin
Radomas - Radom
Radomskas - Radomsko
radonas - radon
Radzionkuvas - Radzionków
raganosis - nosorożec
ragas - róg
raidė - litera
raidinis - literowy
raidynas - alfabet, abecadło
raistas - bagno, bagnisko
raistinis - bagienny
raketa - rakieta
raktas - klucz
ramus - spokojny
Ramusis vandenynas - Ocean Spokojny
ramybė - spokój
randas - blizna
ranka - ręka
rankelė - rączka
rankinis - ręczny, piłka ręczna
rankinukas - torebka
rankovė - rękaw
rasa - rosa
rašalinė - kałamarz
rasė - rasa
rasizmas - rasizm
rąstas - belka
raštinė - kancelaria
raštininkas - pracownik biurowy
rąstinis - belkowy
rašyti - pisać
rašytojas - pisarz
ratas - koło
raudas - kasztanowy (maść konia)
raudona kortelė - czerwona kartka
raudonarmietis - czerwonoarmista
raudonas - czerwony
Raudonasis Kryžius - Czerwony Krzyż
Raudonoji jūra - Morze Czerwone
raudonumas - czerwień
raudoti - beczeć
raugėti - bekać
raumuo - mięsień
reabilitacija - rehabilitacja
realistas - realista
recenzija - recenzja
redaktorius - redaktor
referendumas - referendum
regbis - rugby
reikalauti - żądać, wymagać, domagać się, dopominać się
reikalavimas - żądanie, wymóg, wymaganie, roszczenie
reikalingas - potrzebny
reikėti - potrzeba, trzeba
Reikjavikas - Reykjavík
reikšmė - znaczenie
Reinas - Ren
reinkarnacija - reinkarnacja
reklama - reklama
reklamuoti - reklamować
rekordas - rekord
rektoratas - rektorat
religija - religia
religijotyra - religioznawstwo
religinis - religijny
relikvija - relikwia
remontas - remont
renis - ren
rentgenis - roentgen
reportažas - reportaż
reputacija - reputacja
respublika - republika
restauracija - restauracja, odnowienie
restoranas - restauracja
retai - rzadko
retsina - retsina
retušas - retusz
Reunionas - Reunion
revolveris - rewolwer
rezerfordis - rutherford
rezidencija - rezydencja
režisierius - reżyser
režisūra - reżyseria
rialas - rial
riaugėti - bekać
Riazanė - Riazań
Ričardas - Ryszard
riebus - tłusty
Rijadas - Rijad
riktas - błąd, pomyłka
rimbas - bat
rimtai - poważnie
rimtas - poważny, solidny, statyczny
rinka - rynek
rinkėjas - wyborca, zbieracz
rinkimai - wybory
ritualas - rytuał
rizikuoti - ryzykować
robotas - robot
rodis - rod
rodonitas - rodonit
rodyti - pokazywać, wskazywać, okazywać
rojus - raj
Roma - Rzym
romanas - powieść, romans
romantiškas - romantyczny
romanų - romański
Rona - Rodan
roplys - gad, (Reptilia), złośliwie/pogardliwie o człowieku
rotveileris - rottweiler
rožančius - różaniec
rožė - róża
rožinis - różowy
Ruanda - Rwanda
rubidis - rubid
rubinas - rubin
rublis - rubel
rūda - ruda
rudas - brązowy
ruduo - jesień
rugpjūtis - sierpień
rugsėjis - wrzesień
rūgštis - kwas
rūgštus - kwaśny
rugys - żyto
rūkas - mgła
rūkyti - palić
rumunas - Rumun
rumunė - Rumunka
Rumunija - Rumunia
rumuniškas - rumuński
rungtynės - zawody, mecz
ruonis - foka
rūpestingas - dbały
rūpestingumas - dbałość
rupija - rupia
rūpinimasis - dbałość
rupūžė - ropucha
rusakalbis - rosyjskojęzyczny
rusas - Rosjanin
rusė - Rosjanka
Rusija - Rosja
Rusijos Federacija - Federacja Rosyjska
rusiškas - rosyjski
rusiškumas - rosyjskość
rūstauti - gniewać się
rūsys - piwnica (pomieszczenie), przechowalnia, loch, krypta, podziemie
rutenis - ruten
Rybnikas - Rybnik
Ryga - Ryga
ryklė - gardło, gardziel
ryklys - rekin
ryšulys - bagaż
rytai - wschód
rytas - rano
rytdiena - jutro
rytoj - jutro
rytojus - jutro
Rytų Timoras - Timor Wschodni
šablonas - szablon
Sachara - Sahara
šachmatai - szachy
šachmatininkas - szachista
saga - guzik
šaika - szajka, gang
šaka - gałąź
šakalas - szakal
sakinys - zdanie
šaknis - korzeń, rdzeń, pierwiastek
saksofonas - saksofon
šakutė - widelec
sakyti - mówić, powiedzieć
sala - wyspa
salamandra - salamandra
saldus - słodki
šaldytuvas - lodówka
saldžiai - słodko
Saliamono salos - Wyspy Salomona
salieras - seler
šalininkas - zwolennik
šalis - kraj
šalmas - kask, hełm
salonas - salon
salota - sałata
šaltas - zimny
šaltinis - źródło
šaltis - zimny
šaltkalvis - ślusarz
Salvadoras - Salwador
salynas - archipelag
samanė - samogon
samaris - samar
Sana - Sana
sąnarys - staw, przegub
Sandomieras - Sandomierz
sankryža - skrzyżowanie
San Marinas - San Marino
Sanokas - Sanok
sanskritas - sanskryt
santechnikas - hydraulik
San Tomė ir Prinsipė - Wyspy Świętego Tomasza i Książęca
santrauka - podsumowanie, streszczenie
santrumpa - skrót
santuoka - małżeństwo
sapnas - sen, marzenie
sapnuoti - śnić, marzyć
Sarajevas - Sarajewo
Sardinija - Sardynia
sargyba - straż, warta
sargybinis - strażnik, wartownik
šarka - sroka
šarma - szadź
šarvas - zbroja
sąsiuvinis - zeszyt
satanizmas - satanizm
Saturnas - Saturn
Saudo Arabija - Arabia Saudyjska
saugiai - bezpiecznie
saugus - bezpieczny
šauksmininkas - wołacz
šaukštas - łyżka
šaukti - krzyczeć
saulė - słońce
Saulė - Słońce
saulėlydis - zachód słońca
saulėtekis - wschód słońca
Šaulys - Strzelec, Strzelec - nazwa jednego ze znaków zodiaku
sauna - sauna
sausas - suchy, wytrawny
sausgyslė - ścięgno
sausis - styczeń
sausra - susza
šauti - strzelać
savaitė - tydzień
savaitraštis - tygodnik
savanoris - wolontariusz
savas - jego
sąveika - interakcja
savininkas - właściciel, posiadacz
savivalda - autonomia, samokontrola, samorządność, samorządowość, samorząd
savotiškumas - osobliwość
savybė - cecha, właściwość
sąžiningumas - rzetelność, sumienność
Ščeberka - Szczeberka
scenarijus - scenariusz
sėdėti - siedzieć
šeima - rodzina
šeimininkas - gospodarz
Seišeliai - Seszele
seismografas - sejsmograf
seismologija - sejsmologia
sėkla - nasiono, nasienie
sėklidė - jądro
sekmadieninis - niedzielny
sekmadienis - niedziela
sėkmė - pomyślność
Sekminės - Zesłanie Ducha Świętego, Zielone Świątki, Pięćdziesiątnica
seksas - seks
seksualumas - seksualność
sekti - śledzić, opowiadać
sekundė - sekunda
selenas - selen
Šelmenta - Szelmentka
semestras - semestr
Sena - Sekwana
senamiestis - starówka
senas - stary
senatorius - senator
Senegalas - Senegal
senelė - babcia
senelis - dziadek
seniai - dawno
senis - starzec, staruszek
senmotė - prababcia, prababka
senovinis - dawny
Sen Pjeras ir Mikelonas - Saint-Pierre i Miquelon
sentėvis - pradziad
Sent Kitsas ir Nevis - Saint Kitts i Nevis
Sent Lusija - Saint Lucia
Sent Vinsentas ir Grenadinai - Saint Vincent i Grenadyny
separatizmas - separatyzm
šepetys - szczotka
septintas - siódmy
septynetas - siódemka
septyni - siedem
septyniasdešimt - siedemdziesiąt
septyniasdešimtas - siedemdziesiąty
septyniolika - siedemnaście, 17
septynioliktas - siedemnaście
Seradzas - Sieradz
serbas - Serb
serbė - Serbka
Serbija - Serbia
serbiškas - serbski
serialas - serial
šermukšnis - jarzębina
šermuonėlis - gronostaj
šernas - dzik
sertifikacija - certyfikacja
sertifikatas - certyfikat
sertifikavimas - certyfikacja
sertifikuoti - certyfikować
serveris - serwer
šerys - szczecina
šešėlis - cień
šešetas - szóstka
šeši - sześć
šešiasdešimt - siedemdziesiąt, 70
šešiasdešimtas - siedemdziesiąty
šešiolika - szesnaście, 16
šešioliktas - szesnasty
šeškas - tchórz
šeštadieninis - sobotni
šeštadienis - sobota
šeštas - szósty
sėsti - siąść, siadać
sesuo - siostra
Šešupė - Szeszupa
Seulas - Seul
Sevilija - Sewilla
sezonas - sezon
šiandien - dziś, dzisiaj
šiandieninis - dzisiejszy
siauras - wąski
šiaurė - północ
šiaurės - północny
Šiaurės Airija - Irlandia Północna
Šiaurės Amerika - Ameryka Północna
Šiaurės jūra - Morze Północne
Šiaurės Korėja - Korea Północna
Šiaurės Osetija - Osetia Północna
Sicilija - Sycylia
sidabras - srebro
sidabrinis - srebrny
siekiamybė - dążenie
siekimas - dążenie
siekis - dążność
siela - dusza
siena - ściana, mur
šienas - siano
siera - siarka
Siera Leonė - Sierra Leone
sieros rūgštis - kwas siarkowy
sifonas - syfon
šifruoti - szyfrować
signalas - sygnał
sija - belka
sikhisms - sikhizm
sikhizmas - sikhizm
šikna - dupa
šikšnosparnis - nietoperz
šilas - las
Silezija - Śląsk
silicis - krzem
šilkas - jedwab
silpnas - słaby
šiltas - ciepły
šiluma - ciepło
simetriškas - symetryczny
simpatiškas - sympatyczny, ładny, atrakcyjny
šimtas - sto, setny
šimtmetis - stulecie
sinagoga - synagoga
Singapūras - Singapur
sinonimas - synonim
sintaksė - składnia, syntaktyka
širdelė - serduszko
širdingas - serdeczny
širdis - serce
sirgalius - ktoś ciągle chory, kibic
sirgti - chorować
Sirija - Syria
širšė - szerszeń
širsti - gniewać się
sistema - system
sistematinis - systematyczny
situacija - sytuacja
siūlas - nić, nitka
siurrealistas - surrealista
siūti - szyć
siuvėjas - krawiec
Sivė - Sif
Sizifas - Syzyf
skaičiuotė - wyliczanka
skaičius - liczba
skaistažiedė - chryzantema
skaistykla - czyściec
skaitmuo - cyfra
skaitvardis - liczebnik
skaitykla - czytelnia
skaitymas - czytanie
skaityti - czytać
skalbėja - praczka
skalbimo mašina - pralka
skalbyklė - pralka
skalikas - pies myśliwski
skambinti - telefonować, dzwonić
skanaus - smacznego
skandis - skand
skanduoti - skandować
skara - chusta
skausmas - ból
skelbėjas - głosiciel, kaznodzieja
skeptikas - sceptyk
skeptras - berło
skersvėjis - przeciąg
skėrys - szarańcza
skiemuo - sylaba, zgłoska
skiepyti - szczepić
skirstyti - alokować
skirti - oddzielić
skirtumas - różnica
skolintis - pożyczać
skonis - smak, gust
skorpionas - skorpion
Skorpionas - Skorpion
škotas - Szkot
škotė - Szkotka
Škotija - Szkocja
škotiškas - szkocki
skrandis - żołądek
skriauda - krzywda
skriestuvas - cyrkiel
skristi - latać, lecieć
skruostas - policzek
skruzdė - mrówka
skruzdėlė - mrówka
skruzdėlynas - mrowisko
skrybėlė - kapelusz
skrynia - skrzynia
skulptorius - rzeźbiarz
skulptūra - rzeźba
skumbrė - makrela
skundas - pozew
skurdas - bieda, nędza, ubóstwo
skurdeiva - nędzarz, biedak, nędzarka, biedaczka
skurdinti - ubożyć, doprowadzać do nędzy
skurdus - biedny, nędzny, marny, żałosny
skurdžius - biedak, nędzarz, żebrak
skųstis - skarżyć się, żalić się, narzekać, uskarżać się
skveras - skwer
skylė - dziura
skystis - ciecz, płyn
šlakas - cętka
Šlamica - Szlamica
šlapias - mokry
šlapimas - mocz
šlaplė - cewka moczowa
slaptažodis - hasło
slaugė - pielęgniarka
slaugytoja - pielęgniarka
šlaunis - udo
slavas - Słowianin
slavė - Słowianka
slėgis - ciśnienie
slėnis - dolina
slėpti - chować, ukrywać
slibinas - smok
slidininkas - narciarz
Šlina - Ślina
slovakas - Słowak
slovakė - Słowaczka
Slovakija - Słowacja
slovakiškas - słowacki
šlovė - sława, honor
slovėnas - Słoweniec
slovėnė - Słowenka
Slovėnija - Słowenia
slovėniškas - słoweński
Slupskas - Słupsk
slyva - śliwa
smakras - podbródek, bródka
smegenys - mózg
šmėkla - duch, upiór, zjawa
smėlinis - beżowy
smėlis - piasek
smilius - palec wskazujący
smuikas - skrzypce
smuikininkas - skrzypek
smulkmena - szczegół
snaigė - śnieżynka, płatek śniegu
snapas - dziób
sniegas - śnieg
šnipas - szpieg
šnipinėti - szpiegować
socialdemokratas - socjaldemokrata
socialistas - socjalista
socializmas - socjalizm
sociologija - socjologia
soda - soda
sodas - ogród, sad
sodinys - sadzonka
sodžius - wieś, wioska
Sofija - Sofia
šokis - taniec
šokoladas - czekolada
Sokratas - Sokrates
šokti - skakać, tańczyć
Solonas - Solon
Somalis - Somalia
Sopotas - Sopot
Sosnovecas - Sosnowiec
sostinė - stolica
šovinys - nabój, pocisk
spalis - październik
spalva - kolor, barwa
šparagas - szparag
sparnas - skrzydło
sparnuotas - skrzydlaty, uskrzydlony
sparva - bąk
spausdintuvas - drukarka
specialistas - fachowiec, specjalista
sperma - sperma, nasienie
spidometras - prędkościomierz, szybkościomierz
spinta - szafa
spintelė - szafka
sportas - sport
sprandas - kark
sprandinė - karkówka
spūstis - ścisk, tłok, tłum
spyglys - igła drzew iglastych
spyruoklė - sprężyna
sraigė - ślimak
sraigtasparnis - helikopter, śmigłowiec
srautas - przepływ, ruch, strumień
Šri Lanka - Sri Lanka
sritis - region, obwód, dziedzina
sriuba - zupa
srovė - prąd, nurt
stabdys - hamulec
stabligė - tężec
stačiakampis - prostokątny
stadionas - stadion
staiga - nagle, znienacka, raptem
stalas - stół
stalius - stolarz
staltiesė - cerata
Stambulas - Stambuł
standusis diskas - dysk twardy
starkis - sandacz
startsakalis - drzemlik
statinė - beczka
statistika - statystyka
statyba - budownictwo, budowa
statybinis - budowlany
statyti - budować
stebėti - obserwować
stebukladarys - cudotwórca
stebuklas - cud
stebuklingas - cudowny
stemplė - przełyk
sterkas - sandacz
stibis - antymon
stiebas - łodyga, maszt
stiklas - szkło, szyba
stiklinė - szklanka
stipendija - stypendium
stipendininkas - stypendysta
stiprus - mocny, silny
stiprybė - moc, siła
stirna - sarna
stogas - dach
stoginis - dachowy
Stokholmas - Sztokholm
storas - gruby
stotis - stacja, dworzec
stovėti - stać
strategija - strategia
strazdanotas - piegowaty
strazdas - drozd
streikas - strajk
streikuoti - strajkować
strėlė - strzała
stroncis - stront
struktūra - struktura
strutis - struś
stuburas - kręgosłup
studentas - student
studentė - studentka
studentiškas - studencki
studijuoti - studiować
su - z
subjektyvus - subiektywny
sublimacija - sublimacja
submarinas - łódź podwodna
Sudanas - Sudan
šūdas - gówno
sudedamoji lova - łóżko polowe
Sudetai - Sudety
sudėtingumas - zawiłość, złożoność
sueiti - zejść się
šūkis - hasło, slogan, okrzyk, apel
suknelė - suknia, sukienka
šukos - grzebień
Sulechuvas - Sulechów
suma - suma, kwota
sumanytojas - pomysłodawca
sumokėti - zapłacić
sunaikinti - wytępić, unicestwić
sūnėnas - bratanek, siostrzeniec
sunerimti - zaniepokoić się
sunkus - ciężki, trudny
sunkvežimis - ciężarówka, samochód ciężarowy
sūnus - syn
šunvotė - czyrak
šuo - pies
suomė - Finka
Suomija - Finlandia
suomis - Fin
suomiškas - fiński
suopis - myszołów
suprasti - rozumieć
surasti - znaleźć
Surinamas - Surinam
sūris - ser
sūrus - słony
susenti - starzeć się
susidraugauti - zaprzyjaźnić się
susidvejinusios asmenybės - rozdwojenie jaźni
susirgti - zachorować
suspensija - zawiesina
suteikti - dać
sutema - zmierzch
sutuoktinė - małżonka
sutuoktinis - małżonek
šuva - pies
Suvalkija - Suwalszczyzna
suvirintojas - spawacz
svainė - szwagierka
svainis - szwagier
svajonė - marzenie
svajotojas - marzyciel
Svalbardas - Svalbard
švankus - uprzejmy, przyzwoity
svarbus - ważny, istotny
svarstybos - debata
Svarstyklės - Waga, Waga - nazwa jednego ze znaków zodiaku
švarus - czysty
Svazilandas - Suazi
Svebodzinas - Świebodzin
svečias - gość
švedakalbis - szwedzkojęzyczny
švedas - Szwed
švedė - Szwedka
Švedija - Szwecja
švediškai - po szwedzku
švediškas - szwedzki
šveicarė - Szwajcarka
Šveicarija - Szwajcaria
sveikas - zdrowy
sveikata - zdrowie
sveiki - cześć, czołem, witaj, witam
sveikti - zdrowieć
šventas - święty
šventovė - świątynia
šventykla - świątynia
Svidnica - Świdnica
Svidvinas - Świdwin
šviesa - światło
sviestas - masło
šviesus - jasny
šviežias - świeży
svilikas - grubodziób
švilpikas - świstak
švilpukas - gwizdek
švinas - ołów, kula (ołowiana)
svirplys - świerszcz
svogūnas - cebula
svoris - waga
syborgis - seaborg
šypsena - uśmiech
šypsotis - uśmiechać się
tabakas - tytoń
tabletė - tabletka
taburetė - taboret
tachikardija - tachykardia, częstoskurcz
tad - tak więc, zatem
Tadas - Tadeusz
Tadžikija - Tadżykistan
taika - pokój
taiklus - celny, trafny
Tailandas - Tajlandia
taip - tak
taisyklė - reguła, prawidło
taisyklingas - regularny
taisytuvė - debugger
Taivanas - Tajwan
takas - ścieżka, dróżka
taksi - taksówka
taksistas - taksówkarz
talentas - talent
Talinas - Tallinn
talis - tal
tamsa - ciemność
tamsiai mėlynas - granatowy
tamsus - ciemny
tankas - czołg, tank
tantalas - tantal
Tanzanija - Tanzania
tapyba - malarstwo
tapyti - malować
tapytojas - malarz
tarakonas - karaluch
tarakonynas - lęgowisko karaluchów
tardymas - śledztwo, dochodzenie
tardymo izoliatorius - areszt śledczy
tarimas - wymowa
tarnautojas - pracownik
Tarnobžegas - Tarnobrzeg
Tarnuvas - Tarnów
tarp - między, pomiędzy, pośród, wśród
tarptautinis - międzynarodowy
Tarptautinis valiutos fondas - Międzynarodowy Fundusz Walutowy
tarpvietė - krocze
Tarybų Sąjunga - Związek Radziecki
Tarybų Socialistinių Respublikų Sąjunga - Związek Socjalistycznych Republik Radzieckich
tašas - belka
taškas - kropka, punkt
Taškentas - Taszkent
Tasmanija - Tasmania
Tatrai - Tatry
tatuiruotė - tatuaż
taupyti - oszczędzać
Tauras - Byk, (symbol ♉)
tauta - naród, lud
tautininkas - nacjonalista, narodowiec
tautinis - narodowy
tautybė - narodowość
tavo - twój
Tbilisis - Tbilisi
Tčevas - Tczew
teatras - teatr
technecis - technet
technikumas - technikum
teikti - dawać
teisė - prawo
teisėjas - sędzia
teisininkas - prawnik
teismas - sąd
tekėti - płynąć, wschodzić, wyjść za mąż
tekintojas - tokarz
tekstas - tekst
telefonas - telefon
televizija - telewizja
televizorius - telewizor
telūras - tellur
telyčia - jałówka
temperatūra - temperatura
ten - tam
teologija - teologia
teptukas - pędzel
terapeutas - terapeuta
terbis - terb
teritorija - terytorium
terminas - termin
termitas - termit
teroristas - terrorysta
terorizmas - terroryzm
terviurenas - tervueren
tėtė - tata
tėvas - ojciec
tėvelis - tata
tėvynė - ojczyzna
Tibetas - Tybet
Tibras - Tyber
tiesa - prawda
tiesioginis - bezpośredni
tiesus - prosty
tigras - tygrys
tikėti - wierzyć
tikėtinumas - wiarygodność
tikėtis - mieć nadzieję
Tikocinas - Tykocin
tikslas - cel
tikslus - dokładny, bezbłędny
tiltas - most
tinginys - leń
tingus - leniwy
tinkas - tynk
tinklas - sieć, niewód
tinkuotojas - tynkarz
Tirana - Tirana
Tirėnų jūra - Morze Tyrreńskie
tironija - tyrania
tirpalas - roztwór
tirpumas - rozpuszczalność
Tisa - Cisa
titanas - tytan
titnagas - krzemień
titulas - tytuł, godność
Točna - Toczna
Togas - Togo
Tokijas - Tokio
toksikologija - toksykologia
tol - do (aż)
tolerancija - tolerancja
tolesnis - dalszy
toli - daleko
toliaregis - dalekowzroczny
toliaregiškas - dalekowzroczny
toliaregiškumas - dalekowzroczność
toliaregystė - nadwzroczność, dalekowzroczność
toliau - dalej
tolimas - daleki
Tolimieji Rytai - Daleki Wschód
tolimojo susisiekimo - dalekobieżny
toluma - dal
tolybė - dal
Tonga - Tonga
topazas - topaz
topologija - topologia
Tora - Tora
Toras - Thor
toris - tor
tornadas - tornado
tortas - tort
Torunė - Toruń
Toskana - Toskania
totorius - Tatar
trachėja - tchawica
tracheotomija - tracheotomia
tradicija - tradycja
traktorius - traktor
tramvajus - tramwaj
Transilvanija - Siedmiogród, Transylwania
trapecija - trapez
traškesys - trzask, chrupot
traškėti - trzaskać, trzeszczeć
traškus - trzaskający, chrupki, chrupiący
traukinys - pociąg
traumatologija - traumatologia, chirurgia urazowa
trečiadienis - środa
trečias - trzeci
trejetas - trójka
treneris - trener
trigonometrija - trygonometria
trigubai - potrójnie
trikampis - trójkąt
Trikampis - Trójkąt
trimitas - trąbka
Trinidadas ir Tobagas - Trynidad i Tobago
trisdešimt - trzydzieści
trisdešimtas - trzydziesty
trisdešimtmetis - trzydziestolatek, trzydziestolecie
trispalvis - trójkolorowy
triukšmingas - hałaśliwy
triušis - królik
trombonas - puzon
trombozė - tromboza
trotilas - trotyl
trumpas - krótki
trylika - trzynaście, 13
tryliktas - trzynasty
trys - trzy, 3
Tšebiatuvas - Trzebiatów
TSRS - Związek Socjalistycznych Republik Radzieckich, ZSRR
tu - ty
tūkstantas - tysięczny
tūkstantis - tysiąc, 1000
tūkstantmetis - tysiąclecie, millenium, tysiąc lat, tysiącletni
tulis - tul
tulpė - tulipan
tunelis - tunel
Tunisas - Tunezja, Tunis
tuopa - topola
turėti - mieć, posiadać, musieć, trzymać, zawierać
turgavietė - rynek, targ
turgus - rynek, targ
Turinas - Turyn
tūris - objętość
turistas - turysta
turkas - Turek
turkė - Turczynka
Turkija - Turcja
turkinis - turkusowy
turkis - turkus
turkiškas - turecki
Turkmėnija - Turkmenistan
turmalinas - turmalin
turtas - mienie, dobytek, majątek
turtėti - bogacić się
turtingas - bogaty, zamożny
tušas - tusz
tuščias - pusty
Tuvalu - Tuvalu
tvarkaraštis - harmonogram
tvartas - budynek przeznaczony dla zwierząt gospodarskich
TVF - MFW, Międzynarodowy Fundusz Walutowy
tvirtovė - forteca, twierdza
tvora - płot
tyla - cisza
tylėti - milczeć
tylus - cichy
ūdra - wydra
ūgis - wzrost
ugniagesys - strażak
ugnikalninis - wulkaniczny
ugnikalnis - wulkan
ugningas - ognisty, płomienny
ugnis - ogień
uiti - besztać
ūkas - mgławica
ukinija - cukinia
ūkis - gospodarka, gospodarstwo
Ukraina - Ukraina
ukrainietė - Ukrainka
ukrainietis - Ukrainiec
ukrainietiškas - ukraiński
Ulan Batoras - Ułan Bator
Ungura - Węgorzewo
ungurys - węgorz
universitetas - uniwersytet
universitetinis - uniwersytecki
uodas - komar
uodega - ogon
uoga - jagoda
uola - głaz, skała
uosis - jesion
uostas - port
uosti - wąchać, węszyć
uošvė - teściowa
uošviai - teściowie, uošvis
uošvis - teść
upė - rzeka
upelis - rzeczka, strumyk
upėtakis - pstrąg
upokšnis - strumień
uraganas - huragan
Uralas - Ural
Uralo - uralski
uranas - uran
Uranas - Uranos, Uran
Urugvajus - Urugwaj
urvas - jaskinia
usnis - oset
ūsuotas - wąsaty
utėlė - wesz
utopija - utopia
Uzbekija - Uzbekistan
užbūti - być opóźnionym
uždavinys - ćwiczenie
uždegti - zapalić
užeiti - zajść, odwiedzić
užmiršti - zapomnieć
užmušti - zabić
užsakovas - klient, zleceniodawca
užsispyrėliškas - uparty
užuomina - aluzja
užvakar - przedwczoraj
užvakarykštis - przedwczorajszy
užvirinti - zagotować
vabalas - chrząszcz
vabzdys - owad
vadas - przywódca, dowódca, wódz, herszt
vadeiva - przywódca, dowódca, watażka
vadovėlis - podręcznik
vadukas - herszt
vagis - złodziej
vaidila - wieszcz, kapłan
vaiduoklis - duch
vaikas - dziecko
vaikinas - chłopak
vaikščioti - chodzić, spacerować, uczęszczać
vaikų darželis - przedszkole
vairuotojas - kierowca
vaisingai - owocnie, płodnie, wydajnie
vaisingas - owocny, płodny, wydajny
vaisius - owoc
vaistas - lek, lekarstwo
vaistinė - apteka
vaistininkas - aptekarz
vaivorykštė - tęcza
vaizdas - obraz, widok
vaizdingas - malowniczy
vakar - wczoraj
vakarai - zachód
vakaras - wieczór
vakarienė - kolacja
Vakarų Berlynas - Berlin Zachodni
Vakarų Krantas - Zachodni Brzeg
Vakarų Sachara - Sahara Zachodnia
valanda - godzina
Valbžychas - Wałbrzych
Valčas - Wałcz
valdininkas - urzędnik
valdyba - dyrekcja, zarząd
valdyti - administrować, zarządzać, rządzić, panować, sprawować władzę, kierować, sterować, władać, poskramiać
valdytojas - zarządca, administrator
valdžia - rząd, władza
Valeta - Valletta
valgis - posiłek, jedzenie
valgomas - jadalny
valgomasis - jadalny
valgomasis kambarys - jadalnia, pokój jadalny, pokój stołowy
valgyti - jeść, spożywać
valiuta - waluta
valstija - stan
valstybė - państwo
valstybingumas - państwowość
valstybinis - państwowy, krajowy
valtininkas - łódkarz
valtis - łódź, łódka
valtorna - waltornia
valytoja - sprzątaczka
vampyras - wampir
vamzdis - rura, lufa
vanadis - wanad
vanagas - jastrząb
vandenilis - wodór
Vandenis - Wodnik, Wodnik - nazwa jednego ze znaków zodiaku
vandenynas - ocean
vanduo - woda
Vanuatu - Vanuatu
vapsva - osa
vapsvaėdis - trzmielojad, pszczołojad
varanas - waran
vardadienis - imieniny
vardas - imię
vardininkas - mianownik
varganas - ubogi
vargas - nędza, ubóstwo
vargonai - organy
variklis - silnik
varis - miedź
varlė - żaba
varna - wrona
varnėnas - szpak
varpa - prącie, penis, kłos
varpas - dzwon
varputė - łechtaczka
Varšuva - Warszawa
varšuvietė - warszawianka
varšuvietis - warszawianin
Varta - Warta
vartai - brama, bramka
vartininkas - bramkarz
vartoti - używać, konsumować
vartotojas - użytkownik - osoba korzystająca z danej rzeczy, konsument, spożywca, odbiorca
vasara - lato
vasaris - luty
Vašingtonas - Waszyngton
vaškas - wosk
vaškuotė - cerata
Vatikanas - Watykan (państwo)
važiuoti - jechać
vazonas - wazon
Vda - Wda
vėdinimas - wentylacja
vėduoklė - wachlarz
veganizmas - weganizm
vegetaras - wegetarianin
vegetariškas - wegetariański
vegetarizmas - wegetarianizm
veidas - twarz
veidrodis - lustro
Veiherovas - Wejherowo
veikalas - dzieło, utwór
veiksmas - akcja, czyn, działanie
veiksmažodinis - czasownikowy
veiksmažodis - czasownik
veja - trawnik
vejas - wiatr
vėjas - wiatr
veksilologija - weksylologia
vektorizacija - wektoryzacja
vėl - znowu, znów
vėlė - dusza
velėna - darń, darnina
vėliava - flaga, chorągiew, sztandar
vėliavėlė - chorągiewka
Velička - Wieliczka
Veliunis - Wieluń
velnias - czart, diabeł
Velsas - Walia
veltedys - darmozjad
veltui - daremnie
Velykos - Wielkanoc
vemti - wymiotować
vena - żyła
Venecija - Wenecja
Venera - Wenus, Wenera
Venesuela - Wenezuela
vengras - Węgier
vengrė - Węgierka
Vengrija - Węgry
vengriškas - węgierski
ventiliatorius - wentylator
vėplys - mors
Vepša - Wieprza
Vepšas - Wieprz
verdenė - krynica, źródło
vergas - niewolnik
vergija - niewola
vergovė - niewolnictwo
vergvaldys - ciemiężca
verksmas - płacz
verksnys - beksa
verkti - płakać
veršiukas - cielak, cielę
verslas - biznes
verslininkas - biznesmen, przedsiębiorca
verslo planas - biznesplan
versmė - źródło, zdrój, krynica
versminis - źródlany
versmynas - miejsce obfitujące w źródła
vertėjas - tłumacz
vertimas - tłumaczenie
veteranas - kombatant, weteran
veteranų - kombatancki, veteranas
veterinaras - weterynarz
Vėtrėlauža - Wiatrołuża
vėžlys - żółw
vezuvianitas - wezuwian
Vėžys - Rak
Vičenca - Vicenza (miasto)
vidurinė mokykla - szkoła średnia
vidurinis - średni, środkowy
vidurnaktis - północ (pora dnia)
vidurys - środek
Viduržemio jūra - Morze Śródziemne
Vielenė - Wieleń
Viena - Wiedeń
vienas - jeden
vienaskaita - liczba pojedyncza
vienetas - jedynka
vienuolika - jedenaście, 11
vienuoliktas - jedenasty
vienuolynas - klasztor
viešbutis - hotel
viešėti - bawić
vieta - miejsce
vietininkas - miejscownik
Vietnamas - Wietnam
vieversys - skowronek
vikingas - wiking
Vikipedija - Wikipedia
Vikižodynas - Wikisłownik
vikšras - gąsienica
Vilhelmas - Wilhelm
vilkas - wilk
vilkolakis - wilkołak
vilna - wełna
vilnietė - wilnianka
vilnietis - wilnianin
vilnietiškas - wileński
Vilnius - Wilno
vilti - oszukiwać
viltis - nadzieja, mieć nadzieję
Vincenta - Wincenta
Vincentas - Wincenty
vingiuotas - kręty
vinis - gwóźdź
violetinis - fioletowy
violončelė - wiolonczela
virdulys - samowar
virėja - kucharka
virėjas - kucharz
virškinimas - trawienie
viršūnė - szczyt, wierzchołek
viršus - wierzch
virtualizacija - wirtualizacja
virtuvė - kuchnia
virvė - lina, sznur
Visa - Wissa
visada - zawsze
visi keliai veda į Romą - wszystkie drogi prowadzą do Rzymu
viskas - wszystko
viskis - whisky
Viskonsinas - Wisconsin
Viškuvas - Wyszków
Visloka - Wisłoka
višta - kura
vištvanagis - jastrząb gołębiarz
visuma - całość
visuomenė - społeczeństwo
visur - wszędzie
vitaminas - witamina
vitražas - witraż
Vižiskas - Wyrzysk
Vkra - Wkra
Vladivostokas - Władywostok
Vloclavekas - Włocławek
Vlodavka - Włodawka
vogti - kraść
vokas - koperta, powieka
vokiečių - niemiecki (język), Niemców, niemiecki, vokietis
vokietakalbis - niemieckojęzyczny
vokietė - Niemka
vokietėti - germanizować się
Vokietija - Niemcy
Vokietijos Federacinė Respublika - Republika Federalna Niemiec
vokietinti - zniemczać, germanizować
vokietis - Niemiec
vokiškai - po niemiecku
vokiškas - niemiecki
vokiškumas - niemieckość
volframas - wolfram
Volkušanka - Wołkuszanka
voltas - wolt
volungė - wilga
voluoti - walcować, wałkować
vonia - łazienka, wanna, kąpiel
vora - rząd, kolejka, szereg, gatunek, klasa, odmiana, łańcuch
voras - pająk
voratinklis - pajęczyna
voriškas - pajęczy
vos - ledwo, omal
votėtas - owrzodzony, pokryty wrzodami
votis - wrzód
voveraitė - wiewióreczka, kurka
voverė - wiewiórka
voveruška - kurka
vožti - zamykać, uderzyć (z całych sił)
vožtuvas - zawór, klapa, wentyl, zatrzask, zastawka
Vroclavas - Wrocław
vualis - woal, woalka, welon
vulgarėti - stawać się wulgarnym, wulgaryzować się
vulgarinti - wulgaryzować
vulgarizatorė - wulgaryzatorka
vulgarizatorius - wulgaryzator
vulgarizmas - wulgaryzm
vulgarizuoti - wulgaryzować
vulgarus - wulgarny, chamski, ordynarny
vulgarybė - wulgaryzm
vulkanas - wulkan
vulkaninis - wulkaniczny
vulkanizacija - wulkanizacja
vulkanizatorius - wulkanizator
vulkanizuoti - wulkanizować
vylius - oszustwo
vynas - wino
vynuogė - winogrono
vyras - mężczyzna, mąż
vyriausybė - rząd
vyriška giminė - rodzaj męski
vyriškas - męski
vyriškumas - męskość
vyskupas - biskup
Vysla - Wisła
Vyslokas - Wisłok
vyšnia - wiśnia
Vytautas - Witold
vyturys - skowronek
vyzdys - źrenica
ydingas - uszkodzony
ypač - szczególnie, w szczególności, zwłaszcza
ypatingas - szczególny, osobliwy, niepowtarzalny
yra - forma trzeciej osoby czasownika
žadas - mowa
žadėti - obiecywać, przyrzekać
žadintuvas - budzik
Žagarė - Żagory
Zagrebas - Zagrzeb
žaibas - błyskawica
žaibolaidis - piorunochron
žaidėjas - gracz
žaidimas - gra, zabawa
žaisti - bawić się
žaizda - rana
Zakopanė - Zakopane
zakristija - zakrystia
zakristijonas - zakrystian, kościelny
žala - szkoda
žalia - zielony
žalias - zielony
Žaliasis Kyšulys - Republika Zielonego Przylądka
žalvarinis - mosiężny
žalvaris - mosiądz
Zambija - Zambia
žandas - policzek, pośladek
žandikaulis - szczęka
žanras - rodzaj
žargonas - żargon
žargoninis - żargonowy
žargoniškas - żargonowy
žargonybė - zwrot, wyraz żargonowy
žarna - jelito
Žarnica - Żarnica
žąsis - gęś
zauksoti - gapić się
zauna - gadanina, paplanina
zaunius - gaduła, papla, płaksa, beksa
zaunyti - gadać głupstwa, paplać, popłakiwać
žavėtis - podziwiać
žebenkštis - łasica
zebras - zebra
zefyras - zefir
želė - galaretka
žemaitis - Żmudzin
žemaitiškas - żmudzki
žemas - niski
žemdirbys - rolnik
žemė - ziemia
Žemė - Ziemia
žemėlapis - mapa
žemuogė - poziomka
žemynas - kontynent
Ženeva - Genewa
zenitas - zenit
zenitininkas - żołnierz artylerii przeciwlotniczej
zenitinis - przeciwlotniczy
ženklas - symbol, znak
žentas - zięć
žėrėti - lśnić, połyskiwać
žiebtuvėlis - zapalniczka
žiedas - kwiat, pierścień
žiedynas - kwiatostan
Zielava - Zielawa
žiema - zima
žievė - kora
zigzagas - zygzak
žilaplaukis - siwowłosy, siwy
žilas - siwy
Zimbabvė - Zimbabwe
žinduolis - ssak
žingsnis - krok
žinia - wiadomość, wieść, nowina
žinoti - wiedzieć
žiobris - certa
žiogas - konik polny
žiotys - gardziel, ujście (rzeki)
žirafa - żyrafa
žirgas - rumak
zirinti - piłować tępą piłą
žirklės - nożyce, nożyczki
žirnis - groch
zirzeklė - płaksa, beksa, mazgaj
zirzeklis - płaksa, beksa, mazgaj
zirzenti - brzęczeć, bzykać
zirzesys - brzęczenie, bzykanie
zirzeti - bzykać, brzęczeć, skrzypieć
zirzinti - rzępolić, skrzypieć
zirzlė - beksa, płaksa, mazgaj
zirzlus - płaczliwy, mazgajowaty
zirzlys - beksa, płaksa, mazgaj
zirzti - brzęczeć, bzykać, nudzić, beczeć
Zita - Zyta
žiūrėti - patrzeć, spoglądać
žiurkė - szczur
žiurkėnas - chomik
žlėgtainis - befsztyk
žliumba - beksa
žliumbis - beksa
žliumbti - beczeć
zlotas - złoty
zmekti - osiąść, osiadać, obsunąć się, obsuwać się
žmogiškas - ludzki
žmogus - człowiek
žmogus žmogui – vilkas - człowiek człowiekowi wilkiem
žmogžudystė - zabójstwo
žmona - żona
žmonės - ludzie, žmogus
žmoniškas - ludzki
zodiakas - zodiak
žodis - słowo, wyraz
žodynas - słownik
žodyniškas - słownikowy
žolė - trawa
zomša - zamsz
zomšinis - zamszowy
zona - strefa
zondas - sonda
zondavimas - sondowanie
zonduoti - sondować
zoninis - strefowy
zoologas - zoolog
zoologė - zoolog (kobieta)
zoologija - zoologia
zoologinis - zoologiczny
zootechnika - zootechnika
zootechnikas - zootechnik
zootechnikė - zootechnik (kobieta)
žudikas - zabójca
žudyti - mordować, zabijać
zuikelis - zajączek
zuikena - zajęcza skórka
zuikiauti - polować na zające
zuikiena - mięso zajęcze
zuikinis - zajęczy
zuikio pyragas - gościniec
zuikį pagauti - złapać zająca
zuikis - zając
zuikiukas - zajączek
zuikmiegis - czujny sen
zuiktaukiai - zajęczy tłuszcz
zuikutis - zajączek
zuiti - biegać, latać
zujoti - biegać
zulinti - trzeć, pocierać
zulintis - ocierać się, drapać się
zumeris - brzęczyk, przerywacz brzęczykowy
žurnalas - dziennik, magazyn, czasopismo
žurnalistas - dziennikarz
žurnalistika - dziennikarstwo
zurza - płaksa, beksa, mazgaj
zurzėti - burczeć, narzekać, nudzić
žuvis - ryba
Žuvys - Ryby
žvaigždė - gwiazda
žvairas - zezowaty
žvakė - świeczka, świeca
zvėga - papla, gaduła
zvėgauti - paplać, gadać głupstwa
žvejys - rybak
zvimbauti - brzęczeć, gwizdać, bzykać
zvimbesys - brzęczenie, brzęk, gwizd
zvimblys - płaksa, beksa
zvimbteleti - zabrzęczeć, zagwizdać
zvimbti - brzęczeć, bzykać, gwizdać, świstać, świsnąć
žvirblis - wróbel
žydėti - kwitnąć, rozkwitać
žydras - błękitny, gej
zylė - sikorka, sikora
zylioti - gzić się (o bydle)
žynys - kapłan
