å - rzeczka | strumyk
abbed - opat
abbedi - opactwo
abbedisse - przeorysza
abbor - okoń
abc-bok - elementarz (książka)
abdisere - abdykować
abnorm - nienormalny | nieprawidłowy
abort - poronienie | aborcja
absolutt - absolutny | absolutnie | zdecydowanie | koniecznie | naprawdę
abstraksjon - abstrakcja
abstrakt - abstrakcyjny | rzeczownik abstrakcyjny
absurd - absurdalny | absurdalnie
absurditet - absurdalność | absurd
adferd - zachowanie
adgang - wejście | wstęp | dostęp
adjektiv - przymiotnik
adjø - żegnaj!
adlyde - słuchać (się) | być posłusznym
administrator - administrator | zarządca
admiral - admirał
adopsjon - adopcja
adoptere - adoptować | przyjmować
adressat - adresat
adresse - adres
adressere - adresować
advare - ostrzegać | przestrzegać
advarsel - przestroga | ostrzeżenie
adverb - przysłówek
advokat - adwokat
ærgjerrig - ambitny
ærgjerrighet - ambicja
ærlig - uczciwy
ærlighet - uczciwość
Æsop - Ezop
ættegransker - genealog
afghaner - Afgańczyk
Afghanistan - Afganistan
afghansk - afgański | afganistański
Afrika - Afryka
afrikaner - Afrykanin | mieszkaniec Afryki
afrikansk - afrykański
aften - wieczór
agent - agent
agentur - agencja | przedstawicielstwo
agg - uraza | złość
aggresjon - agresja
aggressiv - agresywny
aggressivitet - agresywność
agn - przynęta
agurk - ogórek
åk - jarzmo
akademisk - akademicki
ake - jeździć | zjeżdżać
åker - pole
akkurat - dokładnie | właśnie
aks - kłos
akse - oś
aksent - akcent
akseptere - akceptować
aksje - akcja
aksjeeier - akcjonariusz
aksjeselskap - spółka akcyjna
aksjonær - akcjonariusz
ål - węgorz
albaner - Albańczyk
Albania - Albania
albansk - albański
albino - albinos
albue - łokieć
album - album
alder - wiek
alderdom - starość
aldri - nigdy
alene - sam
alfabet - alfabet
alfabetisk - alfabetyczny
Algerie - Algieria
algoritme - algorytm
alkohol - alkohol
alkoholfri - bezalkoholowy
alkoholiker - alkoholik
all - cały | wszystek
alle - wszyscy | wszystkie
allé - aleja
allerede - już
alltid - zawsze
allting - wszystko
alminnelig - powszechny | częsty | popularny | zwyczajny
almisse - jałmużna | datek
alpelue - beret
Alpene - Alpy
alt - wszystko | już
alter - ołtarz
alternativ - alternatywa | alternatywny
altfor - zbyt | za
altså - więc
alvor - powaga
alvorlig - poważny | poważnie
ambassade - ambasada
ambassadør - ambasador
ambulanse - ambulans | karetka
åme - gąsienica
Amerika - Ameryka
amerikaner - Amerykanin
amerikansk - amerykański
Amerikas forente stater - Stany Zjednoczone Ameryki
amfibium - płaz
amharisk - amharski
amøbe - ameba
analfabet - analfabeta
ananas - ananas
Anatolia - Anatolia
and - kaczka
andestjert - kaczy kuper
andrik - kaczor
angre - żałować
angrep - atak
angripe - atakować | napadać
angst - strach | lęk
ankel - kostka (u nogi)
ankomst - przybycie | przyjazd
annen - drugi | inny
annenhver - co drugi | co dwa
annerledes - inny | inaczej
ansette - zatrudniać
ansikt - twarz
anstøt - przestępstwo
ansvar - odpowiedzialność
ansvarlig - odpowiedzialny
antageligvis - prawdopodobnie
antakeligvis - prawdopodobnie
antall - liczba | ilość
antenne - antena
ape - małpa
åpne - otwierać
apotek - apteka
apparat - aparat
appelsin - pomarańcza
appetitt - apetyt
aprikos - morela
aprikossyltetøy - dżem morelowy
april - kwiecień
år - rok
araber - Arab
arabisk - arabski | arabski (język)
aragonesisk - aragoński
arameisk - aramejski
arbeid - praca
arbeide - pracować
arbeider - pracownik
arbeidsgiver - pracodawca
arbeidsledig - bezrobotny
arbeidsledighet - bezrobocie
arbeidsnarkoman - pracoholik
areal - powierzchnia
Argentina - Argentyna
argentiner - Argentyńczyk
argentinsk - argentyński
århundre - wiek | stulecie
arkitekt - architekt
arkitektur - architektura
arm - ramię | ręka
armbånd - bransoleta | bransoletka
armbåndsur - zegarek na rękę
armensk - armeński | ormiański
armhule - pacha
arr - blizna
arrestere - aresztować
artikkel - artykuł | rodzajnik | przedimek
artritt - artretyzm
årtusen - tysiąclecie | millenium
arvelig - dziedziczny
aserbajdsjansk - azerski | azerbejdżański
Asia - Azja
aske - popiół
askebeger - popielniczka
askepott - kopciuszek
Askepott - Kopciuszek
astat - astat
asterisk - gwiazdka | asterysk
astma - astma
asturiansk - asturyjski
at - że
ateisme - ateizm
ateistisk - ateistyczny
atmosfære - atmosfera
åtsel - padlina
atsjo - apsik! | a psik!
åtte - osiem | eie
atten - osiemnaście
attende - osiemnasty
åttende - ósmy
åtti - osiemdziesiąt
åttiende - osiemdziesiąty
august - sierpień
av - z | ze
avholdsmann - abstynent
avis - gazeta
avlegge - składać | złożyć
avstand - odległość
avtale - umowa | kontrakt | traktat
bacon - bekon | boczek
bad - kąpiel | łazienka
bade - kąpać | kąpać się
badedrakt - kostium kąpielowy
badekar - wanna
badetøy - kostium kąpielowy
badstue - sauna
bær - jagoda
bagasje - bagaż
bagasjerom - bagażnik
bak - za
bake - piec
baker - piekarz
bakeri - piekarnia
bakfra - z tyłu
bakgrunn - tło
bakke - wzgórze | ziemia
bakterie - bakteria
bål - ognisko
balkong - balkon
ball - piłka | bal
ballett - balet
ballong - balon
Baltica - Bałtyka
bamse - miś (zabawka)
banan - banan
bånd - taśma | wstążka | smycz
bandasje - bandaż
bank - bank
banke - pukać | stukać
banne - kląć | przeklinać
barberblad - żyletka
barbere - golić | golić się
barberkniv - brzytwa
barbermaskin - maszynka do golenia (elektryczna) | golarka (elektryczna)
bare - tylko
barføtt - bosy | boso
bark - kora
barn - dziecko
barndom - dzieciństwo
barnebarn - wnuk | wnuczka
barnehage - przedszkole
barnevogn - wózek dziecięcy
barnslig - dziecinny | dziecinnie
barokk - barok | barokowy
bart - wąsy
baskisk - baskijski
båt - łódka | łódź | statek
batteri - bateria | akumulator
bavian - pawian
be - prosić | modlić się | zapraszać
bebreide - wyrzucać | robić wyrzuty
bebreidelse - wyrzut
bedøve - znieczulać
bedøvelse - znieczulenie | narkoza
bedra - oszukiwać | zdradzać
bedrager - oszust
bedre - god – lepszy | polepszać | poprawiać | polepszać się | poprawiać się
befinne seg - znajdować się
befolke - zaludniać
befolkning - ludność | mieszkańcy
befri - uwalniać
befrukte - zapładniać
befruktning - zapłodnienie
begå - popełniać
begavelse - talent
beger - kielich
begge - obaj | obydwaj
begivenhet - wydarzenie
begjær - żądza | pożądanie
begjære - pożądać
begrave - chować | grzebać
begravelse - pogrzeb
begrep - pojęcie | termin
begynne - zaczynać | zaczynać się
begynnelse - początek
behå - stanik | biustonosz
behov - potrzeba
behøve - potrzebować
bein - kość | noga
bekken - miednica
bekrefte - potwierdzać
bekreftelse - potwierdzenie
Belgia - Belgia
belgier - Belg
belgisk - belgijski
belte - pasek
bendelorm - tasiemiec
Benin - Benin
benk - ławka
bensin - benzyna
bensinkanne - kanister (na benzynę)
bensinstasjon - stacja benzynowa
berømt - sławny | słynny
beruset - nietrzeźwy
beskrive - opisywać
beskrivelse - opis | rysopis
besøk - odwiedziny | wizyta
besøke - odwiedzać
best - najlepszy | najlepiej
bestå - składać się
bestefar - dziadek
besteforeldre - dziadkowie
bestemme - decydować | postanawiać
bestemor - babcia
bestille - zamawiać
besvime - mdleć
betale - płacić
betegne - oznaczać | wyrażać określoną treść
betennelse - zapalenie
bety - znaczyć | oznaczać
betydning - znaczenie
betydningsfull - ważny
beundre - podziwiać
bevegelse - ruch
bever - bóbr
bevis - dowód
bevise - udowadniać | dowodzić
bibliotek - biblioteka
bie - pszczoła
bihule - zatoka
bikkje - pies
bikube - ul
bil - samochód
bilde - zdjęcie | obraz | obrazek
bildekk - opona samochodowa
bilist - kierowca
billett - bilet
billig - tani | tanio
bind - podpaska | opaska | przepaska | temblak | tom
binde - przywiązywać
binders - spinacz
biolog - biolog
biologi - biologia
biologisk - biologiczny
bite - gryźć | obgryzać
bjeffe - szczekać
bjørk - brzoza
bjørn - niedźwiedź
bjørnebær - jeżyna
blå - niebieski | błękitny
blåbær - jagoda (czarna)
blad - liść | ostrze | czasopismo | magazyn | kartka
blære - pęcherz | dętka
blant - wśród | pośród
ble - bli
blekk - atrament
blekksprut - ośmiornica
blemme - pęcherz
bli - zostawać | robić się | stawać się | być
blind - ślepy | niewidomy
blod - krew
blodgiver - krwiodawca
blodkar - naczynie krwionośne
blomkål - kalafior
blomst - kwiat
blomsterpotte - doniczka
blondine - blondynka
bløtdyr - mięczak
bløtkake - tort
blotter - ekshibicjonista
bly - ołów
blyant - ołówek
blyg - nieśmiały
bo - mieszkać
bøddel - kat
bok - książka | księga | buk
bøk - buk
bøker - bok
bokhandel - księgarnia
bokmål - jeden z dwóch oficjalnych języków używanych w Norwegii
boks - puszka
bokstav - litera
bølgelengde - długość fali
bolig - mieszkanie
Bolivia - Boliwia
bombe - bomba | bombardować
bomull - bawełna
bomullsplantasje - plantacja bawełny
bonde - chłop | pionek
bønder - bonde
bønn - modlitwa
bor - wiertło | bor
bord - stół
boremaskin - wiertarka
borgerkrig - wojna domowa
børs - giełda
Bosnia - Bośnia
bosnier - Bośniak
bosnisk - bośniacki | bośniacki (język)
bøtte - wiadro
bøye - boja | odmieniać
bråk - hałas
brann - pożar
brannbil - wóz strażacki
brannmann - strażak
Brasil - Brazylia
brasilianer - Brazylijczyk
brasiliansk - brazylijski
bre - lodowiec
bred - szeroki
bredde - szerokość
bretonsk - bretoński
brett - deska | taca
brev - list
brille - okulary
briller - brille
bringe - przynosić
bringebær - malina
bringebærsyltetøy - dżem malinowy
brite - Brytyjczyk
britisk - brytyjski
bro - most | mostek
brød - chleb | bochenek chleba
brodd - żądło
bronkie - oskrzele
brønn - studnia
bror - brat
brorskap - braterstwo | bractwo
bru - most
bruke - używać | wydawać | nosić | zwykle coś robić
bruker - użytkownik
brun - brązowy
brunbjørn - niedźwiedź brunatny
bryllup - ślub
bryllupsnatt - noc poślubna
bryllupsreise - podróż poślubna
bryn - brew
bryst - pierś | klatka piersiowa
brystbein - mostek
brystholder - biustonosz | stanik
brystkreft - rak piersi
bud - wieść | wiadomość | posłaniec
Buddha - Budda
buddhisme - buddyzm
buddhist - buddysta
buddhistisk - buddyjski
buk - brzuch
bukett - bukiet
bukhule - jama brzuszna
bukse - spodnie
bukser - bukse
bukspyttkjertel - trzustka
buktaler - brzuchomówca
bulgarer - Bułgar
Bulgaria - Bułgaria
bulgarsk - bułgarski | bułgarski (język)
bulgur - bulgur
bumerang - bumerang
bunn - dno
bur - klatka
burde - powinien
Burkina Faso - Burkina Faso
busk - krzak | krzew
buss - autobus
butikk - sklep
by - miasto
bygg - jęczmień
bygge - budować
bygning - budynek
byråkrati - biurokracja
ca. - około | ok.
Canada - Kanada
celle - komórka | cela
centimeter - centymetr
champagne - szampan
chassis - podwozie
cirka - około
Columbus - Kolumb (odkrywca)
da - wtedy | kiedy | gdy
dachs - jamnik
daddel - daktyl
dag - dzień
dagblad - dziennik
dagbok - dziennik | pamiętnik
dagdriver - obibok | bumelant | wałkoń | próżniak
dagsavis - dziennik
dagsnytt - wiadomości
dal - dolina
dam - tama | zapora | staw | warcaby | damka
dambrett - plansza do gry w warcaby
dameblad - czasopismo dla kobiet
damefrisør - fryzjer damski
damp - para
dampskip - parowiec
dampveivals - walec (drogowy)
Danmark - Dania
danne - tworzyć | powstawać
dans - taniec
danse - tańczyć
danser - tancerz | tancerka
dansk - duński | duński (język)
danske - Duńczyk
dårlig - zły
data - dane
database - baza danych
datamaskin - komputer
dataorm - robak komputerowy
dataspill - gra komputerowa
dato - data
datter - córka
de - oni | one | tamci | tamte | ci | te
definisjon - definicja
De forente stater - Stany Zjednoczone
deg - ciebie | cię
deig - ciasto
deilig - wspaniały | cudowny | wspaniale | cudownie
dekk - pokład | opona
dekke - przykrywać
del - część
dele - dzielić
delfin - delfin
delta - delta | uczestniczyć | brać udział
deltakelse - uczestnictwo | współczucie
deltaker - uczestnik | uczestniczka
deltid - niepełny wymiar godzin
delvis - częściowy | częściowo | po części
dem - ich | oni | one
demning - tama
demokrat - demokrata
demokrati - demokracja
demokratisere - demokratyzować
demokratisk - demokratyczny
demon - demon
demonisk - demoniczny
demonstrant - demonstrant
den - tamten | tamta | tamto | ten | ta | to
Den dominikanske republikk - Dominikana
den gang - wtedy
denne - ten | ta | to
deodorant - dezodorant
depresjon - depresja
deprimert - przygnębiony | załamany | w depresji
der - tam
dere - wy | was
deres - wasz | ich | swój
deretter - potem (a)
derfor - dlatego
derfra - stamtąd
derimot - lecz
dersom - jeżeli | jeśli
desember - grudzień
desertere - dezerterować
desertering - dezercja
desertør - dezerter
dessert - deser
dessuten - poza tym
dessverre - niestety
det - to | ten | ta | tamten | tamta | tamto
detalj - szczegół
detektiv - detektyw
dette - ten | ta | to
diabetes - cukrzyca
diagnose - diagnoza
Diakon - diakon
dialekt - dialekt
dialog - dialog
diamant - diament
diameter - średnica
diaré - biegunka | rozwolnienie
diett - dieta
dikt - wiersz
dikter - poeta
dill - koper | koperek
din - twój | swój
diplom - dyplom
diplomat - dyplomata
disse - ci | te
djevel - diabeł
dø - umierać
dobbel - podwójny
doble - podwajać
død - śmierć | martwy | nieżywy
dødninghode - trupia czaszka
dødsstraff - kara śmierci
døgn - doba
dollar - dolar
dom - osąd
domkirke - katedra
dongeribukse - dżinsy
dør - drzwi
dose - dawka
døtre - datter
døtrer - datter
døv - głuchy
drage - latawiec | smok
drakk - drikke
drap - zabójstwo
dråpe - kropla | krople
dreiebenk - tokarka
dreier - tokarz
drepe - zabijać
drikke - pić
drivstoff - paliwo
drømme - śnić | marzyć
dronning - królowa
drosje - taksówka
drosjesjåfør - taksówkarz
drue - winogrono
drukket - drikke
du - ty
due - gołąb
duft - woń | zapach
duge - nadawać się
dugg - rosa
duk - obrus
dukke - lalka
dum - głupi
dumhet - głupota
dusj - prysznic
dyne - kołdra
dyp - głęboki
dyr - zwierzę | drogi
dyrefett - tłuszcz zwierzęcy
dyreplankton - zooplankton
ed - przysięga
edderkopp - pająk
eddik - ocet
edel - szlachetny
edelstein - kamień szlachetny
edru - trzeźwy
eføy - bluszcz
egen - własny
egennavn - nazwa własna
egenskap - cecha | właściwość
egentlig - właściwy | prawdziwy | właściwie | naprawdę (tak)
egg - jajko | jajo | ostrze
eggeglass - kieliszek do jajek
eggehvite - białko (jajka)
eggeplomme - żółtko (jajka)
eggerøre - jajecznica
eggleder - jajowód
eggstokk - jajnik
eie - posiadać | być właścicielem
eiendomspronomen - zaimek dzierżawczy
eier - właściciel | posiadacz
eik - dąb
eikenøtt - żołądź
ekko - echo
ekorn - wiewiórka
eksamen - egzamin
eksaminator - egzaminator
eksaminere - egzaminować
eksempel - przykład
eksperiment - eksperyment
eksplodere - wybuchać | eksplodować
ektemann - mąż
ekvilibrium - równowaga
eldre - starszy
eldst - najstarszy
elefant - słoń
elektrisitet - elektryczność
elev - uczeń
elg - łoś
eller - albo | lub | czy
elleve - jedenaście
ellevte - jedenasty
El Salvador - Salwador
elske - kochać | kochać się (uprawiać seks) | uwielbiać
elv - rzeka
Emilie - Emilia
emne - temat
en - jakiś | jakaś | jakieś | jeden | ktoś | człowiek
ender - and
endre - zmieniać | zmieniać się
energi - energia
energisk - energiczny
eneste - jedyny
en for alle, alle for en - jeden za wszystkich, wszyscy za jednego
eng - łąka
engel - anioł
engelsk - angielski | angielski (język) | angielszczyzna
engelskmann - Anglik
England - Anglia
enke - wdowa
enkemann - wdowiec
enn - niż | od
ennå - jeszcze
ensom - samotny
ensomhet - samotność
entall - liczba pojedyncza
epilepsi - padaczka | epilepsja
eple - jabłko
epletre - jabłoń
er - være
erkebiskop - arcybiskup
erme - rękaw
esel - osioł
eske - pudełko
eskimo - Eskimos
esperanto - esperanto
ester - Estończyk
estisk - estoński | estoński (język)
Estland - Estonia
et - jakiś | jakaś | jakieś
etasje - piętro
ete - jeść
etnisitet - narodowość
etter - po
ettermiddag - popołudnie | po południu
etternavn - nazwisko
etterpå - potem
euro - euro
Europa - Europa
europeer - Europejczyk
europeisk - europejski
evig - wieczny
evighet - wieczność
evighetsmaskin - perpetuum mobile
evolusjon - ewolucja
få - dostawać | móc | niewiele | mało
fabrikk - fabryka
Færøyene - Wyspy Owcze | Wyspy Farerskie
færøying - Farerczyk | mieszkaniec Wysp Owczych
færøysk - farerski | farerski (język)
færre - mniej
færrest - få – najmniej
falk - sokół
fall - upadek
falle - padać | spadać | upadać | przewracać się | opadać | wpadać | wypadać | przypadać | paść | polec
fallos - penis
falsk - fałszywy
familie - rodzina
fange - jeniec | więzień | łapać
far - ojciec
fare - niebezpieczeństwo | jechać
farge - kolor | barwa | farbować
fargeblind - być daltonistą
farlig - niebezpieczny | groźny
farmasi - farmacja
farmasøyt - farmaceuta
farmor - babcia (ze strony ojca)
fart - szybkość | prędkość | fare
fattig - biedny | ubogi
fattigdom - bieda | ubóstwo
feber - gorączka
februar - luty
fedreland - ojczyzna
feier - kominiarz
feig - tchórzliwy
feighet - tchórzostwo
feil - błąd | wina
felle - pułapka | ścinać
felles - wspólny
fem - pięć
femte - piąty
femten - piętnaście
femtende - piętnasty
femti - pięćdziesiąt
femtiende - pięćdziesiąty
fengsel - więzienie
fengselscelle - cela więzienna
ferge - prom
ferie - wakacje | ferie | urlop
ferje - prom
fersken - brzoskwinia
fest - zabawa
fett - tłuszcz
fiende - wróg
fiendskap - wrogość
fiendtlig - wrogi
fiken - figa
fil - pilnik | plik
film - film
filosof - filozof
filosofi - filozofia
filosofisk - filozoficzny
finger - palec
Finland - Finlandia
finne - Fin | płetwa | znajdować | uważać (że)
finnes - być | istnieć
finsk - fiński | fiński (język)
fintfølende - delikatny | wrażliwy
fiolin - skrzypce
fire - cztery
firkløver - koniczyna czterolistna
firma - firma
fisk - ryba
fiskedam - staw rybny
fisker - rybak
fiskeskjell - rybia łuska
fjær - pióro
fjell - góra
fjerde - czwarty
fjerne - usuwać
fjernsyn - telewizja | telewizor
fjorten - czternaście
fjortende - czternasty
flagg - flaga
flaggermus - nietoperz
flamme - płomień
flaske - butelka
flat - płaski
flåte - tratwa | flota
flått - kleszcz
flekk - plama
flere - kilka
flertall - większość | liczba mnoga
flest - najwięcej ( mange)
flodhest - hipopotam
fløte - śmietana | śmietanka
fløy - skrzydło
flue - mucha
fluesopp - muchomor
fly - samolot | latać | lecieć | fruwać | frunąć
flykte - uciekać
flyplass - lotnisko
flyselskap - linie lotnicze (przedsiębiorstwo)
flytte - przeprowadzać się
fødsel - poród | narodziny | urodzenie
fødselsdagsselskap - przyjęcie urodzinowe
fødselsdato - data urodzenia
fold - fałda
føle - czuć
følelse - uczucie
folkestyre - demokracja
føll - źrebak | źrebię
fontene - fontanna
for - żeby | dla | za | jak na | na | przy | bo | zbyt | ale | co za | jaki | fare
før - przed | zanim | kiedyś
foran - przed
forandre - zmieniać | zmieniać się
forberede - przygotowywać | przygotowywać się
forberedelse - przygotowanie
forbrytelse - przestępstwo
forbryter - przestępca
forelder - rodzic
førerkort - prawo jazdy
forestille - wyobrażać | przedstawiać
forestilling - przedstawienie | wyobrażenie | przekonanie
foretrekke - woleć
forfatter - autor | pisarz
forferdelig - okropny
forfølgelse - prześladowanie
forgjeves - daremny | próżny | nadaremnie | daremnie | na próżno
forkjølelse - przeziębienie
forklare - wyjaśniać | objaśniać | tłumaczyć
forklaring - wyjaśnienie | objaśnienie | wytłumaczenie
forlag - wydawnictwo
forlovelsesring - pierścionek zaręczynowy
formiddag - przedpołudnie | przed południem
formørkelse - zaćmienie
fornavn - imię
fornøyd - zadowolony
fornuft - rozum | rozsądek
fornuftig - rozsądny | rozumny
forræder - zdrajca
forrige - zeszły | ubiegły | poprzedni
forsikringsselskap - towarzystwo ubezpieczeniowe
forsiktig - ostrożny | ostrożnie
forsker - naukowiec | badacz
forskjell - różnica
forskjellig - inny | różny | różni | różne
forsove seg - zaspać
først - najpierw | na początku | z początku | dopiero
forstå - rozumieć
forståelig - zrozumiały | zrozumiale
første - pierwszy
forstoppelse - zaparcie | zatwardzenie
forsvar - obrona
forsvare - bronić | bronić się
forsvinne - znikać
fort - szybko | prędko
fortau - chodnik
fortauskant - krawężnik
fortelle - opowiadać
førti - czterdzieści
fortid - przeszłość
førtiende - czterdziesty
forurense - zanieczyszczać
forvaltning - administracja
fot - stopa | noga
fotball - piłka nożna
fotgjenger - pieszy
fotgjengerfelt - przejście dla pieszych
fotoapparat - aparat fotograficzny
fotograf - fotograf
fotografi - fotografia
fra - z | od
framtid - przyszłość
Frankrike - Francja
fransk - francuski | francuski (język)
franskmann - Francuz
fred - pokój
fredag - piątek
fremmed - obcy
fremmedspråk - język obcy
fremtid - przyszłość
fri - wolny
frihet - wolność | swoboda
friksjon - tarcie
frimerke - znaczek pocztowy
frimerkeserie - seria znaczków
frisør - fryzjer | fryzjerka
friste - kusić
fristelse - pokusa
frokost - śniadanie
frosk - żaba
frost - mróz
frukt - owoc
frykt - strach
fugl - ptak
fuglebrett - karmnik (dla ptaków)
fugleinfluensa - ptasia grypa
fuktig - wilgotny
full - pełny | pełen | pijany
furu - sosna
furunål - igła sosnowa
fylke - region administracyjny
fyllik - pijak
fyrstikk - zapałka
fyrtårn - latarnia morska
fysiker - fizyk
fysikk - fizyka
gå - iść | chodzić | pójść | iść pieszo | chodzić pieszo | pójść pieszo
gaffel - widelec
gal - szalony | zwariowany
gale - piać
galehus - dom wariatów
galge - szubienica
Galilea - Galilea (kraina)
galle - żółć
galleblære - woreczek żółciowy
gallestein - kamień żółciowy
galning - wariat | szaleniec
galskap - szaleństwo
gammel - stary
gane - podniebienie
gang - korytarz | przedpokój | raz
gangsti - ścieżka | dróżka
ganske - dość | dosyć
går - gå | i går
garasje - garaż
gardin - zasłona
Gargantua - Gargantua
gås - gęś
gass - gaz
gate - ulica
gåte - zagadka
gaupe - ryś
gehør - słuch
geit - koza
geni - geniusz
genial - genialny
genser - sweter
geografi - geografia
geolog - geolog
geologi - geologia
georgisk - gruziński
gevær - karabin
geværkolbe - kolba karabinu
gi - dawać
giftering - obrączka (ślubna)
giftig - trujący
gitar - gitara
giver - dawca | ofiarodawca | darczyńca
gjær - drożdże
gjedde - szczupak
gjeld - dług
gjelle - skrzela
gjemme - chować | chować się | kryć się
gjennomsiktig - przezroczysty
gjennomsnittlig - przeciętny | średni | przeciętnie | średnio
gjenstand - przedmiot | obiekt
gjenta - powtarzać
gjerde - płot
gjerne - chętnie | z chęcią
gjespe - ziewać
gjest - gość
gjette - zgadywać
gjødsel - nawóz
gjøk - kukułka
gjøre - robić
gladiator - gladiator
glass - szkło | szyba | szklanka | kieliszek | lampka | słoik
glatt - śliski | gładki | ślisko | gładko
glede - radość | cieszyć | cieszyć się
glemme - zapominać | zostawiać
glødelampe - żarówka
gnager - gryzoń
gnist - iskra
gnostisisme - gnostycyzm
god - dobry
god morgen - dzień dobry
god natt - dobranoc
godta - akceptować | godzić się
godtroende - naiwny
Godzilla - Godzilla
gøy - śmieszny
grå - szary | siwy
grådig - chciwy | zachłanny
grådighet - chciwość | zachłanność
grafitt - grafit
gran - świerk
grapefrukt - grejpfrut
gras - trawa
gråt - płacz
gråte - płakać
gratulere - gratulować
grav - grób | mogiła | rów | dół | wykop
grave - kopać
gravemaskin - koparka
gravid - w ciąży | ciężarna
gregoriansk - gregoriański
greip - widły
greker - Grek
gren - gałąź
grense - granica
gresk - grecki | grecki (język) | greka
gress - trawa | trawka
gresshoppe - konik polny
gresskar - dynia
gressløk - szczypiorek
gressplen - trawnik
grevling - borsuk
grille - grillować
gripe - chwytać | łapać
gripe på fersk gjerning - przyłapać na gorącym uczynku
gris - świnia
Grønland - Grenlandia
grønlandsk - grenlandzki | grenlandzki (język)
grønlender - Grenlandczyk
grønlending - Grenlandczyk
grønn - zielony
grønnsak - warzywo
grunn - powód | płytki
grunnstoff - pierwiastek
grunntall - liczebnik główny
grusom - okrutny
grusomhet - okrucieństwo
gryte - garnek
gud - bóg
gul - żółty
gulag - gułag
gull - złoto | złoty medal
gulrot - marchew | marchewka
gulsott - żółtaczka
gulv - podłoga
gummi - guma | gumka
gutt - chłopiec
gyngehest - koń na biegunach
ha - mieć | perfektum | pluskvamperfektum  presens futurum perfektum -
ha de som plommen i egget - mieć jak u Pana Boga za piecem
hæl - pięta | obcas
hage - ogród
hai - rekin
Haiti - Haiti
hake - podbródek | broda
hakkespett - dzięcioł
hale - ogon
halefinne - płetwa ogonowa
hals - szyja | gardło | szyjka (butelki)
halskjede - naszyjnik
halte - kuleć | utykać
halvøy - półwysep
ham - jego | go
hammer - młotek
hamster - chomik
han - on
hånd - ręka
håndledd - nadgarstek
hane - kogut
hang - skłonność | henge
hangarskip - lotniskowiec
hans - jego
hanske - rękawica | rękawiczka
håp - nadzieja
håpe - mieć nadzieję
hår - włos | włosek | włosy
hard - twardy
hare - zając
hårnål - spinka do włosów
harpe - harfa
hasselnøtt - orzech laskowy
hastig - pospieszny
hastighet - prędkość
hat - nienawiść
hate - nienawidzić
hatt - kapelusz | ha
hauk - jastrząb
hav - morze | ocean
havn - port
havre - owies
hebraisk - hebrajski | hebrajski (język)
hedning - poganin
heis - winda
hekk - żywopłot | płotek
heklenål - szydełko
heks - czarownica
hel - cały
heldigvis - na szczęście
helg - weekend | święto
helgen - święty
helikopter - helikopter
helium - hel
Hellas - Grecja
hellig - święty
helse - zdrowie
helseskadelig - szkodliwy dla zdrowia
helt - bohater | całkiem | całkowicie | zupełnie
helvete - piekło | cholera! | do diabła! | piekło i szatani!
hemmelig - tajny | tajemny
hemmelighet - tajemnica
hemolyse - hemoliza
hende - zdarzać się
henge - wisieć | wieszać | powiesić | zawiesić
henne - ją | ona
hennes - jej
hente - przynosić | odbierać
her - tutaj
herfra - stąd
her ligger hunden begravet - tu leży pies pogrzebany
herrefrisør - fryzjer męski
hersker - władca
hertuginne - księżna
heslig - paskudny | wstrętny | obrzydliwy | szkaradny | ohydny
hest - koń
hete - nazywać się
hevn - zemsta
hierarki - hierarchia
himmel - niebo
hingst - ogier
historie - historia
historiker - historyk
historisk - historyczny
hjelm - hełm | kask
hjelp - pomoc
hjelpe - pomagać
hjem - do domu
hjemme - w domu
hjemmedatamaskin - komputer osobisty | PC
hjerne - mózg
hjerte - serce
hjort - jeleń
hode - głowa
høflighet - grzeczność
hofte - biodro
hofteledd - staw biodrowy
holde - trzymać
høne - kura
Hongkong - Hongkong
honning - miód
hoppe - klacz | skakać | wskakiwać | przeskakiwać
hoppe paradis - grać w klasy
horde - horda
hore - dziwka | kurwa
høre - słyszeć | słuchać
hormon - hormon
horn - róg | klakson | rogal | rogalik
Horus - Horus
hos - u
høst - jesień
hotell - hotel
hov - kopyto
hovedstad - stolica
høy - wysoki | głośny | siano
høydehopp - skok wzwyż
høyre - prawy | prawica
høytid - święto
hud - skóra
huggorm - żmija
hukommelse - pamięć
hule - jaskinia | nora | jama
hull - dziura
hummer - homar
hun - ona
hund - pies
hundre - sto
hundrede - setny
hunger - głód
hus - dom
huske - pamiętać
hva - co
hval - wieloryb
hvem - kto
hvete - pszenica
hvetemel - mąka pszenna
hvil - przerwa (krótka)
hvile - odpoczywać
hvilken - jaki
hvis - jeśli
hvisk - szept
hviske - szeptać
hvit - biały
hvite - białko
hviterusser - Białorusin
hviterussisk - białoruski | białoruski (język)
Hviterussland - Białoruś
hvitløk - czosnek
hvitvin - białe wino
hvor - gdzie
hvordan - jak
hvorfor - dlaczego
hvor mange - ile
hyggelig - fajny
hygiene - higiena
hykleri - hipokryzja
hykling - hipokryzja
hylle - półka
hypnose - hipnoza
i - w | na | do | od
i år - w tym roku
i dag - dzisiaj | dziś
idé - pomysł
idealisere - idealizować
idealisme - idealizm
idealist - idealista
idealistisk - idealistyczny
idrett - sport
i fjor - w zeszłym roku
i går - wczoraj
igjen - znowu | znów
iglo - igloo
i hui og hast - czym prędzej
ikke - nie
i kveld - dziś wieczorem
ild - ogień | ognisko
ildrake - pogrzebacz
i morgen - jutro
i morges - dziś rano
imot - przeciwko
imperium - imperium
i munnen på hverandre - jeden przez drugiego
industri - przemysł
industriell - przemysłowy
influensa - grypa
informasjon - informacja
ingefær - imbir
ingen - nikt
ingensteds - nigdzie
ingenting - nic
innbygger - mieszkaniec
innsats - stawka
innse - zdawać sobie sprawę
innsjø - jezioro
insekt - owad
interessant - interesujący | ciekawy
Irak - Irak
iraker - Irakijczyk
irakisk - irakijski
ire - Irlandczyk
Irland - Irlandia
irsk - irlandzki | irlandzki (język)
is - lód
isbjørn - niedźwiedź polarny
isbryter - lodołamacz
isete - oblodzony
isfjell - góra lodowa
iskald - lodowaty
iskrem - lody
islam - islam
Island - Islandia
islandsk - islandzki | islandzki (język)
islending - Islandczyk
Israel - Izrael
israeler - Izraelczyk
israelsk - izraelski
Italia - Włochy
italiener - Włoch
italiensk - włoski | włoski (język)
ja - tak
jakt - polowanie
jakte - polować
jakthorn - róg myśliwski
januar - styczeń
Japan - Japonia
japaner - Japończyk
japansk - japoński | japoński (język)
jeg - ja
jeger - myśliwy
jente - dziewczynka | dziewczyna
jern - żelazo
jernbane - kolej
jernbanestasjon - stacja kolejowa | dworzec kolejowy
Jesus - Jezus
jo - przecież
jobb - praca
jobbe - pracować
jøde - Żyd
jødedom - judaizm
jødisk - żydowski
jord - Ziemia | ziemia | gleba
jordbær - truskawka
jordbærsyltetøy - dżem truskawkowy
jordbruk - rolnictwo
jordbruker - rolnik
jordskjelv - trzęsienie ziemi
journalist - dziennikarz | dziennikarka
journalistisk - dziennikarski
jul - Boże Narodzenie | święta (Bożego Narodzenia) | gwiazdka
julaften - Wigilia Bożego Narodzenia
julekort - kartka świąteczna (na Boże Narodzenie)
juletre - choinka
juli - lipiec
juni - czerwiec
kabaret - kabaret (spektakl)
kafé - kawiarnia
kaffe - kawa
kaie - kawka
kake - ciastko | ciasto
kakerlakk - karaluch
kakle - gdakać
kaktus - kaktus
kål - kapusta
kald - zimny
kalender - kalendarz
kalkun - indyk
kall - powołanie
kalle - nazywać
kallenavn - przydomek
kalv - cielak | cielę
kalvekjøtt - cielęcina
kamel - wielbłąd
kameleon - kameleon
kamp - walka | mecz
kampanje - kampania
kan - kunne
kanadier - Kanadyjczyk
kanadisk - kanadyjski
kanel - cynamon
kanin - królik
kanne - dzbanek
kanskje - może
kant - krawędź | brzeg
Kapernaum - Kafarnaum
kapitalisme - kapitalizm
kappe - peleryna
kaptein - kapitan
kar - naczynie
karismatisk - charyzmatyczny
karm - futryna | framuga
kart - mapa
kasino - kasyno
kastanje - kasztan
kastanjetre - kasztanowiec
kaste - rzucać | wyrzucać
kaste opp - wymiotować
katedral - katedra
katekisme - katechizm
katt - kot
kaviar - kawior
keiser - cesarz
keiserdømme - cesarstwo
kenguru - kangur
Kenya - Kenia
kikkert - lornetka
kilometer - kilometr
Kina - Chiny
kineser - Chińczyk
kinesisk - chiński | chiński (język)
kinn - policzek
kinnskjegg - baki | bokobrody
kino - kino
kirke - kościół
kirkegård - gravlund
kirkelig - kościelny
kirsebær - wiśnia
kirurg - chirurg
kirurgi - chirurgia
kirurgisk - chirurgiczny
kivi - kiwi
kiwi - kiwi
kjæledyr - zwierzak | zwierzę
kjærlig - czuły
kjærlighet - miłość | lizak
kjede - łańcuch
kjedelig - nudny
kjedsomhet - nuda
kjelke - sanki
kjeller - piwnica
kjemi - chemia
kjemiker - chemik
kjemisk - chemiczny
kjempe - walczyć | olbrzym | gigant
kjenne - znać | czuć | czuć się | wiedzieć o czymś
kjent - znany
kjertel - gruczoł
kjeve - szczęka
kjøkken - kuchnia
kjole - sukienka | suknia
kjøleskap - lodówka
kjønn - płeć | rodzaj
kjøpe - kupować
kjøre - jeździć | prowadzić
kjøretøy - wehikuł | środek transportu
kjøtt - mięso
klær - ubranie | odzież | ubiór
klient - klient
klikke - klikać
klima - klimat
klinikk - klinika
klokke - zegar | dzwon
kloster - klasztor
kløver - koniczyna | trefl
klump - bryła | gruda
knapp - guzik | przycisk
knappenål - szpilka
kne - kolano
knekkebrød - pieczywo chrupkie
knele - klękać
kneledd - staw kolanowy
kniv - nóż
knivblad - ostrze noża
knivsegg - ostrze noża
knute - węzeł | supeł
kø - kolejka
kobber - miedź
koffert - walizka
kolbe - kolba
kollisjon - kolizja
koloni - kolonia
koloskopi - kolonoskopia
kom - komme
komedie - komedia
komfyr - kuchenka
komme - przychodzić | przyjeżdżać
kommunisme - komunizm
kommunist - komunista
kommunistisk - komunistyczny
komponere - komponować
komponist - kompozytor
kone - żona
konge - król
kongerike - królestwo
konjunksjon - spójnik
konkret - konkretny | rzeczownik konkretny
konsert - koncert
konsonant - spółgłoska
kontaktlinse - soczewka kontaktowa
kontinent - kontynent
kontor - biuro | urząd | gabinet
kontrolltårn - wieża kontroli lotów
konversasjon - rozmowa
konvolutt - koperta
kopiere - kopiować
kopp - filiżanka
kor - chór
kornaks - kłos zboża
kornkråke - gawron
kors - krzyż
kort - karta | kartka | krótki
koste - kosztować
krabbe - krab
krage - kołnierz
kragebein - obojczyk
kråke - wrona
krakk - stołek | taboret
kredittkort - karta kredytowa
kreft - rak
kreps - rak
Krepsen - Rak
krig - wojna
krigsfange - jeniec wojenny
kristendom - chrześcijaństwo
kritiker - krytyk
kritt - kreda
kroat - Chorwat
Kroatia - Chorwacja
kroatisk - chorwacki | chorwacki (język)
krok - hak | haczyk
krokodille - krokodyl
krølltang - lokówka
krone - korona | korona  (1 krone = 100 øre) | koronować | ukoronować
kropp - ciało
krydder - przyprawa
krypdyr - gad
krystall - kryształ | ciało krystaliczne
ku - krowa
kuk - chuj
kun - tylko
kunde - klient
kunne - móc | umieć | potrafić
kunst - sztuka | sztuczka
kunstig - sztuczny | sztucznie
kunstner - artysta
kunstverk - dzieło sztuki
kurvball - koszykówka
kusma - świnka
kvadrat - kwadrat
kveld - wieczór
kvern - młynek
kvikksølv - rtęć
kvinne - kobieta
kvise - pryszcz
kylling - kurczak
kyrillisk - cyrylicki
kyss - pocałunek | całus
kysse - całować
labyrint - labirynt
lære - uczyć | uczyć się
lærer - nauczyciel | nauczycielka
lage - robić
lagt - legge
laken - prześcieradło
laks - łosoś
laktase - laktaza
lampe - lampa
land - kraj | ląd
landet - wieś
låne - pożyczać | wypożyczać | zapożyczać
lang - długi
langfinger - palec środkowy
langsom - wolny | powolny
lår - udo
låse - zamykać (na klucz)
lastebil - samochód ciężarowy | ciężarówka
lat - leniwy
latter - śmiech
Latvia - Łotwa
latvier - Łotysz
latvisk - łotewski | łotewski (język)
lav - niski | cichy
le - śmiać się
ledd - staw
leddgikt - artretyzm
ledig - wolny
lege - lekarz | leczyć
legekontor - gabinet lekarski
legeme - ciało
legg - łydka
legge - kłaść | położyć
leie - wynajmować | wypożyczać
leilighet - mieszkanie
leke - zabawka | bawić się
leketøy - zabawka
leksjon - lekcja
lenestol - fotel
lengde - długość
lengdehopp - skok w dal
lenge - długo
leppe - warga
lerke - skowronek
lese - czytać
leselig - czytelny
lete - szukać
lete etter en nål i en høystakk - szukać igły w stogu siana
lett - lekki | łatwy | chudy (o art. spożywczych) | lekko | łatwo | chudo (o art. spożywczych) | lete
leve - żyć
levende - żywy
lever - wątroba
libanesisk - libański
lide - cierpieć
lidelse - cierpienie
ligge - leżeć
lik - zwłoki | podobny | równy | taki sam
like - lubić | podobać się
likevekt - równowaga
likevel - jednak | wszelako | ostatecznie
likhus - kostnica
likkiste - trumna
lillefinger - mały palec
lin - len
lind - lipa
Litauen - Litwa
litauer - Litwin
litauisk - litewski | litewski (język)
liten - mały
litt - trochę
litterær - literacki
litteratur - literatura
liturgi - liturgia
liv - życie
livmor - macica
ljå - kosa
loddrett - pionowy | pionowo
løfte - obietnica | podnosić
logiker - logik
logikk - logika
logisk - logiczny | logicznie
løgn - kłamstwo
løgner - kłamca | łgarz
lojal - lojalny
lojalitet - lojalność
løk - cebula | cebulka
lokal - lokalny | miejscowy
lomme - kieszeń
lommebok - portfel
lommekniv - scyzoryk
lommetjuv - kieszonkowiec | złodziej kieszonkowy
lommetørkle - chusteczka (do nosa) | chustka (do nosa)
lommetyv - kieszonkowiec
lønn - pensja | płaca | klon
løpe - biegać | biec
loppe - pchła
lørdag - sobota
løse - rozwiązywać
love - obiecywać
løve - lew
lue - czapka
luft - powietrze
lufthavn - port lotniczy | lotnisko
lugg - grzywka
lunge - płuco
lungebetennelse - zapalenie płuc
lungekreft - rak płuc
lunte - lont
lus - wesz
lykke - szczęście | sukces | powodzenie
lykkelig - szczęśliwy
lymfeknute - węzeł chłonny | węzeł limfatyczny
lyn - błyskawica | piorun
lys - świeczka
lyske - pachwina
lyst - chęć | ochota
lyve - kłamać | okłamywać
Madeira - Madera
madrass - materac
mage - żołądek | brzuch
mai - maj
mais - kukurydza
maiskolbe - kolba kukurydzy
majones - majonez
måke - mewa
makedoner - Macedończyk
Makedonia - Macedonia
makedonsk - macedoński | macedoński (język)
makrell - makrela
maktbegjær - żądza władzy
male - malować | mielić | mleć | mruczeć
maler - malarz
malm - ruda
mamma - matka
man - człowiek
mandag - poniedziałek
mandarin - mandarynka
måne - księżyc
måned - miesiąc
mange - wiele | dużo
mangemillionær - multimilioner
mann - mężczyzna | mąż
mannen med ljåen - kostucha
mannlig - męski
margarin - margaryna
marihøne - biedronka
mark - robak
mars - marzec
måse - mewa
maskin - maszyna
mat - jedzenie
mate - karmić
måte - sposób | metoda | umiar
matematiker - matematyk
matematikk - matematyka
matematisk - matematyczny
materiale - materiał
matolje - olej (spożywczy)
måtte - musieć
maur - mrówka
maurtue - mrowisko
med - z
medisin - medycyna | lekarstwo | lek
medlem - członek
medlemskap - członkostwo
meg - mnie
meitemark - dżdżownica
mel - mąka
melk - mleko
melke - doić
melkesjokolade - czekolada mleczna
Melkeveien - Droga Mleczna
mellom - między
Mellom-Amerika - Ameryka Środkowa
melon - melon
men - ale | lecz
menneske - człowiek
menneskelig - ludzki
mesterverk - arcydzieło
metall - metal
meter - metr
middag - południe (pora dnia) | obiad
Middelhavet - Morze Śródziemne
midnatt - północ
mikrofon - mikrofon
miljø - środowisko
millimeter - milimetr
million - milion
millionær - milioner
millionte - milionowy
min - mój | swój
mineral - minerał
mink - norka
minutt - minuta
mirakel - cud
misfornøyd - niezadowolony
misjonær - misjonarz
mistanke - podejrzewać
miste - gubić | tracić
mistenke - podejrzewać
mistenkelig - podejrzany
mistenksom - podejrzliwy
mjaue - miauczeć
mjød - miód pitny
mjølk - mleko
mjølke - doić
møbel - mebel
mobiltelefon - telefon komórkowy
modig - odważny
møll - mól
monarki - monarchia
monofysittisme - monofizytyzm
mønster - wzór
Montenegro - Czarnogóra
mor - matka
mord - morderstwo
morder - morderca
morell - czereśnia
morgen - poranek | ranek | rano
mørk - ciemny
mormor - babcia (ze strony matki)
mort - płoć | płotka
moské - meczet
mot - odwaga | wbrew | niezgodny z | przeciw | przeciwko | pod | wobec | dla
mote - moda
motorsykkel - motocykl
motorvei - autostrada
muldvarp - kret
mule - pysk
mulig - możliwy
mund - usta
munk - mnich
munn - usta
munter - wesoły
mus - mysz
museum - muzeum
musiker - muzyk
musikk - muzyka
muskel - mięsień
muslim - muzułmanin
musling - małż
mustasje - wąsy
mye - dużo | duży | bardzo | niezbyt
mygg - komar
mynt - moneta | mennica
mynte - mięta
myrde - mordować
nå - teraz | docierać do
nabo - sąsiad | sąsiadka
Nairobi - Nairobi
naken - nagi
nål - igła | szpilka
nå og da - od czasu do czasu
når - kiedy
narhval - narwal
narkoman - narkoman
nasjonalisme - nacjonalizm
nasjonalist - nacjonalista
nasjonalistisk - nacjonalistyczny
nåtid - teraźniejszość
natt - noc
nattergal - słowik
nattsvermer - ćma
naturlig - naturalny
navle - pępek
navn - imię | nazwisko | nazwa
nebb - dziób
ned - w dół | na dół
nede - na dole | w dole
nedenfor - poniżej
Nederland - Holandia
nederlandsk - holenderski | holenderski (język)
nederlender - Holender
negl - paznokieć
nei - nie
nektarin - nektarynka
nellik - goździk
Nepal - Nepal
nese - nos
neshorn - nosorożec
nesle - pokrzywa
neste - bliźni | następny | przyszły
nesten - prawie
netter - natt
neve - pięść
ni - dziewięć
niende - dziewiąty
nitten - dziewiętnaście
nittende - dziewiętnasty
nitti - dziewięćdziesiąt
nittiende - dziewięćdziesiąty
Nix - Nix
nødvendig - konieczny | potrzebny
noe - coś
noen - ktoś
nok - dość | dosyć | chyba
nøkkel - klucz
nonne - zakonnica
nord - północ | na północ
Nord-Amerika - Ameryka Północna
nordamerikansk - północnoamerykański
nordavind - wiatr północny
nordlig - północny
nordmann - Norweg
Nordsjøen - Morze Północne
Norge - Norwegia
norsk - norweski | norweski (język)
nøtt - orzech
nøtteskrike - sójka
november - listopad
nøyaktig - dokładny | dokładnie | właśnie
null - zero
ny - nowy
nynorsk - nynorsk | nynorsk (w)
nyre - nerka
nyrestein - kamień nerkowy
nysgjerrig - ciekaw | ciekawy
nysgjerrighet - ciekawość
nyttårsaften - sylwester
obduksjon - sekcja zwłok | obdukcja
oddetall - liczba nieparzysta
ofte - często
og - i | a
også - też | także | również
øke - zwiększać | zwiększać się | wzrastać | rosnąć
økologi - ekologia
økologisk - ekologiczny
øks - siekiera
okse - byk
oksygen - tlen
oktober - październik
øl - piwo | piwo ( butelka piwa, szklanka piwa, kufel piwa, puszka piwa )
oliven - oliwka | oliwkowy
olje - olej
oljeplattform - platforma wiertnicza
oljeselskap - kompania naftowa
Olympia - Olimpia (miasto w Grecji)
om - o | za | czy | jeśli | jeżeli | gdyby
omdanne - przekształcać
omfavne - obejmować
omsorg - opieka | pielęgnowanie | dbałość | troska | troskliwość
omtrent - około | prawie
onkel - wujek | wuj
onsdag - środa
ønske - życzenie | pragnienie | życzyć | chcieć | pragnąć
opp - do góry | w górę | na górę
oppdage - odkrywać
oppe - u góry | na górze | w górze
oppfinne - wynaleźć
oppfinnelse - wynalazek
oppfinner - wynalazca
oppgi - podawać
oppslagsord - hasło | wyraz hasłowy
oppstandelse - zmartwychwstanie | poruszenie
oppvaskmaskin - zmywarka do naczyń
or - olcha
oransje - pomarańczowy
ord - słowo | wyraz
ordbok - słownik
ordenstall - liczebnik porządkowy
ordklasse - część mowy
ordne - porządkować
øre - ucho | øre -
organisasjon - organizacja
organisere - organizować
orgasme - orgazm
ørken - pustynia
orm - wąż | żmija | robak
ørn - orzeł
ørret - pstrąg
øsregn - ulewa | ulewny deszcz
oss - nas | my
ost - ser
øst - wschód | na wschód
østavind - wiatr wschodni
Østerrike - Austria
østerriker - Austriak
østerriksk - austriacki
Østersjøen - Bałtyk | Morze Bałtyckie
Ostia - Ostia
østlig - wschodni
Øst-Timor - Timor Wschodni
oter - wydra
over - nad | ponad
overalt - wszędzie
overdrive - przesadzać
overleppe - górna warga
overnaturlig - nadprzyrodzony
oversette - tłumaczyć | przekładać
oversettelse - tłumaczenie
oversetter - tłumacz
øy - wyspa
øye - oko
øyebryn - brew
øyeeple - gałka oczna
øyelokk - powieka
øyenstikker - ważka
øyevippe - rzęsa
på - na | po | w
padde - ropucha
pære - gruszka
pakke - paczka | pakować
palass - pałac
panne - czoło | patelnia
pannekake - naleśnik
papegøye - papuga
papir - papier
pappa - ojciec
paprika - papryka
parabolantenne - antena satelitarna
paradis - raj
paranoia - paranoja
paraply - parasolka | parasol
parasitt - pasożyt
Paris - Paryż
park - park
parkere - parkować
partall - liczba parzysta
parti - partia
pasient - pacjent
påske - Wielkanoc
passasjer - pasażer
passord - hasło
pastor - pastor
patron - nabój
pattedyr - ssak
pave - papież
pekefinger - palec wskazujący
pelotong - pluton
pels - futro | futerko | sierść
penge - pieniądz
penger - pieniądze
penis - penis
perrong - peron
persille - pietruszka
persisk - perski
personalia - dane osobowe
personbil - samochód osobowy
personlighet - osobowość
piano - pianino
piemontesisk - piemoncki
pike - dziewczyna | dziewczynka
pingvin - pingwin
pinne - patyk
pinnsvin - jeż
Pittsburgh - Pittsburgh (stolica Allegheny)
plan - plan | płaszczyzna | poziom | szczebel
planet - planeta
planetarium - planetarium (obiekt)
plantasje - plantacja
plante - roślina | sadzić
plantefett - tłuszcz roślinny
plass - plac | miejsce
plast - plastik
pleie - opieka | pielęgnowanie | pielęgnacja | opiekować się | pielęgnować | dbać | mieć zwyczaj (robić coś)
plen - trawnik
plikt - obowiązek
plog - pług
plomme - żółtko | śliwka
plommesyltetøy - dżem śliwkowy
pløye - orać
plutselig - nagły | nagle
poker - poker
pokerspiller - pokerzysta
polakk - Polak
Polen - Polska
politi - policja
politiker - polityk
politikk - polityka
politisk - polityczny
pølse - kiełbasa
polsk - polski | polski (język) | polszczyzna
poppel - topola
populær - popularny
Portugal - Portugalia
portugiser - Portugalczyk
portugisisk - portugalski | portugalski (język)
postkontor - poczta | urząd pocztowy
potet - ziemniak | kartofel
potte - doniczka | nocnik
praksis - praktyka
preposisjon - przyimek
president - prezydent
presis - dokładny | precyzyjny
presisjon - precyzja | dokładność
presse - prasa
prest - ksiądz | kapłan
preteritum - czas przeszły
primogenitur - primogenitura
prinsesse - księżniczka
prinsipp - zasada | reguła
pris - cena | nagroda
problem - problem
professor - profesor
pronomen - zaimek
propaganda - propaganda
prosjekt - projekt
protest - protest
protestere - protestować
prøve - próbować | usiłować | spróbować | przymierzyć | próba | ćwiczenie czegoś | co będzie wykonywane przed publicznością | klasówka,egzamin | próbka | usiłowanie (wykonania jakiejś czynności) | test | badanie
psykolog - psycholog
psykoterapeut - psychoterapeuta
psykoterapi - psychoterapia
publikasjon - publikacja
pukkel - garb
pulverkaffe - kawa rozpuszczalna
pumpe - pompa | pompka | pompować
pungdyr - torbacz
pupill - źrenica
purre - por
puste - oddychać
pute - poduszka
rå - surowy
rabarbra - rabarbar
rabies - wścieklizna
råd - rada | porada
radar - radar
radio - radio
radioaktiv - radioaktywny
radioaktivitet - radioaktywność | promieniotwórczość
rådyr - sarna
rake - grabie | grabić
ramme - rama
rasende - wściekły
rasjonell - racjonalny
rask - szybki | prędki
rav - bursztyn
ravn - kruk
reaksjon - reakcja
redd - bać się
reddik - rzodkiewka
regel - reguła
regjering - rząd | panowanie | rządy
regn - deszcz
regnbue - tęcza
regne - padać (o
regnemaskin - kalkulator
regning - rachunek
regnskapsfører - księgowy | księgowa
rein - renifer | czysty
reir - gniazdo
reise - podróż | podróżować | jeździć | wyjeżdżać
reisende - podróżny | podróżujący
reke - krewetka
rekkefølge - kolejność | porządek
religion - religia
ren - czysty
rense - czyścić | oczyszczać
republikk - republika
retning - kierunek
retsina - retsina
rettferdig - sprawiedliwy
rettferdighet - sprawiedliwość
rev - lis
ribbein - żebro
ridder - rycerz
rigg - takielunek | platforma wiertnicza
rik - bogaty
rikdom - bogactwo
ring - pierścionek | kolczyk | obwodnica miejska
ringe - dzwonić
ringfinger - palec serdeczny
risikabel - ryzykowny
risikere - ryzykować
risiko - ryzyko
Rjukan - Rjukan (miasto) | Rjukan (gmina)
rød - czerwony
rødbete - burak
rødvin - czerwone wino
rogn - jarzębina | ikra
røkelse - kadzidło
Roland - Roland
rom - pokój ( | miejsce | przestrzeń
roman - powieść
Romania - Rumunia
røntgenstråler - promienie rentgena
rop - wołanie
rope - wołać
ror - ster
rosa - różowy
rose - róża | chwalić
rosin - rodzynek | rodzynka
rot - korzeń | pierwiastek
rotte - szczur
rovdyr - drapieżnik
røyk - dym | papieros
røyke - palić | wędzić
røyker - palacz | osoba paląca papierosy
røyking - palenie papierosów | wędzenie
rug - żyto
rullebrett - deskorolka
rulletrapp - schody ruchome
rumener - Rumun
rumensk - rumuński | rumuński (język)
rumpe - tyłek
rumpetroll - kijanka
rund - okrągły
rundstykke - bułka
rundt - wokół | dookoła
russer - Rosjanin
russisk - rosyjski | rosyjski (język)
Russland - Rosja
rust - rdza
ruste - rdzewieć
rusten - zardzewiały
rygg - plecy
ryggfinne - płetwa grzbietowa
ryggrad - kręgosłup
sa - si
så - siać | se | tak | taki | to | potem (a) | więc | żeby
sabotasje - sabotaż
sabotere - sabotować
sabotør - sabotażysta
saftig - soczysty
sag - piła
sak - sprawa
saks - nożyce | nożyczki
sakte - wolny | powolny | wolno | powoli
salat - sałata | sałatka | surówka
salg - sprzedaż | wyprzedaż
salme - hymn
salt - słony
same - Lapończyk
samfunn - społeczeństwo | społeczność
samisk - lapoński | lapoński (język)
samle - zbierać | kolekcjonować
samme - ten sam | taki sam
sammen - razem
sammendrag - streszczenie | podsumowanie
samtale - rozmowa
samtidig - jednoczesny | równoczesny | jednocześnie | równocześnie
samvittighet - sumienie
sand - piasek
sann - prawdziwy
sannhet - prawda
São Tomé og Príncipe - Wyspy Świętego Tomasza i Książęca
såpe - mydło
sår - rana
sarkofag - sarkofag
satte - sette
sau - owca
saus - sos
schizofreni - schizofrenia
Schlesien - Śląsk
se - widzieć | zobaczyć | patrzeć | oglądać
sebra - zebra
seddel - banknot
seg - się
seier - zwycięstwo
seil - żagiel
seilbåt - żaglówka
seilbrett - deska windsurfingowa
seilskip - żaglowiec
seks - sześć
seksten - szesnaście
sekstende - szesnasty
seksti - sześćdziesiąt
sekstiende - sześćdziesiąty
seksuell - seksualny
sekund - sekunda | chwila
sel - foka
selge - sprzedawać | sprzedawać się
selleri - seler
selskap - towarzystwo | przyjęcie | przedsiębiorstwo | firma | spółka | kompania
selskapelig - towarzyski
selv - sam
selvfølgelig - oczywiście
selvhypnotisk - autohipnotyczny
selvmord - samobójstwo
selvmorder - samobójca
sen - późny
sende - wysyłać | posyłać | słać
seng - łóżko
sennep - musztarda
sent - późno
sentral - centralny | w centrum (położony)
se på - oglądać
september - wrzesień
serber - Serb
Serbia - Serbia
serbisk - serbski | serbski (język)
serie - seria | serial
setning - zdanie
sette - stawiać | postawić
se ut - wyglądać
sfære - sfera
si - mówić | powiedzieć
sigar - cygaro
sigarett - papieros
signal - sygnał
sigøyner - Cygan
sigøynersk - cygański
sikker - bezpieczny | pewny | pewien
sikkerhetsnål - agrafka
sikkert - na pewno | z pewnością
sikring - bezpiecznik
sild - śledź
silhuett - sylwetka
sin - swój
Singapore - Singapur
sinn - umysł
sirkel - koło | okrąg
sist - ostatni
sitron - cytryna
sitte - siedzieć
situasjon - sytuacja
sjåfør - kierowca
sjakk - szachy
sjakkbrett - szachownica
sjalu - zazdrosny
sjalusi - zazdrość
sjampinjong - pieczarka
sjarmerende - uroczy
sjef - szef
sjel - dusza
sjette - szósty
sjiraff - żyrafa
sjokolade - czekolada
sju - siedem
sjuende - siódmy
skadelig - szkodliwy
skallamann - łysol | łysy
skalle - czaszka
skallet - łysy
skandinav - Skandynaw
Skandinavia - Skandynawia
skandinavisk - skandynawski
skap - szafa | szafka
skape - tworzyć
skar - rozpadlina | szczelina | skjære
skåret - cięty | skjære
skatt - skarb | podatek
skau - las
ski - narta
skikkelig - porządny | przyzwoity | porządnie | przyzwoicie
skilpadde - żółw
skinke - szynka
skinn - skóra
skinne - szyna | świecić
skip - statek | okręt | nawa (główna)
skive - plaster | plasterek | kromka | kroić (w plastry)
skjære - sroka | kroić | ciąć
skjærebrett - deska do krojenia
skje - łyżka | zdarzać się | dziać się
skjebne - los | dola | przeznaczenie
skjede - pochwa
skjegg - broda
skjelett - szkielet
skjell - muszla | łuska
skjønnlitteratur - literatura piękna
skjørt - spódnica | spódniczka
skjorte - koszula
sko - but
skog - las
skogbrann - pożar lasu
skole - szkoła
skoleår - rok szkolny
skorstein - komin
skotsk - szkocki | szkocki (język)
skotte - Szkot
Skottland - Szkocja
skøyte - łyżwa
skøytebane - lodowisko
skrev - skrive
skrik - krzyk | wrzask
skrike - krzyczeć | wrzeszczeć
skritt - krok | krocze
skrive - pisać
skrivebord - biurko
skrivemaskin - maszyna do pisania
skrujern - śrubokręt
skrutrekker - śrubokręt
skuddår - rok przestępny
skuespiller - aktor
skuff - szuflada
skuffe - szuflada
skulder - bark | ramię
skulderblad - łopatka
skulle - mieć | powinienem | powinieneś | powinien | podobno
skumring - zmierzch
sky - chmura | obłok | niebo (atmosfera ziemska) | nieśmiały | płochliwy | stronić | unikać
skygge - cień
skyggekabinett - gabinet cieni
skyte - strzelać
skytsengel - Anioł Stróż
slå - uderzyć
slag - uderzenie | cios | bitwa
slange - wąż
slank - szczupły
slave - niewolnik | niewolnica
slaver - Słowianin
slaveri - niewolnictwo
slavisk - niewolniczy | słowiański
slikke - lizać | oblizywać | lizać się | oblizywać się
slikkepinne - lizak
slips - krawat
slott - zamek | pałac
slovak - Słowak
Slovakia - Słowacja
slovakisk - słowacki | słowacki (język)
slovener - Słoweniec
Slovenia - Słowenia
slovensk - słoweński | słoweński (język)
slutt - koniec
smal - wąski
smerte - ból | boleć
smil - uśmiech
smile - uśmiechać się
smokk - smoczek
smør - masło
smørbrød - kanapka
snabel - trąba
snakke - mówić | rozmawiać
snart - wkrótce | niedługo
snegl - ślimak
snekker - stolarz
snø - śnieg | padać
snøball - śnieżka
snøbrett - deska snowboardowa
snømann - bałwan
snøplog - pług śnieżny
snorke - chrapać
snus - snus
snute - pysk
sofa - kanapa
sokk - skarpeta | skarpetka
sol - słońce (gwiazda)
solbrille - okulary przeciwsłoneczne
soldat - żołnierz
solgt - selge
solgte - selge
sølibat - celibat
solnedgang - zachód słońca
soloppgang - wschód słońca
solsikke - słonecznik
solur - zegar słoneczny
sølv - srebro
som - jak | jako | który
sommer - lato
sommerfugl - motyl
søndag - niedziela
sønn - syn
sønnavind - wiatr południowy
sopp - grzyb
sør - południe | na południe
Sør-Amerika - Ameryka Południowa
søramerikansk - południowoamerykański
sorg - żal | smutek | żałoba | zmartwienie
sørlig - południowy
sort hull - czarna dziura
sosiolog - socjolog
søster - siostra
sot - sadza
søt - słodki
søtsaker - słodycze
sove - spać
sovne - zasypiać
søvngjenger - lunatyk
spade - łopata | szpadel
Spania - Hiszpania
spanjol - Hiszpan
spansk - hiszpański | hiszpański (język)
sparke - kopać | zwalniać
spedbarn - niemowlę
speil - lustro
speilegg - jajko sadzone
spiker - gwóźdź
spille - grać
spiller - gracz
spinat - szpinak
spindelvev - pajęczyna
spise - jeść
spøkelse - duch
spør - spørre
spørre - pytać
spørsmål - pytanie | kwestia
sportsfisker - wędkarz
sporvogn - tramwaj
språk - język
spurv - wróbel
spytt - ślina
spytte - pluć | spluwać
spyttslikker - lizus
Sri Lanka - Sri Lanka
sta - uparty
stå - stać | być napisanym
stadig - stały | stale | ciągle | coraz
stakkars - biedny
stål - stal
stamp - lombard
stasjon - stacja | dworzec
stat - państwo | stan
statsminister - premier
stearinlys - świeca
sted - miejsce
stein - kamień | pestka
steke - smażyć | prażyć | piec
stekepanne - patelnia
stemme - głos (dźwięk wydawany przez człowieka lub zwierzę) | głos (opinia wyrażona podczas głosowania) | głosować | stroić (instrument) | zgadzać się
stemmerett - prawo wyborcze | prawo do głosowania
stenge - zamykać
stengel - łodyga
sterk - mocny | silny
sti - ścieżka
stiftemaskin - zszywacz
stige - drabina | rosnąć | wzrastać
stikkelsbær - agrest
stjerne - gwiazda | gwiazdor | gwiazdka
stjert - ogon | kuper
stoff - materiał | substancja
stol - krzesło
stolt - dumny
stolthet - duma
stor - duży | wielki
Storbritannia - Wielka Brytania
stork - bocian
større - większy
størrelse - rozmiar
størst - największy
stortå - duży palec u nogi
støvsuger - odkurzacz
strå - słoma | źdźbło
straff - kara
straffe - karać
stråhatt - kapelusz słomkowy
stråle - promień
strand - plaża
strikkhopp - skok na bungee
struts - struś
strykebrett - deska do prasowania
student - student | studentka
studere - studiować
studieår - rok akademicki | rok studiów
stue - chata | chatka | pokój | sala
stund - chwila | moment
stygg - brzydki
stykke - kawałek | sztuka
substantiv - rzeczownik
sukker - cukier
sult - głód
sulten - głodny
sunn - zdrowy
suppe - zupa
surfebrett - deska surfingowa
sutte - ssać
suvenir - pamiątka
svært - bardzo
svak - słaby
sval - chłodny | zimny
svale - jaskółka
svamp - gąbka
svane - łabędź
svar - odpowiedź
svare - odpowiadać
svart - czarny
svart hull - czarna dziura
sveise - spawać
sveiser - spawacz
Sveits - Szwajcaria
sveitser - Szwajcar
sveitsisk - szwajcarski
svelge - połykać | przełykać
svensk - szwedzki | szwedzki (język)
svenske - Szwed
Sverige - Szwecja
svette - pot | pocić się
svigerdatter - synowa
svigerfar - teść
svigermor - teściowa
svigersønn - zięć
svimmelhet - zawroty głowy
svin - świnia
sviske - suszona śliwka
svømme - pływać
svømmeblære - pęcherz pławny
svovel - siarka
svulst - guz
sy - szyć
syfilis - syfilis | kiła
syk - chory
sykdom - choroba
sykehus - szpital
sykepleier - pielęgniarka | pielęgniarz
sykkel - rower
sykkelpumpe - pompka do roweru
sykkelsti - ścieżka rowerowa
syklist - rowerzysta | kolarz
syltetøy - dżem
symaskin - maszyna do szycia
symbol - symbol
synagoge - synagoga
Synagoge - synagoga
synd - grzech
synder - grzesznik
synes - wydawać się | sądzić | uważać (mieć opinię)
synge - śpiewać
synonym - bliskoznaczny | synonim
syre - kwas
syrin - lilak
system - system
sytten - siedemnaście
syttende - siedemnasty
sytti - siedemdziesiąt
syttiende - siedemdziesiąty
ta - brać | wziąć | trwać
tå - palec u nogi
tær - tå
tak - dach | sufit | chwyt
tåke - mgła
takk - podziękowanie
takke - dziękować
taksidermi - taksydermia
taler - mówca
talisman - talizman
tall - liczba | wiek  -
tallerken - talerz
tallord - liczebnik
tålmodig - cierpliwy
tålmodighet - cierpliwość
tang - obcęgi | wodorost
tanke - myśl | opinia | zamiar | idea
tann - ząb
tannkjøtt - dziąsło | dziąsła
tannlege - dentysta
tante - ciocia | ciotka
tape - przegrywać | tracić
tapet - tapeta
tapetsere - tapetować
tåre - łza
tarm - jelito
tårn - wieża
ta til fange - brać do niewoli
tatovere - tatuować
tatovering - tatuaż
tatt - ta
tau - lina | sznur
te - zachowywać się | postepować | herbata
teater - teatr
tegne - rysować | projektować
tegnefilm - film rysunkowy | kreskówka
tegneserie - komiks
tegning - rysunek
telefon - telefon
telt - namiot
tempel - świątynia
temperatur - temperatura
tenåring - nastolatek | nastolatka
tenke - myśleć | zamierzać | uważać | mieć opinię | rozważać
tenne - zapalać
tenner - tann
teppe - dywan | kurtyna
terne - rybitwa
testikkel - jądro
testosteron - testosteron
Thailand - Tajlandia
Thermopylene - Termopile
ti - dziesięć
tid - czas
tidlig - wczesny | wcześnie
tiende - dziesiąty
tiger - tygrys
tigger - żebrak
til - do | dla | na
tilbake - z powrotem
tilbringe - spędzać
til forskjell fra - w odróżnieniu od | w przeciwieństwie do
tilgi - przebaczać | wybaczać
time - godzina | lekcja | wizyta (umówiona)
ting - rzecz
tinning - skroń
tinnsoldat - żołnierzyk | cynowy żołnierzyk
tirsdag - wtorek
tistel - oset
tittel - tytuł
tjene - zarabiać | służyć
tjue - dwadzieścia
tjuende - dwudziesty
to - dwa
toalett - toaleta
toalettpapir - papier toaletowy
tobakk - tytoń
tog - pociąg | pochód
tok - ta
tolv - dwanaście | 12
tolvte - dwunasty
tom - pusty
tomat - pomidor
tommel - kciuk
tømmermenn - kac
topphemmelig - ściśle tajny
Tora - Tora
torg - targ | rynek
torn - kolec | cierń
tornekrone - korona cierniowa
tørr - suchy | wytrawny
torsdag - czwartek
torsk - dorsz
tøy - ubranie
tråd - nitka | nić
tradisjon - tradycja
trådløs - bezprzewodowy
trær - tre
tråkle - fastrygować
traktor - traktor
trane - żuraw
trang - ciasny | obcisły | wąski
trapp - schody
tre - drzewo | drewno | trzy
tredje - trzeci
trekant - trójkąt
trekkspill - akordeon
trenge - potrzebować
trett - zmęczony
tretten - trzynaście
trettende - trzynasty | męczący
tretthet - zmęczenie
tretti - trzydzieści
trettiende - trzydziesty
trikk - tramwaj
trillebår - taczka
trist - smutny
tro - wiara | wierzyć | myśleć | sądzić | wydawać się
trygg - bezpieczny
trykk - akcent
tsjekker - Czech
Tsjekkia - Czechy
tsjekkisk - czeski | czeski (język)
tulipan - tulipan
tunge - język
tunnel - tunel
turisme - turystyka
turist - turysta | turystka
turn - gimnastyka
tusen - tysiąc
tusende - tysięczny
tusenfryd - stokrotka
tv - telewizja
tvare - mątewka
tvil - wątpliwość
tvile - wątpić
Tvillingene - Bliźnięta
tvinge - zmuszać
TV-serie - serial telewizyjny
tyggegummi - guma do żucia
tykk - gruby | gęsty
tynn - chudy | cienki | rzadki
Tyren - Byk
tyrker - Turek
Tyrkia - Turcja
tyrkisk - turecki | turecki (język)
tysk - niemiecki | niemiecki (język)
tysker - Niemiec
Tyskland - Niemcy
tyttebær - borówka brusznica
tyv - złodziej
tyve - dwadzieścia
uærlig - nieuczciwy
uærlighet - nieuczciwość
ubåt - okręt podwodny | łódź podwodna
ugle - sowa
ugress - chwast
uke - tydzień
ukeblad - tygodnik
Ukraina - Ukraina
ukrainer - Ukrainiec
ukrainsk - ukraiński | ukraiński (język)
ull - wełna
ulv - wilk
under - cud | pod | poniżej | podczas | w czasie
undergang - przejście podziemne
underholdsbidrag - alimenty
underleppe - dolna warga
undersøkelse - badanie medyczne | badanie naukowe
underveis - w drodze | po drodze
ung - młody
ungarer - Węgier
Ungarn - Węgry
ungarsk - węgierski | węgierski (język)
ungdom - młodość | młodzież | młodzieniec | młody człowiek
uniform - mundur
universitet - uniwersytet
unngå - unikać
unnskyld - przepraszam!
ur - zegar | zegarek
urbefolkning - ludność rdzenna
urin - mocz
urinblære - pęcherz moczowy
ut - wy-
ute - na dworze
uten - bez
utenlandsk - zagraniczny | obcy
utfordring - wyzwanie | trudność
utland - zagranica
utlending - cudzoziemiec | obcokrajowiec
utseende - wygląd
uttale - wymowa | wymawiać
vær - pogoda | baran
væra - być
være - być
Væren - Baran
værhår - wąsy
vær så god - proszę
vær så snill - proszę | bądź tak miły
vært - være
vagina - pochwa
vakker - piękny
våkne - budzić się
vaksinasjon - szczepienie
vaksine - szczepionka
vaksinere - szczepić | szczepić się
vakuum - próżnia
valg - wybór | wybory
valnøtt - orzech włoski
valp - szczeniak | szczenię
vanligvis - zwykle | zazwyczaj
vann - woda | jezioro
vanndamp - para wodna
vanningskanne - konewka
vannmelon - arbuz
vannrett - poziomy | poziomo
vanskelig - trudny
vanskelighet - trudność
var - være
vår - wiosna | nasz | swój
vare - towar | trwać
varm - ciepły | gorący
varulv - wilkołak
vase - wazon
vaske - myć | prać
vaskemaskin - pralka
vaske opp - zmywać (naczynia)
vaskeservant - umywalka
våt - mokry
ved - drewno | przy | pod | nad
veg - droga | vei
vegetabilsk - warzywny
vegetarianer - wegetarianin
vegg - ściana
vei - droga
veie - ważyć
veke - tydzień
vekke - budzić
vekkerklokke - budzik
vel - dobrze | chyba | być może | zdaje się | że | dobro | dobrobyt
veldig - ogromny | bardzo
velge - wybierać | postanowić | zdecydować się
velger - wyborca
veltalenhet - elokwencja | retoryka
ven - piękny
venn - przyjaciel
vennligst - proszę
vennskap - przyjaźń
venstre - lewy | lewica
vente - czekać | spodziewać się
veps - osa
verb - czasownik
verden - świat
verdi - wartość
verdigris - grynszpan
verdsette - cenić
verdt - warty | wart
verk - dzieło
vermut - wermut
verneplikt - służba wojskowa | obowiązek służby wojskowej
veske - torba | torebka | teczka
vest - kamizelka | zachód | na zachód
vestavind - wiatr zachodni
vestlig - zachodni
vi - my
Vietnam - Wietnam
vietnameser - Wietnamczyk
vietnamesisk - wietnamski | wietnamski (język)
viking - wiking
viktig - ważny
vil - ville
vill - dziki
ville - chcieć
villsvin - dzik
vin - wino
vind - wiatr
vindmølle - wiatrak
vindu - okno
vinduskarm - rama okienna | parapet
vinge - skrzydło
vinke - machać
vinne - wygrywać
vinter - zima
vinterdekk - opona zimowa
virkelig - prawdziwy | naprawdę
virkelighet - rzeczywistość
virveldyr - kręgowiec
visdom - mądrość
vise - pokazywać
vise seg - okazywać się
vite - wiedzieć
vitenskap - nauka
vitenskapelig - naukowy
vitenskapsmann - naukowiec
vodka - wódka
vokal - samogłoska
voksen - dorosły
vold - przemoc
voldta - gwałcić
vollgrav - fosa
vugge - kołyska | kolebka
Wales - Walia
Warszawa - Warszawa (stolica Polski)
Wiktionary - Wikisłownik
ydmyke - upokarzać | poniżać
ydmykelse - upokorzenie | poniżenie
