abecadło - альфабэт m
abiecadło - альфабэт m
adwentnik - сьнежань m
Afganistan - Аўганістан
aktyn - актын m
aktywność - актыўнасьць f
Albania - Альбанія f
Aleksander - Аляксандар m
alfabet - альфабэт m
alfabetu - альфабэт m
algebra - альгебра f
algebraiczny - альгебраічны
Algieria - Альжыр
aluminium - алюмін m
ameryk - амэрыц m
Ameryka - Амэрыка f
Ameryka Łacińska - Лацінская Амэрыка f
Amerykanin - амэрыканец m
Amerykanka - амэрыканка f
amerykański - амэрыканскі
Ameryka Północna - Паўночная Амэрыка f
Ameryka Południowa - Паўднёвая Амэрыка f
amper - ампэр m
analfabetyzm - няпісьменнасьць f, няграматнасьць f
analogia - аналёгія f
analogiczny - аналягічны
anonimowość - ананімнасьць f
antagonizm - супраціўнасьць f
antropolog - антраполяг m
antropologia - антрапалёгія f
antropologiczny - антрапалягічны
antymon - антымон m
antysemita - антысэміт m
antysemitka - антысэмітка f
antysemityzm - антысэмітызм m
antyseptyczny - антысэптычны
antyseptyk - антысэптык m
apiologia - апіялёгія f
Arabia Saudyjska - Саудаўская Арабія
arachnologia - арахналёгія f
archeologia - археалёгія f
archeologiczny - археалягічны
Archimedes - Архімэд m
arsen - аршэньнік m
Arystoteles - Арыстотэль m
astrologia - астралёгія f
astrologiczny - астралягічны
astrologio - астралёгія f
Atlantyk - Атлянтычны акіян m
atmosfera - атмасфэра f
atmosferyczny - атмасфэрны
autobiografia - аўтабіяграфія f
Azja - Азія f
Babilon - Бабілён m
bakteriologia - бактэрыялёгія f
Belg - бэльгіец m
belgijski - бэльгійскі
Belize - Бэліз m
Berlin - Бэрлін m
berliński - бэрлінскі
beryl - бэрыль m
bezdzietność - бязьдзетнасьць f
bezdzietny - бязьдзетны
bezpotomność - бязьдзетнасьць f
bezsilny - бясьсільны
biografia - біяграфія f
biologia - біялёгія f
biologiczny - біялягічны
biotechnologia - біятэхналёгія f
biskup - біскуп m
Bizancjum - Бізантый m, Бізантыя f
bizantyjski - бізантыйскі
bizantyński - бізантыйскі
biznes - бізнэс m
biznesmen - бізнэсмэн m
Bliski Wschód - Блізкі Ўсход m
bohr - борыюм n
Bośnia - Босьнія f
Bośnia i Hercegowina - Босьнія і Герцагавіна
Brazylia - Бразылія f
Bronisław - Браніслаў m
Bułgar - баўгарын m
Bułgaria - Баўгарыя, Baŭharyja
bułgarski - баўгарскі, баўгарская мова f
cer - цэр m
cez - цэз m
chlor - хлёр m
chlorofil - хлярафіл m
chrystianizm - хрысьціянства n
chrześcijanin - хрысьціянін m
chrześcijanka - хрысьціянка f
chrześcijaństwo - хрысьціянства n
cyna - цына f
cyrkon - цыркон m
Czechosłowacja - Чэхаславаччына f
Czecho-Słowacja - Чэхаславаччына f
częstotliwość - частасьць f
czwartek - чацьвер
czyhunka - тор m
darmsztadt - дармштат m
Demokratyczna Republika Wyspy Świętego Tomasza i Wysp Świętego Tomasza i Książęcej - Дэмакратычная Рэспубліка Сан-Тамэ і Прынсыпі
dietetyka - дыеталёгія f
Dniepr - Дняпро
doświadczenie - экспэрымэнт m
druga wojna światowa - другая сусьветная вайна f
dubn - дубн m
dyplomata - дыплямат m
dyplomatyczny - дыпляматычны
dysproz - дыспроз m
efekt - эфэкт m
efekt cieplarniany - парніковы эфэкт m
efekt szklarniowy - парніковы эфэкт m
efektywny - эфэктыўны
einstein - айнштайн m
ekologiczny - экалягічны
ekspert - экспэрт m
eksperyment - экспэрымэнт m
eksperymentalny - экспэрымэнтальны
Elza - Лізавета f
Elżbieta - Лізавета f
energia - энэргія f
entomologia - энтамалёгія f
epidemiologia - эпідэміялёгія f
erb - эрб m
Etiopia - Этыёпія f
etiopski - этыёпскі
etymologia - этымалёгія f
Eurazja - Эўразія f
europ - эўроп m
Europa - Эўропа
Europejczyk - эўрапеец m
Europejka - эўрапейка f
europejski - эўрапейскі
eurosceptycyzm - эўраскептыцызм m
federacja - фэдэрацыя f
Federacja Rosyjska - Расейская Фэдэрацыя f
federalny - фэдэратыўны
feministka - фэміністка f
feministyczny - фэміністычны
feminizm - фэмінізм m
ferm - фэрм m
festiwal - фэстываль m
filozof - філёзаф m
filozofia - філязофія f
filozoficzny - філязофскі
Finlandia - Фінляндыя
fiord - ф’ёрд m
fizjologia - фізыялёгія f
fizjologiczny - фізыялягічны
flerow - флеровіюм n
flora - флёра f
forteca - фартэцыя f
frans - франц m
frazeologia - фразэалёгія f
frazeologiczny - фразэалягічны
ftyzjatra - пульманоляг m, пульманоляг f
gadolin - гадалін m
gal - галь m
genetyczny - генэтычны
genetyka - генэтыка f
geolog - геоляг m
geologia - геалёгія f
geologiczny - геалягічны
geometria - геамэтрыя f
geometryczny - геамэтрычны
german - герман m
gęstość - шчыльнасьць f
ginekologia - гінэкалёгія f
glajza - тор m
glin - алюмін m
globalizacja - глябалізацыя f
gotówka - наяўнасьць f
gregoriański - грэгарыянскі
Grenlandia - Грэнляндыя f
grudzień - сьнежань m
gruźlica - тубэркулёз m
hafn - гафн m
has - гас m
hel - гель m
herc - гэрц m
herpetologia - герпэталёгія f
holm - гольм m
homo - гомасэксуаліст m
homoseksualista - гомасэксуаліст m
homoseksualizm - гомасэксуалізм m
homoseksualny - гомасэксуальны
hydraulik - гомасэксуаліст m
ideologia - ідэалёгія f
ideologiczny - ідэалягічны
II wojna światowa - другая сусьветная вайна f
ilość - колькасьць f
imperator - імпэратар m
imperialista - імпэрыяліст m
imperium - імпэрыя f
ind - інд m
Irlandia - Ірляндыя
iryd - ірыд m
Islandia - Ісляндыя
iterb - ітэрб m
itr - ітар m
I wojna światowa - першая сусьветная вайна f
język obcy - чужаземная мова f
judofob - антысэміт m
kaliforn - каліфорн m
kaloria - калёрыя f
kataloński - каталянскі, каталёнскі, каталянская мова f, каталёнская мова f
kazanie - казаньне n
kilogram - кіляграм m
kiur - кюр m
kolonia - калёнія f
kolonializm - каляніялізм m
kolonialny - каляніяльны
kolonizator - калёнізатар m
Kolumbia - Калюмбія f
kolumbijski - калюмбійскі
kometa - камэта f
konfederacja - канфэдэрацыя f
kontynent - кантынэнт m
kontynentalny - кантынэнтальны
kopernik - капэрніц m
Korsyka - Корсыка f
Kościuszko - Касьцюшка m
krauza - слоік
krzem - крэмн m
ksenofobia - ксэнафобія f
kulomb - кулён m
kwas chlebowy - квас m
lantan - лянтан m
lekarz chorób płuc - пульманоляг m, пульманоляг f
leksykologia - лексыкалёгія f
lesbijka - лесьбіянка f
lit - літ m
Litwa - Летува f
liwermor - лівэрморыюм n
lodowiec - ледавік m
logiczny - лягічны
logika - лёгіка f
logiko - лёгіка f
lorens - лаўрэнс m
Luksemburg - Люксэмбург m
lutet - лютэц m
magnez - магн m, магнэз m
małoduszność - маладушнасьць f
medycyna - мэдыцына f
meitner - майтнэр m
Meksyk - Мэксыка f
meksykański - мэксіканскі
metafizyczny - мэтафізычны
metafizyka - мэтафізыка
metal - мэтал m
metr - мэтар m
Mezopotamia - Мэсапатамія f
miedźwiedź - мядзьведзь m
mikologia - мікалёгія f
mikrobiologia - мікрабіялёгія f
mitologia - міталёгія
mitologiczny - міталягічны
morfologia - марфалёгія f
muzeum - музэй m
mykologia - мікалёгія f
myrmekologia - мірмекалёгія f
myślenie - мысьленьне n
neodym - нэадым m
Neptun - Нэптун m
niedźwiedź - мядзьведзь m
Niemiecka Republika Demokratyczna - Нямецкая Дэмакратычная Рэспубліка f
niepodległość - незалежнасьць f
niewdzięczność - няўдзячнасьць f
niezależność - незалежнасьць f
niob - ніоб m
nobel - набэлій m
Nowa Zelandia - Новая Зэляндыя f
obiecadło - альфабэт m
obóz koncentracyjny - канцэнтрацыйны лягер m
Ocean Atlantycki - Атлянтычны акіян m
ogród zoologiczny - заалягічны парк m
ołów - волава f
oologia - аалёгія f
osm - осм m
owadoznawstwo - энтамалёгія f
padalec - вераценьніца f, мядзянка f
pallad - паляд m
parlament - парлямэнт m
parlamentarny - парлямэнцкі
penicylina - пэніцылін m
pierwiastek chemiczny - хімічны элемэнт m
pierwsza wojna światowa - першая сусьветная вайна f
pismo - альфабэт m
planeta - плянэта f
planetarny - плянэтарны
planta - расьліна f
Platon - Плятон m
platyna - плятына f
platynowy - плятынавы
pluton - плютон, зьвяз m
pneumonolog - пульманоляг m, пульманоляг f
pobożność - пабожнасьць f, багабойнасьць f
północnoamerykański - паўночнаамэрыканскі
polon - палён m
południowoamerykański - паўднёваамэрыканскі
powstanie styczniowe - паўстаньне 1863—1864 гадоў n
prawdopodobieństwo - праўдападобнасьць, вераемнасьць f, імавернасьць f
prezes - прэзыдэнт m
prezydent - прэзыдэнт m
produkt krajowy brutto - сукупны ўнутраны прадукт m
profesor - прафэсар m
promet - прамэт m
protaktyn - пратактын m
przemysł - прамысловасьць f
psor - прафэсар m
psychiatra - псыхіятр m
psychiatria - псыхіятрыя f
psychika - псыхіка f
psycholog - псыхоляг m
psychologia - псыхалёгія f
psychologiczny - псыхалягічны
psychopata - псыхапат m
psychopatyczny - псыхапатычны
psychoza - псыхоз m
pulmonolog - пульманоляг m, пульманоляг f
pulmonologia - пульманалёгія f
pustelnik - пустэльнік m
rad - рад m
radioaktywny - радыяактыўны
referendum - рэфэрэндум m
ren - рэн m
rewolucja październikowa - Кастрычніцкая рэвалюцыя f
rod - род m
roentgen - рэнтген m
rok świetlny - сьветлавы год m
roślina - расьліна f
roślinność - расьліннасьць f
rosyjski - расейскі
równanie - раўнаньне n
równość - роўнасьць f
rubid - рубід m
ruten - рутэн m
rutherford - рэзэрфорд m
rzeczywisty - рэчавісты
samar - самар m
seaborg - сыборг m
sejsmologia - сэйсмолёгія f
seks - сэкс m
seksualność - сэксуальнасць f
seksualny - сэксуальны
seksuologia - сэксалёгія f
sekunda - сэкунда f
selen - сэлен m
semantyczny - сэмантычны
semantyka - сэмантыка f
separatyzm - сэпаратызм m
Serb - сэрб m
Serbia - Сэрбія f
Serbka - сэрбка f
serbski - сэрбскі
siarka - серка f
skand - сканд m
słoik - слоік
Słowacja - Славаччына f
socjolog - сацыёляг m
socjologia - сацыялёгія f
sód - натар m
solidarność - салідарнасьць f
śpiew - сьпеў m
srebro - срэбра n
stront - стронц m
suwerenność - сувэрэнітэт m
światopogląd - сьветапогляд m
światowy - сусьветны
symbol - сымбаль m
symboliczny - сымбалічны
syntetyczny - сынтэтычны
synteza - сынтэз m
system - сыстэма f
sztuczny - штучны, сынтэтычны
Szwajcaria - Швайцарыя f
Szwajcarka - швайцарка f
szwajcarski - швайцарскі
Szwecja - Швэцыя
Szwecyjo - Швэцыя
tal - таль m
technet - тэхнэц m
tellur - тэлюр m
temperatura - тэмпэратура f
teologia - тэалёгія f
teologiczny - тэалягічны
terminologia - тэрміналёгія f
terminologiczny - тэрміналягічны
tor - тор m
torpeda - тарпэда f
tory - тор m
tragikomedia - трагікамэдыя f
tuberkuloza - тубэркулёз m
tul - туль m
Tunezja - Туніс
Turcja - Турцыя, Турэччына
twórczość - творчасьць
układ - сыстэма f
Układ Słoneczny - Сонечная сыстэма f
Unia Europejska - Эўрапейскі Зьвяз
uniwerek - унівэрсытэт
uniwersytet - унівэрсытэт
ununhexium - унунгекс m
ununoctium - унунокт m
ununpentium - унунпэнт m
ununseptium - унунсэпт m
wacha - вада (wada)
Walia - Валія f, Ўэльс
wanad - ванад m
wapń - вапень m, кальц m
wdzięczność - ўдзячнасьць f
wegetarianizm - вэгетарыянства n
Węgier - вэнгерац m, вугорец m
Węgry - Вэнгрыя f, Вугоршчына f
Wenecja - Вэнэцыя f
Wenezuela - Вэнэсуэла f
Wenezuelczyk - вэнэсуэлец m
Wenezuelka - вэнэсуэлька f
wenezuelski - вэнэсуэльскі
Westa - Вэста f
Wielka Brytania - Вялікая Брытанія f, Вялікабрытанія f
Wikipedia - Вікіпэдыя
woda - вада (wada)
Wschód - Блізкі Ўсход m
Wyspa Świętego Wyspy Świętego Tomasza i Wyspa Książęca - Сан-Тамэ і Прынсыпі
wyznanie - канфэсія f
Zatoka Perska - Пэрсыдзкая затока f
Zjednoczone Królestwo Wielka Wielkiej Brytanii i Irlandia Irlandii Północnej - Злучанае Каралеўства Вялікабрытаніі і Паўночнай Ірляндыі n
zoolog - заалягічны парк m
zoologiczny - заалягічны
związek chemiczny - хімічнае злучэньне n
życiorys - жыцьцяпіс m
żydożerstwo - антысэмітызм m
