abak - abaco
abakus - abaco
abat - abbate
abażur - abat-jour
abdykacyjny - abdicatori
abdykować - abdicar
abecadlny - alphabetic
abecadło - alphabeto
abecadłowo - alphabeticamente
abecadłowy - alphabetic
abfal - anomalia
abiecadło - alphabeto
abiogeneza - abiogenese, abiogenesis
abiogenezo - abiogenese, abiogenesis
abiotyczny - abiotic
Abisyńczyk - abyssino
Abisynia - Abyssinia
abisyński - abyssin
ablegat - delegato
ablegierek - infante
abnegacja - abnegation
abolicjonizm - abolitionismo
abonament - subscription, abonamento
abonent - subscriptor
aborcja - abortamento
absolutyzm - absolutismo
absorbent - absorbente
abstynencja - abstinentia
abstynent - abstinente
abzac - calce
aceton - acetona
acetylen - acetylen
adadżio - adagio
Adam - Adam
adapter - gramophono
adaptować - adaptar, appropriar, aptar
addendum - addendum
adiunkt - adjuncto
adiutant - adjutante
administracyjny - administrative
administrator - administrator
admirał - admiral
admirator - admirator
adopcja - adoption
adrenalina - adrenalina
adresować - adressar
Adriatyk - Adriatico
adwentnik - decembre
adwokat - advocato
aeracja - aeration
aerobus - aerobus
aerodrom - aerodromo, aeroporto
aerodynamika - aerodynamica
aerologia - aerologia
aeronauta - aeronauta
aeronautyka - aeronautica
aeroplan - avion
afazja - aphasia
afekt - affecto
afektowany - affectate
Afganistan - Afghanistan
afiks - affixo
afrodyzjak - aphrodisiaco
agat - agata
agitator - agitator
agnostycyzm - agnosticismo
agnostyk - agnostico
agonia - agonia
agora - agora
agorafobia - agoraphobia
agresywny - aggressive
agronomia - agronomia
ajmer - situla
ajzynbaniok - ferroviero
akacja - acacia
akademia - academia
akademie - academia
akademik - academico
akademizm - academismo
akademus - academico
akant - acanto
akcent - accento
akceptacja - acceptation
akcesorium - accessorio
akcja - compartir
aklamacja - acclamation
akordeonista - accordionista
akr - acre
akrobacja - acrobatia
akrobata - acrobata
akronim - acronymo
akselbant - agulietta
akt - acto
aktywować - activar
akumulator - accumulator
akupunktura - acupunctura
akuratnie - exactemente
akuratny - precise
akuzatyw - accusativo
akwamaryna - aquamarina
akwarela - aquarella
akwarium - aquario
akwatinta - aquatinta
akwedukt - aqueducto
alabaster - alabastrite, alabastro
alarm - alerta, allerta
Albańczyk - albaniano, albanese
Albania - Albania
albański - albanese, albaniano
albatros - albatros
album - album m
albumina - albumina
albuminuria - albuminuria
alegoria - allegoria
alegoryczny - allegoric
aleja - allee, vico
alergen - allergene
alergia - allergia
alergiczny - allergic
alfa - alpha
alfabet - alphabeto
alfabetu - alphabeto
alfabetycznie - alphabeticamente
alfabetyczny - alphabetic
alga - alga
algebra - algebra
algebraiczny - algebraic
algida - meretrice
Algier - Alger
Algierczyk - algeriano
Algieria - Algeria
algierski - algerian
algo- - algo-
algometria - algometria
algorytm - algorithmo
alias - alias
alibi - alibi m
aliteracja - alliteration
alizaryna - alizarina
alkalizować - alcalisar
alkaloid - alcaloide
alkoholik - alcoholico
alkoholizm - alcoholismo
alkoholowy - alcoholic
alkowa - alcova
alleluja - alleluia
almanach - calendario
alpejski - alpestre, alpin
alpinista - alpinista
alpinizm - alpinismo
Ałtaj - Altai
altruista - altruista
ałun - alume
aluzja - allusion
Alzacja - Alsatia
alzacki - alsatian
amalgamator - amalgamator
amant - amante
amazoński - amazonie
ambasada - ambassada
ambasador - ambassator
ambicja - ambition
ambirz - gingibre
ambitny - ambitiose, arriviste
ambulans - ambulantia
ameba - ameba
Ameryka - America
Ameryka Łacińska - America Latin
Amerykanin - americano
amerykanizm - americanismo
amerykański - american
Ameryka Północna - America del Nord
Ameryka Południowa - America del Sud
Ameryka Środkowa - America Central
amfibia - amphibio
amfiteatr - amphitheatro
aminokwas - aminoacido
amnestia - amnestia
amnestionować - amnestiar
amnestyja - amnestia
amoniak - ammoniaco
amonit - ammonite
amplitud - amplitude
amplituda - amplitude
ampułka - ampulla
Amsterdam - Amsterdam
amulet - amuleto
anachroniczny - anachronic, anachrone
anachronizm - anachronismo
anagram - anagramma
analfabeta - analphabeto
analfabetyzm - analphabetismo
analityk - analysta
analiza - analyse
analizator - analysator
analizować - analysar
analogiczny - analoge, analogic
anarchia - anarchia
anarchizm - anarchismo
anatomia - anatom
Andaluzja - Andalucia
Andaluzyjczyk - andaluso
andaluzyjski - andaluse
Andora - Andorra
andorski - andorran
anegdociarz - anecdotista
anegdota - anecdota
anekdota - anecdota
aneksja - annexion
anektować - annecter, annexar
anemia - anemia
anestetyk - anesthetico
anestezja - anesthesia
Angielka - anglese
angielski - anglese
angio- - angio-
angiografia - angiographia
angiologia - angiologia
Anglia - Anglaterra
anglicyzm - anglicismo
Anglija - Anglaterra
Anglik - anglese, anglo
anglikanin - anglicano
anglomania - anglomania f
anglosaski - anglosaxone
angol - anglese, anglo
Angol - anglese, anglo
anilina - anilina
animista - animista
animozja - animositate
Anioł Pański - angelus
anioł stróż - angelo tutelar
anoda - anodo
anomalia - anomalia
anonimowość - anonymitate
anonimowy - anonyme, innominate
antagonista - antagonista
antidotum - contraveneno
antonim - antonymo
antracyt - anthracite
antropofagia - anthropophagia
antropologia - anthropologia
antropomorfizm - anthropomorphismo
antybiotyk - antibiotico
antyczny - antique
antyfaszysta - antifascista
antyinflacyjny - antiinflationari
antyk - antiquo, antiquitate
antykatolicki - anticatholic
antyklerykalizm - anticlericalismo
antykomunizm - anticommunismo
antykoncepcyjny - anticonceptional
antykwariusz - antiquario
antykwarz - antiquario
antylopa - antilope
antymon - antimonio
antypapież - antipapa
antyreligijny - antireligiose
antysemicki - antisemitic
antysemityzm - antisemitismo
antyseptyczny - antiseptic
antywirusowy - antiviral
anulować - annullar
aorta - aorta
aparat - apparato
apartament - appartamento
apartheid - apartheid
apasz - delinquente
apeniński - apennin
apetyczny - appetitive
apetyt - appetentia, appetito
apologia - apologia
apostata - apostata
apostazja - apostasia
apostrof - apostropho
apoteoza - apotheosis
appendektomia - appendicectomia
aprobata - accollada, approbation, sanction
aprykoza - albricochiero, armeniaca
apryl - april
apsyda - apside
aptek - apotheca, pharmacia
apteka - apotheca, pharmacia
aptekarz - apothecario
Arab - arabe
Arabia Saudyjska - Arabia Saudi
arabista - arabista
arabski - arabe, arabic
arabus - arabe
arbiter - arbitro
arbitralny - arbitrari
archanioł - archangelo
archeolog - archeologo
archeologia - archeologia
archetyp - archetypo
archipelag - archipelago
architekt - architecto
architektoniczny - architectonic, architectural
architektonika - architectonica
architektoński - architectonic, architectural
architektura - architectonica
architraw - architrave
arcybiskup - archiepiscopo
areał - area
arena - arena
aresztant - arrestato
arfa - harpa
Argentyna - Argentina
Argentyńczyk - argentino
argentyński - argentin, argentinian
argon - argon
argument - argumento
argumentacja - argumentation
aria - aria
Ariadna - Ariadna
Arizona - Arizona
arkada - arcada
Arkansas - Arkansas
arlekinada - arlequinada
armeński - armenie, armenian
armia - armea
armijo - armea
arsen - arsenico
arsenał - arsenal
artefakt - artefacto
arteria - arteria
artykuł - articulo
artyleria - artilleria, cannoneria
artystycznie - artisticamente
artystyczny - artistic
Aryjczyk - aryano
aryjski - aryan
Arystoteles - Aristotele m
arytmetycznie - arithmeticamente
arytmetyk - arithmetico
arytmetyka - arithmetica
arywista - arrivista
as - asse
ascetyczny - ascetic
asceza - ascese
aseksualny - asexual
asfalt - asphalto
asfaltować - asphaltar
aspiracja - aspiration
aspiryna - aspirina
asta - branca
Astrachań - Astrakhan
astrofotografia - astrophotographia
astrolog - astrologo
astrologia - astrologia
astrologio - astrologia
astronautyka - astronautica
astronomia - astronomia
astronomiczny - astronomic
astronomio - astronomia
asymetryczny - asymmetric, asymmetre
asymptota - asymptote
aszynbecher - cineriera
atawizm - atavismo
ateista - atheista, atheo
ateizm - atheismo
atencja - advertentia, advertimento
Ateny - Athenas
ateusz - atheista, atheo
Atlantyk - Oceano Atlantic
atlas - atlas
atmosfera - atmosphera
atol - atollo
atrybucja - attribution
audiometr - audiometro
audytorium - auditorio
aukcja - auction
Austria - Austria
austriacki - austriac
auszpik - aspic
autentycznie - authenticamente
auto - auto
autobiografia - autobiographia
autobus - autobus, omnibus, bus
autodafe - autodafe
autograf - autographo
autoklaw - autoclave
autokracja - autocratia
autonomia - autonomia
autonomiczny - autonomic
autopsja - autopsia
autostop - autostop m
awantura - altercation
awanturnik - picaro, aventurero
awaria - avaria, emergentia
awokado - avocato
Azerbejdżan - Azerbaidzhan
Azja - Asia
Azjata - asiatico
azjatycki - asiatic
azot - nitrogeno, nitro
B - accusativo
Babilon - Babylon
babiloński - babylonian
bachanalia - bacchanalia
bachantka - bacchante
bachraty - crasse
Bachus - Baccho
bać się - angustiar
badminton - badminton
Bagdad - Baghdad
bagnet - baionetta, bayonetta
bagno - palude
bagrować - dragar
bajerować - mentir
bajstruk - bastardo
bajtel - infante
bakcyl - bacillo
bakelit - bakelite
bakteria - bacterio
bakteriobójczy - antiseptic, bacteriocide, germicidal
bakteriolog - bacteriologo
bakteriologia - bacteriologia
bakteryjny - bacterial
bałabajka - balalaika
bałaguła - cochiero
bałałajka - balalaika
balansowanie - balanciamento
balista - ballista
bałkański - balkanic
Bałkany - Balkanes
ballada - ballada
balsam - balsamo, unguento
balsamiczny - unguentari
Bałt - balto
Bałtyk - Mar Baltic, Baltico
balustrada - balustrada
balustrado - balustrada
bałwan - beotio
banan - banana
banana - banana
bandaż - bandage
bandażować - bandar
bania - cucurbita, capite
baniak - capite
baniok - ferroviero
baniorz - ferroviero
banjo - banjo
bank - banca
bankowy - bancari
barabola - patata
barani - arietari
bark - humero
barkarola - barcarola
barki - humero
barman - barman
barokowy - baroc
barykada - barricada
barzoł - palude
barzy - argute
baserunk - correction
Bask - basco
baskijski - basco
baśń - fabula
basta - assatis
bastard - bastardo
bastylia - bastille
basza - pasha, forrage, pastura
batłąch - bottilia
batożyć - flagellar
Bawaria - Bavaria
bawełna - coton
bawić - amusar (se)
bazooka - bazooka
Bazylea - Basel
beatyfikacja - beatification
bebech - stomacho
bęben - tamburo
beczeć - lacrimar, plorar, luger
bednarz - barrilero, cupero
Beduin - beduin
befsztyk - beefsteak
bejc - dipsomano
bękart - bastardo
beletrystyka - belles-lettres
Belg - Belga
Belgia - Belgica
belgijski - belge
benedyktyn - benedictino
Benin - Benin
benzol - benzol
benzyna - gasolina, benzina
berbela - vodka
Berlin - Berlin
Berno - Bern
beryl - beryllium, beryllo
beton - beton
bezbarwny - achromate, achromatic
bezbożny - athee
bezdyskusyjnie - indisputabilemente, indiscutibilemente
bezgraniczny - dismensurate, dismesurate, immense, illimitabile, illimitate
bezkształtny - amorphe, informe
bezlistny - disfoliate
beznadzieja - desperantia
beżowy - beige
bezpieczeństwo - securitate
bezpośredni - directe
bezsporny - indiscutibile, indisputabile, indubitabile, incontestabile, incontrovertibile
bezstronność - impartialitate
bezwarunkowo - inconditionalmente
bezzwłocznie - immediatemente, promptemente
białaczka - leucemia
białko - albumine
Białoruś - Bielorussia, Belorussia
białoruski - belorusse, belorusso
biały - albe
Biblia - Biblia
bibliotekarz - bibliothecario
biblista - biblista
bić - bastonar, colpar, disgranar, frappar, massar, percuter, palpitar
biceps - bicipite
bida - miseria, paupertate, povressa
bieda - miseria, paupertate, povressa
biedny - impecuniose
biegacz - currero, cursor
biegunka - diarrhea, lienteria
Bielsko-Biała - Bielsko-Biala
biernik - accusativo
bigel - distraction, intertenimento
bigiel - distraction, intertenimento
bigot - bigot
bigoteria - bigoteria
bikini - bikini
bikorn - bisonte
bilateralny - bilateral
bileter - billetero
bindka - bandage
biograf - biographo
biograficzny - biographic
biotechnologia - biotechnologia
Birma - Burma
biseksualny - bisexual
biskup - episcopo
biskupi - episcopal
biurko - bureau, scriptorio
biust - busto
Bizancjum - Byzantio
bizantyjski - byzantin
bizantyński - byzantin
bizon - bisonte
bladź - meretrice
blaga - auripelle
błagać - deprecar, obsecrar, rogar, supplicar, implorar
błaganie - obsecration, prece, conjuration
blagier - bluffator, prevaricator
błahy - futil
błecha - pulice
blef - bluff
błękit - azurato
bliskość - proximitate
blizna - cicatrice
błogość - beatitude
blondyn - blonde
blondynka - blonda, blondessa
błotnik - guardafango
bluza - blusa
bluźnierstwo - blasphemia
bóbr - castor
bocian - ciconia
Bóg - Deo
bogactwo - ricchessa
bogacz - ricco
bogaty - ric, affluente
Bohemia - Tchechia
bojkot - boycott, boycottage
bojtlik - cartiera, portafolio
ból - algesia
boleściwy - dolorose
bolesny - dolorose, afflictive
Boliwia - Bolivia
Boliwijczyk - boliviano
bolszewik - bolchevico
bombardon - bombardon
bombardować - bombar, cannonar
bombel - infante
bor - boro
Bośnia - Bosnia
bośniacki - bosnie
Bośnia i Hercegowina - Bosnia-Herzegovina, Bosnia e Herzegovina
Bośniak - bosniaco
botanik - botanista
botanika - botanica, botanologia
boży - divin, dive
brać - sumer, prender
brachol - fratre
bracieniec - fratre
brakować - mancar, carer
brat - fratre
bratanek - nepote
braterski - fraternal
braterstwo - fraternitate, confraternitate
bratni - fraternal
bratobójstwo - fratricidio
brauza - ducha
brawura - bravada
brąz - bronzo
brązowy - brun
Brazylia - Brasil
brazyliana - caffe
brele - berillos
briftasza - cartiera, portafolio
briftreger - postero, currero
broda - barba, mento
brokuł - broccoli
brom - bromo
broń - arma, armamento
bronować - hirpicar
broszka - broche
broszura - brochure
browar - bira
brudny - immunde
bruk - pavimento
brukarz - pavitor
brusić - acuminar, acutiar, affilar
bryka - auto, automobile, carro
brylant - brillante
bryle - berillos
Brytyjczyk - Britanno, anglo
bryza - brisa
brzeg - ripa
brzoskwinia - albricoc
brzoza - betula
brzuchomówca - ventriloquo
brzuchomówstwo - ventriloquia
brzydki - fede
brzydota - feditate
buda - canil, schola
buddyjski - buddhic
buddyzm - buddhismo
budka telefoniczna - cabina telephonic
budować - struer
budowa ciała - corporatura
budowlany - constructive
budowniczy - constructor
budzić - eveliar
Bug - Bug
Bukareszt - Bucarest
bukiet - bouquet
bukszpan - buxo
buła - musculo
bulba - patata
Bułgar - bulgaro
Bułgaria - Bulgaria
bułgarski - bulgare, bulgaro
bułka - musculo
bulwa - patata
bumelować - otiar
burdel - bordello
Burkina Faso - Burkina Faso
burnus - burnus
burzowiny - bira
burżuj - burgese
burzyć - fermentar
busola - bussola
but - scarpa
butelka - bottilia
być - esser, ser
byk - tauro
bystry - argute
bździągwa - cimice
C - dativo
całkiem - assatis
całkowicie - totalmente
car - czar/tsar
carski - czarian, czarista
cebula - cibolla
cecha - contramarca
cegła - bricca
Cejlon - Ceylon
cela - cella
celestyn - celestina, celestite
celny - doanal
celofan - cellophan
celownik - dativo
celtycki - celtic
cenotaf - cenotaphio
centaur - centauro
centrum - centro
centymetr - centimetro
cera - filia
certacja - combatto
cesarstwo - imperio
cesarzowa - imperatrice
cętka - lentigine
cewka moczowa - urethra
chachor - dipsomano, mendico
Cham - Cham
chamera - nube
chamicki - chamitic
chamski - aspere
chamstwo - crassitude
chaos - chaos
charakterystyka - characteristica
charczeć - roncar
charkać - sputar
charlać - tussir
chatować - insidiar, chattar
chciwość - avidia, aviditate, rapacitate, cupiditate
chciwy - insatiabile, avide, rapace
chemia - chimia
chemiczny - chimic
chemik - chimico, chimista
chemioterapia - chimotherapia
chemoterapia - chimotherapia
cherub - cherubin
cherubin - cherubin
chętny - alacre
chilijski - chilen
Chiny - China
chira - vodka
chirurg - chirurgo
chirurgia - chirurgia
chirurgiczny - chirurgic
chirus - dipsomano
chlać - potar
chleb - pan
chłodny - frigide
chłodzić - refrigidar
chlor - chloro, dipsomano
chlorek - chloruro, chlorido
chmiel - lupulo, bira
chmura - nube
choinka - arbore de Natal
chójk - arbore de Natal
cholera - cholera
choreograf - choreographo
choroba morska - cinetosis, nausea
Chorwacja - Croatia
Chorwat - croato
chować - abstruder
chowanka - celario
chrapać - roncar
chrom - chromo
chromosom - chromosoma
chronić - albergar
chronologia - chronologia
chronometria - chronometria
chrystianizacja - christianisation
Chrystus - Christo
chryzantema - chrysanthemo
chrząstka - cartilagine, chondro
chrześcijanin - christiano
chrześcijański - christian
chrzest - baptismo
chudoba - miseria, paupertate, povressa
churchać - tussir
chuśle - violino
chwalebny - commendabile, laudabile
chwiejny - indecise, instabile, irresolute, vacillatori
chyc - canicula
ciążowy - gestatori
cichy - quiete
cielesny - carnal, corporal, corporee
ciemnia - camera obscur
ciemnia fotograficzna - camera obscur
ciemno - tenebrositate
ciemność - tenebrositate
ciemny - obscur, tenebrose, analphabete, analphabetic, ignorante, illitterate
cień - umbra
ciepły - affectionate
ciernisty - aculeate, spinose
cierpieć - patir, indurar
cierpkość - acerbitate, acritate
cieść - patre affin
cieśnina - stricto
cieszyć - allegrar, jubilar, joiar
ciężki - ardue, difficile, intricate
ciotka - amita
ciupa - prision
ciurma - prision
ciżma - scarpa
ćma - tenebrositate, meretrice
ćmaga - vodka
cmentarz - cemeterio
ćmić - adurer
ćmik - cigarretta
ćmy - obscur, tenebrose, analphabete, analphabetic, ignorante, illitterate
cnotliwy - virtuose, caste
cofać - disdicer
córa - filia
córczysko - filia
córka - filia
coś - alco, alique
ćpać - manducar
cudowny - admirabile
cudzić - appurar, expurgar, purificar, depurar, furbir, mundificar, mundar, nettar
cudzołożnica - adultera
cudzołożyć - adulterar
cugle - brida, redina
cukier - sucro
cukrzyca - diabete
cupać - tussir
ćwiczenia - exercitio
ćwiczenie - exercitio
cydr - cidra
cygan - vagabundo, deceptor, dupator, fraudator
Cygan - bohemo
cygański - tsigan
cygareta - cigarretta
cygaretka - cigarretta
cyklista - cyclista
cylindryczny - cylindric
cyngiel - berillos
cynizm - cynismo
cynk - zinc
cynowy - stannic
Cypr - Cypro
cypresz - cypresso
cyprys - cypresso
cyrk - circo
cyrkon - zircon
Cyryl - Cyrillo
cytadela - citadella
cytra - cithera
cytryna - limon
cytrynat - limon
cyzelować - cisellar
czaj - theiero, the
czajnik - capite
czarna ryba - dahlia w
Czarnogóra - Montenegro
czarny - nigre
czarodziej - mago, incantator
czasami - aliquando, alquando
czasem - aliquando, alquando
czasopismo - periodico, revista
czasownik - verbo
czasowy - temporal
czaszka - cranio
czatować - insidiar, chattar
czcionka - typo
Czech - Checo
Czechosłowacja - Checoslovachia
Czecho-Słowacja - Checoslovachia
Czechy - Tchechia
Czeczenia - Chechenia
czędo - infante
czekolada - chocolate
czerwiec - junio
czerwony - rubie, communista
cześć - salute
czeski - chec, Checo, tchec
człowiek - homine
czołg - tank
czorny - nigre, immunde
czosnek - allio
czteroletni - quadriennal
czteronogi - quadrupede, tetrapode
czteronożny - quadrupede, tetrapode
czterosilnikowy - quadromotor
czuły - affectionate
czwartek - jovedi
czworonogi - quadrupede, tetrapode
czworonożny - quadrupede, tetrapode
czy - esque
czynność - activitate
czyrwiec - junio
czyrwień - junio
czyścić - appurar, expurgar, purificar, depurar, furbir, mundificar, mundar, nettar
czyście - bellemente
czyściec - purgatorio
czysto - purmente
czystość - puritate, castitate
czysty - munde, nitide, nette, caste
czyszczenie - nettage, mundification, appuramento, depuration
czytać - leger
czytelnia - cabinetto de lectura
dać wolną rękę - dar carta blanc
daktyl - dactylo, dattilo
dalia - dahlia w
dama - dama
Dania - Danmark
dar - souvenir
daremny - otiose, frustranee
darwinista - darwinista
dawca - dator
dążenie - aspiration
dążność - aspiration
defetyzm - defaitismo
definicja - definition
definitywnie - definitivemente
deflacja - deflation
deforestacja - deforestation
defraudacja - defraudation
dega - sabla, sabra
deista - deista
deizm - deismo
dekada - decade
Dekalog - decalogo
dekapitacja - decapitation
dekiel - capite
deklaracja - declaration
deklinacja - accidentia
dekolonizacja - decolonization
dekoracja - decoration
dekoracyjny - decorative
dekorować - decorar
delegat - delegato
delfin - delphino
deliberować - deliberar
delicja - delicia
delikatność - delicatessa, mansuetude
delta - delta
demiurg - demiurgo
demografia - demographia
demokracja - democratia
demokrata - democrate
demokratyczny - democratic
demokratyzować - democratisar
demolować - demolir
demoniczny - demoniac
demonolatria - demonolatria
demonologia - demonologia
dendrologia - dendrologia
denerwować - perturbar
dentysta - dentista
depilacja - depilation
depilator - depilatorio
depilować - depilar
depopulacja - depopulation
deportacja - deportation
deportować - deportar
deprecha - abattimento
deprecjonować - depreciar
depresja - abattimento
dermatologia - dermatologia
derwisz - dervich
despota - despota
despotyzm - despotismo
destrukcja - destruction
deszcz - pluvia
deszczowy - pluviose, pluvial
detonator - detonator m
deuter - deuterium
deuteron - deuteron
dewastator - devastator
deżdż - pluvia
dezelować - annihilar
dezerter - desertor
diabelski - diabolic
diagnoza - diagnose
diagnozować - diagnosticar
dialektyczny - dialectic
dialektyk - dialectico
dietetyczny - dietetic
dietetyka - dietetica
digamma - digamma
diorama - diorama
dla - por
dławić - strangular, suffocar
dłuto - cisello
dłużnik - debitor
dno - fundo
dobitnie - emphaticamente, expressemente
dobosz - timbalero
dobrobyt - benesser
doceniać - appreciar
docent - docente
dochód - rendimento, lucro, ganio, renta
dodatek - accessorio
dodawać - adder, additionar
dogmat - dogma
dogmatyzm - dogmatismo
dogodny - commode, convenibile, expediente, opportun
dojrzały - adulte, matur
dokładny - precise
doktor - medico, doctor
dół - fossa
dolar - dollar
dołek - abattimento
dolny - infere
dołować - abstruder
dom - casa
dom dziecka - casa de infantes
Dominik - Dominico
dorosły - adulte, adulto
Dorota - Dorothea
doś - quot
dość - assatis
doskonałość - perfection, excellentia
dostany - adulte, matur
dostarczać - approvisionar, aprovisionar, delivrar, fornir, livrar, munir, provider, subministrar, suppler
dostatecznie - sufficientemente
dostęp - accesso
dostrzegalny - discernibile, apprehensibile
dosyć - assatis
dotyczyć - concerner
dotyk - tacto
dotykać - affliger
dotykalny - tangibile
do widzenia - adeo
dowód - prova
do zobaczenia - adeo
dramatyczny - dramatic
drastycznie - drasticamente
dratewka - scarpero
drętki - acetose
drewno - ligno
drobnoustrój - animalculo
druid - druida
druk - typo
drwal - abattitor, serrator
drwić - irrider
drzemać - dormettar
drzewce - fuste
drzewo - arbore
duch - apparition
duchowo - spiritualmente
duchowość - spiritualitate
dudek - upupa
dudlać - lacrimar, plorar, luger, potar
dukat - ducato
duma - orgolio
dumnie - orgoliosemente
dumny - orgoliose
Dunaj - Danubio
duński - dan
dupa - culo
durniacha - credule
durszlak - colatorio, colo
dusza - apparition
duży - ample, grosse
dwojaki - duple
dwubarwny - bicolor
dwuczęściowy - bipartite
dwudzielny - bifide, dichotomic
dwujęzyczny - bilingue
dwujęzykowy - bilingue
dwukierunkowy - bidirectional
dwulicowość - duplicitate
dwulicowy - duplice, pharisaic
dwupłat - biplano
dwupłatowiec - biplano
dwuramienny - bicipital
dwusieczna - bisectrice
dwusilnikowy - bimotor
dwutomowy - ditome
dwuwymiarowy - bidimensional
dwuznaczny - ambigue
dycht - assatis, totalmente
dygnitarz - dignitario
dykcja - diction
dyktat - dictato, dictamine
dyktator - dictator
dylać - dansar
dyletancki - dilettante
dyletant - dilettante
dymać - captar, deluder, dupar, deciper
dynastia - dynastia
dynia - cucurbita
dyplomata - diplomate, diplomatico, diplomato
dysertacja - dissertation
dyskryminować - discriminar
dysputacja - contention, contestation, controversia
dystrykt - districto
dżez - jazz
dziad - mendico
dziadkowie - granparentes
działać - ager
działalność - activitate
działanie - activitate
dziąsło - gingiva, alveolo
dziąsłowy - gingival
dzieciobójstwo - infanticidio
dzieciszczko - infante
dziecko - infante
dziedzic - hereditario
dziedziczyć - hereditar
dziękówa - regratiar
dziękować - regratiar
dziękówka - regratiar
dziękuję - regratiar
dziela - por
dzielić - departir
dzień - jorno
dziennikarstwo - jornalismo
dziennikarz - jornalista
dziesięciolecie - decennio
dziób - becco, rostro
dżistać - peder
dziwaczność - bizarria, peculiaritate
dziwny - peculiar
dżuma - peste
dżungla - jungla
dźwiękowy - sonor
dzwonić - tintinnar
efektywnie - effectivemente
Egipt - Egypto
egiptolog - egyptologo
egiptologia - egyptologia
ego - ego
egocentryczny - egocentric
egoista - egoista
egoistyczny - egoistic
egzaltacja - exaltation
egzamin - examine
egzorcysta - exorcista m
egzystencja - existentia
egzystencjalizm - existentialismo
egzystować - exister, subsister
ekologia - ecologia
ekologiczny - ecologic
ekologio - ecologia
ekosystem - ecosystema
ekshibicjonizm - exhibitionismo
ekskomunika - anathema
ekskomunikować - excommunicar
ekspansja - aggrandimento
ekspansywny - expansive
ekspedycja - expedition
ekspert - experto
eksperymentator - experimentator
eksploatować - exploitar
eksplozja - explosion
ekspozycja - exposition
ekspresowy - expresse
ekstrapolacja - extrapolation
ekstrawagancki - extravagante
ekstremalny - extremal
ekstremizm - extremismo
Ekwador - Ecuador
ekwipunek - equipamento
elefant - elephante
elegancki - elegante
elegiacki - elegiac
elegijny - elegiac
elektrolit - electrolyto
elektroluks - aspirator
elektronika - electronica
elektryczność - electricitate
elektryczny - electric
elementarny - elementar
embargo - embargo
emigracja - emigration
emirat - emirato
emocja - affecto
empiryczny - empiric
emu - emu
encyklopedia - encyclopedia
encyklopedyczny - encyclopedic
endokrynologia - endocrinologia
enigmatyczny - enigmatic
ententa - entente
entomolog - entomologo
entuzjazm - entusiasmo
enzym - enzyma
epidemia - epidemia
epidemio - epidemia
epidemiologia - epidemiologia
epitafium - epitaphio
epoka kamienia gładzonego - neolitho
epoka kamienia łupanego - paleolitho
eponim - eponymo
epsilon - epsilon, epsylon
eremita - eremita
Eros - Eros
erudycja - erudition
erudyta - erudito
erupcja - eruption
Erytrea - Eritrea
eschatologia - eschatologia
eseista - essayista
esej - essayo
eskapada - escappada
eskulap - medico, doctor
esperancki - esperantistic
esperanto - esperanto
Estonia - Estonia
eta - eta
eteryczny - etheree
Etiopia - Ethiopia
etruski - etrusc
etyczny - ethic
etyka - ethica
etymologia - etymologia
eugeniczny - eugenic
Euklides - Euclide
Eurazja - Eurasia
Europa - Europa
europejski - europee
eutanazja - euthanasia
ewangelia - evangelio
ewangelista - evangelista
ewangelizować - evangelisar
ewidentnie - apparentemente
ewidentny - evidente
eż - que
Ezop - Esopo
ezoteryczny - esoteric
facet - homine, viro
facetka - femina
fagot - basson, fagotto
fajek - cigarretta
fajerwer - cigarretta
fajka - cigarretta
faks - fax
falisty - undose, undulose
falsyfikacja - falsification
fałszywy - contrafacte, apocryphe, false, pharisaic, erronee, mendose, posticie, suppositicie
fama - fama
fan - devoto
fanatycznie - fanaticamente
fanatyk - fanatico
fanatyzm - fanatismo m
fandzolić - mentir
fantazja - phantasia
faraon - pharaon
farmaceutyczny - pharmaceutic
faryna - sucro
faszysta - fascista
faszyzm - fascismo
fatalnie - fatalmente
fedra - resorto
fefrać się - angustiar
felieton - folieton
Fenicja - Phenicia
ferment - enzyma
ferska - albricoc
fezeła - ape, apicula
Fidżi - Fiji
figa - fico
Filadelfia - Philadelphia
filetować - filettar
filip - lepore
Filip - Philippo
Filipiny - Philippinas
film - film
filmować - filmar
filolog - philologo
filozof - philosopho
finalizować - compler, completar, finir, complir, clausurar
finansowy - financiari
finezja - finessa
Finlandia - Finlandia
fioł - violetta
fiołek - violetta
fioletowy - violette
firma - firma
fiza - physica
fizjolog - physiologo
fizjologia - physiologia
fizyka - physica
flaki - tripa
flanela - flanella
flaszka - bottilia
flet - flauta
fliger - avion
flirt - flirt, amoretto
flora - flora
fluktuacja - fluctuation
fluor - fluor
folga - reposo
folklor - folklore
fonetyka - phonetica
forhang - cortina
fortel - stratagema
fortuna - fortuna f
fosfor - phosphoro
fotel - sede a bracios, sedia confortabile
fotograficzny - photographic
fotografować - photographar
Franciszek - Francisco m
Franciszka - Francisca
franciszkański - franciscan
Francja - Francia
francuski - francese
francuz - clave anglese
frank - franco
frankofilski - francophile
frasunek - enoio, affliction
frazeologia - phraseologia
fryc - germano
Fryc - germano
fulać - mentir
fundament - fundamento, fundation
fundamentalista - fundamentalista
fundamentalny - fundamental
fura - carrettata, auto, automobile, carro
furdygarnia - prision
furia - furia
furt - altere vice
fusbal - football
futbol - football
fyrać - escappar, discampar, fugir, evader
gąbczasty - spongiose
gaduła - confabulator
gaj - arboreto, boschetto
gała - football, corvo
gałąź - branca
galeon - galeon
galera - galera
Galilea - Galilea
gałka muszkatołowa - nuce muscate
galon - galon
gambit - gambito
gamma - gamma
ganc - assatis, totalmente
Ganges - Gange
gangster - gangster
gapa - corvo
gara - somno
garaż - garage
gardło - gorga, gurgite, gutture, jugulo
garnirować - guarnir
gasa - strata
gastronomiczny - gastronomic
gaża - gage
gazon - gazon
Gdańsk - Gdansk, Danzig
gdzie - ubi
gdzieś - alicubi
gelender - balustrada
gen - gen
genetyczny - genetic
genialność - genialitate
Genua - Genua
geograf - geographo
geografia - geographia
geograficzny - geographic
geologia - geologia
geologiczny - geologic
geometra - agrimensor, geometra
geometria - geometria
geopolityczny - geopolitic
georginia - dahlia w
gęś - ansere
gestykulować - gesticular
gibko - precipitatemente
giętko - flexibilemente
gilotyna - guillotine
ginekolog - gynecologo
gips - gypso
gitara - gitarra
gitarzysta - gitarrista
głąb - fundo, profunditate
glancować - appurar, expurgar, purificar, depurar, furbir, mundificar, mundar, nettar
głębia - fundo, profunditate
głęboko - profundemente
głębokość - profundor, profunditate
glicerol - glycerina
gliceryna - glycerina
glicerynowy - glyceric
glina - argilla
globus - capite
głodny - affamate, famelic
glon - alga
głośnik - altoparlator
głosowanie - ballotta, votation, suffragio
głowa - capite
głównie - supertoto
gnat - osso, dato
gniazdo - nido
gnilny - putrefactive, putride
gnot - infante
godka - allocution
godło - emblema
godny - digne
gołąb - columba
golarka - rasorio
gołębnik - columbiera
goły - nude
gondola - gondola
gondoliera - barcarola
goniec - alfil
goniometria - goniometria
gora - incendio
gorąc - ardorosemente
gorąco - ardorosemente
gorący - calorose, ardorose
górka - collinetta
górnik - minator, minero
gorset - corset
gorszy - pejor
gorzałka - vodka
gorzoła - vodka
górzysty - montaniose
gość - convitato
gościnność - hospitalitate
gotować - cocer, cocinar, bullir
gotowanie - coction
graba - mano
grabież - depredation, despoliamento, rapina, spoliation
gramofon - gramophono
granat - granata
graniczny - frontieral, frontier
granit - granito
gratulować - congratular, gratular, felicitar
Grecja - Grecia
grecki - grec
grejpfrut - pompelmus
greka - grec
Grenlandia - Groenlandia
grobowiec - cenotaphio, sepulchro, sepulcro, cellario
gromadzić - accumular, amassar, colliger, agglomerar, assemblar
gronostaj - armenio
groźba - menacia
grubiański - aspere
gruby - crasse
grudzień - decembre
grula - dilatori, tardive, ponderose
grupa - aggrupamento
gryczpan - buxo
grymaśny - argutiose
grypa - influenza w
grzbiet - dorso
grzechotnik - crotalo
gustowny - gustose
gwer - carabina
gwiazda - stella
gwiazdarz - astrologo
gwiazdozbiór - constellation
gwiaździarz - astrologo
Gwinea Równikowa - Guinea Equatorial
gzub - infante
habitat - habitat
haftować - brodar
Haiti - Haiti
haja - altercation
hak - uncino, croc
haki - uncino, croc
hałaburda - altercation
hałaśliwy - ruitose, strepitose
halka - subgonnella
hamować - refrenar
hańbić - dishonorar
hara - vodka
harfa - harpa
harfista - harpista
harmonijka - concertina
harmonijka ustna - concertina
harmonijny - accordante, harmoniose, concorde
harmonizacja - harmonisation
harmonogram - horario
Hawaje - Hawai
hawajski - hawaian
hegemon - hegemono
hegemonia - hegemonia
heklować - crochetar
hektar - hectar
hektolitr - hectolitro
hel - helium
Hellada - Hellade, Grecia
hellenistyczny - hellenistic
hełm - casco
Helsinki - Helsinki
hemisfera - hemisphera, hemispherio
herb - blason
herbata - theiero, the
herbatnik - biscuit
heretycki - heretic
heroicznie - heroicamente
heroiczny - heroic
herold - heraldo
herpetologia - herpetologia
heteroseksualny - heterosexual
hetki - totalmente
hiacynt - hyacintho
hica - canicula
hierarchiczny - hierarchic
hinduski - indian
hipotetyczny - hypothetic, suppositive
histeria - hysteria
historyczny - historic
Hiszpania - Espania
holajza - cisello
Holandia - Hollanda, Pais Basse, Nederland, Nederlanda
Holandyja - Hollanda, Pais Basse, Nederland, Nederlanda
hołota - populaceo
homeopatyczny - homeopathic
homerycki - homeric
homiletyka - homiletica f
Hongkong - Hong Kong
hormon - hormone
horror - horror
horyzont - horizonte
hospitalizacja - hospitalisation
hrabia - conte
hrabina - contessa
humorystyczny - humoristic, humorose
huragan - huracan, hurracan
huśtawka - balanciatoria
hyca - canicula
hydrograficzny - hydrographic
hydroplan - hydroplano
hymn - hymno
i - e, (rzadziej et)
idea - idea
idealista - idealista
identyczny - identic
ideologia - ideologia
ideologiczny - ideologic
idiota - idiota
idiotyczność - idiotismo
idylliczny - idyllic
igła - acicula, agulia
ile - quot
ilość - amonta
ilustrować - illustrar
iluzoryczny - illusori, prestigiose
imaginacja - imagination
imbir - gingibre
imigracja - immigration
imperator - imperator
implikacja - implication
imponować - imponer
imputowanie - allegation
inaczej - alteremente
i na żagiel, i na parę - bisexual
Indonezja - Indonesia
indonezyjski - indonesian
infinitezymalny - infinitesime
inflacja - inflation
influenca - influenza
ingerencja - ingerentia
inhalacja - inhalation
inkszy - alie, altere
inkunabuł - incunabulo
inny - alie, altere
inspiracja - inspiration
instytucjonalny - institutional
instytut - instituto
insurekcja - insurrection
insurekcyjny - insurgente, insurrectional, insurgite
integracja - integration
integralność - integritate
inteligencja - intelligentia
intencja - intention
intencjonalny - intentional
interlingua - interlingua
interlokutor - interlocutor
interpretacja - interpretation
interwencja - intervention
intuicyjny - intuitive
intymny - intime
inundacyja - alluvion
inwalida - invalido
inwazja - invasion
inwentaryzować - inventariar
inwestycja - investimento
iny - alie, altere
inżynier - ingeniero
inżynieria - ingenieria
Irak - Iraq
Iran - Iran
Irlandia - Irlanda
ironia - ironia
ironizować - ironisar
irracjonalny - irrational
iryd - iridium
iskra - scintilla f
islam - islam
islamizować - islamisar
islamski - islamic, islamitic
Islandia - Islanda
islandzki - islandic
istny - aquelle
italski - italian
iż - que
ize - que
izotop - isotopo
Izrael - Israel
ja - io
jabłeczny - pomacee
jabłko - malo
jabłkowy - pomacee
jadać - manducar
jadalny - comestibile
jadeit - jada
jadowity - venenose, virulente
jagnię - agno
jaguar - jaguar
Jahwe - Jahveh
jajko - ovo
jajo - ovo
jakmiarz - assatis
jałmużna - almosna
Japonia - Japon
jara - matre affin
jarecka - matre
jarski - vegetarian
jarzmo - jugo
jaskier - ranunculo
jaszczurka - lacerta
jawny - apparente
jazz - jazz
jednobarwny - monochromatic, monochrome, unicolor
jednokierunkowy - unidirectional
jednomyślność - unanimitate
jednorożec - unicorne
jednoznaczny - inambigue, inequivoc
jedynie - solmente
Jerozolima - Jerusalem
Jerycho - Jerico
Jerzy - Georgio
jeść - manducar
jesień - autumno
jesienny - autumnal
jesion - fraxino
jest - esser, ser
Jezus - Jesus
Jezus Chrystus - Jesus Christo
językowy - lingual, liguistic, linguistic
jidysz - yiddish
jogurt - yogurt
Jowisz - Jove, Jupiter
Józef - Joseph
judaizm - judaismo
judeochrześcijański - judeochristian
juny - juvene
jupa - blusa
Jupiter - Jove, Jupiter
Jur - Georgio
jutrzenka - alba
kabalistyczny - cabalistic
kaban - porco
kabareciarz - cabaretero
kabaret - cabaret
kabat - collega
kaczan - fundo, profunditate
kaczka - anate
kadm - cadmium
kądziel - rocca
kafej - cafe, caffe
kaffa - caffe
Kair - Cairo
kaj - ubi
kajak - kayak, canoa
kajakarz - canoero
kajet - fasciculo, quaderno
kaktus - cacto
kalafa - alcoholico
kalapitra - capite
kalejdoskop - kaleidoscopio
kalendarz - calendario
kalifat - califato
kalifornijski - californian
kalkulator - calculator
kaloryfer - radiator
kalumnia - calumnia
kalwinizm - calvinismo
kam - ubi
kamasz - scarpa
Kambodża - Cambodia
Kamerun - Camerun
Kanada - Canada
Kanadyjczyk - canadiano
kanał - canal
kangur - kanguru
kanibalizm - cannibalismo
kanikuła - canicula
kaniła - cappucio
kankan - cancan
kanonizacja - canonisation
kapeć - pneumatico
kąpiółka - camera de banio
kapitalista - capitalista
kapitalistyczny - capitalistic
kaplica - capella
kapłon - capon
kapować - apprehender, comprehender
kaptur - cappucio
karaba - catto
karabin - carabina
karabin maszynowy - mitraliatrice
karalny - punibile
karawana - caravana
karczoch - artichoc
kardynał - cardinal
karetka - ambulantia
kariatyda - caryatide
karibu - ren
kariera - carriera
karlica - nana
karman - cartiera, portafolio
karmel - caramello
karmenadel - cotelette
karmin - carmino
karnacja - carnation
karnawał - carneval
karo - diamante
kartagiński - carthaginese
kartofel - patata
kartografia - cartographia
kartograficzny - cartographic
Karwat - croato
karygodny - reprehensibile, vituperabile
karykatura - caricatura
karykaturzysta - caricaturista
karzeł - nano
kasa - cassa
kasiarz - ricco
kasjer - cassero
kaskada - cascada
kast - coffro
kasta - coffro
kastrat - castrato
kastrować - castrar, emascular
kastylijski - castilian
kaszleć - tussir
katakumby - catacomba
katalityczny - catalytic
katalog - catalogo
Katalonia - Catalonia
kataloński - catalano
katarakta - cataracta
Katarzyna - Catharina f
katechumen - catechumeno
katedra - cathedral
kation - cation
katolicki - catholic
kąt prosty - angulo recte
kaukaski - caucasian
Kaukaz - Caucaso
kawa - caffe
kawaler - baccalaureo
kawiarnia - cafe, caffe
kazeina - caseina
kaznodzieja - predicator
kędy - ubi
kędzierzawy - crispe
kejter - can
Kenia - Kenya
kenotaf - cenotaphio
kenotafium - cenotaphio
kenozoiczny - cenozoic
kęsim - decapitation
keta - catena
khmerski - khmer
kiedy indziej - altere vices
kiedykolwiek - quandocunque
kiedyś - aliquando, alquando
kiełek - germine
kiepeła - capite
kierowca - autoista, automobilista, chauffeur, conductor, guidator
kierunek - senso
kieszonkowiec - pickpocket
kilka - alcun, aliquot, alicun
kilkujęzyczny - multilingual, multilingue, multilinguistic, plurilingual, polyglotte
kilkujęzykowy - multilingual, multilingue, multilinguistic, plurilingual, polyglotte
kilt - kilt
kimać - dormir, addormite
kimono - somno
kino - cine
kinol - alcoholico
kintop - cine, distraction, intertenimento, divertimento, amusamento
kira - vodka
kirasjer - cuirassero
kirchóf - cemeterio
kirys - cuirasse
kista - coffro
kiszka - lacte
klaka - claque
kłamać - mentir
kłamny - contrafacte, apocryphe, false, pharisaic, erronee, mendose, posticie, suppositicie
klarnet - clarinetto
klarowanie - clarification
klarownica - clarificator
klawesyn - clavicymbalo
klawiatura - tastatura
klawisz - tasta
kleić - glutinar
klej - adhesivo
klękać - genicular
klekotun - ciconia
klerykalizm - clericalismo
klęska - deroute, disfacta, disastro
kleszcze - forcipe
kleszcze porodowe - forcipe
kliber - alcoholico
klikać - cliccar
klima - climatisation
klimatyczny - climatic
klimatyzacja - climatisation
klon - acere, clono
kłopotliwy - embarrassante, disconcertante, moleste
kluber - alcoholico
klucz francuski - clave anglese
klupać - perquirer, bastonar, colpar, disgranar, frappar, massar, percuter, palpitar
kluza - prision
kminek - cumino, carvi
kniądz - prince
knot - micca
koabitacja - cohabitation
koala - koala
koalicja - coalition
kobalt - cobalt
kobieta - femina
kobieta lekkich obyczajów - meretrice
kochać - amar
kochany - amate
kociamber - catto
kocia muzyka - charivari
kociołek - caldieretta
kofeina - caffeina
kohabitacja - cohabitation
kohorta - cohorte
kokietować - coquettar
kokota - meretrice
koksownik - brasiero
kolarz - bicyclista, cyclista
kołdra - coperilecto
kolega - collega
kolejarz - ferroviero
kolejowy - ferroviari
kolektywnie - collectivemente
kolektywny - collaborative, collective
koleś - homine, viro
kolidować - collider
koło - bicyclo, bicycletta
kolokacja - collocation
kolokwializm - colloquialismo
kolonializm - colonialismo
kolonizator - colonisator
kolorowanie - coloration
kołowy - giratori, rotatori
Kolumb - Columbo
kolumbarium - columbario
Kolumbia - Colombia
kolumna - colonna, pilastro, columna
kołyska - cuna
koma - comma
komar - mosquito
komat - comma
komedia - comedia
komediopisarz - comediano
komentator - commentator, explicator
komentować - commentar
komercjalizacja - commercialisation
kometa - cometa
komfort - commoditate
komicznie - comicamente
kominek - camino
komisja - commission
komora - camera, ventriculo
komp - computator
kompania - compania
komparatywny - comparative
kompensacyjny - compensatori, compensative
kompensować - compensar
kompetycja - competion
kompleks - complexo
komplementarność - complementaritate
kompozycja - composition
kompromis - compromisso
kompulsywny - compulsive
komputer - computator
komputerowy - computational, computatori, computatorial
komuch - communista
komunikacja - communication
komunikat - communicato
komunista - communista
komunizm - communismo
koń - cavallo m
kóń - cavallo m
koncentrować - concentrar, focalisar
koncentryczny - coaxial, concentric
koncepcja - conception, concepto
koncert - concerto
koncesyjny - concessionari, concessive
kończyć - finir, compler, complir, completar, clausurar
kondensator - condensator
kondolencje - condolentia
konfesjonał - confessionario
konfetti - confetti
konfiskować - confiscar
konfitura - confectura
konfliktowy - conflictive
konformista - conformista
konformistka - conformista
konfucjanizm - confucianismo
Konfucjusz - Confucio
kongestia - congestion
Kongo - Congo
koniak - cognac, aquardente
koniec - fin
koniugacja - conjugation
konklawe - conclave
konkordat - concordato
konkubinat - concubinato, concubinage
konkwistador - conquisitor
konny - equestre
Konstantynopol - Constantinopole
konstelacja - constellation
konsternacja - consternation
konstytucyjny - constitutional
konsumpcja - consumo, consumption
kontakt - continger
kontekst - contexto
kontemplacja - contemplation
kontent - contente, complacente, satisfacite
kontestacja - contestation
kontinuum - continuo
kontrabanda - contrabando
kontrola - appuramento
kontrowersyjny - controverse, controversial
kontrrewolucja - contrarevolution
kontrwywiad - contraspionage
kontur - contorno
konurbacja - conurbation
konwencjonalny - conventional
konwojować - conviar, convoyar
kooperacja - cooperation
koparka - excavator
koper - anetho
koperta - inveloppe
kopruch - mosquito
koral - corallo, corallina
korbol - cucurbita
kordialny - cordial
kordła - coperilecto
Kordoba - Cordova
Kordowa - Cordova
Korea - Corea
Koreańczyk - coreano
koreański - corean, coreano
kornet - cornetta
korona - corolla, corona, monarchia
koronka - dentella
korpulentny - corpulente, abdominose
Korsyka - Corsica
koryncki - corinthie
korzystać - profitar
kos - merla, falce
kosa - falce
kosaciec - iride, iris
kość - osso, dato
kościsty - ossose, ossee, ossute
kosmetyczny - cosmetic
kosmogoniczny - cosmogonic
kosmopolita - cosmopolita
koszt - sumpto
kot - catto
kotka - catta
kotlarz - caldierero, latonero
kotlet - cotelette
kotwica - ancora
kotwicowisko - ancorage
kowariancja - covariantia
kozi - caprin
krajopis - geographo
krasula - vacca
krater - crater
krawiec - sartor
krążownik - cruciator
kreacja - creation
kreatywny - creative
Kreta - Creta
krętacz - prevaricator
kreton - cretonne
krew - sanguine
krewetka - crangon
kripel - invalido
krokiet - croquet
król - rege
królik - conilio
królowa - regina
kropla - globulo, gutta, stilla
krople - globulo, gutta, stilla
krosta - pustula
krotofila - divertimento, amusamento, intertenimento
krowa - vacca
krucyfiks - crucifixo
kruk - corvo
krużganek - claustro
krykiet - cricket, croquet
Krym - Crimea
kryminał - prision
kryminalista - criminalista
kryptografia - cryptographia
kryptograficzny - cryptographic
krytyk - critico
krytyka - animadversion
kryzys - crise
krzem - silice
krzesło - sedia, chaise
krzest - baptismo
krzyczeć - critar
krzyk - clamor, crito
krzywoprzysięstwo - perjurio
krzyżówka - cruciamento
ksenofobia - xenophobia
książę - prince
księgarnia - libreria
ksylofag - xylophage
ksylofon - xylophono
kształt - forma
kto - qui
ktoś - alcuna, alicuna f, alicuno
któż - qui
Kuba - Cuba
kubański - cuban
kubek w kubek - identic
kubizm - cubismo
kuć - cochiero
kucać - tussir
kuchnia - cocina
kukurydza - mais
kulis - coolie
kulminacja - apogeo, culmine, culmination
kulminacyjny - culminante
kuloodporny - paraballa
kultura - cultura
kumulacja - accumulamento, cumulation
kumulować - cumular
kupować - comprar, emer
kuraż - braveria, corage
kuriozum - curiositate
kurs - curso
kurtyzana - meretrice
kusić - espaventar
kustosz - custode
kusza - arcoballista
kuter - cutter
kwadrans - quarto
kwarantanna - quarantena
kwartet - quartetto
kwas - acido
kwasić - acetificar
kwaśny - acetose
kwestionować - questionar
kwiatowy - floral
kwiecień - april
kwitnąć - florar, florer, florescer, inflorescer
labija - distraction, intertenimento
labirynt - labyrintho
Labrador - Labrador
łacina - latin
lacz - capite
łączność - communication
łączyć - conjunger, adjunger, agglutinar, amalgamar
lądowy - terrestrial
łagodnieć - mollir
łagodzić - alleviar, amortir, appaciar, attemperar, dulcificar, emollir, mitigar, moderar, mollificar, placar, quietar
łąka - prato
laktacja - lactation
łamliwy - fragile
lampart - leopardo
łańcuch - catena
land - campania, village
łapka - insidia
lapoński - lapponese
larmo - altercation, alerta, allerta
las - foreste, bosco
lat - anno
lata - anno
latarnia morska - pharo
lato - estate
łatwość - facilitate
łatwowierność - credulitate
łatwowierny - credule
latyfundium - latifundio
lawa - lava
lawina - avalanche
Łazarz - Lazaro
łazienka - camera de banio
łazior - vagabundo
leberwuszt - pastata, pastisso
łechtaczka - clitoride
leczniczy - curative
legalizacja - legalisation
legenda - legenda
legionista - legionario
lejce - brida, redina
lekarz - medico, doctor
lekarz choroby chorób kobiecych - gynecologo
lekceważyć - despicer, disobligar
lekka atletyka - athletica
lekkoatletyka - athletica
leksykon - lexico
leming - lemming
Lenin - Lenin
Leningrad - Leningrad
leopard - leopardo
lepak - altere vice
łepetyna - capite
lepszy - melior
lesisty - silvose, silvatic, silvan
lewarek - levator
leworęczny - sinistromane
lewszun - sinistromane
lewy - sinistre
leżeć - cubar
łgać - mentir
Liban - Libano
libertariański - libertari
libido - libido
libretto - libretto
licencja - licentia
lichwiarski - usurari
liczba pierwsza - numero prime
liczenie - calculation, conto
ligatura - ligatura
likwidacja - liquidation
likwidować - liquidar
linczować - lynchar
lingwista - linguista
lingwistyczny - liguistic
lingwistyka - linguistica
linoskoczek - funambulo
lipa - tilia
lipiec - julio
lira - lyra
liryczny - lyric
lis - vulpe
lista - lista
listonosz - postero, currero
listopad - novembre
litera - littera
litr - litro
litra - litro
liturgiczny - liturgic
Litwa - Lituania
lizus - adulator
lodowisko - patinatorio
łodyga - pedunculo
logarytm - logarithmo
logarytmiczny - logarithmic
lojalność - loyalitate
lokator - locatario
łokciowy - cubital
łokieć - cubito
Londyn - London
łono - utero, sino
lornetka - binoculo
łosoś - salmon
losowy - aleatori
lotniczy - aeronautic
lotnisko - aerodromo, aeroporto
lotniskowiec - portaaeroplanos
lotos - loto
lotus - loto
Łotwa - Latvia
łów - chassa
lśniący - fulgente, fulgide, lustrose, resplendente
lub - o
lubić - affectionar
łucznik - archero
ludobójstwo - genocidio
łudzić - illusionar, prestigiar
łudzikwiat - april
ludzkość - humanitate
lufa - cannon
łuk - arco
Luksemburg - Luxemburg
luksus - luxo
lulka - cigarretta
luńt - can
łupież - furfure
łuska - scalia, flocco
lut - soldatura
luteranin - lutherano
lutować - bastonar, colpar, disgranar, frappar, massar, percuter, palpitar
luty - februario
luźno - laxemente
łyżwiarz - patinator
mać - matre
Macedonia - Macedonia
machinacja - machination
macica - utero, nacre, nacrate
macierzyński - maternal
mączkować - moler
mafia - mafia
mafijny - mafiose
mafioso - mafioso
mag - mago, magico
magicznie - magicamente
magnes - magnete
magnetofon - magnetophono
Mahomet - Mahomet, Mohammed
maj - maio
majestatyczny - majestatic, majestose, excelse, auguste, sublime
majstersztyk - obra de maestro
mak - papavere
mąka - farina
makabryczny - macabre
makak - macaque
malajski - malay
malaria - malaria
malarz - pictor
maleć - discrescer
malin - frambese
malina - frambese
małpi - simian, simiesc
Malta - Malta
małżeński - conjugal, connubial, matrimonial, sponsal
mam - haber, mama
mama - mama, matre affin
Mandżuria - Manchuria
manewr - manovra
mango - mango
maniera - maniera
manipulować - manipular
manko - manco
mańkut - sinistromane
mansarda - mansarda
manufaktura - manufactura
manuskrypt - manuscripto
mapa - mappa, carta
marchew - carota
marchewka - carota
margaryna - margarina
markiza - marchesa, marquise
marksizm - marxismo
marmur - marmore
marność - vanitate
Maroko - Marocco, Morocco
marszałek - marechal
martyrologia - martyrologio
marynarka wojenna - armea de mar
marzec - martio
marzenie - desiderio, reverie
marzenie senne - somno
marzyć - soniar
masakra - massacro
masa perłowa - nacre, nacrate
maść - unguento
mason - mason
masoneria - masoneria, francmasoneria
masywny - massive
maszyna - machina
maszyna do pisania - machina a scriber
matczyny - materne, maternal
matematyk - mathematico
matka - matre
matriarchalny - matriarchal
mazidło - linimento
mdłość - debilitate
mdłości - nausea
mecenas - advocato
mechaniczny - mechanic
mechanizm - mechanismo
męczennik - martyre
meczet - moschea
mediana - mediana
mediewalny - medieval
mędrzec - sagio
medycyna - medicina
medyk - medico, doctor
megaloman - megalomano
megalomański - megalomane
męka - tormento, cruciation, calvario
Meksyk - Mexico
melać - moler, sputar
melancholia - melancholia, atrabile
melić - moler
melodyjny - melodic, melodiose, canor
memorandum - memorandum
menel - dipsomano
merdać - aberrar
Merkury - Mercurio m
mesjanizm - messianismo
Mesjasz - Messia
metafizyczny - metaphysic
metafora - allegoria, metaphora
metaforyczny - metaphoric, figurative
metempsychoza - metempsychosis
meteorologia - meteorologia
meteorologiczny - meteorologic
metoda - methodo
Metody - Methodio
metropolia - metropole
mewa - laro
mężczyzna - homine, viro
Mezopotamia - Mesopotamia
mezozoiczny - mesozoic
mezzosopranistka - mezzosopranista
mgła - bruma
miałki - superficial, cursori
miasto stołeczne - capital
miąższ - pulpa
mieć - haber
mieć gdzieś - despicer, disobligar
mieć gzik w kolanach - angustiar
miecz - gladio
między Scyllą a Charybdą - inter Scylla e Charybdis
miejski - municipal
mielcuch - bira
mieli - haber
mielić - moler
mierzalny - mesurabile
mięsień - musculo
mięsopust - carneval
mięsopustnik - februario
mięsożerca - creophago
mięsożerny - creophage, carnivore
mieszczaństwo - burgesia
mieszkalny - habitabile
mieszkanie - appartamento
mięta - mentha
migrena - migraine
migrenowy - migrainose
mikrobus - minibus
mikroorganizm - animalculo
milicja - militia
milimetr - millimetro
militarny - bellicista
militaryzacja - militarisation
militaryzm - militarismo
miło - agradabilemente
miłość - amor
miłosierny - gratiose, misericorde, misericordiose
miłosny - amorose
miły - amabile, agradabile, affabile, complacente
mimoza - mimosa
minaret - minaret
miód - melle
miotła - scopa
miscellanea - miscellanea
miseczka - bassinetto, scutella
misjonarz - missionario
miteser - button, carbunculo
mitra - mitra
mleć - moler
mleko - lacte
młody - juvene
młodziec - baby
młyn - molino
mnich - cenobita, monacho
mnogość - multitude
mobilizacja - mobilisation
moc - fortitudo, fortitude, robore
moczowy - urinose
modlić się - orar
modlitwa - oration, precaria, prece
modrakowy - blau
modry - blau
Mojżesz - Moses
mokry - humide
Mołdawia - Moldova, Moldavia
monarchia - monarchia
monogamiczny - monogame, monogamic
monografia - monographia
monopol - monopolio
monoteistyczny - monotheistic
monotonia - monotonia
montaż - montage
montować - assemblar, attruppar, montar
mora - apparition
moralista - moralista
moralność - moralitate
moralny - moral
mord - assassinato, assassination, homicidio, occision
morda - musello
morderca - assassinator, assassino
morderstwo - assassinato, assassination, homicidio, occision
morela - albricochiero, armeniaca
morkwa - carota
morski - maritime
morze - mar
Morze Bałtyckie - Mar Baltic, Baltico
Morze Karaibskie - Mar Caribe
Morze Kaspijskie - Mar Caspie
Morze Południowochińskie - Mar de China Meridional
Morze Śródziemne - Mediterraneo
moskit - culice, mosquito
moskitiera - mosquitiera
Moskwa - Moscova
motocykl - motocyclo
motor - motocyclo
motyl - papilion
mowa - allocution
mózg - cerebro
możliwy - agibile
mrowisko - formicario
mrówkowy - formic
mrówkożerny - formicivore
mrównik - orycteropo
mroźny - frigorifere
mruczenie - murmure
mrugać - palpebrar
mućka - vacca
muł - mulo, fango, bicipite
mumia - mumia
musieć - deber
muskularny - muscular, musculate
musztarda - mustarda
muzułmanin - musulman
mużyk - homine, viro
mykita - vulpe
mylić - aberrar
myśl - pensata
N - ablativo
nacja - nation
nacjonalizować - nationalisar
na cołki łeb - totalmente
naczynie - alveo, vasculo
nadarzyciel - dator
naddźwiękowy - hypersonic, supersonic
nadmiar - excesso, redundantia, surplus, profusion
nadnaturalny - supernatural
nadprzyrodzony - supernatural
nadziany - ric, affluente
nadzieja - sperantia
nadzorca - vigilator, supervidente, superintendente, controlator
nagi - nude
nagle - abruptemente, urgentemente
nagość - nuditate
nagota - nuditate
naiwny - naive, credule
najeżdżać - invader
naleganie - insistentia
należeć - appertiner
nałożenie - superposition
namacalny - tangibile
namawianie - insistentia, exhortation
namiętny - passional
namiot - tenta
naonczas - alora
napalm - napalm
napastnik - assalitor, assaltator
napój - bibitura
napotny - sudatori, sudorific, sudoripare
naprawdę - vermente
narba - cicatrice
narciarz - skiator
nareszcie - finalmente
naród - nation
narzędnik - ablativo
narzucanie - imposition
nasiono - semine, grana
następowanie - sequentia
na sto procent - totalmente
natenczas - alora
naturalność - naturalitate
natychmiastowy - instantanee, prompte
nauczać - docer, erudir, inseniar, instruer, professar, regentar, apprender
nauka - scientia, apprension, apprendimento, apprentissage
naukowiec - scientista
naukowy - scientific
na uwięzi - captif
nawigacyjny - navigational
nawilżać - humectar
nazista - nazista
nazywać - appellar, nominar
Neapol - Neapole
negacja - negation
nękać - plagar
nekrolog - necrologo
nekrologowy - necrologic
neofaszysta - neofascista
neofaszyzm - neofascismo
neolit - neolitho
neolityczny - neolithic
neologizm - neologismo
neon - neon
Nepal - Nepal
nepotyzm - nepotismo
nerwowy - nervose, nerval, irritabile
neurotyczny - neurotic
neutralność - neutralitate
neutralny - neutral, neutre
neutron - neutron
nić Ariadny - filo de Ariadna
Niderlandy - Paises Basse, Hollanda, Pais Basse, Nederland, Nederlanda
nieakceptowalny - inacceptabile
nieaktywny - inactive
niebieski - blau
niechęć - animositate, antipathia
niechętny - nolente
niedojrzały - immatur, impubere, pueril
niedokrwistość - anemia
niedoskonałość - imperfection
niedostępny - inaccessibile
niedostrzegalny - imperceptibile, insensibile
niedziela - dominica
niedźwiedzi - ursin
niefortunny - infortunate
niegdyś - aliquando, alquando
niegodziwy - damnabile, ignobile, indigne
niegrzeczny - discortese
niehigieniczny - inhygienic
niehonorowy - improbe, dishonorabile, ignominiose
niejadalny - inedibile
niejasność - equivoco
niekompetentny - incompetente
niekonsekwentny - inconsequente, inconsequential
niektóry - alicuno, alicun
niełatwy - ardue, difficile, intricate
niemądry - insipiente
niemal - quasi
Niemcy - Germania
Niemiec - germano
nie mieć - haber
niemiły - displacente, ingratiose
niemoralny - immoral
niemowlę - baby
niemożliwy - impossibile
nienaturalny - innatural, non-natural
nienawidzić - odiar
nieobecny - absentista
nieodpowiedni - improprie, inadequate
nieodpowiedzialny - irresponsabile, negligente
nieodwracalny - irreversibile
nieograniczony - illimitabile, illimitate
nieomylny - infallibile
nieostrożny - incaute
nieożywiony - inanimate
niepamięć - oblivion
niepewny - dubitabile
niepodległy - independente
niepodważalny - irrefutabile
niepokoić - disconcertar, molestar, turbar, perturbar
niepokój - agitation, angustia, anxietate
niepomyślny - adverse
nieposłuszny - disobediente, indocile, refractori / refractari, contumace
nieprecyzyjny - imprecise
nieprzemakalny - impermeabile
nieprzewidywalny - imprevisibile
nieprzyjazny - inamical
nierealny - imaginari, irreal
niereformowalny - irreformabile
nierówność - inequalitate, disequalitate
nierozpoznawalny - irrecognoscibile
niesforny - indocile, ingovernabile, intractabile
nieskończony - interminabile
nieskromny - immodeste, impudic, inhoneste
nieskuteczny - inefficace, inefficiente
niesłyszalny - inaudibile
niesmaczny - disgustose
nieśmiertelny - immortal
niespodziewany - impreviste, insperate
niestabilny - instabile
niestały - inconstante, labile, varie
nieświadomie - inconsciemente
nieszczęście - afflixtion, disastro, affliction, infortuna
nietolerancja - intolerantia
nieuczciwy - dishoneste
nieuprzejmy - discortese, inurban
nieuzasadniony - injustificabile
niewdzięczny - ingrate, ingratiose
niewiarygodny - incredibile
niewiasta - femina
niewłaściwy - incorrecte, improprie, inappropriate
niewolniczy - sclave, serve
niewykonalny - inexecutabile, infacibile
niewypowiedziany - indicibile, ineffabile
niewyraźny - indistincte
niewystarczający - insufficiente, inadequate
niezadowolony - discontente, dissatisfacite, dissatisfacte, malcontente, miscontente
niezależny - independente, inattaccabile, substantive
niezapominajka - auricula
niezaprzeczalny - indisputabile, incontestabile, incontrovertibile
niezatapialny - insubmersibile
niezgodny - discrepante, inconsequente, inconsistente, discordante, discorde, incompatibile, incongrue, incongruente
niezgrabny - disgratiose, inhabile
niezmienny - immutabile, inalterabile, invariabile
nieznany - incognoscite
niezniszczalny - indestructibile
nieżonaty - celibe
nieźrzały - immatur, impubere, pueril
niezwyciężony - imbattibile, invicte, invincibile
nieżyczliwy - inamical, incaritabile
nigdy - nunca
Nigeria - Nigeria
nihilizm - nihilismo
niob - columbium
niszczyć - annihilar
niszczyciel - destructor, devastator, chassa-torpedineros
niuans - nuance
no - si
nominowanie - nomination
nonkonformista - nonconformista
nonszalancja - nonchalance
nordycki - nordic
Norweg - norvegiano
Norwegia - Norvegia, Norvega
nos - alcoholico
nostalgia - nostalgia
nostalgiczny - nostalgic
noszenie - porto
Nowa Zelandia - Nove Zelanda
nowoczesny - moderne
nowy - nove
Nowy Jork - New York
Nubia - Nubia
numer - numero
numerować - numerar
numerowanie - numeration
nuncjatura - nunciatura
nuncjusz - nuncio
nyga - mosquito
oaza - oase
obcas - calce
obchodzić - ambir
obejmować - circumferer, accollar
obejmowanie - adition
obelisk - obelisco
obiecadło - alphabeto
obiecny - consuete, consuetudinari
obiegowy - currente
obierać - pellar, bastonar, colpar, disgranar, frappar, massar, percuter, palpitar
obietnica - promissa
obnażać - denudar
obój - oboe
obojczyk - clavicula
obojętność - indifferentia
obolewiec - sinistromane
obowiązek - deber
obraz - pictura, film
obraza - insulto, offensa, ultrage
obrażanie - affrontamento
obrona - defensa
obrońca - advocato
obrotowy - giratori, rotatori
obrzydliwie - abominabilemente
obrzydliwy - horride, nauseabunde, detestabile
obserwator - observator
obserwowalny - observabile
obwiniać - culpar, accusar, criminar, inculpar
obżarstwo - gluttonia
ocean - oceano
Ocean Atlantycki - Oceano Atlantic
Oceania - Oceania
oceanograf - oceanographo
Ocean Spokojny - Oceano Pacific
ocet - aceto
ochota - desiderio, inclination
ochrona - salveguarda
ochronka - asylo
ociec - patre
ociężały - dilatori, tardive, ponderose
octan - acetato
oczyszczać - appurar
oczyszczanie - appuramento, purification, depuration
oczywisty - apparente
od - de, ab
od czubka głowy do pięt - de capite a pedes
odczucie - impression
oddział - formation, truppa
oddziaływać - affectar
ode - de, ab
odkupiciel - redemptor
odkurzacz - aspirator
odmiana - flexion, genere
odmienny - altere, conjugabile
odmowa - refusa, recusation
odpoczynek - reposo
odpowiedni - applicabile
odpowiedniość - conformitate, correspondentia
odpowiedź - replica
odpowiedzialność - responsabilitate
odrażający - abhorribile, disgustose, horride, repulsive
odraźny - abhorribile, disgustose, horride, repulsive
odrębny - distincte
od stóp do głów - de capite a pedes
odtrutka - contraveneno
odwaga - braveria, corage
odważny - prode
odwet - retaliation
odwieczny - immemorial
odwracalny - reversibile, invertibile
odzyskiwać - recuperar
odżywczy - alimentose, alibile
oficjalny - officialmente
oftalmologiczny - oculistic, ophthalmologic
oglądać - spectar
ogórek - cucumere, cucumbre
ogród - jardin, horto
ogrodnik - horticulturista
ojciec - patre
ojczyc - filio
ojczym - patre affin
ojczyzna - patria
ok. - ca.
okłamywać - mentir
okno - fenestra
okoliczność - circumstantia
określać - definir
określony - definir
okrucieństwo - cruelitate, diaboleria, atrocitate, ferocitate
okrutnie - atrocemente
okrutny - cruel
okulary - berillos
okulista - oculista, ophthalmologo
okulistyczny - oculistic, ophthalmologic
olej - oleo
ołów - plumbo
omnibus - omnibus
ona - illa
ontologiczny - ontologic
opat - abbate
opcja - option
operacyjny - operational, operative, operatori
operator - operator
opiąć - altere vice
opięć - altere vice
opierać - accular
opium - opium
opłacalny - remunerative, remuneratori
opłakać - luger
opłakiwać - luger
opłata - quota
opona - pneumatico
oponować - opponer, adversar
opozycja - opposition
oprócz - extra
opryszczka - herpes, herpete
optymizm - optimismo
oracz - arator
oranżeria - estufa
oraz - e, (rzadziej et)
orbita - orbita
orchidea - orchidea
organista - organista
organizacja - organisation
organizm - organismo
orgia - saturnales, bacchanalia, orgia
orientalny - oriental
orlab - congedo, commeato
orli - aquilin
orlik - aquilegia
ormiański - armenian
ornitologiczny - ornithologic
ortografia - orthographia
ortopedyczny - orthopedic
orzeczenie - adjudication
orzeł - aquila, reverso
orżnąć - captar, deluder, dupar, deciper
oscylacja - oscillation
ósemka - octena
ośli - asinin
ośmioraki - octuple
osmotyczny - osmotic
osoba - persona
osobistość - personalitate
ostatecznie - definitivemente
ostateczny - conclusive, definitive, final, peremptori, probante, terminal, ultimate
ostentacja - ostentation, fasto
ostentacyjny - fastose, ostentatiose
ostrosłup - pyramide
ostrożny - avisate, circumspecte, caute
ostry - argute, acuminate
ostryga - ostrea
ostrzeżenie - admonestation, admonition, advertimento
ostrzyć - acuminar, acutiar, affilar
oświadczać - allegar
oszczędność - frugalitate, economisation, parsimonia
oszczep - lancea
oszczerstwo - calumnia, diffamation
oszukiwać - captar, deluder, dupar, deciper
oszust - deceptor, dupator, fraudator
otaczać - circumferer, ambir
otwarcie - apertemente
otwarty - aperite, aperte
otwór - apertura, foramine
otyłość - adiposis, adipositate
ów - aquelle
owies - avena
owulacja - ovulation
owy - aquelle
ozdoba - adornamento
ozdobny - ornamental, decorative
ozon - ozono
ozonować - ozonisar
ożyrok - dipsomano
pachnący - redolente, fragrante, odorose, odorifere, odorante
paciuk - ratto m, ratta f
Pacyfik - Oceano Pacific
pacyfikacja - appaciamento, pacification
padać - faller
Padwa - Padua
paginacja - pagination
paginować - paginar
pagoda - pagoda
pająk - aranea
pajęcznik - septembre, octobre, novembre
pakt - pacto
pała - capite
pałacowy - palatin
palacz - autoista, automobilista, chauffeur, conductor, guidator
pale - capite
palenie - adustion
paleolit - paleolitho
paleolityczny - paleolithic
Palermo - Palermo m
Palestyna - Palestina
palić - adurer
palisada - palissada
pallad - palladio
pan - soverano
pana - pneumatico
pancernik - cuirassato
panda - panda
pandemia - pandemia
panienka - senioretta
panna - senioretta
panorama - panorama
panoramiczny - panoramic
pantera - leopardo
papieros - cigarretta
papierośnica - cigarriera
papieski - papal
paproć - filice
papuć - scarpa
papuga - papagai, psittaco
parabola - parabola
paraboliczny - parabolic
paradygmatyczny - paradigmatic
parafialny - parochial, parochian
parafianin - parochiano
Paragwaj - Paraguay
paraplegia - paraplegia
parasol - parapluvia, parasol
parking - autoparco, parcatorio
parkowanie - parcamento, parcage
Parma - Parma
parodia - parodia
parytet - paritate
pasażer - passagero
pasażerka - viagiatrice
paschał - cereo paschal
pasieka - apiario
pasożyt - parasito
pasterz - pastor
pasza - pasha, forrage, pastura
pasztet - pastata, pastisso
pat - pat
patio - patio
pątnik - pelegrino
patria - patria
patronimiczny - patronymic
patroszyć - eventrar
patrzałki - berillos
Paulek - Paulo
paw - pavon
Paweł - Paulo
pawian - babuin
październik - octobre
paździerzeń - octobre
paznokieć - clavo
pazura - mano
pchła - pulice
pechowiec - infortunato
pedagogika - pedagogia
pedant - pedante
pederasta - pederasta
pederastia - pederastia
peja - pediculo
pejoratywny - pejorative
Pekin - Peking
pensjonat - pensionato
pentagon - pentagono
Pepik - Checo
peregrynacja - peregrinage
perfekcyjnie - perfectemente
perforator - perforator
perfumeria - perfumeria
periodyk - periodico
perka - patata
perła - perla
perliczka - pintada
Pers - persa
Persja - Persia
perski - perse, persian
persona - persona
Peru - Peruvia
perwersyjny - perverse, prave
peryskop - periscopio
pętla - ansa
piana - bira
piasek - sablo
piaskownica - arenario
piaskowy - arenari
piąta kolumna - quinte columna
piątek - venerdi
pić - potar
pięciokąt - pentagono
Pięcioksiąg - pentateucho
pieczęć - sigillo
pięknie - bellemente
piękno - beltate
piękność - beltate
pielęgniarka - infirmera
pielgrzym - pelegrino
pielgrzymka - peregrinage
pieluszka - panno
piemoncki - pedemontese
pieprzny - piperate
pierdy - rumor
pierdzieć - peder
pierścionek - anulo
pies - can
pięść - pugno
pieścić - caressar
pieski - canin
pieśń - canto
pies obronny - can de guarda
pigularz - apothecario
pigwa - cydonia
pijak - dipsomano
pijanica - dipsomano
piła - serra
piłka nożna - football
pingwin - pinguin
piołun - absinthio
pionowo - verticalmente
pióro - penna, pluma
piosenka - canto
Piotr - Petro
piramidalny - pyramidal
pirat - pirata
piroga - piragua
piroman - pyromano
piryt - pyrite
pismo - alphabeto
pistacja - pistacia
piterka - cartiera, portafolio
Pittsburgh - Pittsburgh
piwiarnia - bireria
piwnica - cellario
piwo - bira
pizgać - bastonar, colpar, disgranar, frappar, massar, percuter, palpitar
pizza - pizza
plądrować - despoliar
plagiator - plagiator
płakać - lacrimar, plorar, luger
plakat - placard
planetarium - planetario
planista - planator
planowanie - planification
planta - planta
płaskorzeźba - basse-relievo
płaskostopie - platypodia
płatek - petalo
platfus - platypodia
Platon - Platon
płaz - amphibio
plebiscyt - plebiscito
plotka - rumor
pluć - sputar
pług - aratro
pluskwa - cimice
płynnie - fluentemente
płynny - liquide, fluide
pochodzenie - lineage, ancestria, ascendentia
pocieszyciel - consolator
poczwarka - chrysalide
podatek - imposto
podbój - conquesta
podciśnienie - subpression
poddany - regnicola
poddasze - subtecto
poddźwiękowy - subsonic
podłość - bassessa, ignobilitate, ignominia
podniebienie - palato
podnieta - incentivo
podnosić - altiar
podówczas - alora
podrabianie - contrafaction, adulteration
podstawa - basamento
podstawowy - basal
podsumowanie - summario, summation
podświadomie - subconscientemente
poduszka - cossino, diamante
poduszkowiec - hovercraft
podwójny - duple
podwyższać - altiar
podzielony - dividite, divise
poeta - poeta
poetycki - poetic
pogaństwo - paganismo
pointer - pointer
pojawiać się - apparer
pojedynczy - singule, simplice
pokaz - gala
pokrewny - affin, cognate
pokrywa - copertura
pokrzywa - urtica
pokrzywowy - urticacee
pokutnik - penitente
półbóg - semideo
pole - agro
polec - cader
Polinezja - Polynesia
polio - polio
polityka - politica
polka - polka
półka - planca
półkula - hemisphera, hemispherio
półnagi - seminude
północnoamerykański - nord-american
polo - polo
półotwarty - semiaperte
polowanie - chassa
położnica - puerpera
Polska - Polonia
polski - polac
południe - sud
południowoamerykański - sudmerican
południowy - meridional, austral
półwysep - peninsula
Półwysep Bałkański - Peninsula Balkanic
pomagać - adjutar, adjuvar, auxiliar, coadjuvar, juvar
pomarańczowy - orange
pomidor - tomate
pomoc - adjuta, succurso, adjutor
pomocniczy - adjuncte, accessori, subsidiari
pompa - pompa
pomysłowy - imaginative, industriose, ingeniose, inventive
ponaddźwiękowy - hypersonic, supersonic
poniedziałek - lunedi
ponownie - altere vice
ponton - ponton
poparcie - appoio, indorsamento
popielniczka - cineriera
popiersie - busto
popołudnie - tarde
poprawa - correction
poprawiać - corriger, adjustar, affinar
poprawny - correcte
poprzedni - anterior, previe
popularność - popularitate
popularyzacja - popularisation
popularyzować - popularisar
porcelana - porcellana
porcelano - porcellana
porcja - portion
pornografia - pornographia
pornograficzny - pornographic
poronienie - abortamento
porównanie - comparation
porównywać - comparar, commensurar
portfel - cartiera, portafolio
portret - portrait
portretować - effigiar
Portugalia - Portugal
portugalski - portugese
poruszać - actionar
poruta - vergonia, altercation
porwanie - abduction
porządkowy - administrative, ordinal
porzucać - abandonar
pościć - jejunar
posesor - possessor
posiadać - posseder
posiadacz - detentor
pośladek - culo, podice
pośpiech - haste, urgentia
pospolity - indelicate, trivial
pośrednik - mediator
postanowienie - adjudication
postulować - postular
poszerzać - allargar
potajemny - clandestin
potas - potassium, kalium
potaż - potassa
potępiać - disapprobar, blasmar, condemnar, reprobar
potępienie - blasmo, disapprobation, condemnation, damnation
potmanyj - cartiera, portafolio
potwierdzenie - confirmation
potwierdzić - reaffirmar, confirmar, sancir
potylica - occipite
powątpiewać - questionar
powieka - palpebra
powiększanie - aggrandimento
powierzchowny - superficial, cursori
powieściopisarz - romanciero, romancero
powiestka - citation
powietrze - aer, aere
powietrzny - aeree
powiewać - undear
powodować - causar, ingenerar, occasionar
powódź - alluvion
powolnie - tardivemente
powściągliwość - continentia
powstańczy - insurgente, insurrectional, insurgite
powstrzymywać - impedir, inhibir, moderar, refrenar, remorar, restringer
powtarzać - reiterar, repeter
poza - posa, extra
pożądać - appeter
pożądanie - concupiscentia, anxietate
pożar - incendio
pozawczoraj - anteheri, ante-heri
pozaziemski - extraterrestre
pozłacać - aurar, aurificar, dorar
pozór - apparentia, advertentia, advertimento
pozostały - remanente, restante, alie, cetere
pożywny - alimentari, alimentose, nutriente, nutritive
praca - obra
pracodawca - empleator
prądnica - dynamo
pradziad - atavo
pragmatycznie - pragmaticamente
pragnąć - appeter, aspirar, desirar
pragnienie - aspiration
prałat - prelato
prawa ręka - mano
prawdopodobny - plausibile, possibile, probabile, verisimile, verosimilante
prawdziwy - authentic, genuin
prawdziwych przyjaciół poznaje się w biedzie - un ver amico se cognosce in besonio
praworęczny - dexteromane, dextromane
prawość - probitate
precyzja - precision
prędko - precipitatemente
predylekcja - predilection
preferować - preferer
prekolumbijski - precolumbian
prekursor - precursor, predecessor
prenatalny - prenatal
prewencja - prevention
prezent - souvenir
probabilistyczny - probabilistic
problematyczny - problematic
prócz - extra
profilaktyczny - prophylactic, preventive
programista - programmator
programować - programmar
programowanie - programmation
prolegomena - prolegomeno
proletariusz - proletario
prolog - prologo
promocja - promotion
propaganda - propaganda
propagando - propaganda
propanotriol - glycerina
propedeutyka - propedeutica
proporcja - proportion
prosię ziemne - orycteropo
prostoduszny - innocente, inculpabile
prostokątny - rectangular, rectangule
prostoliniowość - rectilineitate
prostytutka - meretrice
protein - albumine
proteina - albumine
protestantyzm - protestantismo
protokół - protocollo, protocolo, acto
proton - proton
proweniencja - provenientia
pryncypał - principe
pryszcz - button, carbunculo
prysznic - ducha
przać - amar
przebytek - appartamento
przecinek - comma
przeciwastmatyczny - antiasthmatic
przeciwbólowy - analgic
przeciwciało - anticorpore
przeciwlotniczy - antiaeree
przeciwny - adverse
przeciwwaga - contrapeso, contrabalancia
przedchrześcijański - prechristian
przede wszystkim - supertoto
przedni - anterior
przedsiębiorca - interprenditor
przedsięwzięcie - interprisa
przedtem - antea
przedwczoraj - anteheri, ante-heri
przejrzysty - limpide
przeklinać - blasphemar, maledicer, damnar, execrar
przekraczać - contravenir, superpassar, exceder, ultrapassar
przekształcać - modificar, transmutar, transformar
przelewać - transvasar
przemówienie - speech
przemożność - fortitudo, fortitude, robore
przemysł - industria
przemyt - contrabando
przemytnik - contrabandero
przenośnia - allegoria, metaphora
przeorysza - abbatessa
przepaść - precipitio, casse
przepowiednia - augurio, prophetia, prediction
przerażający - espaventabile, horrificante
przerywać - abscinder
przesadny - exaggerative, exaggerate
przesądny - superstitiose
przesadzać - exaggerar
przeskakiwać - voltear, salir
prześladowanie - persecution
przesłanka - premissa
przestarzały - antiquate, obsolete
przestawienie - transposition
przestępca - delinquente
przestępczy - delictuose, criminose
przestrzegać - obsequer
przeświadczenie - convincimento
przesyłka - depeche, inviage
przeszukiwanie - perquisition
przeważność - braveria, corage
przewinienie - delicto, demerito
przewód - filo, conducto, tubo
przewoźnik - barchero
przeznaczenie - destino
przoć - amar
przy - apud
przybliżenie - approximation
przychylny - acquiescente, propitie
przyczyniać się - contribuer
przydatność - applicabilitate
przydomek - supernomine
przygotowywać - apparar, apprestar
przyjacielski - amicabile, amic
przyjaciółka - amica
przyjaźń - amicitate
przyjaźnić się - amicar se
przyjemność - agradamento
przyjmować - adoptar
przykład - instantia
przymiotnik - adjectivo
przymus - coaction, coercition, compulsion, obligation
przynosić - apportar
przypadek - hasardo
przypadkowy - fortuite, aleatori, casual
przypisywać - tribuer, ascriber, attribuer
przyprawa - condimento
przyrodniczy - natural
przysłówek - adverbio
przysłowie - proverbio
przysłowiowy - proverbial
przytcza - instantia, hasardo
przywoływać - adducer
przyzapuście - carneval
przyznawać - conceder, accordar
przyzwoitka - chaperon
pseudonim - pseudonymo
psi - canin
psisko - can
psychiatra - alienista, psychiatro
psychiatria - alienismo, psychiatria
pszczelarz - apiario, apicultor
pszczoła - ape, apicula
ptak - ave
ptaszę - ave
Ptolemeusz - Ptolemeo
puchar - cuppa
pudel - pudel
pugilares - cartiera, portafolio
pułapka - insidia
pulares - cartiera, portafolio
pularysek - cartiera, portafolio
pulyr - dipsomano
punktualnie - punctualmente
punktualny - punctual
purysta - purista
puste - cave, casse, vacue
pustelnik - eremo, solitario, eremita
pustka - desolation, vacuo, vacuitate
pusty - cave, casse, vacue
pustynia - deserto
puszka - prision, bira
putnia - situla
Pyjter - Petro
pyra - patata
pyszny - succulente
pytać - questionar
rabin - rabbin
rabować - despoliar, piratar
raciądz - cavaliero
racjonalista - rationalista
racjonalny - rationabile, rational, rationate
rączka - manetta, ansa, corregia, manico
radosny - gaudiose, gai, hilare, exhilarante, allegre
radzić - advertir
rafinować - raffinar
Rajch - Germania
rajza - excursion
rajzer - vagabundo
rak - cambaro, carcinoma
rakuski - austriac
rasizm - racismo
rasowy - de racia
razdziawa - corvo
razem - conjunctemente
reanimacja - reanimation
rebelia - rebellion
rebelie - rebellion
recesja - recession
redakcja - redaction
redaktor - redactor
referendum - referendum
reformator - reformator
regeneracyjny - regenerative
regiment - regimento
region - region
regresywny - regressive
reinkarnacja - reincarnation
ręka - mano
reklama - annuncio, publicitate, reclamo, propaganda
rekomendować - recommendar
rekrutacja - levata, recrutamento
rekwizyt - requisito
religijność - religiositate
relikwia - reliquia
ren - ren
Ren - Rheno
renifer - ren
renowacja - renovation
reporter - reporter m
reprodukcja - reproduction
reprymenda - reprimenda, reproche
Republika Czeska - Republica Chec
Republika Federalna Niemiec - Republica Federal de Germania
restauracja - restaurante, restauration
reumatyczny - rheumatic
reumatyzm - rheumatismo
rewers - reverso
rewolta - revolta
rewolucja - revolution
rewolucjonista - revolutionario
rezeda - reseda
rezolucja - resolution
robaczywy - verminose
robieniec - laborator
robotnik - laborator
rocznica - anniversario
roczny - annue, annual, annal
rodzaj - genere
rodzicielski - parental
rodzimy - indigene, nativo
rój - essame
rok - anno
rok przestępny - anno bissextil
rok świetlny - anno de lumine
rolniczy - agrari, agricole, agricultural
rolnik - agricola, agricultor, cultor
rolny - agricole, agricultural
romantyczny - romantic
romb - rhombo
ropa naftowa - petroleo
ropucha - bufon
róść - crescer
Rosja - Russia
roślina - planta
rosnąć - crescer
rotacja - rotation
rotor - rotor
rower - bicyclo, bicycletta
rowerowy - bicyclic
rowerzysta - cyclista
równie - equalmente
również - alsi, anque
równina - plana, plateau
równolegle - parallelmente
równoległobok - parallelogrammo
równoległy - collateral, parallel
równonoc - equinoctio
rozbieżność - discrepantia, divergentia
rozbój - depredation
rozczarowanie - disillusion, anticlimax
rozdział - capitulo
rozdzielać - disaggregar, disarticular, disassociar, scinder, separar, secerner, repartir, apportionar, disjunger, disponer
rozeta - reseda
rozgałęzienie - arborisation, arborescentia
rozgoryczać - acerbar
rozmowny - garrule, multiloque, multiloquente
rozmyślać - cogitar
rozmyślnie - deliberatemente
różniczkowalny - differentiabile, derivabile
różnojęzyczny - multilingual, multilingue, multilinguistic, plurilingual, polyglotte
różnojęzykowy - multilingual, multilingue, multilinguistic, plurilingual, polyglotte
różnorodność - diversitate, varietate
różowy - rosate, rosee
rozpacz - despero
rozpaczliwy - desperante
rozrywka - divertimento, amusamento, intertenimento
rozsądny - judiciose, prudente, prudential, avisate, rationabile, consiliabile
rozszerzanie - aggrandimento
rozumieć - apprehender, comprehender
rozwaga - sagacitate, circumspection, prudentia
rozżarty - rancorose
rubel - rublo
rubid - rubidium
rubin - carbunculo
ruch - movimento
ruchomy - cinesthetic, cinetic, locomotive, locomotor, movibile, rolante, mobile
rudny - rubie, communista
rufa - culo, podice
rumianek - camomilla
Rumun - romaniano
Rumunia - Romania
rura - cannon
rurociąg - conducto
rusyfikacja - russification
ruten - ruthenium
Rwanda - Rwanda
ryba - pisce
rybny - piscose
rycerski - cavallerose
rycerz - cavaliero
rychtować - apparar, apprestar
rycina - gravure
ryma - influenza w
rymować - rimar
rywalizacja - rivalitate
rywalizować - rivalisar
rzadny - fede
rządzić - governar
rzeciądz - catena
rzecz - cosa
rzeczny - fluvial, fluviatile
rzemieślnik - artisano, artifice
rzemiosło - artisaneria, mestiero
rzęsa - cilio
rzeź - massacro
rzeźnia - macello
rzeżucha - cresson
rzić - culo
rzykać - orar
Rzym - Roma
sabotaż - sabotage
sadło - lardo
sagan - capite
Sahara - Sahara
sakshorn basowy - bombardon
salamandra - salamandra
saldo - saldo
Salomon - Salomon
salon - salon
salto - salto
Salwador - El Salvador
samochód - auto, automobile, carro
samolot - avion
samotny - solitari, singule, recluse
sanskrycki - sanskrite
satelita - satellite
scenarzysta - inscenator
scenografia - scenographia
sceptycyzm - scepticismo
schizmatyk - schismatico
schowek - celario
schronienie - albergamento, asylo
schronisko - asylo
ściana - muro, pariete
ścichapęk - impreviste, insperate
ścięgno - ligamento, tendine
ściemniać - annoctar, mentir
ściskać - accollar
Scylla - Scylla
sękaty - nodose
sekciarski - sectari
seksualność - sexualitate
sekularyzacja - secularisation
sekunda - secunda
seledynowy - aquamarin
selen - selenium
semazjologia - semasiologia
semicki - semitic
Semita - semita
sen - somno
senator - senator
Senegal - Senegal
sęp - vulture
separatysta - separatista
Serbia - Serbia
sernik - caseina
serum - sero
Seszele - Seychelles
sezonowy - stational, saisonal
siać - seminar
siarkowy - sulfuric
siatkówka - retina
się - se
siećmiory - septuple
sieczeń - februario
siedmioraki - septuple
siedzieć na jajach - covar
sielankowy - idyllic, pastoral
sierociniec - casa de infantes
sierpień - augusto
sierść - pilo
siła - fortitudo, fortitude, robore
Singapur - Singapore
sinolog - sinologo
sinologa - sinologo
sinologia - sinologia
sinusoida - sinusoide
siodłak - agricola, agricultor, cultor
sioło - campania, village
siostra - soror
sioty - polka
sirpień - augusto
skałoczep - patella
skamieniałość - fossile
skand - scandium
Skandynawia - Scandinavia
skandynawski - scandinave
skąpy - avaritiose, exigue
skarbiec - thesauro, tresor, tresoreria
skład - boteca, cellario
składnik - ingrediente
sklep - boteca, cellario
skłonny - alacre
skomplikowany - complicate
skończony - finite, finir, compler, complir, completar, clausurar
skorupiak - crustaceo
skowronek - aloda
skra - scintilla f
skrajnie - extrememente
skrobia - amylo, fecula
skromność - modestia
skroń - tempora
skrót - abbreviato
skrótowiec - acronymo
skrucha - penitentia
skrupulatny - scrupulose
skryba - scriba
skrytka pocztowa - cassa postal
skrzynia - coffro
skrzypce - violino
skrzyżowanie - cruciamento
skutecznie - efficacemente
skuteczność - efficacia, efficacitate
skuteczny - efficiente, efficace, effective, operante
słabość - debilitate
słaby - adyname, adynamic
ślad - vestigio
śląski - silesian
sławny - celebre
śleboda - libertate
ślepiec - ceco
śleptać - lacrimar, plorar, luger
ślepy - ceco
ślicznie - bellemente
ślimak - limace
ślina - saliva
słojerz - cortina
słoń - elephante
słonecznik - heliantho
słonina - lardo
słony - salin, salate
słowa - parola <!-- ' vocabulo, ' verbo -->
Słowacja - Slovachia
słowacki - slovac
Słowianin - slavo
słowiański - slave, slavon
słownik - dictionario
słowo - parola <!-- ' vocabulo, ' verbo -->
słuchać - ascoltar
słuchalnia - auditorio
słuchanie - audita, ascoltamento
sługa - servo
słynny - celebre
słyszalny - audibile
smaczny - gustabile, delicate
smętny - dolorose
smok - dracon
smolny - piciose
smutniak - pan
smutny - desolate, elegiac, luctuose, lugubre
śniadanie - jentaculo
śniedny - comestibile
śnieg - nive
śnieżyć - nivar
snob - snob
sobaczy - canin
sobaka - can
sobota - sabbato
socjalizm - socialismo
socjologia - sociologia
socjologiczny - sociologic
soczysty - succose, succulente
sód - sodium, natrium
soda - soda
sojusznik - alliato
sok - succo
sokół - falcon
Sokrates - Socrates
solić - salar
solidarność - solidaritate
somnambulik - somnambulo
sopranista - sopranista
sopranistka - sopranista
sos - sauce
sosjerka - sauciera
sowiecki - sovietic
spać - dormir, addormite
spacer - promenada, ambulatura
spaghetti - spaghetti
Sparta - Sparta
specjalność - specialitate
spekulant - agiotator
sperma - sperma
śpiący - somnolente
spichlerz - granario
spichrz - granario
śpiew - canto
śpiewać - cantar
spinel - spinello
spisek - complot, conjuration
spiskować - complotar, conspirar
spodziewać się - expectar
spojówka - conjunctiva
spojrzeć - reguardar
spojrzenie - reguardo
spółdzielnia - cooperativa
sponsor - sponsor
spór - contention, contestation, controversia
sporadyczny - sporadic
sport - sport
sportowy - sportive
sposób - guisa
spostrzeżenie - remarca
spotkanie - appunctamento
spowiednia - confessionario
spowiednik - penitentiero, confessor
sprawdzalny - verificabile
sprawiedliwie - justemente
sprawiedliwość - justitia
sprawiedlność - justitia
sprężyna - resorto
sprzeciwiać się - adversar, antagonisar
sprzeczać się - altercar, arguer
sprzeczność - contrarietate, disaccordo
sprzyjać - fomentar
sprzymierzeniec - alliato
sputnik - sputnik
spylać - escappar, discampar, fugir, evader
srebrna - argentee
srebrny - argentee
srebro - argento
średniowiecze - Medievo
średniowieczny - medieval
Sri Lanka - Sri Lanka
środa - mercuridi
środek - centro
środowiskowy - ambiental
ssak - mammal
stabilność - stabilitate
stadion - stadio
stagnacja - stagnation
stal - aciero
stalinizm - stalinismo
Stany - Statos Unite de America, Statos Unite
Stany Zjednoczone - Statos Unite, Statos Unite de America
Stany Zjednoczone Ameryki - Statos Unite de America, Statos Unite
staroświecki - antiquate
starożytność - ancianitate
starszy - patre
statki - alveo, vasculo
statory - alveo, vasculo
statua - statua
staw - articulation
stęchlizna - mucor
stegnisko - vestigio
stereotyp - stereotypo
stężenie - concentration
stok - costa, scarpa, montata
stolica - capital
stomatolog - dentista
stop - alligato
stopień wyższy - comparativo
stosować - applicar
stosowny - apte, decorose, expediente, pertinente
stożek - cono
strach - angustia
strach na wróble - angustia
strajk - exopero
strąpacz - februario
straszny - apprehensive
straszyć - espaventar
strateg - stratego
strategicznie - strategicamente
strawa - sumpto
strofować - admoner, admonestar
strój - cotta
struktur - structura
struktura - structura
struś - struthio
strychnina - strychnina
strzała - sagitta
studio - studio
studiować - studer
stulecie - seculo
stwórca - creator
styczeń - januario
subsoniczny - subsonic
subsydium - subsidio
subtelność - subtilitate, finessa
subwencja - subvention
suchy - aride
Sudety - Sudetes
sufler - sufflator
sułtanat - sultanato
suma - aggregato
sumienie - conscientia
sumienny - conscientiose
sumować - additionar, aggregar
supersoniczny - hypersonic, supersonic
suponować - supponer
supremacja - suprematia, dominantia
suwerenność - soveranitate
swędzić - prurir
świadomie - consciemente, conscientemente
światło - luce
światowy - mundial
świątynia - templo
świeca - candela
świecę - candela
świecznik - candelabro, candeliero
świekier - patre affin
świekra - matre affin
świerzb - scabie
świeść - matre affin
świnia - porco
świński - porcin
świostka - matre affin
Syberia - Sibiria
sybiliński - sibyllin
Sycylia - Sicilia
syfilis - syphilis
Syjam - Siam
syjonizm - sionismo
symetria - symmetria
syn - filio
synonimiczny - synonymic, synonyme
synowiec - nepote
syntetyczny - synthetic
synteza - synthese
Syria - Syria
syrop - sirop
syryjski - syriac
systematyczny - systematic
szabla - sabla, sabra
szach - chac, chaco
szachista - chachista
szachownica - chachiera
szacunek - estimation, deferentia, respecto, veneration
szakal - chacal
szalej - cicuta
szaleństwo - phrenesia, insanitate
szaman - shaman
szantaż - chantage
szary - gris
szczegółowy - detaliate, minutiose, minute
szczekać - latrar
szczekanie - latrato
szczepionka - vaccino
szczery - candide
szczewik - scarpa
szczodry - generose, munificente
szczotka - brossa
szczur - ratto m, ratta f
szczyt - summitate
sześcian - cubo
sześcioraki - sextuple
szewc - scarpero
szezlong - chaise longue
szkielet - skeleto
Szkocja - Scotia
szkodliwość - damnositate
szkoła - schola
szkop - germano
szlachtuz - macello
szlauch - angue
szlug - cigarretta
szmaja - sinistromane
szmania - sinistromane
szmugiel - contrabando
szmuglerka - contrabando
sznur - linea
szowinista - chauvinista
szparag - asparago
szpuk - columba
szron - pruina
sztajmes - dipsomano
sztuczny - affectate
szuflada - tiratorio
szukać - perquirer
szwab - germano
Szwajcaria - Suissa, Switza
Szwecja - Svedia
Szwecyjo - Svedia
Szwed - svedo
szwedzki - svede
szwestera - soror
szybko - precipitatemente
szydełko - crochet
szydełkować - crochetar
szyja - collo
szykowny - elegante
szympans - chimpanze
szyszka - cono
tabela - tabella
tabu - tabu
tacik - patre
tajemniczy - tenebrose
Tajlandia - Thailandia
tak - si
taksonomia - taxinomia
taksydermia - taxidermia
także - alsi, anque
talizman - talisman
tamten - aquelle
tan - dansa
tancerz - dansator
tańczyć - dansar
tangens - tangente
tani - vil
taniec - dansa
tank - tank
Tanzania - Tanzania
tapeta - tapis
taternictwo - alpinismo
tatuaż - tatuage
tauromachia - tauromachia
tautologia - tautologia
tchórzostwo - coardia
technet - technetium
technik - technico
technokracja - technocratia
technokrata - technocrate
technokratyczny - technocratic
technolog - technologo
tęczówka - iris
tekst - texto
tektoniczny - tectonic
telegraficzny - telegraphic
telegrafista - telegraphista
teleskop - telescopio, telescopo
temat - thema
temperatura - temperatura
tendencyjny - tendentiose
tenis - tennis
tenże - aquello, aquesto
teofania - theophania m
teolog - theologo
teologia - theologia
teologiczny - theologic
teozoficzny - theosophe, theosophic
terapeuta - therapeuta
terapia - therapia, curamento
teratologia - teratologia
terier - terrier
terminator - apprentisse
terminologia - terminologia
terminologiczny - terminologic
termometr - thermometro
Termopile - Thermopylae
terroryzm - terrorismo
terytorialny - territorial
teść - patre affin
teściowa - matre affin
tęsknić - aspirar
tęsknota - aspiration
tęskny - appetente
test - test
testament - testamento
tętnica - arteria
tetrarcha - tetrarcha
też - alsi, anque
tezaurus - thesauro
tezauryzować - thesaurisar
Timor Wschodni - Timor Oriental
tiul - tulle
tkanie - textura
tlen - oxygeno
tłumacz - interprete, traductor
tłusty - adipose
to - aquello, aquesto
toksyczny - venenose, virose
tolerancja - tolerantia, toleration
tonsura - tonsura
topnieć - disgelar
torf - turfa
torpedować - torpedar, torpedinar
tort - torta
totalitaryzm - totalitarismo
trąbka - trompetta
traf - hasardo
tragedia - tragedia
tragiczny - tragic
transcendentalny - transcendental
translator - interprete, traductor
transmisja - transmission
transsubstancjacja - transubstantiation
trąt - bombo
tratować - calcar, fullar
trawnik - gazon
tren - cauda, traino
trena - cauda, traino
trenodja - cauda, traino
trezor - thesauro, tresor, tresoreria
trias - trias
tróhła - feretro
Troja - Troia
trojaki - triplice, triple
Trójprzymierze - Triple Alliantia
tron - throno
truchło - cadavere
trud - arduitate
trudny - ardue, difficile, intricate
truflowy - trufari
trujący - venenose
trumna - feretro
truskawka - fraga
truteń - bombo
trwałość - durabilitate, constantia
trybula - cerefolio
trygonometryczny - trigonometric
trzask - crac
trzeć - fricar, frictionar
trzęsienie ziemi - seismo
trzustka - pancreas
tu - hic, iste loco
tudzież - e, (rzadziej et)
tukej - hic, iste loco
tulipan - tulipan
tulp - tulipan
tunel - tunnel
tungsten - wolfram
turbina - turbina
Turcja - Turchia
turysta - tourista
turystyka - turismo
tutaj - hic, iste loco
tybetański - tibetan
tyć - ingrassiar
tydzień - septimana
tyfus - typho
tygiel - crucibulo
tygr - tigre
tygrys - tigre
tygrysica - tigressa
tyj - theiero, the
tymczasem - intertanto, interea, interim
tymianek - thymo
typ - typo
typografia - typographia
tyrania - tyrannia
tytan - titanium
ubezpieczenie - assecurantia
ubogi - impecuniose
uchodźca - refugiato, fugitivo
uciążliwy - ardue, onerose, penose
uciekać - escappar, discampar, fugir, evader
uciskać - astringer, constringer, premer
uczciwość - honestate, honestitate
uczciwy - eque, honeste, sincer
uczeń - alumno, apprentisse
uczuć - affecto
uczucie - affecto
uczyć - docer, erudir, inseniar, instruer, professar, regentar, apprender
ugrofiński - finnougrian
uj - oncle
ujec - oncle
ujek - oncle
ukazywać - apparer
układ - arrangiamento
Ukraina - Ukraina
ukrzyżowanie - crucifixion
ul - apiculario
ulica - strata
ultimatum - ultimato
umieszczać - collocar, implaciar, locar, situar
umowa - pacto
umysł - mente
umyślnie - deliberatemente
umysłowy - mental
Unia Europejska - Union Europee
unieważnienie - abolimento
unikalny - unic
unikatowy - unic
uniwersalny - universal
upadek - fallimento
upał - canicula
upierdliwy - ardue, onerose, penose
uporczywość - perseverantia, obstination
uprzejmy - affabile, amabile, amicabile
Uran - Urano
urlop - congedo, commeato
uroczystość - celebration, festino, festivitate, pompa
urodzajność - fertilitate
uspokajać - appaciar
usprawiedliwiać - exonerar
ustępstwo - concession
ustny - buccal, oral, verbal
usuwać - amover
utęsknienie - aspiration
utopia - utopia
utopijny - utopic
utopista - utopista
utrzymywać - allegar
utylitarny - utilitari
uwaga - advertentia, advertimento
uważny - advertente
uwertura - overtura
uzyskiwać - obtener
wacha - gasolina, benzina, pluvia, mar, aqua
wagon - wagon, carro
wajco - ovo
walczyć - battaliar, contender, guerrear, propugnar, pugnar
Walia - Galles
walka - combatto
waluta - valuta
wampir - vampir
wanad - vanadium
wardawy - sinistromane
warga - labio
wargowy - labial
wariancja - variantia
warkocz - tressa
wartościowy - valorose, preciose
warzyć - cocer, cocinar, bullir
wątpić - questionar
wątpliwy - dubitabile, dubitative, dubitose, insecur
wątroba - hepate, ficato
Watykan - Vaticano
wąż - angue
wbiegać - incurrer
wchodzić - ascender
wcześnie - anteriormente
wcześniej - anteriormente
wczoraj - heri
węborek - situla
wegetariański - vegetarian
węgiel - carbon
węgiel brunatny - lignite
Węgier - hungaro
Węgierka - hungara
węglan - carbonato
węgorz - anguilla
Węgry - Hungaria
wehikuł - vehiculo
wejście - adito
wełnisty - lanose
Wenecja - Venetia
wenecki - venetian, veneteveneto
Wenera - Venere
Wenezuela - Venezuela
wentroba - hepate, ficato
Wenus - Venere
werdykt - verdicto
Wergiliusz - Vergilio
wersja - version
weryfikowalny - verificabile
Westfalia - Westfalia
wesz - pediculo
weterynarz - veterinario
weto - veto
wewnątrzmaciczny - intrauterin
Wezuwiusz - Vesuvio
wezwanie - citation
wiadomość - aviso, depeche
wiadro - situla
wiadukt - viaducto
wiarygodność - credibilitate
widelec - furca, furchetta
widnokrąg - horizonte
widoczny - apparente
widołka - furca, furchetta
widz - spectator
więc - alora
wieczność - eternitate
wieczny - sempiterne, perenne
wieczór - vespere
wieczorny - vesperal
Wiedeń - Vienna
wiejski - rustic, villan, campestre
wiek - seculo
większość - grosso, majoritate
wiela - quot
wielbłąd - camelo
Wielka Brytania - Grande Britannia
Wielka Niedźwiedzica - Ursa Major
Wielkanoc - Pascha
Wielki Piątek - Venerdi Sancte
wielkość - amplitude
wielojęzyczny - multilingual, multilingue, multilinguistic, plurilingual, polyglotte
wielojęzykowy - multilingual, multilingue, multilinguistic, plurilingual, polyglotte
wielokomórkowy - multicellular
wielokulturowy - multicultural
wieloryb - balena
wielość - multiplicitate
wieńcowy - coronari
wierzba - salice
wierzchołek - summitate, apice
wieś - campania, village
Wietnam - Vietnam
wietrzny - ventose
wieża - turre
więzień - prisionero, convicto
więzienie - prision
wigor - brio
Wikipedia - Wikipedia
Wikisłownik - Wiktionario
wiktoria - victoria, vincimento
wilgoć - humiditate
wilk - lupo
wilkołak - lycanthropo
winien - culpabile, vinari
winnica - vinia
winny - culpabile, vinari
winograd - vite, vinia, uva
winogrono - uva
winorośl - vite
wiolonczela - violoncello
wioska - campania, village
wiosło - remo
wiosna - primavera
wirowanie - centrifugation
wirtuoz - virtuoso
wiszczeć - critar
witalność - vitalitate
witaminowy - vitaminic
wiwenda - victo, vivandas, alimento
wizjer - dativo
w końcu - finalmente
Władywostok - Vladivostok
właściciel - possessor
właściwy - apposite
właśnie - exactemente
własny - proprie
włóczęga - vagabundo
włos - capillo, villo
włoski - italian
wnęk - nepto
wniwecz - totalmente
wnuk - nepto
woda - aqua
wóda - vodka
woda mineralna - aqua mineral
wódka - vodka
wodnopłat - hydroplano
wodny - aquatic, aquatile, aquee
wodolot - hydrofoil, hydroplano
wodór - hydrogeno
wodospad - cascada
wojak - combattente
wojna - guerra, bello
wojna religijna - guerra religiose
wojowniczy - bellicose
wojskowy - bellicista, combattente
wokabularz - dictionario
wół - bove, bovello
wola - voluntate
wolfram - wolfram
Wołga - Volga
wolicjonalny - volitive
wolitywny - volitive
wolnomularstwo - masoneria, francmasoneria
wolnomularz - mason
wolność - libertate
woniączka - vodka
wóz - cochi, carretta, carro
wozatarz - cochiero
wózek - carretta
woźnica - cochiero
wpędzać - figer
w pełni - totalmente
wpływać - affectar, afficer, influentiar, influer
wrażenie - impression
wrażliwość - affectibilitate
wrażliwy - affectabile, affectibile
wreszcie - finalmente
wrodzony - innate
wrotycz - balsamita
wróżbiarz - divino
wróżyć - augurar
wrzesień - septembre
wrzos - erica
wrzosowisko - landa
wschodni - oriental
wschodzić - germinar
wścieklizna - rabie
wskazywać - indicar
wspaniały - admirabile
współczesny - contemporanee
współczuć - commiserar, condoler
wspólnie - conjunctemente
współzawodnictwo - competion
wstępny - preliminar, liminar, exordial, initiative
wstyd - vergonia
wstydzić się - vergoniar
wtedy - alora
wtenczas - alora
wtorek - martedi
wtrącać - interloquer, ingerer, intruder, interponer
w tym - aquello, aquesto
wuj - oncle
wujek - oncle
wujko - oncle
wujo - oncle
wulkan - vulcano
wulkaniczny - volcanic, vulcanic
wybrzeże - litore, costa
Wybrzeże kość Kości Słoniowej - Costa de Ebore
wychudzony - emaciate
wyciąg - abstrakt
wycieczka - excursion
wydatkować - erogar
wydawać - erogar
wygląd - apparentia
wyjaśnianie - clarification, acclaramento
wyjście - exito, sortita
wykałaczka - mundadentes
wykonalny - agibile
wykrywacz kłamstw - detector de mentitas
wykształcony - culte, cultivate, educate, erudite, litterate, scholarisate
wyłącznie - exclusivemente, solmente
wymachiwanie - brandimento
wymiana - excambio
wymieniać - excambiar
wymienialny - excambiabile, intercambiabile
wymienny - intercambiabile, permutabile
wymowa - pronunciation
wymuszać - concuter, extorquer
wynagrodzenie - gage, remuneration
wynalazca - inventor
wynalazek - invention
wynosić - amontar
wyobrażać - imaginar se
wyolbrzymianie - aggrandimento
wypalać - cauterisar
wyposażenie - equipamento
wypowiadać - exprimer
wyprysk - button, carbunculo
wyprzedzać - anticipar
wypukły - convexe
wyraz - parola <!-- ' vocabulo, ' verbo -->
wysiadywać - covar
wysiłek - arduitate, effortio, fatiga
wyśmienicie - excellentemente
wysokość - altessa, altor, altura
wyspa - insula
Wyspa Świętego Wyspy Świętego Tomasza i Wyspa Książęca - São Tomé e Príncipe
Wyspy Kanaryjskie - Canarias, Insulas Canarias, Insulas Canari
wystarczający - sufficiente
wystarczyć - sufficer, bastar
wystawa - exhibition
wytrwałość - perseverantia, tenacitate
wywiad - abuccamento
wywijanie - brandimento
wyża - altessa, altor, altura
wyznaczenie - nomination
wyższość - superioritate, predomination
wzniesienie - altura
wzrost - augmento, accrescimento
żaba - rana
zabawa - distraction, intertenimento
ząbek - denticulo
żabie oczko - auricula
zabijak - assassinator
zabójca - assassinator
zabójstwo - assassinato, assassination, homicidio, occision
zabór - annexion
zachodni - occidental
zachowanie - comportamento
zacieniać - umbrar
zaczynać - inciper
żądło - aculeo
zadowolenie - contentamento
zadowolony - contente, complacente, satisfacite
zagłada - extermination
zagraniczny - extere, estranier
zagrożony - menaciate
zainteresowania - incursion, interesse
zainteresowanie - incursion, interesse
zając - lepore
zajadły - rancorose
zakaz - interdicto, interdiction
zakażać - contaminar
zakład karny - prision
zakochany - inamorate
zakonnik - cenobita, monacho
zakrystia - sacristia
załącznik - annexo, appendice, attaccamento
zalesiać - forestar
zależność - dependentia
żałobny - obituari, elegiac, funebre, funerari, lugubre, luctuose
założyciel - erector, fundator
zamknąć - clauder
zamówienie - commanda
zamożność - ricchessa
żandarm - gendarme
zanokcica - panaritio
zapalenie - inflammation
zapalenie oskrzeli - bronchitis
zapalenie wyrostek wyrostka robaczkowego - appendicitis
zapałka - flammifero
zapamiętywać - memorisar
zapiekanka - casserola
zapisywać - inscriber, legar
zapominać - oblidar, disapprender
zapominalski - obliviose
zapora - dica, barrage
zapowiadać - annunciar
zaprzeczenie - negation
zarabiać - lucrar
Zaratusztra - Zoroastre
zaratusztrianizm - zoroastrismo
zaraza - epidemia
żargon - jargon
żarliwy - ardente, ardorose, inflammate, passional, fervente
żarłoczny - vorace
zarodek - embryon
zarozumialstwo - vangloria
żartować - burlar, scherzar
zaś - altere vice
zasada - alcalino, alcali
zasłona - cortina
zasłużony - emerite, meritose, condigne
zasnąć - addormir se
zasobny - opulente
zaszczytciel - advocato
zatoka - baia, golfo
zawartość - contento
zawiadomienie - advertimento
zawieszać - appender
zawieszenie broni - tregua, armistitio
zawilec - anemone
zawiść - invidia
zawistny - cupide, invidiose, jelose
zawód - anticlimax
zawrotny - vertiginose
zazdrosny - invidiose, invide, zelose, jelose
zazwyczaj - solitemente
zbawienny - benefic, salubre
zbędny - dispensabile
zbieg okoliczności - coincidentia
zbierać - assemblar
zbiór - conjuncto
zbliżać - approchar, approximar
zbroić - artillar
zdalasiały - afflicte, preoccupate, lasse, fatigate, fatigabile
zdolny - capabile, capace
zdradziecki - insidiose, perfidiose
zdrowieć - refacer (se), se resanar
zdrowotny - curative
że - que
zebra - zebra
żebrak - mendicante, mendico
zebu - zebu
żec - adurer
żeglarz - nauta
żegleń - carbon
zelant - zelote
zelator - zelote
żelatyna - gelatina
zelota - zelote
zelotyzm - zelotismo
zelozja - zelotismo
zelter - aqua mineral
zelus - zelotismo
zemsta - vengiantia
żeńczyna - femina
zenit - zenit
zeszyt - fasciculo, quaderno
zgadzać - accordar, acquiescer
zginąć - cader
zgniły - putride, infecte, corrupte
zgodny - accordante
z góry - anticipatemente
ziele angielskie - pimento
zielony - verde
ziemniak - patata
zima - hiberno
zimno - frigido, frigor, herpes, herpete
zimorodek - martin piscator
zimowy - hibernal
ziołowy - herbal, herbacee
złocić - aurar, dorar
złodziej - fur
złośliwość - malitia
złoto - auro
złotówka - zloty
złoty - zloty
zmartwienie - enoio, affliction
zmartwiony - afflicte, preoccupate
zmęczony - lasse, fatigate, fatigabile
zmiana - alteration
zmieniać - alternar
zmierzch - crepusculo
zmysłowy - sensori, voluptuose, voluptuari
znienacka - abruptemente, urgentemente
znieważanie - affrontamento
zniewieściały - effeminate
zniszczalny - destructibile, peribile
zniszczenie - annihilation, annulation
znosić - annullar
znów - altere vice
znowu - altere vice
Zofia - Sophia
żołądek - stomacho
żółć - jalne
żołnierz - combattente
żółty - jalne
zoo - zoo
zoo- - zoo-
zoolatria - zoolatria
zoologia - zoologia
zoologiczny - zoologic
zooplankton - zooplancton
zręczność - agilitate, dexteritate, habilitate
źrenica - pupilla
źródło - fonte
źródłosłów - etymo, radicula
zrostek - affixo
zrozumiały - comprehensibile, comprehensive, intelligibile, plan, comprensive, perspicue, justificabile
zrozumienie - apprehensibilitate, apprehension, comprehension
źrzały - adulte, matur
żuć - masticar
zuchwały - audace, audaciose, insolente
żul - dipsomano
zupełnie - totalmente
żuraw - cabestan
żurawina - oxycocco
żurnal - periodico, revista
żurnalista - jornalista
zwać - appellar, nominar
zwiastować - portender
związek - affinitate
Związek Radziecki - Union Sovietic
zwierzak - animal, bestia
zwierzę - animal, bestia
zwieszać się - clinar
zwłoki - cadavere
zwolennik - adherente, partisano, partitario
zwoływać - advocar
zwrotnik - tropico
zwycięski - victoriose, triumphante
zwycięstwo - victoria, vincimento
zwycięzca - victor
zwyczajny - consuete, consuetudinari
z wyjątkiem - extra
z wyłączeniem - extra
żydowski - judee
żydożerstwo - antisemitismo
żyła - venna
żyletka - rasorio
zymft - mustarda
żyroskop - gyroscopio
żyto - secale
żywić - manducar
żywność - victo, vivandas, alimento
żywnościowy - alimentari
żywokost - consolida
