a - og, en
aa - apalhraun
abak - talnagrind f, reiknigrind f
abakus - talnagrind f, reiknigrind f
abat - ábóti m
abażur - lampaskermur m
abbuś - prestur m
abdykacja - afsögn f
abecadło - stafróf f
Abel - Abel
abfal - glópur m, þorskur
abiecadło - stafróf f
abituria - stúdentspróf n
abiturient - stúdentsefni n
ablegierek - barn n
abo - eða
abonent - áskrifandi m
aborcja - fóstureyðing f
abstynent - bindindismaður
absurd - fjarstæða f
abzac - hæll m
aceton - asetón n
acetylen - asetýlen n
acz - þó að, þótt
aczkolwiek - þó að, þótt
adadżio - adagio
adapter - grammófónn m
Adelajda - Adelaide
adorować - dýrka, tilbiðja
adres - heimilisfang n
adresat - viðtakandi bréfs m
adwent - aðventa f, jólafasta f
adwentnik - desember
adwokat - málfærslumaður m
aerodrom - flugvöllur m
aeroplan - flugvél f
afa - api m
afekt - ástúð f, blíða f
afelzina - appelsína f
Afganistan - Afganistan
Afryka - Afríka f
afrykański - afríkanskur
Afryka Północna - Norður-Afríka
agresja - árás
agrest - stikilsber n
agresywny - árásargjarn, bellinn, ofstopafullur
ajmer - vatnsfata f
akacja - akasíutré
akcent - áhersla f
akordeonista - harmóníkuleikari m
akrobata - loftfimleikamaður m
akronim - upphafsstafaheiti n
aksjomat - frumsetning f, frumsenda f
aktor - leikari m
aktorka - leikkona f
akumulator - rafgeymir m, rafhlaða f
akuratnie - áðan
akuzatyw - þolfall n
akwarela - vatnslitur m
akwarium - fiskabúr n
Albańczyk - Albani m
Albania - Albanía f
albański - albanskur
albo - eða
alchemia - alkemía
ale - en
aleja - breiðstræti n, troð
alergia - ofnæmi n
alfabet - stafróf f
alfabetu - stafróf f
alga - þörungur m
algida - gleðikona f, skækja f, vændiskona f
Algieria - Alsír
Alicja - Alice
alkohol - alkóhol n, áfengi n
alkoholik - áfengissjúklingur m, drykkjusjúklingur m
alkoholowy - áfengur
alleluja - hallelúja
almanach - almanak n
alpinista - fjallgöngumaður m
alpinizm - fjallganga f
Alpy - Alpafjöll, Alparnir
ałsztojer - heimanfylgja f
altruizm - ósérplægni f
aluminium - ál n
aluzja - aðdróttun f
amajza - maur m
ambasada - sendiráð n
ambirz - engifer n
ambona - prédikunarstóll m, ræðustóll m
ambulans - sjúkrabifreið f
Amelia - Amelía
Ameryka - Ameríka f
Amerykanin - Bandaríkjamaður m
amerykański - amerískur, bandarískur
Ameryka Północna - Norður-Ameríka f
Ameryka Południowa - Suður-Ameríka f
Amman - Amman
Amos - Amos
amunicja - skotfæri
ananas - ananas m
Anastazja - Anastasía
Anatolia - Anatólía
anatomia - líffærafræði f
ancug - jakkaföt
Andora - Andorra
Andrea - Andrea
Andromeda - Andrómeda
Andrzej - Andreas
Andy - Andesfjöll
Aneta - Anetta
Angelika - Angelíka
angielski - enskur, enska f
Anglia - England n
Anglija - England n
anglosaski - fornenska f
angol - enskur, enska f
angryst - stikilsber n
ani - hvorki…né
Aniela - Angela
anioł - engill m
Anioł Stróż - verndarengill m
anion - anjón f, mínusjón f
Anita - Anita
aniżeli - en
anjoł - engill m
Antananarywa - Antananarívó
Antarktyda - Antarktíka, Suðurskautslandið
antonim - andheiti n
antropologia - mannfræði f
Antyle Holenderskie - Hollensku Antillaeyjar
antysemita - gyðingahatari m
aparat fotograficzny - ljósmyndavél f
apasz - glæpamaður m
Apeniny - Appennínafjöll
apluzyna - appelsína f
aprykoza - aprikósutré n, aprikósa f
apryl - apríl
aptek - apótek n
apteka - apótek n
Arabia Saudyjska - Sádí-Arabía
arabski - arabíska, arabískur
arbuz - vatnsmelóna f
archanioł - erkiengill m
archeologia - fornleifafræði f
Archimedes - Arkímedes
archipelag - eyjaklasi m
architekt - húsameistari m, arkitekt m
architektonika - húsagerðarlist f, byggingarlist f
architektura - húsagerðarlist f, byggingarlist f
arcybiskup - erkibiskup m
arcydzieło - meistaraverk n
arfa - harpa f
argon - argon n
Arktyka - Norðurslóðir
armia - her m
armijo - her m
arteria - slagæð f
artykuł - grein f, vara f, greinir m
artystyczny - listrænn
asafetyda - djöflatað
aspekt - sjónarmið n, horf n
aspiryna - aspirín n
asta - grein f
astat - astat
asteroida - smástirni n
asterysk - stjarna f
astma - asmi m
astronauta - geimfari m
astronomia - stjörnufræði f
astronomio - stjörnufræði f
Asyria - Assyría
asza - aska
aszynbecher - öskubakki m
atak serca - hjartaáfall m
ateista - guðleysingi m, trúleysingi m
ateizm - trúleysi n
Ateny - Aþena f
ateusz - guðleysingi m, trúleysingi m
Atlantyk - Atlantshaf n
atlas - kortabók f
atmosfera - loft
atom - frumeind f, atóm n
Augiasz - Ágeas m
August - Ágúst
Austria - Austurríki n
austriacki - austurrískur
Austriak - Austurríkismaður m
Austro-Węgry - Austurríki-Ungverjaland n
autobus - strætisvagn m, strætó m, langferðabíll m, rúta f
autonomia - sjálfsstjórn f, sjálfstæði n
autor - höfundur m
Azerbejdżan - Aserbaídsjan
Azja - Asía f
Azjata - Asíubúi m
Azory - Asóreyjar
azot - nitur n
B - þolfall n
babcia - amma f
babka - amma f
bachraty - feitur
bądź - eða
bagaż - farangur m
bagażnik - skott n
bagnet - byssustingur m
bagno - mýri f, fen n
bajer - lygi f
bajerować - ljúga
bajka - fafla f
bajtel - barn n
bajzel - hóruhús n
bak - tankur m
bąk - hunangsfluga f
bakałarz - kennari m
bakłażan - eggaldin n
bakteria - baktería f
bala - bolti m, knöttur m, sög f
bałak - viðtal n, samtal n
balet - danssjónleikur m
balsamiczny - balsamik
Bałtyk - Eystrasalt n
bambaryła - glópur m, þorskur
bana - lest f, sporvagn n, stöð f
banan - banani m
banana - banani m
bandzioch - magi m, kviður m, búkur m, belgur m
banerka - dós f
banhof - stöð f
bania - höfuð n (człowieka), haus (innego zwierzęcia)
baniaczek - hattur m
baniak - höfuð n (człowieka), haus (innego zwierzęcia)
bank - banki m
banka - sporvagn n
bankructwo - gjaldþrot
bańtka - flyðra f
barabola - jarðepli n, kartafla f
Baran - Hrúturinn
Baranek Boży - lamb Guðs n, Guðs lamb n
baranina - kindakjöt
bardzo - mjög
barierka - slá
barter - vöruskipti
barwa - litur m
barzej - mjög
barzoł - mýri f, fen n
bas - magi m, kviður m, búkur m, belgur m
basarunek - bætur /f
basen - sundlaug f, sundhöll f
Baskonia - Baskaland n
batłąch - flaska f
baton - súkkulaðistöng f
bazylia - basilíka f
Bazylisa - Vasilia f
bebech - magi m, kviður m, búkur m, belgur m
bęben - magi m, kviður m, búkur m, belgur m
beczeć - gráta
bedki - sveppur m
bejm - peningar
belfer - kennari m
Belgia - Belgía
Benin - Benín
benzyna - bensín
berbela - vodki m
berga - steinn m, tannsteinn m, (nýrna)steinn m
Berlin - Berlín
beryl - beryllín n
bez - yllir m, án
bez- - ó-, -laus
beze - yllir m, án
bezokolicznik - nafnháttur m
bezosobowy - ópersónulega
beżowy - drapplitaður
bezpieczeństwo - öryggi n
bezpieczny - öruggur, hættulaus
bezrobocie - atvinnuleysi
bezuch - heimsókn f, koma f
Białoruś - Hvíta-Rússland n
biały - hvítur
biały kruk - hvítur hrafn m
biber - hattur m
Biblia - biblía f
biblioteka - bókasafn n
bida - fátækt f
bieda - fátækt f
biedny - fátækur
biedronka - maríuhæna f
bieg - hlaup n
bieganie - hlaup
bieg płotkarski - grindahlaup n
bieg przez płotki - grindahlaup n
biegun - póll m
bierne palenie - óbeinar reykingar /f
biernik - þolfall n
bierzmowanie - ferming f
biglosko - pressujárn n
biksa - dós f
bilet - miði m, aðgöngumiði m
bimba - sporvagn n
bindasz - getnaðarlimur m, reður m, typpi n
biochemia - lífefnafræði
biologia - líffræði f
bishalter - brjóstahaldari m
biskup - biskup m
bita śmietana - þeytirjómi m
bitwa - orusta f, bardagi m
biurko - borð n, skrifborð n
biuro podróży - ferðaskrifstofa f
biusthalter - brjóstahaldari m
biustonosz - brjóstahaldari m
bizmut - bismút n
bladź - gleðikona f, skækja f, vændiskona f
blaga - lygi f
błecha - fló f
błędne koło - vítahringur m
błękitna krew - blátt blóð
Bliski Wschód - Mið-Austurlönd
Bliźnięta - Tvíburarnir
blumkol - blómkál n
bluszcz - bergflétta f, vafningsviður m
bluźnierstwo - guðlast
błyskawica - elding f
bo - því, af því að, vegna þess, vegna
boba - húfa f, maríjúana n, hass n
bóbr - bjór m
bocian - storkur m
bóg - guð, goð
Bóg - Guð m
bogactwo - auður m, auðlegð f, auðæfi
bogini - gyðja f
bohater - hetja f
Bohemia - Tékkland n, Bæheimur
bojtel - poki m
bojtlik - peningaveski n, seðlaveski n, veski n
ból - sársauki m, verkur m, verkur
bolesny - sár, sársaukafullur
Boliwia - Bólivía
bombel - barn n
bómbón - brjóstsykur m, kandís n, steinsykur m
bonsai - dvergtré
bor - bór n
borowik - kóngssveppur m
borówka - kinn f
Bośnia i Hercegowina - Bosnía og Hersegóvína
botanik - grasafræðingur m
botanika - grasafræði f
botulizm - bótúlíneitrun f
boża krówka - maríuhæna f
Boże Narodzenie - jól
brachol - bróðir m
bracieniec - bróðir m
brakować - vanta
bransoleta - armband n
brat - bróðir m
bratanek - bróðursonur m
bratanica - bróðurdóttir f
bratowa - mágkona f
brauza - steypibað n, sturta f
brązowy - brúnn
brazyliana - kaffi n
brele - gleraugu
briftasza - peningaveski n, seðlaveski n, veski n
bród - vað n
broda - haka f, skegg n
brokuł - spergilkál n
broń - vopn
browar - ölgerð f, bjór, öl
brud - skítur m, óhreinindi, saur m, sorp n
brudny - skítugur
brukiew - gulrófa f
Bruksela - Brussel
brukselka - rósakál n
brusić - brýna, skerpa, hvessa
brydż - bridds n
bryka - bíll m
bryle - gleraugu
brytfanna - form
Brytyjczyk - Breti m
Brytyjskie Wyspy Dziewicze - Bresku Jómfrúaeyjar, Bresku Jómfrúreyjar, Bresku Meyjaeyjar
brzmienie - hljóð
brzoskwinia - ferskja f
brzoza - björk f
brzuch - magi m, kviður m, búkur m, belgur m
brzydki - ljótur, herfilegur
brzydki jak grzech śmiertelny - forljótur
buda - hundakofi, skóli m
budowa - bygging f, nýbygging, gerð f
budowla - bygging f, nýbygging, gerð f
budynek - bygging f, hús n
budzić - vekja
budzik - vekjaraklukka f
buk - beykitré n, beyki m
bukiet - blómvöndur m
buła - vöðvi m
bulba - jarðepli n, kartafla f
Bułgar - Búlgari m
Bułgaria - Búlgaría f
bulić - greiða, borga, gjalda
bułka - vöðvi m
bulwa - jarðepli n, kartafla f
bunt - uppreisn f
burak - rauðrófa f
burak cukrowy - sykurrófa f
burmistrz - borgarstjóri m
bursztyn - raf n
burzowiny - bjór, öl
but - skór m
butelka - flaska f
butersznyt - samloka f
buzi - koss n
by - til þess að, til að
-by - munu
być - vera, verða
być solą w oku - að vera þyrnir í augum
byk - naut n
Byk - Nautið
Była Jugosłowiańska Republika Macedonii - Fyrrum Júgóslavneska Lýðveldið Makedónía
byrna - rafmagnspera f, ljósapera f
bździągwa - punaise des lits f
bździuch - þefdýr n
bzybzać - sneiða, stela
C - þágufall n
cajtung - blað n, dagblað n
cal - tomma f
całka - heildi n
całki - heill
całkiem - algerlega, með öllu
całować - kyssa
całus - koss n
cały - heill
car - tsar m
cebula - laukur m
celnik - tollvörður m
celownik - þágufall n
cena - verð n
centrum - miðja f
centymetr - sentimetri m
cera - dóttir f
certacja - stríð n, hildur f, stríð
cesarz - keisari m
cez - sesín n
chabanina - kjöt n
chabas - kjöt n
chabić - stela
chachoł - hnakki m
chamera - ský n
charakter - persónuleiki m, skapgerð f
chata - kofi m
chcieć - vilja
chciwość - græðgi m
chciwy - gráðugur
chemia - efnafræði f
chemia biologiczna - lífefnafræði
chemik - efnafræðingur m
Chińczyk - Kínverji m
Chińska Republika Ludowa - Alþýðulýðveldið Kína n
chiński - kínverskur
Chiny - Kína f
chira - vodki m
chirurg - skurðlæknir m
chirurgia - skurðlækningar
chitozan - kítósan
chlać - drekka
chleb - brauð n
chlew - svínastía f
chłopiec - drengur m, piltur m
chłopyszek - drengur m, piltur m
chlor - klór, flakkari m, flækingur m
chmiel - humall m, bjór, öl
chmura - ský n
choć - þótt, þó að
choćby - að minnsta kosti, til dæmis
chocia - þótt, þó að
chociaż - þótt, þó að
chocieć - vilja
chód - þrep n, spor n
chodnik - gangstétt f
chodzić - ganga, fara
choinka - jólatré n
chójk - jólatré n
chojna - fura f, þinur m
cholera - kólera f
chór - kór m
chore - sjúkur
choroba - sjúkdómur m, sýki f, mein n, veiki f
chorwacki - króatískur
chory - sjúkur
chowanka - hólf
chrom - króm n
chronologia - tímatalsfræði f
chrypka - hæsi f
chrystianizm - kristni f, kristindómur m
Chrystus - Kristur m
chrześcijaństwo - kristni f, kristindómur m
chrzest - skírn f
chrzestny - guðfaðir m
chudoba - fátækt f
chuśle - fiðla f
chwost - sporður, tagl, stél, hali, skott, rófa biðröð
chyc - hiti m
ciało - líkami m, kroppur m, skrokkur m, lífvera f, lík n, nár m
ciało niebieskie - stjarnfræðilegt fyrirbæri n, himinfyrirbæri n
ciasnocha - skyrta f
ciasto - teig
ciebie - þú, þér
ciecz - lögur m, vökvi m
ciemno - myrkur n
ciemność - myrkur n
ciemny - myrkur
cień - skuggi m
ciepać - kasta, yfirgefa
ciepło - hiti m, hlýja f
cieść - tengdafaðir m, tengdadóttir f
cieszyć - hlakka
ciężarówa - vörubíll m
ciężarówka - vörubíll m
ciężki - þungur, erfiður
ciga - geit f
ciocia - móðursystir f
cipka - kantarella f, hæna f
cisza - þögn f, kyrrð f
ciupa - fangelsi n
ciurlocek - getnaðarlimur m, reður m, typpi n
ciurma - fangelsi n
ciżma - skór m
ćma - melur m, myrkur n, gleðikona f, skækja f, vændiskona f
ćmaga - vodki m
cmentarz - kirkjugarður m
ćmy - myrkur
co - hvað
co dwie głowy, to nie jedna - betur sjá augu en auga
codziennie - hversdags
cołki - heill
co nagle, to po diable - flas er ekki til fagnaðar
córa - dóttir f
córczysko - dóttir f
córka - dóttir f
coś - eitthvað
ćpać - borða, kasta, yfirgefa
cud - kraftaverk n, undur n, jarteikn n
cudowne dziecko - undrabarn
cudowny - undursamlegur
cudzokrain - útlendingur m
cudzoziemiec - útlendingur m
cug - súgur m, lest f
cukier - sykur
cukierek - brjóstsykur m, kandís n, steinsykur m
cukinia - kúrbítur
cwel - glópur m, þorskur
ćwiczenia - æfing
ćwiczenie - æfing
ćwiczenie czyni mistrza - æfingin skapar meistarann, vaninn gefur listina
ćwierćnuta - fjórðapartsnóta f, fjórðipartur m
cwiter - peysa f
cychalter - brjóstahaldari m
cyferblat - andlit n
cyfra - tala f
cyga - hunangsfluga f
cynamon - kanill m
cyngiel - gleraugu
cynk - sink
Cypr - Kýpur
cysorz - keisari m
cytat - tilvitnun f
cytryna - sítróna f
cytrynat - sítróna f
czad - kolmónoxíð
czajnik - ketill m, höfuð n (człowieka), haus (innego zwierzęcia)
czapka - húfa f
czarna dziura - svarthol
czarna owca - svartur sauður m
czarna porzeczka - sólber n
Czarnogóra - Svartfjallaland n
Czarnogórzanin - Svartfellingur m
Czarnogórzec - Svartfellingur m
czarny - svartur
czarownica - galdranorn f, norn f
czas - tími m, stundum
czasopismo - tímarit n
czasownik - sagnorð n
czas to pieniądz - tíminn er peningar
czaszka - hauskúpa f
Czech - Tékki m
Czechosłowacja - Tékkóslóvakía
Czecho-Słowacja - Tékkóslóvakía
Czechy - Tékkland n, Bæheimur
czędo - barn n
czekać - bíða
czekolada - súkkulaði n
czemu - af hverju, hví, hvers vegna
czernica - brómber n
czerwiec - júní
czerwona porzeczka - rifsber n
czerwony - rauður
czerwony olbrzym - rauður risi m
czesać - greiða, kemba
cześć - sæmd f, halló, hæ
część - partur m, hluti m
czeski - tékkneskur, tékkneska f
często - oft
częstoskurcz - hraðtaktur
czkawka - hiksti
członek - meðlimur m, félagi m, limur m, getnaðarlimur m, reður m, typpi n
człowieczy - mennskur, mannlegur
człowiek - maður m
czołg - skriðdreki m
czoło - enni m
czorny - svartur, skítugur
czosnek - geirlaukur m
czuć - finna fyrir, lykta, hafa, segja, líða, heyra
czwartek - fimmtudagur m
czworokąt - ferhyrningur m
czyhunka - þórín
czynność - tiltæki n, verknaður m
czyrwiec - júní
czyrwień - júní
czyżyk - drengur m, piltur m
D - eignarfall n
dąb - eik, eikatré
dać - gefa
dach - þak n
dach nad głową - skjól n
daktyl - daðla f
dała - gefa
dalece - mjög
dalej - fjarri
daleko - fjarri
daleko- - fjar-, lang-
dama - dama f, drottning f
dana - gefa
Dania - Danmörk f
danie - réttur m, matarréttur m
dany - gefa
dar - gjöf f
data - dagsetning f
debata - umræda f, deila f
decyzja - ákvörðun f, úrskurður m
definicja - skilgreining f, orðskýring f
dekada - áratugur m
dekiel - höfuð n (człowieka), haus (innego zwierzęcia)
delfin - höfrungur m
delikatny - hárfínn
demokracja - lýðræði n
dentysta - tannlæknir m
deser - ábætir m
deszcz - regn n, rigning f, úrfelli n
deżdż - regn n, rigning f, úrfelli n
dezelować - eyðileggja
diabeł - djöfull m
diabelski młyn - parísarhjól n
dialog - samræða f
diament - demantur m
dinozaur - risaeðla f
dioda - díóða f
Diogenes - Díogenes, Díogenes (hundingi)
DJ - plötusnúður m
dla - fyrir
dlaczego - af hverju, hví, hvers vegna
dłoń - hönd f
długi - langur
długo - lengi
długopis - penni m, kúlupenni m
dmuchać - blása
dmuchnąć - stela
Dniepr - Dnjepr
dno - botn
dobranoc - góða nótt
dobrobyt - hagsæld
dobry - góður
dobry wieczór - gott kvöld, góða kvöldið
dobrze - vel
dodawać - leggja saman
doić - mjólka
dokąd - hvert
doktor - læknir m
dolar - dalur m
dołek - depurð f, þunglyndi n, hryggð f
dolina - dalur m
dolnołużycki - neðrisorbneskur, neðrisorbneska
dom - hús n, heimili n, ætt
dom dziecka - munaðarleysingjahæli n
dom publiczny - hóruhús n
dopełniacz - eignarfall n
dopiero - áðan
doradca - ráðgjafi m
doskonałość - ágæti n
dosłownie - bókstaflega
dosłowny - bókstaflegur
dostawać - fá
dostęp - aðgangur m
doświadczenie - reynsla f, upplifun n, tilraun f
do widzenia - bless, bæbæ, vertu sæll / vertu sæl
dowód - sönnun f
do zobaczenia - bless, bæbæ, vertu sæll / vertu sæl
drabina - stigi m
drabka - stigi m
drach - flugdreki m
dracheta - flugdreki m
dramatyczny - dramatískur
drapacz chmur - skýjakljúfur m
dratewka - skósmiður m
drętki - súr
drewniak - tréskór m
drobnowidz - smásjá f
droga - vegur m, braut f
drogi - dýr, kær
drozd - þröstur m
druga wojna światowa - seinni heimsstyrjöldin f, heimsstyrjöldin síðari f
druh - vinur m
drukarnia - prentsmiðja f
drużyna - sveit f
drzewo - tré n
drzewo iglaste - barrtré n
drzwi - hurð f
Dublin - Dyflinn
duch - andi m, draugur m, sál f
dudlać - gráta, drekka
dudy - lunga n
dumny - stoltur af eu.
Dunaj - Dóná
Duńczyk - Dani m
duński - danskur, danska f
dusza - sál f, andi m, draugur m
dutek - peningar
duży - stór
dworzec - stöð f
dwukropek - tvípunktur m
dwunastnica - skeifugörn f
dychawica - asmi m
dycht - algerlega, með öllu
dycki - ávallt, alltaf
dyktator - einræðiherra m
dylać - dansa
dym - reykur m
dymbcok - eik, eikatré
dyplom - vottorð n
dysk - kringla f, plata f, diskur, diskur m, geisladiskur m, liðþófi m
dyskoteka - diskótek
dyskusja - umræda f, deila f
dysleksja - lesblinda f, dyslexía f, lestrarörðugleikar
dysonans - ósamlyndi n, óeining f, mishljómur m
dżem - sulta f
dziać - atvikast
dziadek - afi m, hnetubrjótur m
dziadek do orzechów - hnetubrjótur m
działanie - virkni f, aðgerð f
dziąsło - tannhold n
dziecięcy - barn-
dziecinny - barn-
dzięcioł - spæta f
dzieciszczko - barn n
dziecko - barn n
dziedziczyć - erfa
dziedzina - formengi n, skilgreiningarmengi n
dziękówa - takk, þökk, þakka
dziękować - þakka
dziękówka - takk, þökk, þakka
dziękuję - takk, þökk, þakka
dziela - fyrir
dzień - dagur m
dzień dobry - góðan daginn
dziennikarstwo - blaðamennska, fréttamennska
dziennikarz - blaðamaður m
dziesięciolecie - áratugur m
dzik - villisvín n
dziki - villtur
dziób - nef n
dżip - jeppi m
dziś - í dag
dzisiaj - í dag
dżistać - slúðra, þvaðra, segja gróusögur
dziura - hellir m
dziwka - hóra f
dżungla - frumskógur m
dźwięk - tónn m
ebor - fílabein n
echolalia - bergmálstal n
Edmund - Játmundur
edyficjum - bygging f, hús n
Edyta - Edith
edytor tekstu - ritvinnsluforrit n
egzamin - próf n
ekologia - vistfræði
ekologio - vistfræði
ekosystem - vistkerfi
ekskomunika - kirkjubann n
eksperyment - tilraun f
eksplikować - skýra, afsaka, þýða
ekspozycja - sýning f
elefant - fíll m
elektroluks - ryksuga f
elektron - rafeind f
elektryk - rafvirki m
elf - álfur m, elfur f
elipsa - sporbaugur m
Elza - Elisabeth, Elísabet, Elísabeth
Elżbieta - Elisabeth, Elísabet, Elísabeth
embargo - hafnbann n
encyklopedia - alfræðibók f, alfræðirit n
epilog - eftirmáli m
erupcja - gos n, eldgos n, jarðeldur m
eschatologia - heimsslitafræði f
eskalator - rúllustigi m
eskulap - læknir m
esperanto - esperantó n
Estonia - Eistland n
estoński - eistneskur
etymologia - orðsifjafræði f, orðsifjar
eufemizm - skrauthvörf
Eurazja - Evrasía f
euro - evra f
europ - evrópín n
Europa - Evrópa f, Norðurálfa f
Europa Środkowa - Mið-Evrópa f
Europa Wschodnia - Austur-Evrópa f
Europa Zachodnia - Vestur-Evrópa
Europejczyk - Evrópumaður m, Evrópubúi m
europejski - evrópskur
ewangelista - guðspjallamaður m
eż - að
Ezop - Esóp
fabryka - verksmiðja f
facet - maður, karlmaður
facetka - kona f, kvennamaður m
facjata - andlit n
fagocista - fagottleikari m
fajfus - getnaðarlimur m, reður m, typpi n
fajny - fagur, fallegur, ljótur, ófagur
fakt - staðreynd
fala - bára f
fałszywy - rangur
familio - fjölskylda
famuła - fjölskylda
fana - fáni m
fandzolić - ljúga
faraon - faraó m
farerski - færeyskur, færeyska f
farma - býli n, bær m
farmaceutyk - lyf n
faryna - sykur
fasola - baun f
faszysta - fasisti m
fauna - dýraríki n
Federacja Rosyjska - Rússneska sambandsríkið n
fedrować - vinna
fefer - pipar m
feminizm - femínismi m
ferska - ferskja f
fest - mjög
fezeła - býfluga f
figa - fíkja f
filip - héri m
Filipiny - Filippseyjar
film - bíóleikur m
filok - penni m, kúlupenni m
filozof - heimspekingur m
filozofia - heimspeki f
filozoficzny - heimspekilegur
Fin - Finni m, Finnlendingur m
finalizować - enda
Finlandia - Finnland n
fioletowy - fjólublár
fiord - fjörður m
firma - firma n
fiza - eðlisfræði
fizjologia - lífeðlisfræði f
fiżon - baun f
fizyka - eðlisfræði
flądra - flyðra f
flag - fáni m
flaga - fáni m
flaszka - flaska f
flet - flauta f
fliger - flugvél f
flora - jurtaríki n
Florencja - Flórens
fluor - flúor n
folder - mappa f
fonem - fónem n, hljóðan f, hljóðungur m
fonetyka - hljóðfræði
fontanna - gosbrunnur m
forma - lögun f, mynd f, snið n, form n
forteklapa - flygill m
fortepian - flygill m
foryster - útlendingur m
fosfor - fosfór
fotograf - ljósmyndari m
foton - ljóseind f
Francja - Frakkland n
francuski - franskur, franska f
Francuz - Frakki m
fryc - Þjóðverji m
Fryc - Þjóðverji m
fryzjer - hárskeri m
fryzjerstwo - hárgreiðsla f
fryzura - hárgreiðsla
fulać - ljúga
fura - bíll m
furdygarnia - fangelsi n
furt - aftur, að nýju, á hinn bóginn
fusbal - fótbolti m
fusekla - sokkur m
futbol - fótbolti m
gąbka - svampur m, svampdýr n
gad - skriðdýr n
gadałka - dís f
gadatliwy - málugur, málgefinn, kjöftugur, ræðinn
gajdus - glópur m, þorskur
gajer - jakkaföt
gal - gallín n
gała - auga n, fótbolti m, hrafn m, kráka
galaktyka - stjörnuþoka f, vetrarbraut f
galaretka - hlaup n
gałąź - grein f
galert - hlaup n
Galilea - Galílea f
gałka muszkatołowa - múskat n
galoty - buxur (f)
ganc - algerlega, með öllu
gangol - jakkaföt
gapa - hrafn m, kráka
gar - pottur m
gara - svefn m, draumur m
gardło - kok n, háls m
garnek - pottur m
garnitur - jakkaföt
gasa - gata f, stræti n
gazeta - blað n, dagblað n
gdy - þegar
gdyby - bara
gdyż - því, af því að, vegna þess, vegna
gdzie - þar, hvar
gdzieś - einhversstaðar
geburstag - afmælisdagur m
gędźba - tónlist f
gej - hommi m
geografia - landafræði f
geologia - jarðfræði f
germański - þýskur, þýska f
gęś - gæs f
gest - látbragð n, látæði n, hreyfing f
gibki - fljótur
gierada - heimanfylgja f
giezło - skyrta f
gigant - jötunn m, risi m, tröll m, þurs m
gira - fótur m
gitara - gítar m
głąb - glópur m, þorskur
glacok - sköllóttur
glajza - þórín
glapa - kráka
gleba - jörð f
glin - ál n
glina - leir m, lögregluþjónn m
gliniarz - lögregluþjónn m
globus - höfuð n (człowieka), haus (innego zwierzęcia)
głodny - soltinn, svangur, hungraður
glon - þörungur m
głos - rödd f, atkvæði n
głosować - greiða atkvæði
głowa - höfuð n (człowieka), haus (innego zwierzęcia)
główny - aðal-
głuchy - heyrnarlaus, daufur
głupek - glópur m, þorskur
głupota - heimska f, flónska f, einfeldni f
gnat - bein n
gniazdo - hreiður n
gniew - reiði n, vonska f
gnot - barn n
godać - segja, tala
godka - ræða f, tunga f, mál n, tungumál n
godło - skjaldarmerki n
godoć - segja, tala
godzina - klukkustund f, stund f, tími m
godzina policyjna - útgöngubann n
gołąb - dúfa f
golarz - hárskeri m
golibroda - hárskeri m
goniec - boðberi m, biskup m
gora - eldsvoði m, bruni m
góra - fjall n, háaloft n, loft n, kvistur m
górą - fjall n
gorączka - sótthiti m, hiti m
góral - fjallahjól n
górnik - námumaður m
górnołużycki - efrisorbneskur, efrisorbneska
Góry Skaliste - Klettafjöll
gorzała - alkóhol n, áfengi n
gorzałka - vodki m
gorzki - beiskur
gorzoła - vodki m
gość - gestur m
gospodyni domowa - húsmóðir f, húsfrú f
gotować - sjóða, elda, matbúa, búa til mat
gówno - skítur m
gra - leikur m, spil n
graba - hönd f
gracz - leikmaður
grajcarek - korktrekkjari m, tappatogari m
gramatyka - málfræði f
gramofon - grammófónn m
granatowy - dimmblár
granica - landamæri, takmörk
Grecja - Grikkland n
grejpfrut - greipaldin f
grób - gröf f
grobowiec - flygill m
grom - þruma f
grota - hellir m, skúti m
gruba - náma f
gruby - feitur
grudzień - desember
grula - ólundarlegur
grupa - hópur m, sveit f, flokkur m
gruszka - pera f
Gruzja - Georgía f
gruźlica - berklar, tæring f
gryfny - fagur, fallegur, ljótur, ófagur
gryka - bókhveiti n
grypa - inflúensa f, flensa f
gryźć - bíta
grzebień - greiða f, kambur m, hárgreiða f
grzech - synd f
grzechotnik - skellinaðra f, skröltormur m
Grzegorz - Gregor
grzyb - sveppur m
guła - kalkúnn m
gularz - kalkúnn m
guli - því, af því að, vegna þess, vegna
guma - smokkur
gumka - smokkur
gupielok - glópur m, þorskur
gwiazda - stjarna
gwiazdozbiór - stjörnumerki n
Gwinea - Gínea f
gwóźdź - nagli m
gwóźdź programu - hápunktur
gżegżółka - gaukur m
gzub - barn n, magi m, kviður m, búkur m, belgur m
hajtok - hnífur m
halibut - lúða f, spraka f
handszuły - hanski m
hara - vodki m
harfa - harpa f
hau - voff
haw - þar, þarna, þangað
hę - hvað
heksa - galdranorn f, norn f
hel - helín n
Hellada - Grikkland n
heparyna - heparín
Herod - Heródes
het - fjarri
hetman - drottning f
hica - hiti m
hiena - hýena f
Himalaje - Himalajafjöll
hinduizm - hindúismi m, hindúatrú f
Hindus - Indverji m
hipokryzja - hræsni f
hipopotam - flóðhestur m
hipoteza - tilgáta
historia - saga f, sagnfræði f, sögn f, frásaga f
historyczny - sögulegur
Hiszpania - Spánn
hiszpański - spænskur, spænska f
hobby - áhugamál n, hugðarefni n
holenderski - hollenskur, hollenska f
homoseksualizm - samkynhneigð f
Honduras - Hondúras
Hongkong - Hong Kong
hotel - hótel n, gistihús n
hrabia - greifi m
hreczka - bókhveiti n
huragan - fellibylur
hyca - hiti m
hydrologia - vatnafræði
i - og
ich - þeirra
identyczny - samhljóða
idiota - þorskur m, kálfur m
ignorować - hafa að engu
igrzyska olimpijskie - ólympíuleikar
II wojna światowa - seinni heimsstyrjöldin f, heimsstyrjöldin síðari f
imbir - engifer n
imię - nafn n, fornafn n
imiennik - nafni m
imigracja - innflutningur f
Indie - Indland n
indyk - kalkúnn m
Indyk - Indlandshaf n
informatyka - tölvufræði f
inkszy - annar
inny - annar
ino - bara
insekt - skordýr m, skorkvikindi n
instrument - hljóðfæri n, verkfæri n, tæki n, áhald n, mælitæki n
intelektualny - andlegur
interesujący - skemmtilegur
internet - Internet n
Internet - Internet n
interwencja - íhlutun f
intryga - undirferli n, brögð
inundacyja - flóð n
inwalida - fatlaður, hreyfihamlaður
inwentarz - eignarskrá f
iny - annar
inżynier - verkfræðingur m
inżynieria - verkfræði f
irański - íranskur
Irlandia - Írland
Irlandia Północna - Norður-Írland n
irlandzki - írskur
iryd - iridín n
iść - ganga, fara, liða
iście - örugglega
iść na skibę - stela
islam - íslam n
Islandczyk - Íslendingur m
Islandia - Ísland n
islandzki - íslenskur, frónskur, íslenska f, frónska f
istnieć - vera
italski - ítalskur, ítalska f
itd. - o.s.frv.
iż - að
izba - frið m, herbergi n
ize - að
Izrael - Ísrael n
Izraelczyk - Ísraelsmaður m
izraelski - ísraelskur
ja - ég
jabłko - epli n
jabłoń - eplatré n
jacht - snekkja f, lystisnekkja f
jadać - borða
jądro - eista n, frumeindakjarni m, atómkjarni m, kjarni m, frumukjarni m, stýrikerfiskjarni m
Jadwiga - Heiðveig
jagnię - lamb n
jagoda - kinn f
jajecznica - hrært egg n
jajko - egg
jajko sadzone - spælegg n
jajo - egg n
jajówa - hrært egg n
jak - hvernig, eins, svo
jakby - eins og
jaki - hvaða, hver, hvor, sem, er
jakmiarz - algerlega, með öllu
jako - hvernig, eins, svo
jak się masz? - hvernig hefurðu það?
jak sobie pościelesz, tak wyspać się wyśpisz - eins og maðurinn sáir, svo skal hann og uppskera
jałmużna - ölmusa f
jałowiec - einir m, einiber n
jałówka - kvíga f
Jan - Jón
jangryst - stikilsber n
Jan Kowalski - Jón Jónsson m
jantar - raf n
japa - hellir m
Japonia - Japan
japoński - japanskur, japanska
jara - tengdamóðir f
jarecka - móðir f
jarosz - grænmetisæta
jarzyna - grænmeti n
jaskinia - hellir m
jaskółka - svala f
jasny - léttur, bjartur
jastrząb - haukur m
jaszczurka - eðla f
jątrew - mágkona f
jebadło - svefnherbergi n, rúm n
jednooki - eineygður, eineygur
jednorożec - nashyrningur m
Jędrzej - Andreas
jedza - matur
jedzenie - matur
jego - hans, þess
jej - hennar
jeleń - hjörtur m
jemioła - mistilteinn m
jemiołuszka - silkitoppa f
jeniec - stríðsfangi m, fangi m
jeść - borða
jesień - haust n
jeśli - ef
jest - vera, verða
jeż - broddgöltur m
jeżeli - ef
jezioro - vatn n
Jezus - Jesús m
Jezus Chrystus - Jesús Kristur
język - tunga f, mál n, tungumál n
język ojczysty - móðurmál
jeżyna - brómber n
jidysz - jiddíska
jogurt - jógúrt f
jon - jón f
Jordańczyk - Jórdani m
Jordania - Jórdanía f
jordański - jórdanskur
Jowisz - Júpíter m
judaizm - gyðingdómur m
judofob - gyðingahatari m
Jugosławia - Júgóslavia
juny - ungur
jupa - jakki m
Jupiter - Júpíter m
jura - júratímabilið n
jutro - á morgunn
kabaczek - kúrbítur
kaban - svín n
kabanina - svínakjöt
kabat - kápa f
kac - timburmenn
kaczan - glópur m, þorskur
kaczka - önd f
kaczor - steggur m
Kaczor Donald - Andrés Önd
kafej - kaffihús n
kaffa - kaffi n
kaganiec - múll m
Kair - Kaíró
kaj - þar, hvar
kajet - stílabók f
kajman - krókódíll m
kakao - kakó n, kakóduft n, endaþarmsop n
kaktus - kaktus
kalafa - nef n, áfengissjúklingur m, drykkjusjúklingur m, andlit n
kalafior - blómkál n
kalapitra - höfuð n (człowieka), haus (innego zwierzęcia)
kaldera - askja f, sigketill m
kalejdoskop - kviksjá
kalendarz - almanak n
kalenica - mænir m
kalfas - magi m, kviður m, búkur m, belgur m
kam - hvert, þar, hvar
kamasz - skór m
kambr - kambríumtímabilið n
kamera - kvikmyndatökuvél f
kamień - steinn m, tannsteinn m, (nýrna)steinn m
kanał - rás
kanapka - samloka f
kancerogenny - krabbameinsvaldandi
kangur - kengúra f
kanka - maríjúana n, hass n
kantyna - mötuneyti n
kapcylinder - hattur m
kapeluch - hattur m
kapelusz - hattur m
kąpiółka - baðherbergi n
kapłan - prestur m
kapować - skilja
Kapsztad - Höfðaborg
kapusta - kál n, peningar
kara - refsing f, ráðning f
karaba - köttur m
Karaczi - Karachi
karetka - sjúkrabifreið f
karibu - hreindýr n
kark - hnakki m
karlus - drengur m, piltur m
karman - peningaveski n, seðlaveski n, veski n
karp - karfi m
karta - spil n
kartofel - jarðepli n, kartafla f
karty - spil n
kast - kassi m
kasta - kassi m
kasza - grautur m
kaszalot - búrhvalur
kaszel - hósti m
kaszubski - kassúbískur, kassúbíska f
katana - jakki m, timburmenn
Katarzyna - Katarína
kation - katjón f, plúsjón f
katolicki - kaþólskur
kawa - kaffi n
kawał - hluti m
kawałek - hluti m
kawaleria - riddaralið n
kawa wesoła - hóruhús n
kawiarnia - kaffihús n
kawon - vatnsmelóna f
kazalnica - prédikunarstóll m, ræðustóll m
kazatelnica - prédikunarstóll m, ræðustóll m
każdy - hver
kaznodzieja - predikari m
kciuk - þumall m, þumalfingur m
keczup - tómatsósa f
kędy - þar, hvar
kejter - hundur m
kejza - ostur m
kernel - eista n, frumeindakjarni m, atómkjarni m, kjarni m, frumukjarni m, stýrikerfiskjarni m
keta - keðja f, fjallgarður m
kiecka - kjóll m, pils n
kiedy - hvænar, þegar
kiełbasa - pylsa f, bjúga n
kiepeła - höfuð n (człowieka), haus (innego zwierzęcia)
kierownik - förstöðumaður m
kierunek - átt f
kierz - kjarr n, runni m
kierzek - kjarr n, runni m
kieszonkowiec - vasaþjófur m
kij - stafur m, prik n, hæð f
Kijów - Kíev, Kænugarður m
kilo- - kíló-
kilometr - kílómetri m
kimono - svefn m, draumur m
kino - bíó n, kvikmyndahús
kinol - nef n, áfengissjúklingur m, drykkjusjúklingur m
kintop - bíó n, kvikmyndahús, gaman
kipiatok - sjóðandi vatn n
kira - vodki m
kirchóf - kirkjugarður m
kireja - kápa f
Kirgistan - Kirgistan
kiść - úlnliður m
kista - kassi m
kiszka - mjólk f
kit - lygi f
kitajski - kínverskur
kiwi - kíví n
kląć - bólta, bölva, formæla, sverja
klachać - slúðra, þvaðra, segja gróusögur
klacz - hryssa f, meri f, kapall f
klajdać - klæða, klæða sig, klæðast
kłamać - ljúga
kłamny - rangur
klamot - steinn m, tannsteinn m, (nýrna)steinn m
kłamstwo - lygi f
kłapaczka - munnur m
klapsznita - samloka f
klara - sól f
klekotun - storkur m
kler - prestastétt f, klerkastétt f
kliber - nef n, áfengissjúklingur m, drykkjusjúklingur m
klient - viðskiptavinur m, viðskiptamaður m, kúnni m, biðlari m
klikać - smella
klima - loftjöfnun f
klimat - loftslag n
klimatyzacja - loftjöfnun f
klon - ahorntré n, mösur m, hlynur m, klón n
kłopotliwy - erfiður
kłos - ax n
kloszard - flakkari m, flækingur m
kłótnia - rifrildi n
klub - félag n, klúbbur m
kluber - nef n, áfengissjúklingur m, drykkjusjúklingur m
klucz - lykill m
kluft - klæðnaður m
kluka - nef n
kluza - fangelsi n
klybać - slúðra, þvaðra, segja gróusögur
kniądz - prestur m
knipa - bók f
knot - kveikur m
koafiura - hárgreiðsla
koalicja - samsteypa f
kobalt - kóbalt
kobieta - kona f, kvennamaður m
kobieta lekkich obyczajów - gleðikona f, skækja f, vændiskona f
koc - ábreiða f
kochać - elska
kochanie - elska
kociamber - köttur m
kociątko - kettlingur
kocik - kettlingur
kociokwik - timburmenn
kocur - köttur m
kod kreskowy - strikamerki m
koja - rúm n
kojo - rúm n
kokosz - hæna f
kokoszka - hæna f
kokota - gleðikona f, skækja f, vændiskona f
kolano - hné n, kné n
kolczatka - mjónefur m
kolendra - kóríander
koleś - maður, karlmaður
koło - reiðhjól n, hjól n
kolonia - nýlenda f
kolonoskopia - ristilspeglun m
kolor - litur m
Kolumb - Kólumbus
kolumna - súla f, dálkur m
kołyska - vagga f
koma - komma f
komar - moskítófluga f
komat - komma f
komedia - gamanleikur m
komedogenny - …sem lokar svitaholunum
kometa - halastjarna
komin - reykháfur m
kominiarka - lambhúshetta f
komora gazowa - gasklefi m
komórka - fruma f, farsími m, gemsi m
komp - tölva
kompromis - málamiðlun f
komputer - tölva
komunizm - kommúnismi m
koń - hestur m, hross n, riddari m, getnaðarlimur m, reður m, typpi n
kóń - hestur m, hross n, riddari m
koncert - hljómleikar, tónleikar, konsert m
kończyć - enda
kończyna - limur m
kondensator - rafþéttir
kondom - smokkur
Konfucjusz - Konfúsíus m
koniak - koníak n
koniec - endir
koniugacja - sagnbeyging f
konował - skottulæknir m
konspiracja - samsæri n
konstelacja - stjörnumerki n
kontakt - samband n
kontent - ánægður
kontrabas - kontrabassi m
koń trojański - Trójuhestur
kontynent - álfa f
kopalnia - náma f
Kopenhaga - Kaupmannahöfn
koper - dill n
kopruch - moskítófluga f
kopyto - hófur m
kora - börkur m
Koreańska Republika Demokratyczna - Alþýðulýðveldið Kórea
korkociąg - korktrekkjari m, tappatogari m
korona - kóróna f, krúna f, króna f
korpulentny - feitur
Korsyka - Korsíka f
korzeń - rót f
kos - svartþröstur m
kosa - hnífur m
kość - bein n
kościół - kirkja f
Kościół - kirkja f
kość słoniowa - fílabein n
kosmopolita - heimsborgari m
Kostaryka - Kosta Ríka
kostium - gervi n
kosz - körfuknattleikur m, körfubolti m
koszt - kostnaður
kosztować - kosta, bragða, smakka
kosztowny - dýr, kær
koszula - skyrta f
koszykówka - körfuknattleikur m, körfubolti m
kot - köttur m
kotek - kettlingur
kotku - kettlingur
kotwica - akkeri n
kowal - járnsmiður m
koza - geit f
kozioł ofiarny - blóraböggull
Koziorożec - Steingeitin
kradzież - þjófnaður m, stuldur m
kraj - land n
krajać - sneiða, stela
Kraj Basków - Baskaland n
Kraków - Kraká f
krancek - hluti m
kraść - stela
krasula - kýr f, naut
krater - gígur m
kreda - krít f, krítartímabilið n
kręgosłup - hryggsúla f, hryggur m
kręgowiec - hryggdýr n
krem - krem n
kremacja - líkbrennsla f, bálför f
krepel - berlínarbolla f
krew - blóð n
krewetka - rækja f
kripel - fatlaður, hreyfihamlaður
kroić - sneiða, stela
krok - þrep n, spor n
krokodyl - krókódíll m
krokodyle łzy - krókódílstár, hræsnistár, uppgerðarhryggð f
król - konungur m, drottinn m
królestwo - konungsríki n, ríki n
królik - kanína f
królowa - drottning f
kromka - sneið f, brauðsneið f
krotofila - gaman
krowa - kýr f, naut
kruk - hrafn m
krybuny - kross m
kryminał - glæpasaga f, fangelsi n
Kryspin - Krispin
Krystian - Kristján m
krzak - kjarr n, runni m
krzem - silíkon n
krzesło - stóll m
krzesny - guðfaðir m
krzest - skírn f
krzew - kjarr n, runni m
krzyk - hróp n
krzywoprzysięstwo - meinsæri n
krzyż - kross m
krzyżówka - krossgáta f, stokkönd f, krossgötur
ksiądz - prestur m
książka - bók f
książka kucharska - matreiðslubók
księga - bók f
księgarnia - bókabúð f
księgowość - bókhald n, bókfærsla f
księgozbiór - bókasafn n
księżniczka - prinsessa f
księżyc - tungl n
Księżyc - Tunglið
kształt - mynd f
który - hvaða, hver, hvor, sem, er
ktoś - einhver
kubański - kúbanskur
kubek w kubek - samhljóða
Kubuś Puchatek - Bangsímon m
kuchnia - eldhús n
kucza - kofi m
kuć żelazo, póki gorące - hamra skal járn meðan heitt er
kukułka - gaukur m
kukurydza - maís m
kula - kúla f, fótur m
kulka - kúla f
kulos - fótur m
kult - dýrkun f
kupidło - verð n
kupować - kaupa
kura - hæna f
kurczak - kjúklingur
kurka - kantarella f, hæna f
kurki - kantarella f, hæna f
kuropatwa - akurhænsn n
kurtka - jakki m
kurtyzana - gleðikona f, skækja f, vændiskona f
kurwa - hóra f, mella f, púta f
kusik - koss n
kuśka - getnaðarlimur m, reður m, typpi n
kusy - djöfull m
kutwa - nirfill m
kwadrans - stundarfjórðungur m
kwas - sýra f
kwas foliowy - fólinsýra, fólat, fólasín
kwaśny - súr
kwiat - blóm n
kwiecień - apríl
kynologia - hundafræði
łabęć - svanur m
łabędź - svanur m
labirynt - völundarhús n
łacina - latína f
łacny - léttur
lacz - höfuð n (człowieka), haus (innego zwierzęcia), getnaðarlimur m, reður m, typpi n, lögregluþjónn m
ład - regla f, lag n, röð
ląd - land n
ładny - fagur, fallegur, ljótur, ófagur
laga - stafur m, prik n, hæð f
łagodność - blíða f
lajbik - brjóstahaldari m
łąka - graslendi n
lampa - lampi m
lampart - pardusdýr n
łańcuch - keðja f, fjallgarður m
land - þorp n, sveit f
las - mörk f, skógur m
lat - ár
lata - ár, pils n
latawiec - flugdreki m
lato - sumar n
łatwo - auðveldlega, hæglega
łatwy - léttur
Laura - Lára
lawa - hraun n
ławka - bekkur m
łazienka - baðherbergi n
le - en
lebo - eða
lecieć - fljúga, hænast að e-m
lecz - en
lek - lyf n
lekarstwo - lyf n
lekarz - læknir m
lekceważyć - fyrirlíta, ansa ekki, hafa að engu
lekka atletyka - frjálsar íþróttir
lekkoatletyka - frjálsar íþróttir
lektyka - burðarstóll m
leopard - pardusdýr n
lepak - aftur, að nýju, á hinn bóginn
łepetyna - höfuð n (człowieka), haus (innego zwierzęcia)
lepszy - betri
lesbijka - lesbía f
leśnictwo - skógrækt f, trjárækt f
lew - ljón n
Lew - Ljón
lewica - vinstri n
lewicowy - vinstri
lewy - vinstri
leżeć - liggja
łgać - ljúga
Lhasa - Lasa, Lhasa
libertariański - frjálshyggja
licencja - leyfi n, réttindi n
liczba atomowa - sætistala f
liczba mnoga - fleirtala f
liczba pojedyncza - eintala f
liczebnik - töluorð n
liczebnik główny - frumtala f
liczebnik porządkowy - raðtala f
liczyć - telja
liczykrupa - nirfill m
Liguria - Lígúría
likier - líkjör m
lilia - lilja
lingwista - málamaður m, málfræðingur m, málvísindamaður m
lingwistyka - málvísindi
lipa - linditré n
lipiec - júlí
liść - blað n, lauf n
list - bréf n
lista dyskusyjna - póstlisti m
listopad - nóvember
list otwarty - opið bréf n
lit - litín n, liþín n
litera - stafur m, bókstafur m
literat - rithöfundur m
literatura - bókmenntir
literówka - pennaglöp, ritvilla, slæm ritvilla
litr - lítri m
litra - lítri m
liturgiczny - litúrgískur
Litwa - Litháen n
lizać - sleikja
Lizbona - Lissabon
lód - ís m
lodowiec - jökull m
lodówka - ísskápur m, kæliskápur m, hávella f
łodyga - leggur m
łódź - báturin
logika - rökfræði
logiko - rökfræði
lokatiwus - staðarfall n
łokieć - olnbogi m
lola - stafur m, prik n, hæð f
Londyn - Lundúnir
łoś - elgur m
łosoś - lax m
lotnisko - flugvöllur m
lotos - lótus
lotus - lótus
Łotwa - Lettland n
łoże - rúm n
łóżko - rúm n
lub - eða
łucznictwo - bogfimi
ludność - fólksfjöldi m, landslýður m, höfðatala f
ludzie - fólk n
łudzikwiat - apríl
ludzki - mennskur, mannlegur
łuk - bogi m, örk m
luksus - lúxus
luna - tungl n
luńt - hluti m, hundur m
lustro - spegill m
luty - febrúar
łużycki - sorbneskur, sorbneska f
łydka - kálfi m
łysienie - hárlos n
łysy - sköllóttur
łyżka - skeið f
łza - tár n
łża - lygi f
mać - móðir f
macica - leg n
maciek - magi m, kviður m, búkur m, belgur m
macocha - stjúpa f
mączka - duft n
Madera - Madeiraeyjar
mądry - vitur, spakur, ráðlegur, viturlegur
Maghreb - Magreb
magnes - segull m
magnez - magnesín n
maj - maí m
majonez - majónes n
mak - draumsóley f, valmúi m, valmúafræ
mąka - mjöl n
makaron - núðlur
makrela - makríll m
malaria - malaría f
malarstwo - myndlist f, málverk
malarz - málari m
maleć - minnka
malin - hindber n
malina - hindber n
małomówny - fáorður, fámáll, þegjandalegur
małpa - api m
Malta - Malta
mały - lítill, smár
mały palec - litlifingur m
małżeństwo - hjónaband
małżonek - bóndi m, eiginmaður m, maður m
małżonka - kona, eiginkona f, kona f
mam - hafa
mama - tengdamóðir f
mantel - kápa f
mapa - kort n, landakort n
maras - skítur m, óhreinindi, saur m, sorp n
marcepan - marsípan n
marchew - gulrót f
marchewka - gulrót f
Marcin - Martin m
margaryna - smjörlíki n
marihuana - maríjúana n, hass n
marka - frímerki
marmolada - marmilaði m
marmur - marmari m
marszałek - forseti m
martwy - dauður, dáinn, látinn
marzec - mars
marzenie - draumur
marzenie senne - svefn m, draumur m
masara - fluga f
maść - áburður m
maska - andlit n
maskonur - lundi m
maskonur atlantycki - lundi m
masło - smjör n
maszyna - vél f
maszyna do szycia - saumavél f
matematyka - stærðfræði f
materac - dýna f
matka - móðir f
matriarchat - mæðraveldi n
mąż - bóndi m, eiginmaður m, maður m
mazak - andlit n
mazojen - majónes n
mecenas - málfærslumaður m
meczet - moska f
mediana - miðgildi
Mediolan - Mílanó
meduza - marglytta f
medycyna - læknisfræði f
medyk - læknir m
Meksyk - Mexíkó n, Mexíkóborg f
Melanezja - Melanesía f
meldunek - tilkynning f
melki - brjóstsykur m, kandís n, steinsykur m
menadżer - förstöðumaður m
menda - flatlús f
mendoweszka - flatlús f
Merkury - Merkúríus, Merkúr
męski - karlmannlegur, karlkyn n
meteor - vígahnöttur m
metoda - aðferð f
metr - metri m
metro - neðanjarðarlest f
mewa - máfur m
mężczyzna - maður, karlmaður
Mezopotamia - Mesópótamía
mezozoik - miðlífsöld f
mgła - þoka f
Miami - Miami
mianownik - nefnifall
miasto - borg f, bær m
miasto stołeczne - höfuðborg f
miau - mjá
miażdżyca - æðakölkun
mieć - hafa
mieć gdzieś - fyrirlíta, ansa ekki, hafa að engu
mieć na oku - hafa augastað á einhverju
miecz - sverð n
miecznik - háhyrningur m
miedziany - kopar-, koparrauður
miedźwiedź - björn
międzynarodowy - alþjóðlegur
miejsce - staður m, rúm n, sæti n, lag n
miejscownik - staðarfall n
miękkość - mýkt
mielcuch - ölgerð f, bjór, öl
mieli - hafa
mieśćce - staður m, rúm n, sæti n, lag n
mieśce - staður m, rúm n, sæti n, lag n
miesiąc - mánuður m, tungl n
miesiączek - tungl n
mięsień - vöðvi m
mięso - kjöt n
mięsopustnik - febrúar
mięsożerca - kjötæta f
mieszkać - búa
mieszkanie - íbúð f
mieszkaniec - borgari m, íbúi m
mięta - minta f
mikrofon - hljóðnemi m
Mikronezja - Míkrónesía f
mikroskop - smásjá f
mila - míla
miłość - ást f, elska f, kærleikur m, ástúð f
miłosierny - hjartagóður
minister - ráðherra m
minuta - mínúta f
miód - hunang n, mjöður m
miraż - hilling f
miska - skál f
mit - goðsögn f
mleko - mjólk f
młody - ungur
mnogdy - oft
moc - magn n, kraftur, vald
móc - geta, megna, mega
mocz - þvag n
modlić się - biðja
modlitwa - bæn f
modrakowy - blár
modry - blár
mój - minn
Mojżesz - Móse
mokry - votur, blautur
molo - bryggja f
moment - augnablik n, augabragð n
Monachium - München
monarchia - konungsveldi n
monocykl - einhjól n
monoteizm - eingyðistrú f
mora - andi m, draugur m, sál f
morderca - morðingi m
mordować - drepa, deyða, negla fyrir e-ð
morela - aprikósutré n, aprikósa f
morkwa - gulrót f
morze - haf, sjór, ægir, úthaf
Morze Adriatyckie - Adríahaf n
Morze Arktyczne - Norður-Íshaf n
Morze Bałtyckie - Eystrasalt n
Morze Czarne - Svartahaf
Morze Karaibskie - Karíbahaf n
Morze Północne - Norðursjór m
Morze Śródziemne - Miðjarðarhaf
Moskwa - Moskva f
most - brú f
mostek - lítil brú f, bringubein n
motor - vél f
motorówka - vélbátur
motyl - fiðrildi n
Mount Everest - Everestfjall
mowa - ræða f, tunga f, mál n, tungumál n
mówić - segja, tala
może - ef til vill, kannski, geta, megna, mega
mózg - heili m
możliwość - möguleiki m
możliwy - mögulegur, hugsanlegur
mrówka - maur m
mróz - frost n
Ms - staðarfall n
msza - messa f
mucha - fluga f
muchomor - reifasveppir
muchomór - reifasveppir
mućka - kýr f, naut
mugol - muggi (mashang)
mumia - múmía f, smyrlingur m
mundurowy - lögregluþjónn m
mur - múr m
muraszka - maur m
musztarda - sinnep n
muzeum - safn
muzułmanin - múslími m
mużyk - maður, karlmaður
muzyka - tónlist f
my - við
myć - þvo
mycka - húfa f
mydło - sápa f
mysikrólik - glókollur m
myśleć - hugsa
mysz - mús f
Myszka Miki - Mikki Mús
myt - goðsögn f
mżawka - úði m
N - tækisfall n
nacja - þjóð f, þjóðerni n
nacjonalizować - þjóðnýta
nadbaba - langamma f
nadgarstek - úlnliður m
nadzieja - von f
nadzorca - vörður m
nagle - skyndilega
nagroda - verðlaun
Nairobi - Naíróbí
najpierw - fyrst
naleśnik - pönnukaka f
należeć - tilheyra
nalot - loftárás f
Namibia - Namibía f
namiot - tjald n
naonczas - í þá tíð
na pewno - örugglega
napisać - skrifa
napój - drykkur m
naprany - drukkinn, fullur, ölvaður
na przykład - til dæmis
naród - þjóð f
narodowość - þjóðerni n
narodowy - þjóðlegur, þjóðar-
narzędnik - tækisfall n
nasiono - fræ n
następnie - eftir, vegna, síðár
na sto procent - örugglega
nasz - okkar, vor
natenczas - í þá tíð
naturalny - eðlilegur, náttúrlegur
natychmiast - strax
natychmiastowo - strax
nauczyciel - kennari m
nauka - fræði f
naukowiec - fræðimaður m
naukowy - vísindalegur
nazista - nasisti m
nazizm - nasismi m
nazwa - nafn n
nazwa własna - eiginnafn n
nazwisko - eftirnafn n
nazywać - nefna, heita
n.e. - e.Kr.
Neapol - Napólí
nektaryna - nektarína f
nektarynka - nektarína f
neofaszysta - neofasisti m
neologizm - nýyrði n
neon - neon
Neptun - Neptúnus
nerka - nýra n
neutrino - fiseind f
neutron - nifteind f
ni - hvorki…né, nei, ekki
nic - ekkert
nie - nei, ekki
nie- - ó-
niebawem - brátt, bráðum, bráðlega, senn
niebezpieczeństwo - hætta f, háski m, voði m
niebezpieczny - hættulegur
niebieski - blár
niebiosa - loft n, himinn m, himnar
niebo - loft n, himinn m, himnar
niecierpliwy - óþolinmóður
nieduch - sjúkdómur m, sýki f, mein n, veiki f
niedziela - sunnudagur m
niedźwiedź - björn
niedźwiedź polarny - ísbjörn m
niegrzeczny - óþekkur
niektóry - sumur, sumir/sumar
niełatwy - erfiður
nie ma róży bez kolców - engin rós utan þyrna
Niemcy - Þýskaland n
Niemiec - Þjóðverji m
nie mieć - nei, ekki, hafa
Niemiecka Republika Demokratyczna - Þýska Alþýðulýðveldið
niemiecki - þýskur, þýska f
nienawidzić - hata
nieobecny - fjarstaddur, hugsi
nie od razu Kraków zbudowano - Róm var ekki byggð á einum degi
niepełnosprawność - fötlun
niepodległość - sjálfstæði n
niepodległy - sjálfstæður
niestety - því miður
nieszczęścia chodzą parami - sjaldan er ein báran stök
nietoperz - leðurblaka f
nieupoważniony - óheimill
niewiasta - kona f, kvennamaður m
niewiastka - tengdadóttir f
niewinny - saklaus
niewolnictwo - þrældómur m
niewolnik - þræll m
nie wszystko złoto, co się świeci - ekki er allt gull sem glóir
niewystarczający - ófullnægjandi
niezależny - frjáls
niezapominajka - gleym-mér-ei f
nigdy - aldrei
nigdzie - hvergi
nikaj - hvergi
Nikaragua - Níkaragva f, Nikaragúa f
Nil - Níl
nim - það
niszczyć - eyðileggja
niż - en
niża - láglendi m
nizina - láglendi m
no - já
noc - nótt f
nocny - nátt-, nætur-
noga - fótur m
nogawice - buxur (f)
nordycki - norrænn
Norweg - Norðmaður m
Norwegia - Noregur m
norweski - norskur, norska f
nos - nef n, áfengissjúklingur m, drykkjusjúklingur m
nosorożec - nashyrningur m
nów - nýtt tungl n
Nowa Gwinea - Nýja-Gínea
Nowa Zelandia - Nýja-Sjáland n
nowotwór - æxli
Nowy Jork - New York-borg f, New York-fylki n
Nowy Rok - nýár n
nóż - hnífur m
nożyce - skæri n
nożyczki - skæri n
np. - t.d.
nuda - leiðindi
nudelzupa - súpa f
nudle - núðlur
nudny - leiðinlegur, óskemmtilegur
numer - númer n
nurkować - kafa, dýfa sér
nyga - moskítófluga f
nyra - nirfill m
nyrol - nirfill m
obcas - hæll m
obchodzić - ganga í kringum e-ð, halda, koma e-m við
obcokrajowiec - útlendingur m
oberżyna - eggaldin n
obiad - hádegisverður
obiecadło - stafróf f
obiecny - algengur
obiektywność - hlutlægni f
obiektywny - hlutlægur
obłuda - hræsni f
obój - óbó n
obojczyk - viðbein n
obowiązek - skylda f
obraz - málverk n, bíóleikur m
obrona - vörn f, málsvörn f
obrońca - verjandi m
obszar - svæði n
obwiniać - kenna
obywatel - borgari m, ríkisborgari, m, borgarbúi m, þegn m
obywatelstwo - ríkisborgararéttur m
ocean - haf n
Ocean Arktyczny - Norður-Íshaf n
Ocean Atlantycki - Atlantshaf n
Oceania - Eyjaálfa f
Ocean Indyjski - Indlandshaf n
Ocean Południowy - Suður-Íshaf n
Ocean Spokojny - Kyrrahaf n
ocet - edik n
ociec - faðir m, pabbi m
ociężały - ólundarlegur
oczywisty - augljós
odbyt - endaþarmsop n
oddział - sveit f, deild f
odkurzacz - ryksuga f
odmiana - beyging f, tegund, kyn, ættkvísl f
odpowiedź - svar n, lausn f
odpowiedzialność - ábyrgð f
odrażający - herfilegur
odraźny - herfilegur
odszkodowanie - bætur /f
odważny - hugaður, hugprúður
odzież - klæðnaður m
ogień - eldur m
ogier - graðhestur m
ognisko - bál n
ogon - sporður, tagl, stél, hali, skott, rófa biðröð
ogórek - agúrka, gúrka f
ograniczony - takmarkaður, vitgrannur
ogród - garður m
ogrodnik - garðyrkjumaður m
ogród zoologiczny - dýragarður
ojciec - faðir m, pabbi m
ojciec chrzestny - guðfaðir m
ojczyc - sonur m
ojczyzna - föðurland n
ojla - ugla
ok. - u.þ.b.
okaryna - okkarína
okłamywać - ljúga
okno - gluggi m
oko - auga n
okoń - aborri m
okręt podwodny - kafbátur m
okulary - gleraugu
okulary przeciwsłoneczne - sólgleraugu
okulista - augnlæknir m
okup - lausnargjald n
olej - olía f
oliwka - ólífa f
ołów - blý n
ołówek - blýantur m
ołtarz - altari n
oma - amma f
omieszkać - nei, ekki
ona - hún
oni - þeir m, þau n
ono - það
ONZ - S.þ.
oologia - eggjafræði
opal - ópall m
opalenizna - brúnka f
opat - ábóti m
opera - ópera f
operacja - uppskurður m, skurður m, aðgerð f
opero - ópera f
opiąć - aftur, að nýju, á hinn bóginn
opięć - aftur, að nýju, á hinn bóginn
opium - ópíum
oprócz tego - auk þess
opryszczka - áblásturssótt f
oraz - og
ordnung - regla f, lag n, röð
ordowik - ordóvisíumtímabilið n
Organizacja Narodów Zjednoczonych - Sameinuðu þjóðirnar
Organizacja Traktatu Północnoatlantyckiego - Atlantshafsbandalagið n
organizm - lífvera f
orgazm - fullnæging f
orka - háhyrningur m
orlab - leyfi n, orlof n, frí n
ornitologia - fuglafræði f
ortografia - réttritun f, stafsetning f
orzba - háhyrningur m
orzeczenie - umsögn f
orzeł - örn m
osa - geitungur m
osiągalny - fáanlegur
osika - ösp f, blæösp f
osioł - asni m
ośmiornica - kolkrabbi m
osoba - maður m, persóna f
ostrężyna - brómber n
ostryga - ostra f
ostrze - egg f
ostrzegać - vara (e-n við e-u)
ostrzeżenie - varnaður m, viðvörun f, aðvörun f, áminning f
ostrzyć - brýna, skerpa, hvessa
oszustwo - flærð
otyłość - fita f, offita f
owad - skordýr m, skorkvikindi n
owca - kind f
owies - hafrar
owijać w bawełnę - tala í kringum e-ð
owoc - aldin n
ożarty - drukkinn, fullur, ölvaður
ożyna - brómber n
pachniarz - nef n
pacholę - drengur m, piltur m
paciuk - rotta
Pacyfik - Kyrrahaf n
pączek - berlínarbolla f
Pad - Pó
padać - segja, tala
padlina - hræ n
pagórek - hóll, hæð
pająk - kónguló f, könguló f
pajęcznik - september, október, nóvember
pajęczyna - kóngulóarvefur m
pajucina - kóngulóarvefur m
Pakistan - Pakistan
pakli - ef
Pakt Północnoatlantycki - Atlantshafsbandalagið n
pała - höfuð n (człowieka), haus (innego zwierzęcia), getnaðarlimur m, reður m, typpi n, lögregluþjónn m
palacz - reykingamaður m
pale - höfuð n (człowieka), haus (innego zwierzęcia), getnaðarlimur m, reður m, typpi n, lögregluþjónn m
palec - fingur m, tá f
palec wskazujący - vísifingur m
palenie - reyking f
Palestyńczyk - Palestínumaður
pamięć - minni n, endurminning f
pan - herra m
pancernik - herskip n
pani - þér, frú f
Panna - Meyjan
państwo - land n
pantera - pardusdýr n
papier - pappír
papież - páfi m
Papua-Nowa Gwinea - Papúa Nýja-Gínea
papuć - skór m
papuga - páfagaukur m
paragraf - grein f
parasol - regnhlíf f, sólhlíf f
parking - bílaplan n
park narodowy - þjóðgarður m
parlament - þing n
partykuła - smáorð n
Paryż - París
pasażer - farþegi m
pasierb - stjúpsonur m
pasierbica - stjúpdóttir f
pasjans - kapall m
Pas Kuipera - Kuiper-beltið n
pasożyt - sníkill m, sníkjudýr n
pasta do zębów - tannkrem
pasterz - sauðamaður m
paszport - vegabréf n, passi m
patelnia - panna f
patria - föðurland n
patrzałki - gleraugu
Paulek - Páll
paw - páfugl m
Paweł - Páll
październik - október
paździerzeń - október
paznokieć - nögl f
pazura - hönd f
pchła - fló f
pchli targ - flóamarkaður m
pech - óheppni f, óhamingja f
pediatra - barnalæknir m
peja - lús
pekator - getnaðarlimur m, reður m, typpi n
pełnia - fullt tungl n
penis - getnaðarlimur m, reður m, typpi n
pępek - nafli m
Pepik - Tékki m
perka - jarðepli n, kartafla f
perła - perla f
persona - maður m, persóna f
personifikacja - persónugerving f
Peru - Perú
petronelka - maríuhæna f
pewien - viss, nokkur, öruggur
pewny - viss, nokkur, öruggur
piana - bjór, öl
piasek - sandur m
piaskownica - sandkassi m
piąta kolumna - fimmta herdeild f
piątek - föstudagur m
pić - drekka
piec - baka
pieczara - hellir m
pieg - frekna f
piegża - netlusöngvari m
piekarnia - bakarí n, brauðbúð f
piekarz - bakari m
piekło - helvíti n
piękno - fegurð f
piękność - fegurð f
piękny - fallegur, fagur
pień - bolur m, trjábolur m
pieniądz - peningar
pieprz - pipar m
pierdy - lausafregn f
piernik - engiferkaka f
pierwiastek - frumefni n, rót f
pierwyj - fyrst
pies - hundur m
pięść - hnefi m
pieśń - söngur m, lag n
pies przewodnik - blindrahundur
pięta Achillesa - Akkilesarhæll m
pięta achillesowa - Akkilesarhæll m
piętro - hæð f
pietruszka - steinselja f
pietruziel - steinselja f
pijany - drukkinn, fullur, ölvaður
pijawa - regnbogi m
pijawka - blóðsuga f
pikawa - hjarta n
piksel - díll, depill, pixill
piła - sög f
piłka - bolti m, knöttur m, sög f
piłka nożna - fótbolti m
piłka ręczna - handknattleikur m, handbolti m
piłkarski - fótbolta-
pingwin - mörgæs f
pionek - peð n
piorun - elding f
piosenka - söngur m
piosenkarz - söngvari m
Piotr - Pétur
piromania - íkveikjuæði n
pisać - skrifa
pisanka - páskaegg n
pisarz - rithöfundur m
pismo - stafróf f
pistacja - pistasíuhneta f
Pitagoras - Pýþagóras m
piterka - peningaveski n, seðlaveski n, veski n
Pittsburgh - Pittsburgh
piwo - bjór, öl
pizgać - kasta, yfirgefa
pizza - pizza f
plac - torg n, pláss n
płacić - greiða, borga, gjalda
płakać - gráta
plan - plan n, áform n, áætlun f
planeta - reikistjarna f
planetoida - smástirni n
planta - jurt/urt f, planta f
płaszcz - kápa f
płaszczka - þvermunnur m
płaz - froskdýr n
plebiscyt - þjóðaratkvæði n
płeć - kyn n, kynferði n
plecak - bakpoki m
plemię - þjóðflokkur m, ættbálkur m
pliszka - maríuerla f
plotka - lausafregn f
plotkować - slúðra, þvaðra, segja gróusögur
płucnica islandzka - fjallagrös
płuco - lunga n
pług - plógur m
plurale tantum - fleirtölunafnorð n
pluskwa - punaise des lits f
pluszowy miś - bangsi m
pluton - plúton
Pluton - Plútó m
płyn - lögur m, vökvi m
płynąć - synda, líða, líða hjá, renna
płyta główna - móðurborð
pływanie - sund
p.n.e. - f.Kr.
pobożny - guðhræddur
pocałunek - koss n
pochodnia - blys n, kyndill m
pochodzenie - ætterni n, kyn n
pochwa - leggöng, slíður n
pociąg - lest f
poczta - póstur m, pósthús n
poddasze - kvistur m
poddenerwowanie - spenna f
podejrzenie - grunur m
podkoszulek - nærskyrta f
podkoszulka - nærskyrta f
podkowa - skeifa f
podłoga - gólf n
podłość - illmennska f
podmiot - frumlag n
podniebienie - gómur m
podobny - líkur
podomka - baðsloppur m
podówczas - í þá tíð
podręcznik - handbók f
podróż - ferð f, för f
podróżować - ferðast, fara
podstawówka - grunnskóli m
poduszka - púði m, koddi m, sessa f
poduszka powietrzna - loftpúði m
poezja - ljóðlist
poganin - heiðingi m
pogański - heiðinn
pogłoska - lausafregn
pogoda - veður n
pogrzeb - jarðarför f, greiftrun f, útför f
pokój - frið m, herbergi n
pokrzewka piegża - netlusöngvari m
pół - hálfur
Polak - Pólverji m
pole - akur m, tún n
polędwica - lend
policja - lögregla f
policjant - lögregluþjónn m
policzek - kinn f
Polinezja - Pólýnesía f
politeizm - fjölgyðistrú
polityk - stjórnmálamaður m
Polka - Pólverja f
północ - miðnótt f, miðnætti
Północ - Norðurlönd
polon - pólon
półsamogłoska - hálfsérhljóð n
Polska - Pólland
polski - pólskur, pólska f
półudenyk - hádegisverður
południe - hádegi, suður
Południe - Suðurlönd
południowokoreański - suðurkóreskur
półwysep - skagi m
pomagać - hjálpa
pomarańcza - appelsína f
pomarańczowy - appelsínugulur
pomidor - tómatur m
pomnik - varði m, minnisvarði m, minnismerki n
pomoc - hjálp f, björg f, fulltingi
poniedziałek - mánudagur m
ponieważ - því, af því að, vegna þess, vegna
ponownie - aftur, að nýju, á hinn bóginn
popielniczka - öskubakki m
popiół - aska
popołudnie - eftirmiðdagur m, síðdegi n
poprawny - réttur, hárréttur
por - blaðlaukur m
pornograficzny - klámfenginn
porównywać - bera saman
port - höfn f, flugvöllur m
portfel - peningaveski n, seðlaveski n, veski n
portki - buxur (f)
portret - andlitsmynd
portu - höfn f, flugvöllur m
Portugalia - Portúgal
porządek - regla f, lag n, röð
porzeczka - rifsber n
posag - heimanfylgja f
posesor - eigandi m
posiadacz - eigandi m
posiłek - máltíð f
pośladek - rasskinn f
pośpiech - flýtir m
post - jeûne m
postępowanie - aðferð f
poświadczać - að vitna
pot - sviti m
potas - kalín n
potek - guðfaðir m
potem - eftir, vegna, síðár
potmanyj - peningaveski n, seðlaveski n, veski n
potomstwo - afkvæmi n
potop - syndaflóð n
potrzeba - þörf f
potrzebizna - þörf f
potrzebować - þurfa, hafa þörf fyrir, vanta
potwór - ófreskja f
powieka - augnalok n
powiestka - nafn n, fornafn n, titill m
powietrze - loft n
powód - ástæða f, orsök f, sök f, sóknaraðili m
powodować - orsaka
powódź - flóð n
powstanie - bylting f
pożar - eldsvoði m, bruni m
poza tym - auk þess
pozawczoraj - fyrradag
pozdrowienie - kveðja f
poziomy - láréttur
pozwalać - leyfa, heimila, láta
pożywienie - matur
prababcia - langamma f
prababka - langamma f
praca - vinna f, starf n, verk n
praca domowa - heimavinna
prącie - getnaðarlimur m, reður m, typpi n
pracodawca - atvinnuveitandi m, atvinnurekandi m, vinnuveitandi m
pracować - vinna
pracownik - starfsmaður m, vinnuþegi m
pradziadek - langafi m
Praga - Prag
pralka - þvottavél f
prawa ręka - hönd f
prawda - sannleikur m
prawdziwych przyjaciół poznaje się w biedzie - sá er vinur, sem í raun reynist
prawica - hægri n
prawko - ökuleyfi n
prawo - lög réttindi
prawo jazdy - ökuleyfi n
premier - forsætisráðherra m
prenumerator - áskrifandi m
prezent - gjöf f
prezerwatywa - smokkur
prezydent - forseti m
problem - vandamál n, vandkvæði, vandi m, spursmál n
próbować - bragða, smakka
produkować - framleiða
prom - ferja f
promień - geisli m, radíus m
proroctwo - spádómur m, spá f
prosta - lína f (bein)
prostokątny - rétthyrndur
prostytucja - vændi n
prostytutka - gleðikona f, skækja f, vændiskona f
protestant - mótmælandi
protestować - mótmæla
protokół - gerðabók f
proton - róteind f
prowokować - etja
Prusy - Prússland
prymatologia - fremdardýrafræði f
prysznic - steypibað n, sturta f
przać - elska
przebytek - íbúð f
przeciąg - súgur m
przecinek - komma f
przedchrześcijański - forkristinn
przedimek - greinir m
przedmiot - hlutur m, þing n
przedszkole - leikskóli m, barnaheimili n
przedtem - áður, fyrr
przedwczoraj - fyrradag
przekąska - snarl n
przeklinać - bólta, bölva, formæla, sverja
przemożność - kraftur, vald
przemysł - iðnaður m, atvinnuvegur m
przeorysza - abbadís f
przepowiednia - spá f
prześladowanie - ofsókn, eftirför
przesmyk - eiði n
przestarzały - úreltur
przestępca - glæpamaður m
przestrzegać - vara (e-n við e-u), hlíta (e-u)
przestrzeń kosmiczna - geimur
przeszkoda - hindrun f, grind f
przeszłość - fortíð f
przewinienie - sök f
przeziębienie - kvef
przoć - elska
przygoda - ævintýri n
przyimek - forsetning f
przyjaciel - vinur m
przyjaciółka - vinkona f
przyjaźń - vinátta f, vinfengi n, vinskapur m, kærleikur m
przyjemny - þægilegur
przykazanie - boðorð n
przykład - dæmi n
przymiotnik - lýsingarorð n
przynajmniej - að minnsta kosti
przypadek - tilviljun f, fall n
przypadkiem - af tilviljun
przypadkowo - af tilviljun
przypominać - minna
przyprawa - krydd n
przyprawiać - krydda
przyroda - náttúra f
przysięga - eiður m
przysięgać - sverja
przysłówek - atviksorð n
przysłowie - málsháttur m, orðskviður m
przyśpieszać - hraða, flýta, greiða fyrir, ýta á eftir
przystawka - forréttur
przyszłość - framtíð f
przytcza - dæmi n, tilviljun f, fall n
pseudonim - dulnefni n
psiarnia - lögregla f
psisko - hundur m
pstrąg - silungur m
psychiatra - geðlæknir m
psychiatria - geðsjúkdómafræði f, geðlækning f
psycholog - sálfræðingur m
psychologia - sálfræði f
pszczoła - býfluga f
ptak - fugl m, getnaðarlimur m, reður m, typpi n
ptaszę - fugl m, getnaðarlimur m, reður m, typpi n
puder - duft n
pugilares - peningaveski n, seðlaveski n, veski n
pukieltasia - bakpoki m
pulares - peningaveski n, seðlaveski n, veski n
pularysek - peningaveski n, seðlaveski n, veski n
pultok - kalkúnn m
pumeks - vikur
punk rock - pönkrokk
puste - tómur
pustelnik - einsetumaður m
pusty - tómur
pustynia - eyðimörk f, auðn n
puszka - dós f, fangelsi n, bjór, öl
puter - kalkúnn m
putnia - vatnsfata f
pycha - dramb n, hroki m
Pyjter - Pétur
pyra - jarðepli n, kartafla f
pyrrusowe zwycięstwo - Pyrrosarsigur m
pyta - getnaðarlimur m, reður m, typpi n
pytanie - spurning f
rabarbar - rabarbari m
rachować - telja
raciądz - riddari m
radon - radon
radosny - glaður, kátur
radykalny - róttækur
raj - paradís f
raja - þvermunnur m
Rajch - Þýskaland n
rajza - ferð f, för f, ferð
rajzować - ferðast, fara
rak - krabbamein n
Rak - Krabbinn
rakuski - austurrískur
rana - sár n
rap - rapp
raper - rappari m
raport - sögn f
rasizm - rasismi m
ratusz - ráðhús n
razdziawa - hrafn m, kráka
razem - með, ásamt
realizować - láta e-ð rætast, rætast
rebeliant - uppreisnarmaður
ręczna - handknattleikur m, handbolti m
ręcznik - handklæði n
redyska - hreðka f
redźka - hreðka f
referendum - þjóðaratkvæði n
regularny - reglulegur
ręgulec - flærð
reinkarnacja - endurholdgun, endurfæðing
ręka - hönd f
rękaw - ermi f
rękawica - hanski m
rękawiczka - hanski m
rekin - hákarl m
reklama - auglýsing f
religia - átrúnaður m, siður m, trú f, trúarbrögð
ren - hreindýr n
renifer - hreindýr n
reprymenda - ádrepa f
republika - lýðveldi n
Republika Federalna Niemiec - Sambandslýðveldið Þýskaland
Republika Południowej Afryki - Suður-Afríka f
restauracja - veitingahús n
rewolucja - bylting f
rho - hró
RNA - RKS
ro - hró
Robert - Hróbjartur m, Róbert m
robić z igły widły - að gera úlfalda úr mýflugu
robieniec - verkamaður m
robotnik - verkamaður m
rock - rokk n
Rodezja - Ródesía
rodzaj - tegund, kyn, ættkvísl f
rodzaj męski - karlkyn n
rodzaj nijaki - hvorugkyn n
rodzajnik - greinir m
rodzajnik nieokreślony - óákveðinn greinir m
rodzajnik określony - ákveðinn greinir m
rodzic - foreldri foreldrar
rodzić - fæða
rodzina - fjölskylda
rodzynek - rúsína f
rodzynka - rúsína f
rok - ár, pils n
rok przestępny - hlaupár n
rok świetlny - ljósár n
rolnik - bóndi m, sveitamaður m
romantyczny - rómantískur
ropa naftowa - hráolía f
rosa - dögg f
róść - aukast, vaxa
Rosja - Rússland n
Rosjanin - Rússi m
roślina - jurt/urt f, planta f
roślinność - gróður m, jurtaríki n
rosnąć - aukast, vaxa
roso - dögg f
rosyjski - rússneskur, rússneska f
rouza - rós f
rower - reiðhjól n, hjól n
rower górski - fjallahjól n
również - einnig, líka
równik - miðjarðarlína f, miðbaugur m
róża - rós f
rozczarowanie - vonbrigði n
różdżka - töfrasproti m
rozgwiazda - krossfiskur m, sæstjarna f
rozmiar - stærð f
rozmowa - viðtal n, samtal n
różnica - munur m, mismunur m
różowy - rósrauður
rozrywka - gaman
rozsądny - vafalaus, vafasamur
rozsierdzie - reiði n, vonska f
roztargniony - utan við sig
rozum - vit n
rozumieć - skilja
rozwiązanie - lausn f
rozwidlenie - tvískipting f
rozwód - skilnaður m, hjónaskilnaður m
rtęć - kvikasilfur n
rubid - rúbidín
ruchome schody - rúllustigi m
rudny - rauður
rufa - rasskinn f
rum - romm n
ruten - rúten
ryba - fiskur m
rybitwa - þerna f, kría f
Ryby - Fiskarnir
rycerz - riddari m
ryma - inflúensa f, flensa f
rynka - pottur m
rywalizować - keppa
ryż - hrísgrjón n, grjón n
rząd - landstjórn f
rzadko - sjaldan
rzadny - ljótur, herfilegur
rzeciądz - keðja f, fjallgarður m
rzecz - hlutur m, þing n
rzecznik prasowy - talsmaður m
rzeczownik - nafnorð n
rzeczownik własny - eiginnafn n
rzeczywistość - raunveruleiki m
rzeka - á f
rzemieślnik - iðnaðarmaður m, smiður m
rzęsa - augnhár
rzeżucha - karsi
rzodkiewka - hreðka f
rzucać - kasta, yfirgefa
rzykać - biðja
Rzym - Róm
rzymski - rómverskur
sąd - dómstóll m, réttur m, dómur m
sadzić - planta, gróðursetja
saga - saga
sagan - höfuð n (człowieka), haus (innego zwierzęcia), ketill m
sałata - leigubifreið f, leigubíll m, taxi m
sałatka - salat n
salceson - lögregluþjónn m
Saloniki - Þessaloniki, Saloníka
samar - samarín
samiec - karldýr n
Samoa Amerykańskie - Bandaríska Samóa
samobójstwo - sjálfsmorð
samochód - bíll m
samogłoska - sérhljóð n
samolot - flugvél f
sardela - ansjósa f
Sardynia - Sardinía
sarkazm - kaldhæðni f, hæðni f
sarna - rádýr n
sarnapa - gíraffi m
sąsiad - nágranni m
satelita - gervihnöttur m, gervitungl n, leppríki n
sauna - sána f, gufubað n
schody ruchome - rúllustigi m
schowek - hólf
ściana - veggur m
ścięgno - sin f
ściemniać - ljúga
ścierwo - hræ n
sedno - kjarni m
sekret - leyndarmál n
seks - kynferði n, mök
sekunda - sekúnda f
selen - selen
seler - sellerí
sen - svefn m, draumur m
senny - svefn-, syfjaður
sęp - gammur, hrægammur m
sepsa - blóðsýking f
ser - ostur m
Serbia i Czarnogóra - Serbía og Svartfjallaland
serbski - serbneskur, serbneska f
serce - hjarta n
serdce - hjarta n
serdeczny palec - baugfingur m
seroka - skjór m
serwatka - mysa f
serwer - netþjónn m
siać - sá
siano - hey n
siarka - brennisteinn m
siarkowodór - brennisteinsvetni, vetnissúlfíð
siatkówka - blak n, sjóna f, nethimna f
się - sig, -st, það +, man +
sieczeń - febrúar
siedem grzechów głównych - dauðasyndirnar sjö
siedzieć - sitja
siedzieć na jajach - liggja á eggjum
sień - anddyri
sierociniec - munaðarleysingjahæli n
sierpień - ágúst
siestrzan - systursonur m
siestrzeniec - systursonur m
siki - þvag n
siła - kraftur, vald
silnik - vél f
silno - mjög
Singapur - Singapúr
singulare tantum - eintöluorð n, eintölunafnorð n
siodłak - bóndi m, sveitamaður m
siodło - hnakkur m
sioło - þorp n, sveit f
sioneczka - anddyri
sionka - anddyri
siostra - systir f
siostrzan - systursonur m
siostrzanek - systursonur m, mágur m
siostrzenica - systurdóttir f
siostrzeniec - systursonur m
sirpień - ágúst
sitko - hljóðnemi m
skąd - hvaðan
skand - skandín n
Skandynawia - Skandinavía f
skandynawski - norrænn
skąpiec - nirfill m
skarpeta - sokkur m
skiba - þjófnaður m, stuldur m
skibać - stela
skład - búð f, verslun f
sklep - búð f, verslun f
skoczek - riddari m
skok - stökk n
skok o tyczce - stangarstökk n
skok wzwyż - hástökk n
skończony - enda
Skop - Hrúturinn
skopowina - kindakjöt
skóra - húð f, skinn n, leður /n, hýði m
skorpion - sporðdreki m
Skorpion - Sporðdrekinn
skowroda - panna f
skrępowany - þvingaður
skroń - gagnauga n
skrótowiec - upphafsstafaheiti n
skrzynia - kassi m
skrzypce - fiðla f
skrzyżowanie - krossgötur
skunks - þefdýr n
sładnie - auðveldlega, hæglega
sławny - frægur
śledź - síld f
śledziona - milta
śleptać - gráta
ślepucha - hæna f
ślepy lelek - leðurblaka f
ślimak - snigill m
śliwka - plóma f
słodki - sætur, hugljúfur
słoń - fíll m
słońce - sól f
Słońce - sól f
słoneczny - sól-, sólar-
słony - saltur
słowa - orð
słowacki - slóvakískur, slóvakíska
Słowenia - Slóvenía
słowiański - slafneskur
słowik - næturgali m
słownik - orðabók f
słowo - orð
słynny - frægur
słyszeć - heyra
smak - bragð, smekkur
smakować - bragða, smakka
smażonka - hrært egg n
smerf - Strumpur, Strumpar
śmierć - dauði m, fráfall
śmierdziel - þefdýr n
śmietana - rjómi m
smok - dreki m
smrodyla - sólber n
smutek - depurð f, þunglyndi n, hryggð f
smutniak - brauð n
smutny - hryggur
smysł - vit n
snecha - tengdadóttir f
śniadanie - morgunverður m
śnieg - snjór m
śnieżyć - snjóa
snob - snobb n
sobaka - hundur m
sobota - laugardagur m
sobowtór - tvífari m
socjalizm - félagshyggja f, sósíalismi m
socjologia - þjóðfélagsfræði f, félagsfræði f
soczewica - linsubaun
sód - natrín n
sok - ávaxtasafi m, safi m, saft, djús
sokół - fálki m, valur m
sól - salt n
sola - sólflúra f
somsiad - nágranni m
sos - sósa f, ídýfa f
sosna - fura f, þinur m
sowa - ugla
sowa śnieżna - snæugla f
spacer - skemmtiganga f
śpiący - syfjaður
śpieszyć - liggja, flýta sér
śpiewać - syngja
spinka do włosów - spenna f, hárnál f
śpiwór - svefnpoki m
spódnica - pils n
spodnie - buxur (f)
spojrzenie - augnatillit
spółgłoska - samhljóð n
sport - íþrótt f, sport n
sportowiec - íþróttamaður m
sposób - háttur m
spotykać - hitta, finna
spragniony - þyrstur
sprawiedliwość - réttlæti n
sprawiedlność - réttlæti n
spróbować - bragða, smakka
sprzedawać - selja
srać - drulla, skíta, dríta, gera í buxurnar
srebro - silfur n
średnik - semíkomma f, depilhögg n
średniowiecze - miðaldir
Sri Lanka - Srí Lanka
środa - miðvikudagur m
sroka - skjór m
śrupać - bíta
ssak - spendýr n
stać - standa
stacja - stöð f
stąd - héðan
stadion - íþróttavöllur m, leikvangur m
stal - stál n
stalować się - látast, hræsna, takast, heppnast
stanik - brjóstahaldari m
Stany - Bandaríkin
Stany Zjednoczone - Bandaríkin
Stany Zjednoczone Ameryki - Bandaríkin
starek - afi m, hnetubrjótur m
stare miasto - gamall, borg f, bær m
starka - amma f
starosek - afi m, hnetubrjótur m
staroszek - afi m, hnetubrjótur m
starszy - faðir m, pabbi m
stary - gamall
starzec - öldungur m
starzyk - afi m, hnetubrjótur m
statystyka - staðtölur, tölfræði f
staw - tjörn f, liður m, liðamót
Stefan - Stefán
stefka - þerna f, flugfreyja f
sterczeć - standa
stewardesa - þerna f, flugfreyja f
stocznia - slippur m
stojeć - standa
stół - borð n
stolica - höfuðborg f
stomatolog - tannlæknir m
stopa - fótur m, fet n
stosować - nota
stosunek - hlutfall n
stowarzyszenie - félag n
strach - ótti m, ógn f, hræðsla f
strach na wróble - ótti m, ógn f, hræðsla f
strajk - verkfall n
strąpacz - febrúar
strawa - kostnaður
strefa - svæði n
stres - stress n
struś - strútur m
strych - háaloft n, loft n, kvistur m
stryj - föðurbróðir m
stryjek - föðurbróðir m
strzała - píla f, ör f
Strzelec - Bogmaðurinn
student - háskólanemi m
studiować - stunda nám, læra
studnia - brunnur m
stulecie - aldur m, öld f
styczeń - janúar
subtelność - blíða f
suchy - þurr
sukienka - kjóll m
sułtanat - saltanat
sum - steinbítur m
surowiec - hráefni n
surrealistyczny - súrrealískur
sutek - brjóstvarta f
sutener - melludólgur m
sweter - peysa f
świadczyć - að gera, að bera vitni (um)
świat - heimur m, veröld f
światło - ljós
świątynia - musteri n
świeca - kerti n
świecę - kerti n
świecznik - kertastjaki m, stjaki m
świekier - tengdafaðir m
świekra - tengdamóðir f
świeść - mágkona f, tengdamóðir f
święty - helgur, heilagur, dýrlingur m
święty mikołaj - jólasveinn m
świgać - kasta, yfirgefa
świnia - svín n
świnka - hettusótt
świnka morska - naggrís m
świostka - mágkona f, tengdamóðir f
swój - sinn
swoje - sinn
swok - föðurbróðir m
Syberia - Síbería f
Sycylia - Sikiley f
syfilis - sárasótt f, sífill, sýfílis
sylaba - atkvæði n
sylwek - gamlárskvöld
sylwester - gamlárskvöld
symfonia - sinfónía f, hljómkviða f
syn - sonur m
synagoga - sýnagóga
synapsa - taugamót
synek - drengur m, piltur m
synonim - samheiti n
synowa - tengdadóttir f
synowiec - bróðursonur m
sypialnia - svefnherbergi n
syra - fótur m
syrena - sírena f
syryjski - sýrlenskur
szachownica - taflborð n, skák f
szachy - skák f, tafl n
szacunek - virðing f
szajs - skítur m
szaleństwo - geðbilun, fásinna
szalik - trefill m, slæða f
szampan - kampavín n
szantaż - fjárkúgun f
szantażować - kúga
szarlotka - eplakaka f
szary - grár
szczaw - súra f
szczeniak - hvolpur m
szczenię - hvolpur m
szczery - heiðarlegur, vandaður, ærlegur
szczewik - skór m
szczoteczka do zębów - tannbursti m
szczupak - gedda f
szczur - rotta
szczygieł - þistilfinka f
szczypiorniak - handknattleikur m, handbolti m
szczyt - toppur m, tindur m, toppfundur m, fullnæging f
szef - forstjóri m
szept - hvísl
szeptać - hvísla, pískra, pukra
szeroki - breiður, víður
szewc - skósmiður m
szkielet - beinagrind f
szkita - fótur m
szkło - gler n
Szkocja - Skotland n
szkoła - skóli m
szkoła podstawowa - grunnskóli m
szkoła powszechna - grunnskóli m
szkop - Þjóðverji m
szlachcic - aðalsmaður m
szlafrok - baðsloppur m
szlauch - slanga f, snákur m, pípa f
szminka - varalitur m
szmucha - flærð
szneka - andlit n
sznita - sneið f, brauðsneið f
sznur - taug f
sznytka - sneið f, brauðsneið f
szop pracz - þvottabjörn m
szpak - stari m
szparag - spergill m
szpinak - spínat n
szpital - sjúkrahús n, spítali m
szpuk - dúfa f
Sztokholm - Stokkhólmur m
sztrof - refsing f, ráðning f
sztrofa - refsing f, ráðning f
sztuka - list f, stykki n, leikrit n
szuflada - skúffa f
szulak - haukur m
szurzy - mágur m
szwab - Þjóðverji m
szwagier - mágur m
szwagierka - mágkona f
szwaja - fótur m
szwamka - svampur m, svampdýr n
Szwecja - Svíþjóð f
Szwecyjo - Svíþjóð f
Szwed - Svíi m
szwedzki - sænskur, sænska f
szwestera - systir f
szybki - fljótur
szyć - sauma
szyja - háls m
szyjka macicy - legháls m
szykowny - fagur, fallegur, ljótur, ófagur
szynal - nagli m
tabaka - tóbak n
tabu - bannhelgi f
taca - bakki m, matarbakki m
tachykardia - hraðtaktur
tacik - faðir m, pabbi m, afi m, hnetubrjótur m
Tadżykistan - Tadsjikistan
tajemnica - leyndarmál n
tajfun - fellibylur m
tajny - leynilegt
tak - já
taksówka - leigubifreið f, leigubíll m, taxi m
także - einnig, líka
tal - þallín
tam - þar, þarna, þangað
Tamara - Tamara
tamdotąd - þar, þarna, þangað
tamten - þessi (þetta) þarna
tan - dans n
tańczyć - dansa
taniec - dans n
taniec śmierci - dauðadans n
tank - skriðdreki m
tantal - tantal
tarcza - andlit n
tarcza strzelecka - andlit n
targ - torg n
tartak - sögunarverksmiðja f
tasza - taska f
tata - pabbi m
taternictwo - fjallganga f
tato - pabbi m
teatr - leiklist f, leikhús n
technet - teknetín
techniczny - tæknilegur
technika - tækni n, taktur
technokracja - tækniveldi
tęcza - regnbogi m
tej - þú, þér
telefon komórkowy - farsími m, gemsi m
telewizja - sjónvarp n
tellur - tellúr
temat - spjallþráð
temperatura - hiti m, hitastig n
temperatura pokojowa - umhverfishita f
teologia - guðfræði
teraz - nú, núna
terb - terbín
termit - maur m
Termopile - Laugaskarð n
teść - tengdafaðir m
teściowa - tengdamóðir f
tęsknota - þrá f, löngun f
testament - erfðaskrá f
tętnica - slagæð f
tetragon - ferhyrningur m
też - einnig, líka
tiul - tjull n
tj. - þ.e. (= það er)
tlen - súrefni n
tlenek węgla - kolmónoxíð
tłumacz - þýðandi m, túlkur m
tłumaczenie - þýðing f
tłumaczyć - skýra, afsaka, þýða
tobie - þú, þér
Tomasz - Tómas m, Thomas m
topola - ösp f
topór - öxi f
tor - þórín
torba - taska f
tornado - hvirfilbylur m, hvirfilvindur m
tornister - skólataska f
tort - lagkaka
tory - þórín
towar - vara f
trąba - hvirfilvindur m
trąd - holdsveiki
traf - tilviljun f, fall n
trambimba - sporvagn n
tramwaj - sporvagn n
tramwajka - sporvagn n
translator - þýðandi m, túlkur m
transsubstancjacja - eðlisbreyting f, gjörbreyting f, eðlisbreytingarkenningin f
tranzystor - smári
tratować - trampa
trawa - gras n
trawnik - grasflöt f, flöt f
troć - silungur m
tróhła - líkkista f
trójkąt - þríhyrningur m
trójskok - þrístökk n
truchło - hræ n
trucizna - eitur m, ólyfjan f
trudny - erfiður
trufla - jarðsveppur
trujący - eitraður
trumna - líkkista f
truskawka - jarðarber n
trwały - endingargóður, varanlegur
trybuszon - korktrekkjari m, tappatogari m
trzaszczka - strá n
trzeć - núa
trzęsienie ziemi - jarðskjálfti m, landskjálfti m, jarðhræring f
trzeźwy - algáður, ódrukkinn, edrú
trzmiel - hunangsfluga f
tu - hér, hingað
tuberkuloza - berklar, tæring f
tudzież - og
tuf - móberg n
tukej - hér, hingað
tu leży pies pogrzebany - þar liggur hundurinn grafinn
tulipan - túlipani m
tulp - túlipani m
tuńczyk - túnfiskur m
tundra - freðmýri f, túndra f
Tunezja - Túnis
tunfisz - túnfiskur m
Turcja - Tyrkland
turecki - tyrkneskur
Turyn - Tórínó
turysta - ferðamaður m
tutaj - hér, hingað
twardy - harður
twaróg - kotasæla m
twarz - andlit n
twój - þinn
ty - þú, þér
tydzień - vika f
tygr - tígrisdýr n
tygrys - tígrisdýr n
tylko - bara
tymianek - timjan n
tyn - múr m
typografia - leturfræði
tyrania - áþján
Tyrteusz - Týrtajos m
tytoń - tóbak n
tytuł - titill m
ubierać - klæða, klæða sig, klæðast
ubranie - fatnaður m, klæði n
ucho - eyra n
uczeń - nemandi m, nemi m, námsmaður m
uczestnik - þátttakandi m
uczuć - tilfinning f
uczucie - tilfinning f
uczynek - gjörningur m, gerð f
udawać - látast, hræsna, takast, heppnast
udo - læri n
UE - ESB
ufnal - nagli m
uj - móðurbróðir m, föðurbróðir m
ujec - móðurbróðir m, föðurbróðir m
ujek - móðurbróðir m, föðurbróðir m
układ okresowy - lotukerfi n
Układ Słoneczny - sólkerfi n
ukleja - hreisturglæsir m
Ukraina - Úkraína f
ukraiński - úkraínskur, úkraínska f
ukrop - sjóðandi vatn n
ul - býflugnabú n, býflugnastokkur m, býkúpa f
ulica - gata f, stræti n
umami - umami
umfal - atburður m, óhapp n, slys n, ólán n
umierać - deyja
umysł - sinni n, hugi m, skilningur m, vit n
unia - bandalag n, samband n, samtök
Unia Europejska - Evrópusambandið n
unikać - forðast
unikalny - sjaldgæfur
uniwerek - háskóli m
uniwersytet - háskóli m
upał - hiti m
uprzejmy - kurteis, prúður
Ural - Úralfjöll
urępny - fallegur, fagur
urlop - leyfi n, orlof n, frí n
urodziny - afmælisdagur m
urodziwy - fagur, fallegur, ljótur, ófagur
uryna - þvag n
urządzenie - vél f
uśmiech - bros n
uśmiechać się - brosa
usta - munnur m
utęsknienie - þrá f, löngun f
uwodzić - tæla
użytkownik - notandi m
używać - nota
w - í, á
wacha - bensín, regn n, rigning f, úrfelli n, haf, sjór, ægir, úthaf, vatn n
wachlarz - blævængur m
waga - vog f, þyngd f
Waga - Vogin
wajco - egg
wakacje - sumarleyfi n
walczyć - berjast
wałek - flærð
walka - stríð n, hildur f, stríð
wampir - vampíra
wanad - vanadín n
wapń - kalsín n
wapniak - foreldri foreldrar
war - sjóðandi vatn n
warga - vör f
Warszawa - Varsjá
warzyć - sjóða, elda, matbúa, búa til mat
warzywo - grænmeti n
wąski - þröngur, þéttur
wasz - ykkar
wata cukrowa - ullarbrjóstsykur m, sykurfrauð n
wątpliwość - vafi m
wątroba - lifur f
Watykan - Vatíkanið
wąż - slanga f, snákur m, pípa f
wczoraj - í gær
wdowa - ekkja f
wdowula - ekkja f
we - í, á
węborek - vatnsfata f
wegetarianin - grænmetisæta
wegetarianizm - grænmetishyggja
węgiel - kolefni n, kol n
węgierski - ungverskur
węgorz - áll m
Węgry - Ungverjaland n
wehikuł czasu - tímavél f
wełna - ull f
wełniany - úr ull
wena - innblástur
Wenecja - Feneyjar
wentroba - lifur f
Wesołych Świąt - gleðileg jól, gleðilega páska
wesz - lús
weterynarz - dýralæknir m
węzeł - hnútur m
wezwanie - nafn n, fornafn n, titill m
wiadomość - boð n, boðskapur m, skilaboð n
wiadomości - fréttir
wiadro - vatnsfata f
wiatr - vindur m
wichura - stormur m
widelec - gaffall m
wideo - vídéo n
widołka - gaffall m
widz - áhorfandi
widzieć - sjá
więcej - fleiri, meira, meir
wieczność - eilífð f
wieczór - kvöld n
Wiedeń - Vín f, Vínarborg f
wiedzieć - vita
wiek - aldur m, öld f
większość - meiri hluti
wiela - hvaða, hver, hvor, sem, er
wielbłąd - úlfaldi m
Wielka Brytania - Stóra-Bretland n, Bretland n
Wielkanoc - páskar
wielki - stór
Wielkie Równiny - Slétturnar miklu
Wielki Piątek - föstudagurinn langi
wielokrotnie - ítrekað
wieloryb - hvalur m
wielorybnictwo - hvalveiði f
wieprzowina - svínakjöt
wierzyć - trúa
wieś - þorp n, sveit f
Wietnam - Víetnam
wietrzny - vindugur
wiewiórka - íkorni m
wieża - turn m
więzień - fangi
więzienie - fangelsi n
Wikipedia - Wikipedia
Wikisłownik - Wikiorðabók f
Wikiźródła - Wikiheimild
wiktoria - sigur m
wilk - úlfur m
Wilk - Úlfurinn m
wilkołak - varúlfur m
wilk w owczej skórze - úlfur undir sauðargæru, úlfur í sauðargæru
wino - vín n, vínföng
winograd - vín n, vínföng
wiolonczela - selló n, knéfiðla f
wioska - þorp n, sveit f
wiosło - ár f
wiosna - vor n, vortími m
wirus - veira f, tölvuveira f
wisieć - hanga, lafa
Wisła - Visla f
wiśnia - kirsiber
witać - heilsa, fagna, taka við, heilsast
wiza - vegabréfsáritun f
wizjer - þágufall n
wizyta - heimsókn f, koma f
wkrótce - brátt, bráðum, bráðlega, senn
władza - vald n, veldi n, yfirvald n
właściciel - eigandi m
właśnie - áðan
własny - eiginn
Włochy - Ítalía f
włos - hár n
włoski - ítalskur, ítalska f
wnęk - dóttursonur m, sonarsonur m
wnęka - sonardóttir f, dótturdóttir f, barnabarn n
WNP - SSR
wnuczka - sonardóttir f, dótturdóttir f, barnabarn n
wnuk - dóttursonur m, sonarsonur m
woda - vatn n
wóda - vodki m
wódka - vodki m
Wodnik - Vatnsberinn
wodór - vetni n
wodospad - foss m
wojak - hermaður m
wojaż - ferð f, för f
wojenny - stríðs-
województwo - hérað )
wojna - stríð n, styrjöld f
wojskowy - hermaður m
wokabularz - orðabók f
wół - uxi m
wołacz - ávarpsfall n
wolnomularz - frímúrari m
wolny - frjáls, laus, seinn
wołowina - nautakjöt n
woniączka - vodki m
worek - poki m
wrak - skipbrot n
wróbel - gráspör m, spörfugl m
wróg - fjandmaður m, óvinur m, óvinar
wrona - kráka
wróżka - dís f
wróżyć - spá
wrzątek - sjóðandi vatn n
w rzeczywistości - í raun og veru
wrzesień - september
wrzos - lyng n, beitilyng n
wschód - (sólar)upprás, austur n
Wschód - Mið-Austurlönd
wschodzić - koma upp, renna upp
współczucie - meðaumkun f, samúð f
wspólnie - með, ásamt
Wspólnota Niepodległych Państw - Samveldi sjálfstæðra ríkja
wstrząsy - diskótek
wszystek - allur
wszystko - allt
wtedy - í þá tíð
wtenczas - í þá tíð
wtorek - þriðjudagur m
w tym - í, á
wuj - móðurbróðir m, föðurbróðir m
wujek - móðurbróðir m, föðurbróðir m
wujko - móðurbróðir m, föðurbróðir m
wujo - móðurbróðir m, föðurbróðir m
wulkan - eldfjall n
wuszt - pylsa f, bjúga n
wy - þið
wybrzeże - strönd f
Wybrzeże kość Kości Słoniowej - Fílabeinsströndin f
wychodzić za mąż - giftast (+)
wycieczka - ferð
wydma - sandhóll m
wyjątek - undanskildum
wyłączać - taka úr sambandi
wylogowywać - útskrá
wymowa - framburður m
wynalazca - uppfinningamaður m
wynik - úrslit
wypadek - atburður m, óhapp n, slys n, ólán n
wypełnianie - fylling f
wypełnienie - fylling f
wyraz - orð
wysoki - hár
wyspa - ey f
Wyspa Bożego Narodzenia - Jólaeyja f
Wyspa Świętego Wyspy Świętego Tomasza i Wyspa Książęca - Saó Tóme og Prinsípe
Wyspy Alandzkie - Álandseyjar
Wyspy Kanaryjskie - Kanaríeyjar
Wyspy Kokosowe - Kókoseyjar
Wyspy Owcze - Færeyjar
wystarczający - nógur, nægilegur
wyż - hæð f
wyzwisko - illyrði n
wzdłuż - eftir
wzniesienie - hóll m
za - sala f
ząb - tönn n
żaba - froskur m
zabawka - leikfang n, dót n
ząbek czosnku - hvítlauksgeiri m
żabie oczko - gleym-mér-ei f
zabijać - drepa, deyða, negla fyrir e-ð
zabraniać - banna
zachód - sólsetur n, vestur n, ómak n
zachód słońca - sólsetur n, sólarlag n
zaćmienie - myrkvi m
zaczynać - byrja, verða
zadanie domowe - heimavinna
zadowolony - ánægður
zagranica - útlönd
zagroda - rétt f
zaimek - fornafn n
zając - héri m
zakaz - forboð n, bann n
zakażenie - sýking
zakład - veðmál n
zakład karny - fangelsi n
zakładnik - gísl m
żal - sorg
załącznik - viðhengi n
zalany - drukkinn, fullur, ölvaður
zamach stanu - valdarán n
zamek - borg f, lás n, rennilás n
zamiar - áætlun f, plan n
zamknąć - loka, ljúka upp
zamorski - erlendis
zamożność - auður m, auðlegð f, auðæfi
zamysł - áætlun f, plan n
zapad - sólsetur n, vestur n, ómak n
zapalenie płuc - lungnabólga
zapałka - eldspýta f
zapełnianie - fylling f
zapiekanka - skaftpottur
zapominać - gleyma
zapora - stífla f
zapraszać - bjóða
żarówka - rafmagnspera f, ljósapera f
żart - fyndni n, skrítla/skrýtla f, brandari m, spaug n, grín n
zaś - aftur, að nýju, á hinn bóginn
zasięgnąć języka - spyrjast fyrir (um)
zasługa - verðleikum
zaszczytciel - verjandi m
zatoka - flói m, vík f, vogur m, fjörður m
Zatoka Perska - Persaflói
zatrudniać - ráða
zawartość - innihald n, efni n
zawierać - innihalda
zawstydzony - sneyptur, skömmustulegur
zawsze - ávallt, alltaf
zawżdy - ávallt, alltaf
zazula - gaukur m
zazulka - maríuhæna f
Zbawiciel - Lausnari m
zbieg okoliczności - tilviljun f
zbrodnia - glæpur
zbyt - sala f
żdać - bíða
zdanie - setning f, skoðun f, álit n
zdrowie - heilsa f, heilbrigði n
zdrowy - heilbrigður
zdrzadło - spegill m
źdźbło - strá n
że - að
zebra - sebrahestur m, gangbraut f
żebro - rif n, rifbein n
zebu - sebú m
zegarek - úr n
zegarmistrz - úrsmiður m
zegar słoneczny - sólúr n
zegewerk - sögunarverksmiðja f
żeglarz - sjómaður
żegleń - kolefni n, kol n
żelazko - pressujárn n
żelazo - járn n
zemrzeć - deyja
żeńczyna - kona f, kvennamaður m
żeń-szeń - ginseng n
zeszyt - stílabók f
zewłok - hræ n
zgadzać - samþykkja
zięba - bókfinka
zięć - tengdasonur m
ziele angielskie - allrahanda n, negulpipar m
zielonooki - græneygður
zielony - grænn
ziemia - jörð f, land n
Ziemia - Jörðin
ziemniak - jarðepli n, kartafla f
zieziulka - gaukur m
zima - vetur m
zimnica - sótthiti m, hiti m
zimno - áblásturssótt f
zimorodek - bláþyrill m
ziobro - rif n, rifbein n
zista - amma f
Zjednoczone Królestwo - Hið sameinaða konungsríki
z krwi i kości - í húð og hár
złotnik - gullsmiður m
złoto - gull n
złotówka - úr gulli
złoty - úr gulli
zły - illur, vondur, rangur, óþekkur
zmiana - breyting
żmija - naðra f
zmrok - húm n, rökkur n
zmuszać - neyða
znać - þekkja, kunna
znaczek - frímerki
znaczek pocztowy - frímerki
znaczenie - merking f, vægi n, mikilvægi n, þýðing f
znaczyć - þýða merkja
znajdować - finna
znienacka - skyndilega
znów - aftur, að nýju, á hinn bóginn
znowu - aftur, að nýju, á hinn bóginn
zol - gólf n
zola - gólf n
żołądek - magi m
żółć - gulur
żołnierz - hermaður m
żółtaczka - gula f
żółtek - grjón n
żółty - gulur
żółw - skjaldbaka f
żółwi - skjaldböku- (złoż.)
żołwica - mágkona f
zona - svæði n
żona - kona f
zoolog - dýragarður
zozula - gaukur m
źrebak - folald n
źrebię - folald n
źrebiec - folald n
zręczność - fimi f
źrenica - augasteinn m, auga n
źródło - brunnur, upphaf
zrywka - taska f
żubr - evrópskur vísundur m
zupa - súpa f
żurawina - trönuber
żurnal - tímarit n
żurnalista - blaðamaður m
zwać - nefna, heita
związek - band
Związek Radziecki - Sovétríkin
Związek Socjalistycznych Republik Radzieckich - Sambandsríki Sósíalískra Sovíetlýðvelda
zwierciadło - spegill m
zwierzak - dýr n
zwierzę - dýr n
zwłoki - hræ n
zwycięstwo - sigur m
zwyciężać - sigra
zwycięzca - sigurvegari m
zwyczaj - háttur m
zwyczajny - algengur
żyć - lífa
życie - líf n, æfi f
żyd - gyðingur m, nirfill m
Żyd - gyðingur m
żydowski - gyðinglegur
żyła - æð
zymft - sinnep n
żyrafa - gíraffi m
żyto - rúgur m
żywe srebro - kvikasilfur n
żywić - borða
żywny - lifandi, ljóslifandi, líflegur, kvikur, glaðbeittur
żywopłot - limgerði n
żywy - lifandi, ljóslifandi, líflegur, kvikur, glaðbeittur
