AA - AA (Anonim Alkolikler)
abak - abaküs
abakus - abaküs
abażur - abajur
abchaski - Abhazca
abdest - abdest
abdykować - çekılmek el çekmek | feragat etmek
abecadło - alfabe | abece
abfal - hata | çöp
Abidżan - Abican
abiecadło - alfabe | abece
ablegierek - çocuk
aborcja - kürtaj
Abraham - İbrahim
absolutny - mutlak
abstrakcyjny - abstre
abstynencja - perhiz
absurdalny - abes | saçma | absürd
Abudża - Abuja
Adam - Adem
Adonis - Adonis
adres - yön | adres
adwentnik - aralık
adwokat - avukat
aeroplan - uçak
Afganistan - Afganistan
afisz - afiş
Afrodyzja - Afrodisias
afrykanerski - Afrikaanca
Afryka Północna - Kuzey Afrika
agat - akik
agent - acente
agnostycyzm - agnostisizm
agonia - agoni
ajwar - ayvar
akacja - akasya
akademia - akademi
akademicki - akademik
akademie - akademi
akademski - akademik
akadyjski - Akatça
aklamacja - alkış
akordeon - akordiyon
Akra - Akra
aktor - aktör
aktorka - aktris
akwarium - akvaryum
Akwitania - Akitanya
Albania - Arnavutluk
albański - Arnavutça
albinos - albinos | akşın
alchemia - alşimi
Aleksander - İskender
Aleksandria - İskenderiye
Aleppo - Halep
alergia - alerji
alfabet - alfabe | abece
alfabetu - alfabe | abece
Algieria - Cezayir
algofobia - algofobi
algorytm - algoritma
alkohol - alkol
Allach - Allah
Allah - Allah
almanach - takvim
Alpy - Alpler
aluminium - alüminyum
Alzacja - Alsace
amajza - karınca
Amazonka - Amazon
ambirz - zencefil
ambulans - ambulans
ambus - örs
amen - amin
Ameryka Południowa - Güney Amerika
amharski - Amharca
Amman - Amman
amoniak - amonyak
amper - amper
amputacja - ampütasyon
Amu-daria - Amuderya | Ceyhun
analiza - analiz | tahlil
ananas - ananas
anarchia - anarşi
anarchista - anarşist
anarchizm - anarşizm
Anatolia - Anadolu
anatomia - anatomi
anatomiczny - anatomik
andrologia - androloji
Andromeda - Andromeda
Andy - And Dağları
aneksja - ilhak
anemia - kansızlık | anemi
Anglik - ingiliz
angol - ingiliz
Angol - ingiliz
animista - canlıcı
animizm - animizm | canlıcılık
Ankara - Ankara
anons - bildiri
Antananarywa - Antananarivo
Antares - Antares
Antarktyda - Antarktika
antena - anten
Antigua i Barbuda - Antigua ve Barbuda
Antoni - Antümi
antrejka - koridor
antropologia - antropoloji
antryj - koridor
antybakteryjny - antibakteriyel
antyczny - antik
antyk - antika
antykomunizm - antikomünizm
Antyle Holenderskie - Hollanda Antilleri
antylopa - antilop
antypatia - nefret
antyseptyczny - antiseptik
Apeniny - Apenin Dağları
apetyczny - lezzetli
apryl - nisan
apsik - hapşu!
a psik - hapşu!
aptek - eczane
apteka - eczane
Arab - Arap
arabeska - arabesk
Arabia Saudyjska - Suudi Arabistan
arabski - Arap | Arapça
arabus - Arap
arak - arak
aramejski - Aramice
Ararat - Ağrı Dağı
Arbela - Erbil
arbuz - karpuz
arfa - arp
Argentyna - Arjantin
argon - argon
armia - ordu
armijo - ordu
arogancja - kibir
artykuł - makale
arytmetyczny - aritmetik
arytmetyka - aritmetik
asafetyda - şeytantersi
aseksualizm - aseksüel
asfalt - asfalt
asterysk - asterisk | yıldız imi | yıldız işareti
astrolog - astrolog
astrologia - astroloji
astrologio - astroloji
astronauta - astronot
astronom - astronom | gökbilimci
astronomia - gökbilim | astronomi
astronomio - gökbilim | astronomi
asturyjski - Asturyasça
Asyria - Asurlular
asza - kül
Aszchabad - Aşkabat
ateista - ateist
ateistyczny - Allahsız | ateist
ateizm - ateizm
atencja - dikkat
Ateny - Atina
ateusz - ateist
Atlantyk - Atlantik | Atlas Okyanusu
atmosfera - atmosfer
Augiasz - Augeas
Australia - Avustralya
Austria - Avusturya
autoklaw - otoklav
autonomia - özerklik | muhtariyet | otonomi
autonomiczny - özerk
autyzm - otizm
Azerbejdżan - Azerbaycan
azerski - Azerice
Azja - Asya
Azja Mniejsza - Küçük Asya
Azjata - Asyalı
azot - azot
Badenia-Wirtembergia - Baden-Württemberg
bagaż - bagaj
baglama - bağlama
Bahamy - Bahamalar
Bahrajn - Bahreyn
bajer - yalan
bajka - masal
bajtel - çocuk
bajura - çamur
bak - tankı
bakałarz - öğretmen | muallim
bakelit - bakalit
baklawa - baklava
bakłażan - patlıcan
bałak - sohbet
balneoterapia - balneoterapi
balon - balon
Bałtyk - Baltık Denizi
bambosz - terlik
bambus - bambu
bania - baş
baniaczek - şapka | başlık
baniak - baş
bank - banki
bankructwo - iflas
Barabasz - Barabbas m
Baran - Koç
bardzo - çok | daha
barter - barter
barwa - renk
barzej - çok | daha
baskijski - Baskça
bebech - mide
bekwarek - ardıç bülbülü
belfer - öğretmen | muallim
Belgia - Belçika
bengalski - Bengalce
Benin - Benin
Bergamo - Bergamo
Berlin Zachodni - Batı Berlin
beryl - berilyum
beton - beton
bety - pijama
bezbożny - Allahsız
bezcelowy - amaçsız
bezdzietność - çocuksuzluk
bezgraniczny - hudutsuz
bezlitosny - merhametsiz | amansız | acımasız | Allahsız
bezmózgi - beyinsiz
bezosobowy - kişiliksiz
beżowy - bej
bezpłatny - bedava
bezpotomność - çocuksuzluk
bezrobocie - işsizlik
bezsenność - insomnia
bezużyteczny - abes
bezzapachowy - kokusuz
biały - beyaz
biały fosfor - beyaz fosfor
biber - şapka | başlık
Biblia - Kutsal Kitap
bibliografia - bibliyografya
biblioteka - kütüphane
bibliotekarz - kütüphaneci
bigel - askı
bigiel - askı
biglosko - ütü
bilet - bilet
bindasz - penis
binia - kız
binks - morartı
binol - morartı
biochemia - biyokimya
biograficzny - biyografik
biologia - biyoloji | dirimbilim | canlı bilimi
Birma - Burma | Birmanya
birmański - Burmaca
biseksualizm - biseksüellik
biskup - piskopos
bizmut - bizmut
błąd - hata
blaga - yalan
Bliski Wschód - Yakın Doğu | Orta Doğu | Ortadoğu
Bliźnięta - İkizler
błoto - çamur
bo - çünkü
Bóg - Tanrı | Allah
ból - ağrı
Boliwia - Bolivya
bombel - çocuk
bonsai - bonsai | bonsay
bor - bor
Bośnia - Bosna
Bośnia i Hercegowina - Bosna ve Hersek
Boże Narodzenie - noel
brać - almak
bratanek - yeğen
brauza - duş
Brazylia - Brezilya
brazyliana - kahve
broń - silah
browar - bira
brudny - bulaşık
brydż - briç
bryka - araba
brzmienie - ses
brzydota - çirkinlik
brzytwa - ustura
buc - yarak
buda - okul
Budapeszt - Budapeşte
budka telefoniczna - telefon kulübesi
buldożer - buldozer
Bułgaria - Bulgaristan
bułgarski - Bulgarca
bulić - ödemek | tediye etmek
Burkina Faso - Burkina Faso
bursztyn - kehribar
burzowiny - bira
buzuki - buzuki
Byk - Boğa
Była Jugosłowiańska Republika Macedonii - Makedonya Eski Yugoslav Cumhuriyeti
cacyki - cacık
całować - öpmek
cegła - tuğla
cenotaf - anıt mezar
cera - kız evlat
chałwa - helva
chan - kağan
chaotyczny - karmakarışık | düzensiz
chart - tazı
chemia - kimya
chemia biologiczna - biyokimya
chemia organiczna - organik kimya
Cheronea - Chaeronea
Cheroneja - Chaeronea
chętny - gönüllü
Chiny - Çin
chipset - chipset
chirurgiczny - cerrahi
chleb - ekmek
chlor - klor
chlorofil - klorofil
chmiel - bira
choinka - Noel ağacı
chójk - Noel ağacı
chojna - çam
choroba - hastalık
choroba von Willebranda - von Willebrant hastalığı
Chorwacja - Hırvatistan
chorwacki - Hırvatça
chuj - yarak
ciągnąć - çekmek
ciągnik - traktör
ciało - beden
ciap - terlik
ciapryka - çamur
ciepły - ılık | sıcak
ciężarny - hamile
ciga - keçi
ciocia - teyze
cipka - tavuk
ciśnienie - basınç
ciupa - cezaevi | hapishane
ciurlocek - penis
ciurma - cezaevi | hapishane
ciut - biraz
ćmik - sigara
cnotliwy - erdemli
córa - kız evlat
córczysko - kız evlat
córka - kız evlat
cos - cos
co z oczu, to z serca - gözden ırak olan gönülden de ırak olur
ctg - cot
cukier - şeker
cukrowiec lekarski - şeker kamışı
cyferblat - yüz
Cygan - Çingene
cygareta - sigara
cygaretka - sigara
cynk - çinko
Cypr - Kıbrıs
cytologia - sitoloji
cywilizacja - uygarlık | medeniyet
Czad - Çad
czador - çador
czaj - çay
czajnik - baş
czarna dziura - kara delik
czarna skrzynka - kara kutu | karanlık kutu
Czarnogóra - Karadağ
czarny - siyah
czarny rynek - karaborsa
czarodziej - sihirbaz
czarujący - alımlı
czas niniejszy - şimdiki zaman
czasownik - fiil
czas teraźniejszy - şimdiki zaman
czas to pieniądz - vakit nakittir
Czechosłowacja - Çekoslovakya
Czecho-Słowacja - Çekoslovakya
Czeczenia - Çeçenya
czędo - çocuk
czernica - dut | böğürtlen
czerwiec - haziran
czerwony - kırmızı
cześć - selam | merhaba
Częstochowa - Çestohova
częstoskurcz - taşikardi
częstotliwość - frekans | titreşim sayısı
czkawka - hıçkırık
członek - penis
człowiek - adam | insan
czoło - alın
czorny - siyah | bulaşık
czwartek - perşembe
czwartorzęd - Kuvaterner
czyhunka - toryum
czyrwiec - haziran
czyrwień - haziran
czytać - okumak
Dagestan - Dağıstan
dalece - çok | daha
Dania - Danimarka
darowanemu koniowi w zęby się nie zagląda - hediye atın dişine bakılmaz
deizm - deizm
dekiel - baş
dekorować - bezenmek
delfin - yunus
delikatność - hassasiyet
demografia - demografi
demokracja - demokrasi
Demokratyczna Republika Wyspy Świętego Tomasza i Wysp Świętego Tomasza i Książęcej - São Tomé ve Príncipe Demokratik Cumhuriyeti
demonstracja - gösterme | gösteri
dermatolog - dermatolog
dermatologa - dermatolog
despota - despot w
despotyzm - despotizm
deszcz - yağmur
deżdż - yağmur
dezinformacja - dezenformasyon
diagnoza - teşhis
dialekt - lehçe | diyalekt
difalia - diphallia
dioda - diyot
Diogenes - Diyojen
dłoń - el
długo - uzun
dmuchać - sikmek
Dniepr - Dinyeper
dobranoc - iyi geceler
dobrobyt - refah
dobrowolny - gönüllü
dobry wieczór - iyi akşamlar
Dodekanez - Onikiada
dogmatyzm - dogmatizm | dogmacılık
dogodny - münasip
doktor - doktor | hekim | tabip
dolegliwość - hastalık
dolmen - dolmen
dom - ev
doradca - danışman
doś - çok
doświadczać - yaşamak
do widzenia - Allah'a ısmarladık
dowódca - kaptan
do zobaczenia - Allah'a ısmarladık
dram - dram
dramatyczny - acıklı
drażliwość - alınganlık
drewno - tahta
drożdżówka - çörek
druh - ahbap
drukarka - yazıcı
drzewo - ağaç
dudy - akciğer
dupek - pislik
Duszanbe - Duşanbe
dużo - çok
dyktator - diktatör
dylać - dans etmek
dynamiczność - hız
dyplom - diploma
dysfagia - disfaji
dysleksja - disleksi
dywan - kilim | keçe
dywanik - halı
Dżamila - Cemile
działanie - etki
dziąsło - dişeti
Dżibuti - Cibuti
dzicz - yaban
dzięcioł - ağaçkakan
dzieciszczko - çocuk
dziecko - çocuk
dzieje - tarih
dziękówa - tesekkür ederim
dziękówka - tesekkür ederim
dziękuję - tesekkür ederim
dzielny - acar
dzień - gün
dzień dobry - günaydın
dziennikarstwo - gazetecilik
dziennikarz - gazeteci
dzierżyć - tutmak
dziewa - kız
dziewczę - kız
dziewczyna - kız
dżihad - cihad
dziki - vahşi
dżinn - cin
dziób - gaga
dziołcha - kız
dziopa - kız
dżistać - osurmak
dziunia - kız
dziwaczny - acayip
dziwka - fahişe
dżungla - cungla | orman | sık orman
echo - yankı
echolalia - ekolali
Edirne - Edirne
edukacyjny - eğitici
efekt - etki | sonuç
Egipt - Mısır
egzemplarz - örnek
egzystencja - varoluş
egzystencjalizm - varoluşçuluk | egzistansiyalizm
ejakulacja - boşalma | ejakülasyon
ekologia - ekoloji
ekologio - ekoloji
ekonomiczny - ekonomik
ekosystem - ekosistem
ekskomunika - aforoz
Ekwador - Ekvador
elefant - fil
elektroliza - elektroliz
Emili - Emine
Emilia - Emine
emir - emir
empiryczny - ampirik
encyklopedia - ansiklopedi
Eos - Eos f
epilepsja - epilepsi
Erytrea - Eritre
erytrocyt - alyuvar
Erzurum - Erzurum
ESBC - AMBS
eschatologia - eskatoloji
eskalator - yürüyen merdiven
eskulap - doktor | hekim | tabip
espresso - espresso
Estonia - Estonya
estragon - tarhun
Etiopia - Etiyopya
etologia - etoloji
etyka - etik
etymologia - etimoloji | kökenbilim
eufemizm - edepi kelam | örtmece
Europa - Avrupa
ewangelia - İncil
ewangelista - İncil yazarı
Ezdrasz - Üzeyir
Ezop - Ezop
facet - adam
facetka - kadın
facjata - yüz
fajek - sigara
fajerwer - sigara
fajfus - penis
fajka - sigara
fajny - sirin
fakt - gerçek
fałszywy przyjaciel - yalancı eşdeğer
familio - aile
famuła - aile
fana - bayrak
fanatyzm - fanatiklik | fanatizm
faraon - firavun
farba - boya
farmaceuta - eczacı
faryna - şeker
faszystowski - faşist
fatalista - fatalist
fatwa - fetva
Federacyjna Republika Brazylii - Brezilya Federal Cumhuriyeti
fefer - biber
Fenicja - Fenike
fest - çok | daha
fezeła - arı
fiasko - fiyasko
Fidżi - Fiji
film - film
filolog - filolog
filozofia dziejów - tarih felsefesi
filozofia historii - tarih felsefesi
Finlandia - Finlandiya
fioletowy - mor
fiut - yarak
fizjologia - fizyoloji
flag - bayrak
flaga - bayrak
flet - yarak
fliger - uçak
Florencja - Floransa
fluor - fluor
fobia - fobi
Focjusz - Fotios
fojerman - itfaiyeci
fonetyka - fonetik
fort - kale
fosfor - fosfor
fotorealizm - fotogerçekçilik
Francja - Fransa
frela - kız
fresk - fresk
fryc - Alman
Fryc - Alman
fryzjerstwo - berberlik
Fudżi - Fuji
fundament - ana
fura - araba
furdygarnia - cezaevi | hapishane
fusbal - futbol
futbol - futbol
fyrtel - açı
gabinet cieni - gölge hükûmet
Gad - Gad
gadałka - peri
gała - göz | futbol | kuzgun | leş kargası
galancie - çok
Galia - Galya
Galilea - Celile
gapa - kuzgun | leş kargası
gar - çanak w
gara - uyku | rüya | düş | hayal
gardło - boğaz
garnek - çanak w
gaskoński - Gaskonca
gaz - gaz
gaz musztardowy - hardal gazı
gdy spieszyć się człowiek spieszyć spieszy, to cieszyć się diabeł cieszyć cieszy - acele işe şeytan karışır
gdyż - çünkü
gdzie - nerede
gejsza - geyşa
geograf - coğrafyacı
geografia - coğrafya
geologia - jeoloji
gichać - terlik
giez - atsineği
gitara - gitar
glajda - çamur
glajza - toryum
glapa - leş kargası
glin - alüminyum
globus - baş
głód - açlık
głodny - aç | acıkmış | abazan
głowa - baş
główny - asıl | esas | başlıca
głupota - aptallık
gnat - kemik | zar
gnot - çocuk
gnuśny - tembel
godka - konuşma
Godzilla - Godzilla
godzina - saat
Godzina dla Ziemi - Dünya Saati
gołąb - güvercin
golem - golem
golfista - golfçü
góra - dağ
górą - dağ
gorący - sıcak
gorączka - ateş
Górny Śląsk - Yukarı Silezya f
gorzała - alkol
gospodarczy - iktisadi | ekonomik
gra - oyun
graba - el
gracz - oyuncu
gratulować - tebrik etmek
Grenlandia - Grönland
grenlandzki - Grönlandca
gronostaj - kakım
grudzień - aralık
gruziński - Gürcüce
gryfny - sirin
guli - çünkü
guma - prezervatif | kondom | kılıf
gumka - prezervatif | kondom | kılıf
gwiazda - yıldız
gwiazdarz - astronom | gökbilimci | astrolog
gwiaździarz - astronom | gökbilimci | astrolog
Gwinea Równikowa - Ekvator Ginesi
gwóźdź - çivi | mıh
gzub - çocuk
Haiti - Haiti
Hajfa - Hayfa
hajtok - bıçak
hałaśliwy - gürültülü
hamburger - hamburger
hampelman - palyaço
handlowy - ticari
harem - harem
harfa - arp
haś - çöp
hau - hev | hav
Hawana - Havana
heban - abanoz
hedonizm - hedonizm | hazcılık
heparyna - heparin
herbarz - bitki müzesi | bitki koleksiyonu
herbata - çay
Hestia - Hestia
hiacynt - sümbül
hidżab - hicab
hierarchia - hiyerarşi
higiena - hijyen
hinduizm - hinduizm
Hindukusz - Hindukuş Dağları
hipoteza - varsayım | hipotez
histeria - histeri
historiozofia - tarih felsefesi
historyk - tarihçi
hokej - hokeyi
homeopatia - homeopati
homeostaza - homeostaz
homo- - homo-
homoseksualny - homoseksüel | eşcinsel
Hongkong - Hong Kong
hormon - hormon
Horus - Horus
hotel - otel
humor - mizah
Hun - Hun
Hurghada - Hurgada
huśtawka - salıncak
hydrologia - hidroloji | su bilimi
i - ve
ideologia - ideoloji
idiota - salak
igła - iğne
imbir - zencefil
immaterializm - immateryalizm
imperium - imparatorluk
inauguracja - açış | açılış
informować - haber vermek
ino - sadece
inżynieria - mühendislik
Irańczyk - İranlı
Irlandia - İrlanda
Irlandia Północna - Kuzey İrlanda
iryd - iridyum
iść - gitmek
iść do łóżka - yatmak
iść spać - yatmak
islamizm - İslamcılık
Islamska Republika Mauretańska - Moritanya İslam Cumhuriyeti
Itaka - İthaka
Izrael - İsrail
izraelski - israilli
ja - ben
jabłko - elma
jąderko - çekirdekçik
Jahwe - Yahveh
jajko - yumurta | tohum (fertilized)
jajo - yumurta | tohum (zapłodnione)
jałowiec - ardıç
jama ustna - ağız
jantar - kehribar
japa - ağız
jara - kaynana
jarecka - ame | ana
jaśmin - yasemin
jasny - anlaşılır
jebać - sikmek
jebadło - yatak odası
jeden za wszystkich, wszyscy za jednego - birimiz hepimiz, hepimiz birimiz için
jednorożec - tekboynuz
jemeński - Yemen
Jerycho - Eriha
jeśli - eğer
jeśli wejdziesz między wrony, musisz krakać jak i one - Roma'dayken Romalılar gibi davran
jeż - kirpi
jeżeli - eğer
Jezus - İsa
Jezus Chrystus - İsa Mesih
język obcy - yabancı dil
język ojczysty - anadili
jeżyna - dut | böğürtlen
jidysz - Yidiş
jogurt - yoğurt
Jowisz - Jüpiter
Judasz - Yehuda
Jugosławia - Yugoslavya
juny - genç
Jupiter - Jüpiter
Jutrzenka - Eos f
kabuki - kabuki
kafej - kahvehane
kafenijo - kahvehane
kaffa - kahve
kaj - nerede
kakadu - kakadu
kalafa - burun | yüz
kalapitra - baş
kalendarz - takvim
kalifat - hilafet | halifelik
kam - nerede
Kamerun - Kamerun
kanarek - kanarya
kaolin - kaolin
kapcylinder - şapka | başlık
kapeć - terlik
kapeluch - şapka | başlık
kapelusz - şapka | başlık
kąpiółka - banyo
kapitalizm - kapitalizm
kapować - anlamak
karaba - kedi
karawana - kervan
karczoch - enginar
karetka - ambulans
karlus - yakışıklı
karta graficzna - görüntü kartı
karta pocztowa - kartpostal
kartka - kartpostal
Kaszmir - Keşmir
kąt - açı
Katalonia - Katalonya
katastrofa - afet
Katmandu - Katmandu
Katyń - Katyn Katliamı
kawa - kahve
kawa po turecku - Türk kahvesi
kawiarnia - kahvehane
kawon - karpuz
kciuk - başparmak
keczup - ketçap
kędy - nerede
kefir - kefir
kejter - köpek m
Kenia - Kenya
kenotaf - anıt mezar
kenotafium - anıt mezar
kiełbasa - solsis
kiepeła - baş
kijanka - iribaş
Kilimandżaro - Kilimanjaro Dağı | Kilimanjaro
kimać - uyumak
kimono - uyku | rüya | düş | hayal
kinematyka - kinematik
kinol - burun
Kirgistan - Kırgızistan
kiszka - süt
kit - yalan
kłąb - çile
kłamstwem daleko się nie zajdzie - yalancının mumu yatsıya kadar yanar
kłamstwo - yalan
kłamstwo ma krótkie nogi - yalancının mumu yatsıya kadar yanar
kłapaczka - ağız
klasy - seksek
klasyczny - klasik
klaustrofobia - klostrofobi
kliber - burun
klika - klik | hizip
klimatyczny - iklimsel
kluber - burun
klucz - anahtar
kluka - burun
kluza - cezaevi | hapishane
knipa - kitap
koala - koala
kobalt - kobalt
kobieta - kadın
kochanie - aşkım
kociamber - kedi
kocioł - kazan
kodeina - kodein
kod kreskowy - barkod | bar kod
kogeneracja - kojenerasyon
kokosz - tavuk
kokoszka - tavuk
kołchoz - kolhoz
kolczyk - küpe
kolebka - beşik
kolekcjoner - koleksiyoncu
koleś - adam
koło garncarskie - çömlekçi çarkı
kolonoskopia - kolonoskopi
kolor - renk
Kolumb - Kolomb
Kolumbia - Kolombiya
Kolumbia Brytyjska - Britanya Kolumbiyası
kołysanka - ninni
koma - virgül
komar - sivrisinek
komat - virgül
komedia - güldürü
kometa - kuyruklu yıldız
komitet - kurul | komite | heyet
komp - bilgisayarı
kompromis - uzlaşma
komputer - bilgisayarı
komuch - kırmızı
komunista - kırmızı
komunizm - komünizm
koń - at | beygir | penis
kóń - at | beygir
koncentracja - dikkat toplaşımı | konsantrasyon
koncepcja - fikir
kondensator - kondansatör
kondom - prezervatif | kondom | kılıf
Konfucjusz - Konfüçyüs
koniec - son | sonuç
konieczność - zorunluluk
konsens - oybirliği
konsensus - oybirliği
Konstantynopol - Konstantinopolis
konstytucja - anayasa
konstytucyjny - anayasal
konsumpcja - tüketim
kontynent - kıta | anakara
koper - dere otu
kopruch - sivrisinek
Koran - Kur'an
kord - kard
korespondencja - mektuplaşma
Kos - İstanköy
kosa - bıçak
kość - kemik | zar
kość sitowa - etmoid kemik
kosmos - acun | kozmos
Kosowo - Kosova
kot - kedi
kot bengalski - pars kedisi
kot syjamski - siyam kedisi
kotwica - çıpa
kowadło - örs
kowalno - örs
koza - keçi
kozioł ofiarny - günah keçisi | şamar oğlanı
Koziorożec - Oğlak
krajopis - coğrafyacı
Kraków - Krakov
krasula - sığır | inek
krauza - kavanoz
krew - kan
królik - tavşan
krowa - sığır | inek
krowa, która dużo ryczy, mało mleka daje - havlayan köpek ısırmaz
krtań - gırtlak
krucjata - Haçlı Seferleri
krucyfiks - haç
kruk - kuzgun
kryminał - cezaevi | hapishane
krymskotatarski - Kırım Tatarca
krytyk - münekkit
książka - kitap
księgozbiór - kütüphane
kto chce żyć z swojej pracy, dolegać nie trzeba - erken kalkan yol alir
kto rano wstaje, temu Pan Bóg daje - erken kalkan yol alir
Kuba - Küba
kucharz - aşçı | ahçı
kuć żelazo, póki gorące - demir tavında dövülür
kulturowy - kültürel
kura - tavuk
kurdyjski - Kürt | Kürtçe
Kurdystan - Kürdistan
kurka - tavuk
kurki - tavuk
kurkuma - zerdeçal
kuropatwa - keklik
kuśka - penis
kuskus - kuskus
kutafon - yarak
kutas - yarak
kwarantanna - karantina
kwas - asit
kwas akrylowy - akrilik asit
kwas foliowy - folik asit
kwiecień - nisan
lać - terlik
łacina - Latince
lać jak z cebra - bardaktan boşanırcasına yağmak
lacz - baş | penis
laczek - terlik
łącznik - koşaç
ładny - sirin
łagodny - aheste | acısız
Lahaur - Lahor
lakier do paznokci - oje
lala - kız
Lamia - Lamia
łańcuch pokarmowy - besin zinciri
Laos - Laos
lat - yıl
lata - yıl
lateks - lateks
łatwiutki - kolaycacık
lawenda - lavanta
laweta - top arabası
łazienka - banyo
Lazurowe Wybrzeże - Fransız Rivierası
łechtaczka - klitoris
lęk - anksiyete
lekarz - doktor | hekim | tabip
Leningrad - Petersburg
leniwy - tembel
łepetyna - baş
lepszy wróbel w garści niż gołąb na dachu - bir eldeki kuş çalıdakinin iki misli değerdir
lew - aslan
Lew - Aslan
Liban - Lübnan
liberalizm - liberalizm
liberalny - hoşgörülü | liberal
liceum - lycée
lichwa - aşırı faiz | tefecilik
limuzyna - limuzin
linie lotnicze - hava yolu
lipiec - temmuz
lis - tilki
list - mektup
listopad - kasım
literatura - edebiyat
Litwa - Litvanya
lód - buz
łódź - kayık
logika - mantık
logiko - mantık
łokieć - dirsek
lola - kız
Lombardia - Lombardiya
Londyn - Londra
lotos - nilüfer
lotus - nilüfer
Łotwa - Letonya
lub - veya
łucznictwo - okçuluk
ludzie - ahali
łudzikwiat - nisan
Luksemburg - Lüksemburg
lulka - sigara
luńt - köpek m
luty - şubat
łża - yalan
mać - ame | ana
macica - rahim
magister - kaptan
mahometanizm - Müslümanlık
maj - mayıs
Makau - Makao
malaria - sıtma
malowidło - boya
Malta - Malta
mały palec - serçe parmağı
małżeństwo - evlilik
małżonek - zevç | koca
mama - kaynana
Mandżuria - Mançurya
maniurka - kız
maras - çamur
maraton - maraton
Marokańczyk - Faslı
marokański - Faslı
Mars - Mars
Marsylia - Marsilya
martwy - ölü
marzec - mart
marzenie senne - uyku | rüya | düş | hayal
masakra - katliam | kırım | toplukıyım
masara - sinek
maska - yüz
masochizm - mazoşizm
maszyna do szycia - dikiş makinesi
matematyka - matematik
materialista - özdekçi | materyalist | maddeci
matka - ame | ana
matriarchat - anaerkillik
matrioszka - matruşka
Mauretania - Moritanya
mauzoleum - mozole | anıtmezar
mąż - zevç | koca
mazak - yüz
mecenas - avukat
męczennik - şehit
meczet - cami | mescit
mediana - ortanca
medyk - doktor | hekim | tabip
melatonina - melatonin
melodia - melodi
melodio - melodi
Merkury - Merkür
metabolizm - metabolizma
metafora - mecaz
metal - metal
meteor - akanyıldız | meteor
meteoryt - göktaşı
metr sześcienny - metreküp
mężczyzna - adam
Mezopotamia - Mezopotamya
Miami - Miami
miasto stołeczne - başkent
miau - miyav
micela - misel
Michał - Mikail
miecz - kılıç
miedźwiedź - ayı
Międzynarodowy Ruch Czerwonego Krzyża i Czerwonego Półksiężyca - Uluslararası Kızılhaç ve Kızılay Hareketi
miejska legenda - şehir efsanesi
mielcuch - bira
miesiąc - ay
mięsopustnik - şubat
migdał - badem
Mila - Emine
milioner - milyoner
militarny - askeri
militaryzm - militarizm
miłość - aşk
miłość platoniczna - platonik aşk
miłosierdzie - merhamet
minaret - minare
ministerstwo - bakanlık
minuta - dakiki
miraż - serap | ılgım
mistrzostwa - şampiyonluk
mistycyzm - mistisizm
mitologiczny - mitolojik
mleko - süt
młody - genç
młotek - çekiç
mniejszość - azınlık
mniej więcej - aşağı yukarı
moc - güç | kudret | kuvvet
modrakowy - mavi
modry - mavi
Mojżesz - Musa
mokry - ıslak
moment - an | lahza
monocykl - tekteker
monofizytyzm - monofizit
monogamiczny - tekeşli
monogamista - tekeşli kimse
monotonia - monotonluk
montaż - montaj
moralność - ahlak
moralny - ahlaki
mordować - öldürmek
morze - deniz
Morze Arabskie - Umman Denizi
Morze Bałtyckie - Baltık Denizi
Morze Czarne - Karadeniz
Morze Czerwone - Kızıldeniz
Morze Śródziemne - Akdeniz
most - köprü
Mount Everest - Everest Dağı
mowa - konuşma
mowa jest srebrem, a milczenie złotem - söz gümüşse, sukut altındır
mozaika - mozaik
Mozambik - Mozambik
mózg - beyin
możliwy - mümkün
mrówka - karınca
mucha - sinek
mućka - sığır | inek
muł - katır
muraszka - karınca
Mustafa - Mustafa
muszla - kabuk
mużyk - adam
mydło - sabun
mykita - tilki
naczyniak krwionośny - hemanjiyom
nadnaturalny - doğaüstü
nadprzyrodzony - doğaüstü
nadzieja - umut
Nairobi - Nairobi
na litość boską - Allah aşkına!
Namibia - Namibya
namiętny - tutkulu
napalony - abazan
napletek - sünnet derisi
naprany - sarhoş
naskórek - epiderm
nauczyciel - öğretmen | muallim
nauka - bilim | ilim
neoliberalizm - neoliberalizm
neon - neon
neptun - neptünyum
Neptun - Neptün
neutralny - tarafsız
ni - hayır
nic - hiçbir şey
nie - hayır
nieatrakcyjność - alımsızlık
niebieski - mavi
niebieskooki - gök gözlü
niedaleko pada jabłko od jabłoni - armut dalının dibine düşer
niedokrwistość - kansızlık | anemi
niedokrwistość tarczowatokrwinkowa - akdeniz anemisi | akdeniz kansızlığı | talasemi
nie dospać trzeba, kto chce dostać chleba - erken kalkan yol alir
niedożywienie - kıtlık
nieduch - hastalık
niedziela - pazar
niedźwiedź - ayı
niegodziwy - şerefsiz
niehonorowy - şerefsiz
nie ma dymu bez ognia - ateş olmayan yerden duman çıkmaz
Niemcy - Almanya
Niemiec - Alman
nie mieć - hayır
Niemiecka Republika Demokratyczna - Demokratik Almanya Cumhuriyeti
nie od razu Kraków zbudowano - sabreden derviş, muradına ermiş
niepewność - şüphe
niepodległość - bağımsızlık
niepogromny - aheste | acısız
nieprawidłowy - anormal
nieskuteczny - etkisiz
nieśmiertelność - ölümsüzlük
nieśmiertelny - ölümsüz
nietoperz - yarasa
niewiasta - kadın
niewiedza - bilgisizlik
nigdy - asla
Nigeria - Nijerya
nihilizm - nihilizm
nikczemny - alçak
nikotyna - nikotin
Nikozja - Lefkoşa
Niniwa - Ninova
NLPZ - NSAİİ
no - evet
noc - gece
nonsens - saçmalık
Normandia - Normandiya
Norweg - Norveçli
nos - burun
Nowa Zelandia - Yeni Zelanda
nóż - bıçak
nożyce - makas
nożyczki - makas
Numidia - Numidya
nurkować - dalmak
nyga - sivrisinek
oaza - vaha
obelisk - dikilitaş
oberżyna - patlıcan
obfity - bereketli | feyizli
obiecadło - alfabe | abece
obiektywny - tarafsız
obłok - bulut
obój - obua
obojętność - aldırmazlık
obojętny - aldırmaz
obraz - film
obraza - hakaret | onur kırma
obrzezanie - sünnet
obserwować - gözlemlemek | gözlemek
obwarzanek - simit | gevrek
ocean - okyanus
Ocean Atlantycki - Atlas Okyanusu
ociec - baba
odcisk palca - parmak izi
Odessa - Hacıbey
odpadek - çöp
odrażający - iğrenç
odraźny - iğrenç
ogórecznik lekarski - hodan
ogórek - salatalık
ojciec - baba
ojla - baykuş
oko - göz
okra - bamya
okręt podwodny - denizaltı
okrucieństwo - zulüm | acımasızlık | gaddarlık
oksymoron - oksimoron
okupacja - işgal
olcha - kızılağaç
Olimpia - Olimpiya
omieszkać - hayır
opal - opal
opera mydlana - pembe dizi
opium - afyon
orangutan - orangutan
oraz - ve
orgazm - orgazm
orientalistyka - doğubilim
origami - origami
osierdzie - perikard
osioł - eşek
ośmiornica - ahtapot
osoba - kişi
ostateczny - kati
ostrężyna - dut | böğürtlen
otwarcie - açıkça | açış
owoc - meyve
ożarty - sarhoş
ożyna - dut | böğürtlen
pachniarz - burun
paciuk - sıçan
padaczka - epilepsi
Padwa - Padova
pajac - palyaço
pająk - örümcek
pajęcznik - eylül | ekim | kasım
Pakistan - Pakistan
pakli - eğer
pała - baş | penis
pale - baş | penis
palec wskazujący - işaret parmağı
Palermo - Palermo
Palestyńczyk - Filistinli
palindrom - palindrom
palma - palmiye
palto - palto
pani - abla
Panna - Başak
pantera śnieżna - kar parsı
papeć - terlik
papier - kâğıt
papieros - sigara
papuć - terlik
para - su buharı
paraliż - paralizi
partenogeneza - partenogenez
partner - ortak | eş | arkadaş
pasterz - çoban
paszenog - bacanak
paszport - pasaport
pasztet strasburski - foie gras
pawęża - kalhan
październik - ekim
paździerzeń - ekim
pechowy - bedbaht
pedagogika - pedagoji
pejoratywny - aşağılayıcı | küçültücü
pekator - penis
penis - penis
perfumy - parfüm
persona - kişi
Peru - Peru
perwersyjny - sapık
Petersburg - Petersburg
piana - bira
piątek - cuma
pidżama - pijama
piękny - güzel
pielęgniarka - hemşire
pieprz - biber
pieprzyć - sikmek
pierdolić - sikmek
pierdy - dedikodu
pierdzieć - osurmak
pierścionek - yüzük
pies - köpek m
pięść - yumruk
pies pasterski - çoban köpeği
pijany - sarhoş
pijawa - gökkuşağı
pikawa - yürek
piksel - piksel
piła - testere
pilaw - pilav
piłka nożna - futbol
piłkarzyki - langırt
piorun - yıldırım
piosenka - şarkı
piosenkarz - şarkıcı
Pireneje - Pireneler
piromania - piromani
piryt - pirit
pismo - alfabe | abece
Pittsburgh - Pittsburgh
piwo - bira
piżama - pijama
Pizydia - Pisidya
plac - meydan
płacić - ödemek | tediye etmek
plajster - plaster
planeta - gezegen
planetarium - planetaryum
planta - bitki
plaster - plaster
plotka - dedikodu
płuco - akciğer
płyn - akışkan
płynny - sıvı
pływak - yüzücü
POChP - KOAH
poczekalnia - bekleme odası | bekleme salonu
pocztówka - kartpostal
podatek - vergi
podatnik - vergi mükellefi
podejrzewać - şüphelenmek | kuşkulanmak
podróżować - yolculuk etmek | seyahat etmek
podstawowy - birincil | temel | esaslı | asıl
poduszka - yastık
podwórze - avlu
pogaństwo - paganlık | paganizm
pójść z kimś do łóżka - yatmak
poker - poker
poleku - yavaş
poligamia - poligami
poliptyk - poliptik
polityka - politika
polon - polonyum
położenie - yer
Polska - Polonya / Lehistan
polski - Lehçe
południowy wschód - güneydoğu
Półwysep Arabski - Arap Yarımadası
Półwysep Iberyjski - İber Yarımadası
Półwysep Pirenejski - İber Yarımadası
pomarańczowy - turuncu
pomidor - domates
pomnik - abide
pomoc - yardım
pomocny - yararlı
poniedziałek - pazartesi
ponieważ - çünkü
ponton - ponton
popiół - kül
populizm - popülizm
pornografia - pornografi
pornograficzny - pornografik | müstehcen | açık saçık
portret - portre
porucznik - üsteğmen
poruta - utanç
poślubić - evlenmek
posowa - tavan
potas - potasyum
powątpiewać - şüphelenmek
powoli - yavaş
powtarzać - tekrarlamak
pozór - dikkat
praca domowa - ödev
prącie - penis
pracownik - amele | işçi
pralka - çamaşır makinesi
prawa zwierząt - hayvan hakları
prawda - hakikat
prawdopodobny - muhtemel
prawdziwych przyjaciół poznaje się w biedzie - dost kara günde belli olur
prezerwatywa - prezervatif | kondom | kılıf
prezydent - başkan
proch - barut
proch strzelniczy - barut
profesor - profesör
profilaktyczny - profilaktik
profit - kazanç
program - program | izlence
prokurator - savcı
propaganda - propaganda
propagando - propaganda
prostolinijność - doğruluk
proszę - lütfen
protestować - protesto etmek
prysznic - duş
przebaczenie - bağışlama | affetme
przebiśnieg - kardelen
przecinek - virgül
przeciwciało - antikor
przedmiot - şey
przedpokój - koridor
przeludnienie - nüfus fazlalığı
przemożność - güç | kudret | kuvvet
przenośnia - mecaz
przerażający - korkunç | korkulu
przesadzać - abartmak
przesmyk - kıstak
przestraszyć - korkutmak
przewrażliwiony - alıngan
przybity - yýpranmýþ
przyjaciel - ahbap
przyjaźń - ahbaplık | arkadaşlık | dostluk
przymiotnik - sıfat
przymus - zorlama
przynosić - getirmek
przyprawa - baharat
przysadka mózgowa - hipofiz
przystojny - yakışıklı
przytulić - sarılmak
przywódca - önder
pseudonauka - sözdebilim
Psia Gwiazda - Sirius | Akyıldız
psisko - köpek m
psor - profesör
psycholog - psikolog | ruhbilimci
psychologiczny - ruhbilimsel | psikolojik
psy szczekają, karawana idzie dalej - it ürür, kervan yürür
pszczoła - arı
pszenica - buğday
Ptah - Ptah
ptak - penis
ptasia grypa - kuş gribi
ptaszę - penis
puste - boş
pusty - boş
pustynia - çöl
puszka - cezaevi | hapishane | bira
pyta - penis
rabarbar - ravent
rachatłukum - lokum
raciądz - serefli | şövalye | sipahi
radon - radon
raj - behişt
Rajch - Almanya
rajzować - yolculuk etmek | seyahat etmek
Rak - Yengeç
ramadan - Ramazan
rasizm - ırkçılık | anasoyculuk
razdziawa - kuzgun | leş kargası
raz na ruski rok - kırk yılda bir
reakcja - aksitesir
recesja - resesyon
referencja - dolaylama
rękaw - kol
rekin - köpek balığı
reklama - reklâm | ilan | duyuru
relacja - alaka
republika bananowa - muz cumhuriyeti
Republika Czeska - Çek Cumhuriyeti
Republika Federalna Niemiec - Almanya Federal Cumhuriyeti
Republika Południowej Afryki - Güney Afrika Cumhuriyeti
Republika Słowacka - Slovak Cumhuriyeti
rewolucja - devrim
robić z igły widły - pireyi deve yapmak
robieniec - amele | işçi
robotnik - amele | işçi
robotyka - robotik
rocznica - yıldönümü
rodzimy - yerli
rodzina - aile
roentgen - röntgenyum
rogacizna - sığır
rok - yıl
rolnictwo - çiftçilik | ziraat
romantyzm - coşumculuk | romantizm
ropa naftowa - yer yağı | neft | petrol
ropień - apse
roślina - bitki
rouza - gül
również - ayrıca
równina aluwialna - birikinti ovası
równość - adalet
róż - pembe
róża - gül
rozmowa - sohbet
różnorodny - çeşitli
różny - farklı | başka | ayrı
różowy - pembe
rozpaczać - ağlamak
rozrzutny - müsrif
roztomaity - farklı | başka | ayrı
rozumieć - anlamak
rozwód - boşanma
rubid - rubidyum
ruchome schody - yürüyen merdiven
ruczaj - akarsu
rudny - kırmızı
rugby - ragbi
ruten - rutenyum
ryba - balık
Ryby - Balık
rycerz - serefli | şövalye | sipahi
rynka - çanak w
rynna - oluk
rynwa - oluk
rysunek - çizim | desen
rytuał - tören
rywal - rakip
rywalizować - ölçüşmek
ryż - pirinç
ryzyko - tehlike
rzeczywistość - gerçeklik
rzeka - nehir | ırmak | akarsu
rzeźbiarz - heykeltıraş
rzut karny - penaltı
sabotaż - sabotaj
Safakis - Sfaks | Sfakes | Safakes
sagan - baş
Sahara Zachodnia - Batı Sahra
sałatka - salata
Salwador - El Salvador
samar - samaryum
samochód - araba
samolot - uçak
samowar - semaver | semâver
santuri - santur
sarnapa - zürafa
sąsiad - komşu
Saturn - Satürn
sceptycyzm - kuşkuculuk
schody ruchome - yürüyen merdiven
schyłek - son
Scylla - Scylla
seks oralny - oral seks
seksualność - cinsellik
seksuologia - seksoloji
selen - selenyum
sen - uyku | rüya | düş | hayal
Serbia i Czarnogóra - Sırbistan ve Karadağ
serce - yürek
serdce - yürek
serdeczny palec - yüzük parmağı
seroka - saksağan
siano - saman
siarkowodór - hidrojen sülfür
Side - Side
sieczeń - şubat
siedem grzechów głównych - yedi ölümcül günah
sierpień - ağustos
siestrzan - yeğen
siestrzeniec - yeğen
sikhizm - sihizm
siła - güç | kudret | kuvvet
silno - çok | daha
sin - sin
Singapur - Singapur
siniak - morartı
siostra - abla (starsza siostra) | kız kardeş (młodsza siostra)
siostrzan - yeğen
siostrzanek - yeğen
siostrzeniec - yeğen
sirpień - ağustos
sitwa - klik | hizip
siusiu - çiş
skand - skandiyum
Skandynawia - İskandinavya
skład - tavan
sklep - tavan
skok o tyczce - sırıkla yüksek atlama
Skop - Koç
Skorpion - Akrep
skrajna prawica - aşırı sağ
skrobia - nişasta
skrót - kısaltma
śleboda - özgürlük
śledziona - dalak
ślepucha - tavuk
ślepy lelek - yarasa
ślimak - salyangoz | sümüklüböcek
słoik - kavanoz
słoń - fil
słońce - güneş
słowa - söz
Słowenia - Slovenya
Słowianin - Slav
słowik - bülbül
słowik szary - ardıç bülbülü
słownik - sözlük
słowo - söz
ślusarz - çilingir
smacznego - afiyet olsun
smartfon - akıllı telefon
smerf - Şirin | Şirinler
śmieć - çöp
śmierć - ölüm
smutniak - ekmek
smutny - üzgün
śnieg - kar
sobaka - köpek m
sobota - cumartesi
socjolog - sosyolog
soczewica - mercimek
soczystość - sululuk
sód - sodyum
sojusznik - müttefik
solniczka - tuzluk
Solon - Solon
Somalia - Somali
somsiad - komşu
sosna - çam
sos sojowy - soya sosu
sowa - baykuş
sowa śnieżna - kar baykuşu
spać - uyumak
specjalnie - özellikle
sperma - meni | er suyu
śpiący - uykulu
śpiewać - ötmek
śpiewak - şarkıcı
śpioch - ayakta uyuyan kimse
spirulina - spirulina
spis rzeczy - fihrist
spis treści - fihrist
spowiedź - itiraf
spragniony - susamış
sprawiedliwość - adalet | haklılık
sprawiedlność - adalet | haklılık
sprzeciw - itiraz
srebro - gümüş
średniowiecze - ortaçağ | Orta Çağ
Sri Lanka - Sri Lanka
środa - çarşamba
środki masowego przekazu - kitle iletişim araçları
sroka - saksağan
ssak - memeli hayvan
stacja kolejowa - tren istasyonu
Stambuł - İstanbul
stara panna - kalmış
stare miasto - eski
starszy - baba
stary - eski
staw łokciowy - dirsek
Stefan - İstefanos
stół - masa
stolica - başkent
stonka - böceği
strach - korku | korkuluk
strach na wróble - korku | korkuluk
strąpacz - şubat
strażak - itfaiyeci
strit - kent
strój - elbise | giysi
strój kąpielowy - mayo
strumień - akarsu
strumyk - akarsu
struna głosowa - ses teli
Strzelec - Yay
strzykwa - deniz hıyarı
styczeń - ocak
suchy - kuru | susuz
Suez - Süveyş
sufit - tavan
sufizm - tasavvuf | sufizm
sułtanat - sultanlığı
sutener - pezevenk
świadomość - bilinç | farkındalık
świat - dünya
świekra - kaynana
świeść - kaynana
święty mikołaj - Noel Baba
świostka - kaynana
Sydon - Sayda
syfilis - frengi | sifiliz
syjam - siyam kedisi
syjonizm - siyonizm
symbolizować - sembolü olmak
synapsa - sinaps
synowiec - yeğen
sypialnia - yatak odası
Syriusz - Sirius | Akyıldız
syrop klonowy - akçaağaç şurubu
szachy - satranç
szahada - kelime-i şehadet | şahadet
szakal - çakal
szaleństwo - delilik
szaman - şaman
szampon - şampuan
szaszłyk - şaşlık
szczegółowy - ayrıntılı
szczekać - havlamak
szczerość - doğruculuk | doğruluk
szczerze - açıkça
szczęśliwego Nowy Nowego Roku - yeni yılınız kutlu olsun
szczoteczka do zębów - diş fırçası
szczur - sıçan
szczyt - orgazm
szef - ahçıbaşı
szept - fısıltı
szeroki - geniş
szkarłatny - kırmızı
szkira - kız
Szkocja - İskoçya
szkoła - okul
szkop - Alman
szlug - sigara
szmaragd - zümrüt
sznek - çörek
szneka - çörek | yüz
sznur - ip | urgan
szok - şok
szpiegostwo - casusluk
szpuk - güvercin
sztuka - kız
sztuki piękne - güzel sanatlar
szwab - Alman
Szwecja - İsveç
Szwecyjo - İsveç
szwestera - abla (starsza siostra) | kız kardeş (młodsza siostra)
szyja - ense
szykowny - sirin
szynal - çivi | mıh
tachykardia - taşikardi
tacik - baba
Tadżykistan - Tacikistan
tajfun - tayfun
Tajlandia - Tayland
Tajpej - Taipei
tajski - Tayca
tak - evet
także - ayrıca
tak zwany - sözde
tal - talyum
talasemia - akdeniz anemisi | akdeniz kansızlığı | talasemi
Tamiza - Thames Nehri
tan - dans | raks
tańczyć - dans etmek
Tangier - Tanca
tango - tango
taniec - dans | raks
tantal - tantal
Tanzania - Tanzanya
taoizm - taoizm
tarcza - kalhan | yüz
tarcza krystaliczna - kalhan
tarcza strzelecka - kalhan | yüz
tarcza szkolna - kalhan
tasza - torba
Tbilisi - Tiflis
technet - teknesyum
technokracja - teknokrasi
technologia - teknoloji
tęcza - gökkuşağı
Teksas - Teksas
tekst - metin
Tel Awiw - Tel Aviv
telefon - telefon
teleskop - teleskop
tellur - tellur
temat - konu
ten śmiać się śmieje, kto śmiać się śmieje ostatni - son gülen iyi güler
teologiczny - teolojik
teozoficzny - teozofik
terapeuta - terapist
terb - terbiyum
termodynamika - termodinamik
termometr - termometre
Termopile - Termopylae
terroryzm - terörizm
teściowa - kaynana
tetrapylon - tetrapylon
tetum - Tetum
też - ayrıca
Tezeusz - Theseus
tg - tan
Timor Wschodni - Doğu Timor
tlen - oksijen
Tokio - Tokyo
toksyna - toksin
tor - toryum
Tora - Tevrat
torba - torba
tory - toryum
totem - totem
trąd - cüzzam
trądzik - akne
tragiczny - trajik acıklı
traktor - traktör
trichotillomania - trikotillomani
trochę - biraz
Troja - Troya
trwałość - kalıcılık | dayanıklılık
Trynidad i Tobago - Trinidad ve Tobago
trzcina cukrowa - şeker kamışı
trzęsienie ziemi - zelzele | deprem | yer sarsıntısı
trznadel zwyczajny - Sarı kiraz kuşu
trzymać - tutmak
tudzież - ve
Tunezja - Tunus
turban - türban
Turcja - Türkiye
Turecka Republika Cypru Północnego - Kuzey Kıbrıs Türk Cumhuriyeti
turecki - Türk | Türkçe
Turkmenistan - Türkmenistan
turkus - firuze
turysta - turist
turystyczny - turistik
turystyka - turizm
twarz - yüz
Tybetańczyk - Tibetli
tydzień - hafta
Tygrys - Dicle
tyj - çay
tylko - sadece
typografia - tipografi
tyrania - zulüm
Tyrteusz - Tyrtaios
ubóstwo - yoksulluk
ucho - kulak
uczciwość - doğruluk
uczciwy - dürüst | hilesiz | namuslu
uderzyć w kimono - yatmak
ufnal - çivi | mıh
Ugarit - Ugarit
uj - dayı
ujec - dayı
ujek - dayı
Ujgur - Uygur
układ okresowy - periyodik cetvel
układ okresowy pierwiastków - periyodik tablo | periyodik cetvel
Ukraina - Ukrayna
ukraiński - Ukrayince | Ukraynaca | Ukraynca
ultrafiolet - morötesi
ultraprawica - aşırı sağ
umierać - ölmek
umysł - akıl
Unia Europejska - Avrupa Birliği
unikatowy - eşsiz
upiec dwie pieczenie na jednym ogniu - bir taşla iki kuş vurmak
Uran - Uranüs
urępny - güzel
uroczy - hoş | alımlı
urodziwy - sirin
urologia - üroloji
urządzenie - aygıt
usta - ağız
uwaga - dikkat
Uzbekistan - Özbekistan
wacha - vahu | yağmur | deniz | su
Waga - Terazi
wajco - yumurta | tohum (fertilized)
wariat - deli | budala
warstwowy - ince tabakalı | tabakalı
wata cukrowa - pamuk şekeri | pamuk helvası
wątpić - şüphelenmek
Watykan - Vatikan
ważność - önem
wcześniactwo - erken doğum
wczoraj - dün
wczorajszy - dünkü
weganizm - veganizm | veganlık
węgiel - karbon
Węgry - Macaristan
Wenera - Venüs
Wenezuelczyk - Venezuelalı
Wenus - Venüs
Wesołych Świąt - Mutlu Noeller
wgłębienie - çukur
wiatr - rüzgâr | yel
wideoklip - video klip
widzieć - görmek
wieczność - sonsuzluk
wieczór - akşam
wieczorny - akşam
Wiedeń - Viyana
wiedzieć - bilmek anlamak
wielbłąd - deve
Wielka Brytania - Birleşik Krallık
Wielkanoc - Paskalya
wielki - büyük
Wielkie Antyle - Büyük Antiller
wieszak - askı
wieża ciśnień - su kulesi
wieża Eiffla - Eyfel Kulesi
więzienie - cezaevi | hapishane
Wikipedia - Vikipedi
Wikisłownik - Vikisözlük
Wikiźródła - VikiKaynak
wiktoria - zafer | galibiyet
wilk - kurt | böri
willa - villa
winnica - bağ
winograd - bağ | üzüm
winogrono - üzüm
wiosna - ilkbahar | bahar
Wirakocza - Viracocha
Wisła - Vistül
wiśnia - vişne
Włochy - İtalya
woda - su
woda mineralna - maden suyu
Wodnik - Kova
wodór - hidrojen
wojak - asker
wojna - savaş
wojskowy - asker
wokabularz - sözlük
wolność - özgürlük
wolny - aheste
worek sercowy - perikard
wrodzony - doğuştan
wrona - leş kargası
wróżka - peri
wrzesień - eylül
wrzód - ülser
Wschód - Yakın Doğu | Orta Doğu | Ortadoğu
wścieklizna - kuduz
wspaniałomyślny - cömert
wstyd - utanç
wszechświat - gök kubbe
wszyscy - hacısı hocası
wszystkie - hacısı hocası
wszystkie drogi prowadzą do Rzymu - tüm yollar Roma'ya çıkar
wtorek - salı
wuj - dayı
wujek - dayı
wujko - dayı
wujo - dayı
wulkan - yanardağ | volkan
wuszt - solsis
Wybrzeże kość Kości Słoniowej - Fildişi Sahili | Fildişi Kıyısı
wydma - kumul
wykonawca - yapan
wykrywacz kłamstw - yalan makinesi
wykształcony - eğitimli
wykusz - cumba
wyraz - söz
Wyspa Świętego Wyspy Świętego Tomasza i Wyspa Książęca - São Tomé ve Príncipe
Wyspa Wniebowstąpienia - Ascension Adası
Wyspy Kanaryjskie - Kanarya Adaları
Wyspy Owcze - Faroe Adaları
wytrysk - boşalma | ejakülasyon
wytrzymałość - tahammül
wytrzymały - acar | atılgan
zabawny - komik | güldürücü | eğlendirici
zabijać - öldürmek
Zabulon - Zebulun | Zevulun | Zvulun | Zebulon | Zabulon
Zachodni Brzeg - Batı Şeria | Cisürdün
Zachodni Brzeg Jordanu - Batı Şeria | Cisürdün
zachód słońca - gurup
zaćmienie - tutulma
zadanie domowe - ödev
zakażenie - enfeksiyon
zakład karny - cezaevi | hapishane
żal - keder
zalany - sarhoş
zamówienie - sipariş
zapalenie płuc - zatürree
zapominać - unutmak
zapraszać - çağırmak
żargon - argo
żartować - şaka yapmak
Zatoka Bengalska - Bengal Körfezi
Zatoka Meksykańska - Meksika Körfezi
Zatoka Perska - Basra Körfezi
zawój - türban
zazdrość - çekememezlik | kıskançlık
zbieg okoliczności - tesadüf
zbieracz - koleksiyoncu
zboczeniec - sapık
zbrodnia katyńska - Katyn Katliamı
zbrodnia wojenna - savaş suçu
zdecydować - kararlaştırmak
ździebluchno - biraz
żebrak - dilenci
żegleń - karbon
żelazko - ütü
żelazo - demir
zelter - maden suyu
zemrzeć - ölmek
żeńczyna - kadın
zgromadzenie - toplantı
ziele angielskie - yenibahar
zielnik - bitki müzesi | bitki koleksiyonu
zielonooki - yeşil gözlü
zielony - yeşil
Ziemia - Dünya
zima - kış
zimnica - ateş
ziołolecznictwo - herboloji
Zjednoczone Emiraty Arabskie - Birleşik Arap Emirlikleri
zjeżdżalnia - kaydırak
złodziej - hırsız
złoto - altın
zmieniać - degiştirmek
zmuszać - zorlamak
znak wodny - filigran
zodiak - Zodyak | burç
żołądek - mide
żołnierz - asker
żółw - kaplumbağa
żongler - jonglör
źrenica - gözbebeği | açıklık | göz
źródło - kaynak
zrozumiały - anlaşılır | açık
zrywka - torba
ZUM - İYE
żurnalista - gazeteci
Związek Radziecki - Sovyetler Birliği
Związek Socjalistycznych Republik Radzieckich - Sovet Sosyalist Cumhuriyetleri Birliği
zwierzak - hayvan
zwierzę - hayvan
zwycięstwo - zafer | galibiyet
życzenie - arzu
żyrafa - zürafa
Żyzny Półksiężyc - Bereketli Hilal
