a - a, ale
abaja - abája
abat - opat m
abażur - stínítko
abchaski - abcházština f
Abdon - Abdon m
abdykacja - abdikace
abdykować - abdikovat, odstupovat, odstoupit
abecadło - abeceda
Abel - Ábel, Abel
abertam - abertam, abertamský sýr
abfal - blb, blbec
Abidżan - Abidžan m
abiecadło - abeceda
Abisyńczyk - Habešan m
Abisynia - Habeš
Abisynka - Habešanka f
abisyński - habešský
ablegat - delegát m
ablegierek - dítě n
ablutomania - nutkavé mytí n
abonament - předplatné
abonent - abonent, předplatitel
abonować - abonovat, předplácet
Abraham - Abrahám
Abruzja - Abruzzo
ABS - ABS
absces - absces m
absencja - absence f, nepřítomnost f
absolutny - absolutní, úplný, naprostý
absolutyzm - absolutismus
abstrakcja - abstrakce, zobecnění
abstrakcyjny - abstraktní, abstraktivní
abstynencja - abstinence f
absurd - absurdnost f, nesmysl m
absurdalny - absurdní
Abudża - Abuja
Abu Zabi - Abú Zabí n
Abwehra - Abwehr
abwera - Abwehr
aby - aby
abzac - podpatek m
Achilles - Achilles m, Achilleus m
Achillesowy - Achillův
achondryt - achondrit
achromat - achromát
achy i ochy - achich ouvej
aczkolwiek - ačkoli, i když
Ada - Ada f
Adam - Adam m
Adamowy - Adamův
adaptacja - adaptace f
adapter - přenoska, gramofon m
adapterowy - gramofonový
Addis Abeba - Addis Abeba f
Adelajda - Adelajda, Adelaida
administracja - administrativa, správa, administrace f
administrator - administrátor m, správce
administrować - obdivovat, uctívat, zbožňovat
Adonis - Adónis
adopcja - adopce f
adres - adresa f
adresat - adresát
adresować - adresovat
Adriatyk - Jadran
adwent - advent m
adwentnik - prosinec m
adwentowy - adventní, adventový
adwokat - advokát m
ady - přece
aedicula - edikula
aeracja - aerace
aerobik - aerobik
aerodrom - letiště
aerodynamika - aerodynamika f
aeroplan - letadlo n
afa - opičák m, opice f, zavináč m
afekt - afekt
afelzina - pomeranč m
Afganistan - Afghánistán m, Afganistan m
afgański - afghánský
afisz - plakát
Afroamerykanin - Afroameričan m
Afrodyta - Afrodita f
Afryka - Afrika f
Afrykańczyk - Afričan m
Afrykanin - Afričan m
Afrykanka - Afričanka f
afrykański - africký
Agata - Agáta f
agencja - agence, agentura
agent - agent, představitel, tajný policista
Aggeusz - Ageus m
agitacja - agitace f
agitować - agitovat
Agnieszka - Anežka f
agonia - agonie, agónie
agrarny - agrární
agregat - agregát
agresja - agrese
agrest - angrešt [{m}}
aguti - aguti
aikido - aikido n
ajzynbaniok - železničář m
akadyjski - akkadština f
akatyst - akafist
akcent - přízvuk m, akcent m
Akra - Accra f
akrobacja - akrobacie f
akronim - akronym m, akronymum
akson - axon
aktor - herec m
aktorka - herečka f
aktyn - aktinium n
akumulator - akumulátor m
akupresura - akupresura f
akupunktura - akupunktura f
akuratnie - přesně
akuratny - přesný
akuzatyw - akuzativ m, čtvrtý pád m
akwarelista - akvarelista m
akwedukt - akvadukt
Akwizgran - Cáchy
Aladyn - Aladin m
alarm - poplach
alaskański - aljašský
alaski - aljašský
alaskijski - aljašský
Albańczyk - Albánec m
Albania - Albánie
Albanka - Albánka
albański - albánština
Alberta - Alberta
Albin - Albín
albinos - albín m
Aldebaran - Aldebaran m
ale - ale
alegoryczny - alegorický
aleja - alej f
Aleksander - Alexandr m, Alexander m
Aleksandra - Alexandra f
alergen - alergen m
alergia - alergie f
alergiczny - alergický
alergik - alergik m
alergologia - alergologie f
alfabet - abeceda
alfabetu - abeceda
Alfred - Alfréd
algebra - algebra
algebraiczny - algebraický
Algier - Alžír
Algieria - Alžírsko
alibi - alibi
Alicja - Alice
alimenty - alimenty
Alina - Alina
alkoholik - alkoholik m
alkoholowy - alkoholický
Allach - Alláh m
Allah - Alláh m
allel - allela f
alleluja - aleluja, halejuja
almanach - kalendář m
Alojz - Alois
Alojzy - Alois
alpinista - horolezec m], alpinista m]
alpinizm - horolezectví
Alpy - Alpy
aluminium - hliník m
Alzacja - Alsasko
Amadeusz - Amadeus
amajza - mravenec m
Amalia - Amálie f
ambirz - zázvor m
ambona - kazatelna
Ambrożowy - Ambrožův
Ambroży - Ambrož m
ambulatoryjny - ambulantní
ambus - kovadlina f
Amelia - Amélie f
amen - amen
ameryk - americium n
Ameryka - Amerika
Amerykanin - Američan
Amerykanka - Američanka f
Ameryka Północna - Severní Amerika f
Ameryka Południowa - Jižní Amerika f
ametyst - ametyst m
ametystowy - ametystový
amfa - amfetamin m
amfetamina - amfetamin m
amharski - amharština
Amman - Amán
amok - amok
amoniak - amoniak, azan
amoralizm - amoralismus
Amos - Amos
ampułka - ampule f
amputacja - amputace f
Amsterdam - Amsterdam
Amu-daria - Amudarja
amulet - amulet
Amur - Amur m
anachroniczny - anachronistický, anachronický
anachronizm - anachronismus, anachronizmus
anagram - anagram m
anakonda - anakonda
ananas - ananas
anarchizm - anarchismus
Anastazja - Anastázie
Anatol - Anatol
anatom - anatom
anatomia - anatomie f
ancug - oblek m
Andora - Andorra, Andorra la Vella
Andrea - Andrea
android - android m
andrologia - andrologie
andromeda - kyhanka f
Andromeda - Andromeda f
Andrzej - Andrej m, Ondřej m
Andrzejowy - Ondřejův
Andy - Andy
aneksja - anexe f
anekumena - anekumena
anemia - chudokrevnost f
anemo- - anemo-
anestetyk - anestetikum n
anestezjolog - anestetik m
Aneta - Aneta f
anewryzm - aneurysma f
Angielka - Angličanka f
angielski - angličtina
angiografia - zobrazení cév n, angiografie f
angiologia - angiologie f
Anglia - Anglie f
anglicyzm - anglicismus m, anglicizmus m
Anglija - Anglie f
Anglik - Angličan m
angol - Angličan m, angličtina
Angol - Angličan m
Angola - Angola f
angryst - angrešt [{m}}
ani - ani
Aniela - Anděla f
animozja - animozita f
anioł - anděl m
Anioł - Anděl m
Anioł Pański - Anděl Páně m
Anioł Stróż - anděl strážný m
Anita - Anita
aniżeli - než
anjoł - anděl m
Ankara - Ankara
ankieta - anketa f
Anna - Anna f
Annasz - Annáš m
anoda - anoda
anonimowy - anonymní, bezejmenný
anoreksja - anorexie f
Antananarywa - Antananarivo
Antares - Antares
Antarktyda - Antarktida
antidotum - protijed m
Antigua i Barbuda - Antigua a Barbuda
Antoni - Antonín m, Anton m, Antal m
antonim - antonymum
antrejka - chodba f
antropo- - antropo-
antryj - chodba f
Antwerpia - Antverpy
antyamerykański - protiamerický
antybiogram - antibiogram m
antyfaszystowski - protifašistický
antyfona - antifona f
antygen - antigen m
antyimperialistyczny - protiimperialistický
antyklerykalizm - antiklerikalismus
antykomunista - antikomunista m
antykomunistyczny - antikomunistický
antykwariat - antikvariát
antykwarnia - antikvariát
Antyle Holenderskie - Nizozemské Antily
antymateria - antihmota
antymon - antimon
antypapieski - protipapežský
antypolski - protipolský
antysemicki - antisemitský
antysemityzm - antisemitismus m
antyseptyczny - antiseptický
Anubis - Anup m
anyż gwiazdkowy - hvězdicový anýz, badyán m, čínský anýz m, hvězdový anýz m
anyż gwiaździsty - badyán m, čínský anýz m, hvězdový anýz m
Anzelm - Anselm
aorta - aorta
aparat fotograficzny - fotoaparát m
aparat rentgenowski - rentgenový přistroj m
apartheid - apartheid
apasz - zločinec m
apatia - apatie f
apeniński - apeninský
Apeniny - Apeniny
apetyczny - chutný
Apia - Apia
aplikator - aplikátor m
aplikować - podávat, poskytovat
apluzyna - pomeranč m
Apollo - Apollo m, Apollón m, Apollón
Apolonia - Apolena f
apostoł - apoštol m
aprykoza - meruňka f
apryl - duben m
apsik - hepčí!
a psik - hepčí!
apteczka - lékárnička f
aptek - lékárna f
apteka - lékárna f
aptekarz - lékárník m
Arab - Arab m
Arabia Saudyjska - Saúdská Arábie
arabistyka - arabistika
arabski - arabština
arabus - Arab m
arachnologia - arachnologie f
archaiczny - archaický
archanioł - archanděl
archeolog - archeolog m
archimandryta - archimandrita m
Archimedes - Archimedes m
architekt - architekt
architektonika - architektura f
architektura - architektura f
archiwum - archiv
arcybiskup - arcibiskup
arcykapłan - velekněz m
areografia - areografie f
areszt - vazba f
arfa - harfa f
Argentyna - Argentina f
argon - argon m
arkebuz - arkebuza
armata - dĕlo
Armenia - Arménie
Armida - Armida f
arogancja - arogance f, domýšlivost f
aromaterapia - aromaterapie f
aromatyczny - aromatický, voňavý, vonný
arsen - arsen m
artefakt - artefakt m
Artemida - Artemis f
Artemis - Artemis f
arteterapia - arteterapie f
artykuł - článek
arystokrata - aristokrat m, šlechtic m
arytmetyczny - aritmetický
arytmia - arytmie f
-arz - -ář, -ař
as - eso
asceta - asketa m
ascetyczny - asketický
aseksualizm - asexualita
asfalt - asfalt
Asmara - Asmara
Astana - Astana
astat - astat m
astma - astma n
astro- - astro-
astrofizyczka - astrofyzička f
astrofizyk - astrofyzik m
astrofizyka - astrofyzika f
astrolog - astrolog m, hvězdopravec m
astrolożka - astroložka f
astronom - astronom m
astronomiczny - astronomický
astronomka - astronomka f, hvězdářka f
asygnata - bankovka
asymptota - asymptota f
Asyria - Asýrie
Aszchabad - Ašchabad
atak - útok m, záchvat m
atakować - útočit
ateista - ateista m
ateistka - ateistka f
Atena - Aténa f, Athéna f
atencja - pozor
Ateny - Athény
ateusz - ateista m
Atlantyda - Atlantida f
Atlantyk - Atlantský oceán m
atłas - atlas
atol - atol
atrakcja - atrakce f
atrament - inkoust m
Augiasz - Augiáš m
August - August m
Augustów - Augustov
Aurora - Aurora f
Australia - Austrálie
Australijczyk - Australan m
Australijka - Australanka f
Austria - Rakousko n
austriacki - rakouský
Austro-Węgry - Rakousko-Uhersko n
aut - aut
autentyczny - autentický
auto - auto
autobana - dálnice f
autobus - autobus m
autodydakta - samouk m
autoklaw - autokláv m
autokratyzm - autokracie f
automat - automat m
Autonomia Palestyńska - Palestinská autonomie f
autor - autor m
autostop - autostop m
autostopowicz - stopař m
autostopowiczka - stopařka f
autostrada - dálnice f
autystyczny - autistický
autyzm - autismus m
awaria - havárie f, porucha f
Awentyn - Aventin m
awokado - avokado n
Azerbejdżan - Ázerbájdžán
azerski - ázerbájdžánština
Azja - Asie
Azja Mniejsza - Malá Asie f
Azjata - Asijec m
Azjatka - Asijka f
azjatycki - asijský
azot - dusík m
aztecki - aztécký
B - akuzativ m, čtvrtý pád m
baba - bábovka
babakoto - indri
babcia - babička f
Babia Góra - Babia hora
babie lato - babí léto n
babka - babička f
baciar - darebák
bać się - bát se
bać się jak diabeł święconej wody - bát se jako čert kříže
bać się jak ognia - bát se jako ohně
bączek - bukáček malý
baczyć - přemýšlet
badanie - vyšetření n
Badenia-Wirtembergia - Bádensko-Württembersko
badian właściwy - badyán m, čínský anýz m, hvězdový anýz m
badminton - badminton
bądź - bud'
bagaż - zavazadlo
bagażnik - kufr m
Bagdad - Bagdád
bagienny - bažinný
bagietka - bageta
bagnet - bodák m
bahamski - bahamský
Bahamy - Bahamy
Bahrajn - Bahrajn
bajbot - bukáček malý
bajer - lež f
bajerować - lhát
bajka - pohádka
bajtel - dítě n
bajtoła - lenoch m
bajzel - zmatek
bąk - vlk, čmelák m
bakałarz - učitel m
bakelit - bakelit m
bakelitowy - bakelitový
bakłażan - oberžina f
bakłażanowy - lilkový, baklažánový
bakteria - bakterie f
bakteriemia - bakteriémie f, bakteriemie f
bakteriobójczy - dezinfekční
bakteriolog - bakteriolog m
bakteryjny - bakteriální
Baku - Baku
bal - ples m
bala - míč f, balón m
bałabajka - balalajka f
bałagan - zmatek
bałak - rozhovor
bałałajka - balalajka f
balanga - party, hov. akce, mejdlo, mejdan, spářka
balejaż - melír m
baletnica - baletka f
balkon - balkon
balneologia - balneologie f
balsam - balzám m
bałtycki - baltský
Bałtyk - Baltské moře
Bałtyka - Baltika f
balustrada - balustráda f
balustrado - balustráda f
bałwan - sněhulák m, hlupák m
Bamako - Bamako
bambaryła - blb, blbec
bambusowy - bambusový
bana - vlak, tramvaj f
banał - banalita f
banan - banánovník m, banán m
banana - banánovník m, banán m
bananowiec - banánovník m
bandaż - bandáž f, obvaz
Bandżul - Banjul
banerka - plechovka f
Bangi - Bangui
Bangkok - Bangkok
Bangladesz - Bangladéš
bania - dýně f, hlava f
baniaczek - klobouk m
baniak - hlava f
baniok - železničář m
baniorz - železničář m
bank - banka f
banka - tramvaj f
bank krwi - krevní banka f
banknot - bankovka
bankomat - bankomat m
bankowy - bankovní
bank spermy - spermabanka f
Bańska Bystrzyca - Banská Bystrica f
bar - baryum n
Barabasz - Barabáš m
barabola - brambor
baran - beran m
Baran - Beran m
Baranek Boży - Beránek Boží m
barani - skopový, beraní
Barbados - Barbados
Barbara - Barbora f
Barcelona - Barcelona f
bardzo - velmi
baribal - baribal
bark - rameno n, bark
barkarola - barkarola
barki - rameno n, bark
Barnaba - Barnabáš m
barometr - barometr m
baron - baron m
barszcz - boršč
Bartłomiej - Bartoloměj m
Bartłomiejowy - Bartolomějův
barwa - barva
barwić - barvit
barwinkowy - barvínkový
barykada - barikáda f
baryton - baryton m
barzej - velmi, hodně
basior - bič
baskijski - baskičtina
baśń - báje
basta - dost
basza - paša, krmivo
bat - bič
batalion - prapor
batki - kalhotky
batłąch - láhev f
batymetria - batymetrie f
Bawaria - Bavorsko
bawarski - bavorský
bawełna - bavlna
bazalt - čedič m
bażanci - bažantí
bażant - bažant m
bazar - bazar
Bazylea - Basilej
Bazyli - Basil m
bazylia - bazalka f
Beata - Beáta, Beata
Beatrycze - Beatrice f
bebech - žaludek m
beczeć - plakat
beczka - sud m
bedki - houba f
befsztyk - biftek m
bejm - peníz m
Bejrut - Bejrút m
bela - balík
bele kaj - kdekoliv
beletrystyka - beletrie f
belfer - učitel m
Belg - Belgičan m
Belgia - Belgie
Belgijka - Belgičanka f
belgijski - belgický
Belgrad - Bělehrad
Belize - Belize
Belmopan - Belmopan
Benedykt - Benedikt m
bengalski - bengálština f
Beniamin - Benjamín m
Benin - Benin m
berać - vyprávět
Berenika - Berenika f
beret - baret
beretka - baret
Bergamo - Bergamo
berkel - berkelium n
Berlin - Berlín
Berlin Zachodni - Západní Berlín
Bermudy - Bermudy
Berno - Bern
berta - Tlustá Berta f
beryl - beryllium n
Beskid Śląski - Slezské Beskydy
Beskidy - Beskydy
beta-karoten - beta-karoten m
Betlejem - Betlém
beton - beton
betoniarka - míchačka betonu
bety - pyžamo n
bez - šeřík m
bezalkoholowy - nealkoholický
bezbarwny - bezbarvý
bezbramkowy - bezbrankový
bezczelny - drzý
bezdech - zástava dechu f
bezdomny - bezdomovec m
beze - šeřík m
bezgorączkowy - bez horečky
bezkompromisowy - nekompromisní
bezlistny - bezlistý
bezmocz - anurie f
beznadziejność - beznaděj
bezosobowy - neosobní
bezpieczeństwo - bezpečnost
bezpiecznik - pojistka
bezpłatny - bezplatný
bezpodstawny - bezpodstatný
bezpośrednio - přímo
bez pracy nie ma kołaczy - bez práce nejsou koláče
bez pracy nie ma płacy - bez práce nejsou koláče
bezręki - bezruký
beztroski - bezstarostný
bezuch - návštěva f
bezwarunkowo - naprosto
Bhutan - Bhútán
Biała - Bělá
białaczka - leukémie f
biała magia - bílá magie
białko - bílek m, bělima f, oční bělmo n, bílkovina f
Białoruś - Bělorusko
białoruski - běloruština
białowieski - bělověžský
biały - bílý
biatlon - biatlon m
biber - klobouk m
Bibiana - Bibiana f
Biblia - Bible f
biblijny - biblický
biblio- - biblio-
bibliofil - bibliofil m
biblioteka - knihovna f
bibliotekarz - knihovník m
bić - bít
bicykl - bicykl m
bida - chudoba f, bída f
bidet - bidet m
biec - běžet
bieda - chudoba f, bída f
biedak - chudák m
biedny jak mysz kościelna - chudý jako kostelní myš
biedronka - beruška f
biegać - běhat
biegacz - běžec m
biegaczka - běžkyně f
biegnąć - běžet
biegunka - průjem m
bielizna - prádlo n
Bielsko - Bílsko
Bielsko-Biała - Bílsko-Bělá
bierne palenie - pasivní kouření
biernik - akuzativ m, čtvrtý pád m
bieżący - běžný
bieżeć - běžet
bigel - věšák m
bigiel - věšák m
biglosko - žehlička f
biglować - žehlit
biksa - plechovka f
bilet - lístek m, vstupenka f, jízdenka f
bilirubina - bilirubin m
bilokacja - bilokace
bimba - tramvaj f
bindał - bederní zástěrka f
bindasz - penis m, pyj m
bindka - oprátka f, bandáž f, obvaz
binia - holka f, dívka f, přítelkyně f
binks - modřina f
binol - modřina f
binturong - binturong
biochemia - biochemie
biocybernetyka - biokybernetika f
biografia - biografie f, životopis m
biograficzny - biografický, životopisní
biologia - biologie
biologiczny - biologický
bionika - bionika f
biopsja - biopsie f
biotyna - biotin
birmański - barmština
biseksualizm - bisexualita
bishalter - podprsenka f
biskup - biskup m
Bissau - Bissau
Biszkek - Biškek
biurko - psací stůl m
biust - poprsí n, busta f
biusthalter - podprsenka f
biustonosz - podprsenka f
Bizancjum - Byzanc f
bizmut - bismut m
blady - bledý
blaga - lež f
blamaż - blamáž f
blaszany - plechový
Błażej - Blažej m
błecha - blecha f
błędne koło - bludný kruh
błękitna krew - modrá krev
błękitny - blankytný, belasý
Bliski Wschód - Blízký východ m
blisko - blízko
blizna - jizva f
bliźniak - sourozenec m, dvoudomek m
Bliźniak - Blíženec m
Bliźnięta - Blíženci, Blíženci m, Blíženec m
bliźnięta syjamskie - siamská dvojčata
błona dziewicza - panenská blána f
błona śluzowa - sliznice f
blondyn - blondýn, blonďák
błonnik - vláknina f
błotnik - blatník m
blumkol - květák m
bluszcz - břečťan m
bluźnierstwo - blasfemie
błyskawica - blesk m
bo - protože
bóbr - bobr
bocian - čáp m
bociani - čapí
bocznica - vlečka f
bodziec - podráždĕní n
bóg - bůh m
Bóg - Bůh, Hospodin, Pán m
bogactwo - bohatství
Bóg dał, Bóg wziął - Pán Bůh dal, Pán Bůh vzal
bogini - bohyně f
Bogota - Bogotá
Bogumił - Bohumil m
Bogumiła - Bohumila f
Bogusław - Bohuslav m
Bogusława - Bohuslava f
bohater - hrdina m
Bohemia - Česko n, Čechy
bohemistka - bohemistka f
bohemizm - bohemismus m, bohemizmus m
bohr - bohrium n
bójka - rvačka f
bojler - bojler
bojownik - prapor
bojtel - pytel, vak m, výběžek m
bojtlik - peněženka f
boks - box
ból - bolest f
Bolesław - Boleslav m
Boliwia - Bolívie f
bomba - bomba
bomba atomowa - atomová bomba f
Bombaj - Bombaj
bombel - dítě n
bombka - holba f
Bonifacy - Bonifác m
bonsai - bonsai f, bonsaj f
boński - bonnský
bor - bor m
bordo - bordó n, bordový
bordowy - bordový
borg - kredit m, úvěr m
borowik szlachetny - hřib smrkový m
borowina - fango n
borówka - brusnice borůvka, borůvka, tvář f
boski - božský
bośniacki - bosenština
Bośnia i Hercegowina - Bosna a Hercegovina
Botswana - Botswana f
botulizm - botulismus m
boża krówka - beruška f
boźdór - kluk m, přítel m
Bożena - Božena
Boże Narodzenie - Vánoce
bożonarodzeniowy - vánoční
brachol - bratr m, brácha m
bracieniec - bratr m, brácha m
braciszek - bratříček m
brać nogi za pas - vzít nohy na ramena
brak miesiączki - vynecháni menstruace n
bramkarz - brankář m
brat - bratr m, brácha m
brat mniejszy - bratr menší
Bratysława - Bratislava f
bratysławski - bratislavský
brauza - sprcha f
brązowawy - hnědavý
brązowy - hnědý
Brazylia - Brazílie f
Brazylijczyk - Brazilec m
Brazylijka - Brazilka f
brele - brýle
brewiarz - breviář m
brifkastla - poštovní schránka f
briftasza - peněženka f
briftreger - listonoš m
Brno - Brno n
brodaty - bradatý
brodawka sutkowa - prsní bradavka f
brokuł - brokolice f
brom - brom
broń - zbraň
Bronisław - Bronislav m, Branislav m
broszura - brožura
browar - pivo m
brucski - bruselský
Bruksela - Brusel m
brukselka - kapusta f
brukselski - bruselský
Brunei - Brunej
brunet - brunet m
bryczesy - rajtky
brydż - bridž m
bryg - briga f
bryka - automobil m, auto n, vůz m
bryle - brýle
bryndza - brynza f
Brytyjczyk - Brit m
Brytyjka - Britka f
brzmienie - zvuk m
brzoskwinia - broskev f
brzozowy - březový
brzuchomówca - břichomluvec m
brzuszny - břišní
brzuszysko - panděro
brzydki - ošklivý
brzydota - ošklivost f
brzytwa - břitva
buc - chuj
buda - bouda
Budapeszt - Budapešť
buddyjski - buddhistický
buddyzm - buddhismus
budka telefoniczna - telefonní budka f, veřejný telefonní automat m, VTA
budowa - stavba f
budować zamki na lodzie - stavět si vzdušné zámky
budowla - stavba f
budowniczy - budovatel
budynek - budova f, stavení n, stavba f
budzik - budík m
Budziszyn - Budyšín
Bug - Západní Bug
buk - buk
Bukareszt - Bukurešť f
bukinista - bukinista m
buła - žemle f, sval
bulba - brambor
buldożer - buldozer m
Bułgar - Bulhar m
Bułgaria - Bulharsko
Bułgarka - Bulharka f
bułgarski - bulharština
bulić - platit
bulimia - bulimie f
bułka - žemle f, sval
bulwa - brambor
burak - červená řepa
burdel - bordel m
burdynek - souboj m
Burgundia - Burgundsko n
Burkina Faso - Burkina Faso
burmistrz - purkmistr m, purkmistrová f
bursztyn - jantar m
bursztynowy - jantarový
Burundi - Burundi
burza - bouřka
burza w szklance wody - bouře ve sklenici vody f
burzowiny - pivo m
but - bota
butan - butan
butelka - láhev f
butelkowy - lahvový, láhvový
butersznyt - chlebíček m
Bużumbura - Bujumbura
być - být
być bardziej papieskim niż papież - být papežštĕjší než papež
być bardziej papieskim od papieża - být papežštĕjší než papež
być na noże - být na nože
być sto lat za Murzynami - být sto let za opicemi
być w siódmym niebie - být v sedmém nebi
być w swoim żywiole - být ve svém živlu
Bydgoszcz - Bydhošť
Byk - Býk m
Była Jugosłowiańska Republika Macedonii - Bývalá jugoslávská republika Makedonie
Bytom - Bitom
bzybzać - krást
C - mířidlo n, zaměřovač m, hledáček m, dativ m, třetí pád m
cajtung - noviny
całka - integrál m
całkiem - úplně, naprosto, docela
całkowity - úplný
całować - líbat
car - car m
Caracas - Caracas
cebula - cibule f
Cecylia - Cecílie
cedr - cedr
cefeida - cefeida
Cefeusz - Kéfeus m, Cefeus m
cegła - cihla
ceglany - cihlový
ceglasty - cihlový
cel - cíl, účel
cela - cela f
Celestyn - Celestýn m
celibat - celibát m
celownik - mířidlo n, zaměřovač m, hledáček m, dativ m, třetí pád m
celtycki - keltský
cel uświęca środki - účel světí prostředky
cennik - ceník m
centralny - centrální
cep - cep
cepeen - benzínová pumpa f
cer - cer
cera - dcera
cerber - cerber m, cerberus m
Cerber - Kerber m, Kerberos m, Cerber m, Cerberus m
Cerera - Ceres f
Ceres - Ceres f
cesarskie cięcie - císařský řez m
cesarstwo - císařství
cesarz - císař
cewka moczowa - močová trubice f
cewnik - katetr m
cez - cesium
chabić - krást
chabrowy - chrpový
chachoł - krk
chachor - darebák
chamera - mrak m
charakterystyka - charakteristika f
charczeć - chrápat
charkać - plivat
Charków - Charkov m
chart - chrt
Chartum - Chartúm
charyzmatyczny - charismatický
chasyd - chasid m
chcieć - chtít
Chełmno - Chlumno n
Chełmża - Chlumže
chemia biologiczna - biochemie
chemik - chemik
chemioterapia - chemoterapie f
chemoterapia - chemoterapie f
chemotropizm - chemotropismus m
chepresz - chepreš
Cheronea - Chairóneia
Cheroneja - Chairóneia
chichrać się - smát se
Chile - Chile
chilijski - chilský, čilský
Chińska Republika Ludowa - Čínská lidová republika
Chiny - Čína
chipowy - čipový
chipset - čipová sada f
chirurgia kosmetyczna - kosmetická chirurgie f
chitozan - chitosan m
chleb - chléb m
chlebak - chlebník m
chlebowy - chlební
chlew - chlév m, vepřín m
chłodnica - tepelný výměník
chłodny - chladný
chłopak - kluk m, přítel m
chłopiec - kluk m, chlapec m, hoch m
chłopyszek - kluk m, chlapec m, hoch m
chlor - chlor
chloroaceton - chloraceton
chlorofil - chlorofyl m
chłystek - hejsek
chmiel - chmel m, pivo m
chmura - mrak m
choćby - například
chocieć - chtít
chód - chůze f
chodzić - chodit
chodzić od Annasza do Kajfasza - chodit od Annáše ke Kaifášovi
choinka - vánoční stromek m, vánoční stromeček m
chójk - vánoční stromek m, vánoční stromeček m
chojna - borovice
choleryk - cholerik m
cholesterol - cholesterol m
chomik - křeček m
chore - nemocný
choroba - nemoc
choroba cywilizacyjna - civilizační choroba f
choroba morska - mořská nemoc f
choroba Parkinsona - Parkinsonova nemoc f
chorobotwórczość - patogenita f
Chorwacja - Chorvatsko
chorwacki - chorvatský, chorvatština
Chorwat - Chorvát m
Chorwatka - Chorvátka f
chory - nemocný
Chorzów - Chořov
chów - chov m
chrapać - chrápat
chrom - chrom m
chromosfera - chromosféra f
chromosom - chromozom m
chronić - chránit
chronologia - chronologie f
chronologiczny - chronologický
chruścik - chrostík
chrypka - chrapot m
chrystologia - christologie f
Chrystus - Kristus m
Chrystus Pan - Kristus Pán m
chrzan - křen
chrząstka - chrupavka f
chrząszcz - brouk m
chrześcijanin - křesťan m
chrześcijanka - křesťanka f
chrześcijański - křesťanský
chrzestna - kmotra f
chrzestny - kmotr m
chudoba - chudoba f, bída f
chuj - chuj
chuśle - housle
chusteczka - kapesník m
chwalić - chválit
chwila - chvíle f
chwytać - chytat
chytry - chytrý
chyża - stodola f
ciągnik - traktor
ciało obce - cizí tĕleso n
ciało szkliste - sklivec m
ciąża - těhotenství
ciążowy - těhotenský
cicha woda brzegi rwie - tichá voda břehy mele
cicho - potichu
cicho jak w grobie - ticho jako v hrobě
cicho niczym w grobie - ticho jako v hrobě
ciebie - ty
ciecierzyca pospolita - cizrna beraní
cieciorka - čičorka f
ciecz - tekutina f, kapalina f
ciecz łzowa - slzní tekutina f
cielesieństwo - pohlavní styk
ciemnia - temná komora f
ciemnia fotograficzna - temná komora f
ciemnobłękitny - tmavěblankytný, tmavě blankytný
ciemnobrązowy - tmavohnědý, tmavěhnědý, tmavě hnědý
ciemnoczekoladowy - tmavěčokoládový, tmavě čokoládový
ciemnoczerwony - tmavočervený, tmavěčervený, tmavě červený
ciemnofioletowy - tmavěfialový, tmavě fialový
ciemnokasztanowy - tmavěkaštanový, tmavě kaštanový
ciemnoniebieski - tmavomodrý, tmavěmodrý, tmavě modrý
ciemnopomarańczowy - tmavěoranžový, tmavě oranžový
ciemnoróżowy - tmavěrůžový, tmavě růžový
ciemnoszary - tmavošedý, tmavěšedý, tmavě šedý
ciemnowłosy - tmavovlasý
ciemnozielony - tmavozelený, tmavězelený, tmavě zelený
ciemnożółty - tmavožlutý, tmavěžlutý, tmavě žlutý
cień - stín m
Cieplickie Skalne Miasto - Teplické skalní město
ciernisty - trnitý
cierpliwość - trpělivost f
cieść - tchán m, snacha f
cieśnina - průliv m
cieszyński - těšínský
ciężki - téžký
ciga - koza f
ciii - pst!, pšt!
ciocia - teta f
cios poniżej pasa - rána pod pás
ciotka - teta f
cipa - píča f
cipka - slípka zelenonohá, slepice f
cis - modřín
Cisa - Tisa f
ciśnienie - tlak
ciuciubabka - slepá bába, na slepou bábu
ciupa - věznice f, vězení n
ciurlocek - penis m, pyj m
ciurma - věznice f, vězení n
ciżma - bota
cło - clo n
cmentarz - hřbitov
ćmić - palit, kouřit
ćmik - cigareta f
cnotliwy - ctnostný, ctný
co - co, proč, každý, každo-
codzienność - všednost
cofać - ustupovat
cokolwiek - cokoli
córa - dcera
córczysko - dcera
córka - dcera
co z oczu, to z serca - sejde z očí, sejde z mysli
ćpać - jíst
cudzysłów - uvozovka f, zazwyczaj w
cug - průvan, vlak
cukier - cukr
cukiernik - cukrář m
cukrowiec lekarski - cukrová třtina f
cukrzyca - cukrovka f
curig - zpět, zpátky
cwel - blb, blbec
ćwierćfinał - čtvrtfinále
cybernetyk - kybernetik m
cybernetyka - kybernetika f
cyberprzestrzeń - kyberprostor
cychalter - podprsenka f
cydr - cidre
cyferblat - ciferník m, obličej m, tvář f
cyfra - cifra f
cyga - vlk, čmelák m
cygan - podvodník m
Cygan - Cikán m
cygański - cikánský, cikánština
cygareta - cigareta f
cygaretka - cigareta f
cygaro - doutník m
cyjon - dhoul
cyklista - cyklista m
cyklotron - cyklotron
cyklotymia - cyklotymie f
cyna - cín
cynamonowy - skořicový
cyngiel - brýle
cynizm - cynismus, cynicism
cynk - zinek
cypel - mys m, výběžek m
Cypr - Kypr
cypresz - cypřiš m
Cyprian - Cyprián m
cyprys - cypřiš m
cyrkiel - kružítko n
cyrkon - zirkonium
Cyryl - Cyril m
cyrylijski - cyrilský, kyrilský
cyrylo-metodejski - cyrilometodějský
cyrylo-metodiański - cyrilometodějský
cyrylo-metodyjski - cyrilometodějský
cysorz - císař
cytryna - citron m
cytrynat - citron m
cyzjojan - cisiojan
Czad - Čad, Čadské jezero
czador - čádor
czaj - čaj m
czajnik - hlava f
czapla - volavka f
czarna dziura - černá díra
czarna jagoda - brusnice borůvka, borůvka
czarna magia - černá magie
czarna porzeczka - černý rybíz m
czarna skrzynka - černá skříňka f
czarne złoto - černé zlato n, tekuté zlato n
czarnobrązowy - černohnědý
Czarnogóra - Černá Hora f
czarny - černý
czarodziej - čaroděj m
czart - čert m
czas - čas m
czasopismo - časopis
czasownik - sloveso
czas to pieniądz - čas jsou peníze
czciciel - ctitel m
czcionka - litera f, písmeno n, typ m
Czech - Čech m
czechizm - bohemismus m, bohemizmus m
Czechosłowacja - Československo n
Czecho-Słowacja - Československo n
Czechosłowaczka - Čechoslováčka f
Czechosłowak - Čechoslovák m
czechosłowakizm - čechoslovakismus m
Czechy - Česko n, Čechy
Czeczenia - Čečensko n
czędo - dítě n
czekolada - čokoláda f
czekoladowy - čokoládový
czereśnia - třešeň f
czernica - brusnice borůvka, borůvka, ostružina
Czerniowce - Černovice
czerwcowy - červnový
czerwiec - červen m
czerwona porzeczka - červený rybíz m
czerwonobrązowy - červenohnědý
czerwonopomarańczowy - červenooranžový
czerwony - červený, rudý, komunista m
czerwony olbrzym - červený obr m
cześć - ahoj, nazdar
czeski - český, čeština
Czeskie Budziejowice - České Budějovice
cześnia - třešeň f
często - často
Częstochowa - Čenstochová
częstoskurcz - tachykardie f
częsty - častý
Czeszka - Češka f
czeszki - cvička f
czipowy - čipový
czkawka - škytavka
członek - člen m, penis m, pyj m
człowiek - člověk m
człowiek neandertalski - neandertálec m
czołg - tank m
czoło - čelo n
czorny - černý
czosnek - česnek m
czterdziestoletni - čtyřicetiletý
czternastoletni - čtrnáctiletý
czteroletni - čtyřletý
czterosilnikowy - čtyřmotorový
czterystuletni - čtyřsetletý
czuć - cítit, slyšet
czujność - bdělost f, pozornost f
czujny - bdělý, ostražitý
czulent - šoulet
czuły - něžný
czwartek - čtvrtek m
czwartkowy - čtvrteční
czwartorzęd - čtvrtohory f, kvartér, antropozoikum
czy - zda, jestli, nebo
czyhunka - železnice f, thorium, izolovaná skála, tor, izolovené skalisko, mrazový suk
czyrwiec - červen m
czyrwień - červen m
czystość - čistota f
czytać - číst
czytać między wierszami - číst mezi řádky
czytelnia - čítárna, studovna
czytelniczka - čtenářka f
czytelnik - čtenář m
czyżyk - kluk m, chlapec m, hoch m
D - genitiv m, druhý pád m
dąb - dub
dąb korkowy - dub korkový m
Dąbrówka - Doubravka f
dać - dát
dach - střecha f
Dafne - Dafné f
Dagestan - Dagestán
Dakar - Dakar
daktyl - datle f
dała - dát
dalajlama - dalajlama m, dalajláma m
dalece - velmi
dalekowzroczność - dalekozrakost f
Dalmacja - Dalmácie
dalmatyka - dalmatika f
Damaszek - Damašek
dana - dát
Dania - Dánsko
Danisława - Danislava f, Dana f, Danuše f, Danuška f
dany - dát
dar - dárek m
darmsztadt - darmstadtium
darowanemu koniowi w zęby się nie zagląda - darovanému koni na zuby nehleď, darovanému koni na zuby nekoukej
Dawid - David m
dech - oddech, oddych
defenestracja - defenestrace f
deficytowy - deficitní
definicja - definice f
deflacja - deflace
Deimos - Deimos
dekalog - dekalog m
dekiel - hlava f
deklaracja - prohlášení
deknąć - uhodit
dekolt - výstřih
dekoracja - výzdoba
dekret - dekret m
delegat - delegát m
delikatny - něžný
demagogia - demagogie
dementi - dementi
Demeter - Demeter f
Demetra - Demeter f
demografia - demografie f
demokracja - demokracie
Demokratyczna Republika Konga - Demokratická republika Kongo f
demokratyczny - demokratický
demokratyzacja - demokratizace f
demon - démon
denazalizacja - denazalizace
dentysta - zubař m
denuncjować - denuncovat
depilator - epilátor m
depok - knoflík m, tlačitko n
deratyzacja - deratizace
dereń - dřín m
deszcz - déšť m
deszczówka - dešťovka f
detektyw - detektiv m
deuterokanoniczny - deuterokanonický
deżdż - déšť m
dezelować - ničit
dezercja - dezerce f, zběhnutí n
dezinformacja - dezinformacen f
dezodorant - deodorant m
dezynfekcja - dezinfekce f
diabeł - ďábel m
diabeł nie śpi - čert nikdy nespí
diabelski - ďábelský
diagnoza - diagnóza f
diagnozować - diagnostikovat
dialog - dialog m
diament - diamant m
Diana - Diana f
dietetyka - výživa f
Dike - Diké f, Dike f
Dili - Dili
dinozaur - dinosaurus m
dioda - dioda f
Diogenes - Díogenés m, Díogenés m (ze Sinópé)
Dionizos - Dionýsos m
dip - dip
diplodok - Diplodocus m
discman - discman m
dla - pro
dłoń - dlaň f
długonogi - dlouhonohý
długopis - propiska f, propisovačka f
dłuto - dláto n
dłużnik - dlužník m
dmuchnąć - krást
DNA - DNA
Dniepr - Dněpr m
dobranoc - dobrou noc
dobrobyt - blahobyt m
Dobromiła - Dobromila f
dobry - dobrý
dobry wieczór - dobrý večer
dodać - přidat
Dodoma - Dodoma
dogmat - dogma n
dogmatyzm - dogmatismus m, dogmatizmus m
doić - dojit
dokąd - kam
dokładnie - přesně
dokładny - přesný
dokonały - dokonalý, skvělý
doktor - lékař m
doktryna - doktrína f
dół - jáma f, dole, spodek m
dolar - dolar
dolina - údolí n
dolmen - dolmen
dolnołużycki - dolnolužická srbština, dolnolužičtina
dolnośląski - dolnoslezský
dolny - dolní
dom - dům m
dom dziecka - sirotčinec
domek z kart - domeček z karet
Dominika - Dominika, Dominika f
Dominikana - Dominikánská republika
domowej roboty - domácí
domowy - domácí
doniczka - květináč
doniosłość - vážnost f
dopełniacz - genitiv m, druhý pád m
doradca - poradce m, rádce m
Dorota - Dorota f
dorożka - drožka f
doś - hodně
dość - dost
doskonałość - výtečnost f
doskonały - dokonalý, skvělý
dosyć - dost
do widzenia - na shledanou
do zobaczenia - na shledanou
dozwolony - přípustný
dożywotni - celoživotní
drabina - žebřík m
drabka - žebřík m
drach - drak
dracheta - drak
dragon - dragoun
drapacz chmur - mrakodrap m
drapieżnik - dravec m, predátor, šelma f
drawit - dravit
dres - tepláky m
drętki - kyselý
drewniak - dřevák m
drewno - dřevo n
Drezno - Drážďany
drobnowidz - mikroskop
droga - silnice, cesta
droga ekspresowa - rychlostní silnice
Droga Mleczna - Mléčná dráha
drogi - drahý
drogocenny - vzácný
Drohobycz - Drohobyč
drożdże - kvasinka, droždí
drugie śniadanie - svačina f
druh - přítel m
druk - knihtisk, litera f, písmeno n, typ m
drukarka - tiskárna
drukarz - tiskař m
drzemka - zdřímnutí n
drzewo - strom
drzewo iglaste - jehličnan m
drzwi - dveře
Dublin - Dublin
dubn - dubnium n
duch - přízrak, duše, duch
Duch Święty - Duch svatý m
dudek - dudek
dudlać - plakat
dudy - plíce f
duma - pýcha f, hrdost f
Duńczyk - Dán m
Dunka - Dánka f
duński - dánština
dupa - prdel f, buchta f, roštěnka f
dupek - kretén m
dupoliz - vlezdoprdelista m, prdelolezec m
dureń - blbec m
dusza - duše f, přízrak, duše, duch
Duszanbe - Dušanbe
Duszniki-Zdrój - Dušníky m
dutek - peníz m
dużo - hodně
duży - velký, veliký
dwudziestoletni - dvacetiletý
dwuletni - dvouletý
dwunastoletni - dvanáctiletý
dwupokojowy - dvoupokojový
dwusilnikowy - dvoumotorový
dwustuletni - dvěstěletý
dyć - přece
dychawica - astma n
dycht - úplně, naprosto, docela
dycki - vždy, vždycky
dydaktyczny - didaktický
dyftongizacja - diftongizace f
dygać - běžet
dyktafon - diktafon m
dyktator - diktátor m
dyliżans - dostavník m
dym - kouř m, dým m
dymbcok - dub
dymić - kouřit
dynamika - dynamika
dynia - dýně f
dyniowy - dýňový
dyplom - diplom m
dyplomata - diplomat m
dyplomatyczny - diplomatický
dyr - ředitel m
dyrcio - ředitel m
dyrektor - ředitel m
dyro - ředitel m
dysfagia - dysfagie f
dyskietka - disketa f
dyskryminacja - diskriminace f
dysmorfofobia - dysmorfofobická porucha f
dyspensa - dispens
dysproz - dysprosium
dysydent - disident m
dyszel - oj f, ojnice f
dywan - koberec m
dywanik - kobereček m
Dżakarta - Jakarta
dżamahirijja - džamáhíríje
Dżamila - Džamila
dżampreza - party, hov. akce, mejdlo, mejdan, spářka
dzbanek - džbánek m
dżdżownica - žížala m
dżelada - dželada
dżem - džem m
dżez - jazz
dziabka - motyka
dziadek - dědeček m, děd m, děda m, děda
działać na nerwy - lézt na nervy
działo - kanón m
dziąsło - dáseň f
Dżibuti - Džibutsko n, Džibuti n
Dzieciątko - Ježíšek m
dzieciństwo - dětství n
dzięcioł - žluna
dzieciszczko - dítě n
dziecko - dítě n
dzięki - díky
dziela - pro
dzień - den m
dzień dobry - dobré jitro
dziennikarka - novinářka f
dziennikarski - novinářský
dziennikarstwo - novinářství n, žurnalistika f, publicistika f
dzierzba - ťuhýk m
dzierżyć - držet
dziesięcioletni - desetiletý
dziewa - holka f, dívka f, přítelkyně f, panna f
dziewczę - holka f, dívka f, přítelkyně f
dziewczyna - holka f, dívka f, přítelkyně f
dziewczynka - holčička f, děvče n
dziewica - panna f
dziewięćdziesięcioletni - devadesátiletý
dziewięcioletni - devítiletý
dziewiętnastoletni - devatenáctiletý
dzieżka - džbánek m
dżihad - džihád m
dżihadysta - džihádista m
dzik - divočák
dzika karta - divoká karta f
dzika róża - růže šípková f, psí růže f, šípek m
dżinn - džin m
dżinsy - džíny
dziób - zobák m
dziołcha - holka f, dívka f, přítelkyně f
dziopa - holka f, dívka f, přítelkyně f
dżip - jeep, džíp
dziś - dnes
dzisiaj - dnes
dzisiejszy - dnešní
dżistać - prdziet
dziunia - holka f, dívka f, přítelkyně f
dziura - díra f, jeskyně f
dziura zabita deskami - díra f, zapadákov m
dziurkacz - děrovačka f
dziurkacz biurowy - děrovačka f
dżudo - judo
dźwig - jeřáb m, výtah m
dzwonić - telefonovat
dzwonnica - zvonice f
Edirne - Edirne
Edward - Eduard m
edyficjum - budova f, stavení n, stavba f
edykuł - edikula
edyl - aedil
Edyta - Edita
edytor tekstu - textový procesor
efekt domina - dominový efekt
Egipcjanin - Egypťan
egipski - egyptský
egipskie ciemności - egyptská tma f
Egipt - Egypt m
egiptologia - egyptologie f
egoista - sobec m
egoistka - egoistka f
egoizm - egoismus
egzoksiężyc - exoměsíc m
egzorcysta - exorcista m
einstein - einsteinium
ejber - kluk m, přítel m
eka - balík, roh m
ekierka - trojúhelník m
ekologia - ekologie f
ekologio - ekologie f
ekonomia - ekonomie
ekosystem - ekosystém
ekspert - expert m
eksplodować - explodovat
eksplozja - exploze f
eksponat - exponát m
ekspresjonizm - expresionismus
ekstremistyczny - extremistický
ekstremizm - extremismus m
ekumena - ekumena
Ekwador - Ekvádor
ekwipunek - výstroj f
elefant - slon m
elegancki - elegantní
elektroenergetyka - elektroenergetika
elektrolit - elektrolyt
elektroluks - vysavač
elektron - elektron
elektronika - elektronika f
Eliasz - Eliáš m
Eligiusz - Eligius m
elita - elita f
Elza - Alžběta f
Elżbieta - Alžběta f
embriologia - embryologie f
emigracja - emigrace f
emigrant - emigrant m
Emili - Emílie, Emilia
Emilia - Emílie, Emilia
emir - emír
empiryczny - empirický
encyklopedia - encyklopedie f
encyklopedyczny - encyklopedický
encyklopedysta - encyklopedista m
Endymion - Endymión m
entomologia - entomologie f
entomologiczny - entomologický
entropia - entropie
entuzjazm - nadšení n
enzym - enzym m
eoliczny - eolický
Eos - Éós f, Eos f
epitafium - epitaf m
epoka - epocha f
epos - epos
epruwetka - zkumavka f
erb - erbium n
erekcja - erekce f
Eris - Eris
Ernest - Arnošt
erogenny - erotogenní
erotyka - erotika f
erozyjny - erozívní
Eryda - Eris
Eryk - Erik m
Eryka - Erika f
Erytrea - Eritrea
erytrocyt - erytrocyt m
Erywań - Jerevan
ESBC - ESCB
eschatologia - eschatologie f
esej - esej
eskalator - jezdící schody, pohyblivé schody, eskalátor m, pohyblivé schodiště n
eskimoski - eskymácký
eskulap - lékař m
esperanto - esperanto
Estera - Ester f
estetyka - estetika f
Estończyk - Estonec m
Estonia - Estonsko
Estonka - Estonka
estoński - estonština
estrogen - estrogen m
etalon - etalon
etan - ethan
eten - ethen, ethylen
eternit - eternit m
Etiopia - Etiopie f
etniczny - etnický
etno- - etno-
Etolia - Aitólie f, Ajtólia f
etologia - etologie
etologiczny - etologický
ETPC - ESLP
etruski - etruský, etruština f
etylen - ethen, ethylen
etymologia - etymologie
euforia - euforie f
Eugeniusz - Evžen m
europ - europium
Europa - Evropa f
Europa Wschodnia - Východní Evropa
Europejczyk - Evropan m
Europejka - Evropanka f
eurosceptyk - euroskeptik
eutanazja - eutanázie f
Ewa - Eva f
ewangelia - evangelium n
ewangeliarz - evangeliář m
ewangelistarz - evangelistář m
Ewaryst - Evarist m
ewidentny - evidentní
eż - že
Ezdrasz - Ezdráš
Ezop - Ezop m
facet - muž m
facetka - žena f, učitelka f
facjata - obličej m, tvář f, fasáda f, průčelí n
fagocista - fagotista m
fajans - blbec m
fajek - cigareta f
fajer - svátek m
fajera - svátek m
fajerwer - cigareta f
fajfus - penis m, pyj m
fajka - cigareta f
fajrant - přestávka f
fałat - bankovka
fałszywy - falešný
familio - rodina
famuła - rodina
fana - vlajka f
fanatyzm - fanatismus m
fandzolić - lhát
fantazja - fantazie
fara - fara f, farnost f
farbować - barvit
farerski - faerština
farorz - farář m
farsa - fraška f
farsz - nádivka f
faryna - cukr
fasada - fasáda f, průčelí n
fasola - fasole f
faszystowski - fašistický
fatwa - fatva f
fauna - fauna
fazan - bažant m
fedrować - pracovat
fefrać się - bát se
felieton - fejeton m
Feliks - Felix m
felinologiczny - felinologický
fenek - fenek
Fenicja - Fénicie
Ferdynand - Ferdinand m
ferm - fermium
ferment - enzym m
ferromangan - feromangan
ferska - broskev f
fest - velmi
feta - amfetamin m
fezeła - včela f
Fidżi - Fidži
figa - fík m, fíkovník
figowiec - fíkovník
figura retoryczna - řečnická figura f
fikus - fíkovník
filatelistyka - filatelie f
Filip - Filip m
filipiński - filipínský
Filipiny - Filipíny
film - film m
filok - propiska f, propisovačka f
filolog - filolog m
filozof - filozof
filozofia dziejów - filosofie dějin f
filozofia historii - filosofie dějin f
filtr - filtr m
filuterny - šibalský
Fin - Fin m
finalista - finalista m
finalistka - finalistka f
finalizować - končit
finansowy - finanční
Finlandia - Finsko
finlandzki - finština
fiński - finština
finwal - plejtvák myšok m
fioletowy - fialový, šeřikově modrý, violetový
fiord - fjord m
fitogeografia - fytogeografie
fiut - chuj
fizjologia - fyziologie f
fizjoterapeuta - fyzioterapeut m
fiżon - fasole f
flag - vlajka f
flaga - vlajka f
flaming - plameňák
flaszka - láhev f
flecista - flétnista m
flegmatyczny - flegmatický
flet - chuj
fletnia Pana - Panova flétna f, syrinx
fliger - letadlo n
flirt - flirt
Florencja - Florencie
Florian - Florián m
Florianowy - Floriánův
flugelhorn - křídlovka
fluor - fluor
-fobia - -fobie
fojerman - hasič m
folga - odpočinek m, oddech m
folklor - folklor
fonetyka - fonetika f
forint - forint
forteca - pevnost
fosa - vodní příkop m
fosfodiesteraza - fosfodiesteráza f
fosfor - fosfor m
fotel - křeslo n
fotka - fotka f
fotografia - fotografie f
fotografie - fotografie f
fotografować - fotografovat
fotomontaż - fotomontáž m
foton - foton
fotorealizm - fotorealismus m
fototropizm - fototropismus
fowizm - fauvismus m
frajda - legrace
frak - frak
Franciszek - František m
Franciszka - Františka
Franciszkowe Łaźnie - Františkovy Lázně
Francja - Francie
francuski - francouzština
francuski pocałunek - francouzák m
Francuz - Francouz m
Francuzka - Francouzka f
frans - francium
frasunek - starost
frechowny - drzý
frela - holka f, dívka f, přítelkyně f
fresk - freska
fretka - fretka f
frezarka - frézka f
front - fronta f
frutarianizm - frutariánství n
fryc - Skopčák, Němec m
Fryc - Skopčák, Němec m
Fryderyk - Bedřich m
Fryderyka - Bedřiška f
fryzjer - holič m, kadeřník m
fulać - lhát
fundamentalista - fundamentalista
fundamentalny - základní
funkcja stanu - stavová veličina
funkcjonować - fungovat
fura - automobil m, auto n, vůz m
furdygarnia - věznice f, vězení n
furgać - létat
fusbal - fotbal
fusekla - ponožka f
futbol - fotbal
futbolistka - fotbalistka
futrować - krmit, živit, kojit
futurologiczny - futurologický
fynsterbret - parapet
fyrtel - úhel m
gabinet cieni - stínová vláda f
Gabon - Gabon
Gaborone - Gaborone
gadałka - víla f
gadolin - gadolinium
gagatowy - gagátový
gajdus - blb, blbec
gajer - oblek m
gal - gallium n
gała - oko n, fotbal, krkavec m, vrána
galancie - hodně, hesky
Galia - Galie
Galicja - Halič
galicyzm - galicismus m, galicizmus m
Galilea - Galilea f
galoty - kalhoty
Gambia - Gambie
gametangium - gametangium
ganc - úplně, naprosto, docela
gang - gang m
gangol - oblek m
gangster - gangster m
gapa - krkavec m, vrána
gara - spánek m, sen m, zdřímnutí n
gardło - hrdlo n, krk m
garncarstwo - hrnčířství n
garnitur - oblek m
garść - hrst f
garsonka - kostým m
gasa - ulice f
gasić - zhasnout, tlumit
gąsię - house
gąsior - houser m
gasnąć - hasnout
Gaza - Gaza f
gazeta - noviny
gaz musztardowy - hořčičný plyn
gaz ziemny - zemní plyn m
gdakać - kdákat
Gdańsk - Gdaňsk
gdański - gdaňský
gdy kota nie ma, myszy harcują - když není kocour doma, myši mají pré
Gdynia - Gdyně
gdyż - protože
gdzie - kde
gdzie diabeł nie może, tam babę pośle - kam nemůže čert, nastrčí babu
gdzie dwóch bić się bije, tam trzeci korzysta - když se dva perou, třetí se směje
gdziekolwiek - kdekoliv
gdzie kucharek sześć, tam nie ma co jeść - mnoho kuchařů přesolilo polévku
geburstag - narozeniny
gędźba - hudba f
gęgać - kejhat
gejzer - gejzír
gekon - gekon m
gelender - balustráda f
gemyla - zmatek
generał - armádní generál m
generał broni - generálporučík m
generał dywizji - generálmajor m
genetyczny - genetický
Genewa - Ženeva
genewski - ženevský
genialny - geniální, brilantní
Genowefa - Jenovefa f, Jenovéfa f, Genovefa f
Genua - Janov
geografia - zeměpis
geologia - geologie
geomancja - geomantie f
Georgina - Jiřina f
german - germanium n
germanista - germanista m
germanizm - germanismus m, germanizmus m
germański - německý, němčina
gęś - husa f
getto - ghetto n
Ghana - Ghana f
gibon - gibon
gichać - lít, smát se
giełd - burza f
giełda - burza f
giez - velká moucha
gil - hýl m
ginekolog - ženský lékař
ginekologia - gynekologie
gira - noha f
gitara - kytara f
głąb - blb, blbec
glacok - plešatý
głagolica - hlaholice f
glajza - dlaha f, thorium, izolovaná skála, tor, izolovené skalisko, mrazový suk
glapa - vrána
glaska - sklenice f
głaskać - hladit
głębokość - hloubka f
glin - hliník m
glina - hlína f, policista m
gliniarz - policista m
glista - škrkavka f, žížala m
Gliwice - Glivice, Hlivice
glizda - škrkavka f, žížala m
globus - glóbus m, hlava f
głód - hlad m, hladomor m
głodny - hladový
Głogów - Hlohov
głośnik - reproduktor m
głośno - nahlas
głoszenie - hlásání
głowa - hlava f
główka - hlavička f
głownia - čepel
główny - hlavní
Głubczyce - Hlubčice, Glubčice
głubczycki - hlubčický
Głuchołazy - Hlucholazy, Glucholazy
głuchota - hluchota f
głuchy - hluchý
glukometr - glukometr m
glukoza - glukóza f
głupek - blb, blbec
głupiec - blbec m
gnat - kost f, kostka f
gniazdo - hnízdo
Gniezno - Hnězdno
gnot - dítě n
gnu - pakůň žíhaný
gnuśny - líný
godać - mluvit
godka - jazyk m
godło - znak
godność - důstojnost
godoć - mluvit
Godzilla - Godzilla m
godzina - hodina f
gol - gól
golarz - holič m, kadeřník m
gołębnik - holubník m
Golgota - Golgota f
golibroda - holič m, kadeřník m
gołoledź - náledí n, námraza f
gondoliera - barkarola
gong - gong
goniec - posel m
góra - hora
górą - hora
górka - plec
górnictwo - hornictví n
górnik - horník m
górnołużycki - hornolužická srbština, hornolužičtina
górnośląski - hornoslezský
Górny Śląsk - Horní Slezsko n
gorset - korzet m
gorszy - horší
goryl - gorila f
Góry Skaliste - Skalnaté hory, Skalisté hory
gorzki - hořký
gość - host m
gościnność - pohostinnost f
gospodarka - ekonomika f
gospodyni - hospodyně f
gospodyni domowa - žena v domácnosti f
gotować - vařit
gotyk - gotika f
gówno - hovno
goździk - hřebíček m
gra - hra f
graba - ruka, dlaň f
gracz - hráč
gram - gram m
gramofon - gramofon m
gramofonowy - gramofonový
granatowy - tmavomodrý
granica - hranice f
granit - žula f, granit m
gra słów - slovní hříčka f
gratulacja - blahopřání n
grawiton - graviton m
Grecja - Řecko
grecki - řečtina
Greczynka - Řekyně f
grejpfrut - grapefruit m, grep m
Grek - Řek m
greka - řečtina
Grenada - Grenada
Grenlandia - Grónsko
grenlandzki - grónský
grób - hrob
grobowiec - sklep
groch - hrách m
grog - grog m
gromadzić - nahromadit, akumulovat, sbírat
gromnica - hromnice f, hromnička f
gronostaj - hranostaj m
groza - hrůza f
groźba - hrozba f
gruba - důl m
gruba berta - Tlustá Berta f
gruba ryba - vzácný pták
grubaska - tlusťoška f
grubiański - hrubý
grudniowy - prosincový
grudzień - prosinec m
grunt - základ m
grupa docelowa - cílová skupina f
gruszka - hruška f
gruziński - gruzínský, gruzínština
Gruzja - Gruzie
grycha - žemle f
grymas - grimasa f
grynszpan - měděnka f
grypa - chřipka f
grzanka - topinka f
grzbiet - hřbet
grzebień - hřeben
grzechotka - chrastítko n
Grzegorz - Řehoř m
grzesznica - hříšnice f
grzeszyć - hřešit
grzyb - houba f
grzybobranie - houbaření
grzywka - ofina f
grzywna - pokuta f
Gujana - Guyana
Gujana Francuska - Francouzská Guyana
guła - krůta
guli - protože
guma - žvýkačka f
gupielok - blb, blbec
Gustaw - Gustav
guzik - knoflík m, tlačitko n
gwałciciel - násilník m
gwałtowny - násilný
gwer - puška
gwiazda - hvězda f
Gwiazda Poranna - Jitřenka f
gwiazdarz - astronom m, astrolog m, hvězdopravec m
Gwiazda Wieczorna - Večernice f
gwiazdka - Štědrý den
gwiazdozbiór - souhvězdí
gwiaździarz - astronom m, astrolog m, hvězdopravec m
Gwinea - Guinea
Gwinea Bissau - Guinea-Bissau
Gwinea Równikowa - Rovníková Guinea f
gwizdnąć - uhodit
gwóźdź - hřebík
gzub - dítě n
habituacja - habituace f
haczka - motyka f
Hades - Hádes m, hádes m
hafn - hafnium n
haft - výšivka f
haitański - haitský
Haiti - Haiti
Hajfa - Haifa f
hajtok - nůž m
hala - hala
hałaśliwy - hlučný, rámusivý
hamulec - brzda f
Hana - Haná f, Hanácko n
hańba - hanba f, ostuda f
Hanna - Hana f
Hanoi - Hanoj
haplotyp - haplotyp m
Harare - Harare
harest - vazba f
harfa - harfa f
harować jak wół - dřít jako vůl, dřít jako kůň
has - hassium n
haski - haagský
haszysz - hašiš
hau - haf
haubica - houfnice
haw - tam
hawajski - havajský
Hawana - Havana
hawerz - sapér m
hazard - hazardní hra
hę - co, proč, každý, každo-
hebdow - hedvábí n
hebrajski - hebrejský, hebrejština f
hedonista - hédonista m
hedonistyczny - hédonistický
hedonizm - hédonismus m
Hefajstos - Hefaistos m
heftować - zvracet
Hekata - Hekaté f, Hekate f
Hekate - Hekaté f, Hekate f
hektar - hektar m
hektolitr - hektolitr m
hel - helium
Helena - Helena f, Helene f
heligonka - heligonka f
helikopter - helikoptéra f, vrtulník m
helio- - helio-
Helios - Hélios m
Hellada - Řecko
hellenistyczny - helénistický
Helsinki - Helsinky
helsiński - helsinský
Henryk - Jindřich
Henryka - Jindřiška f
heparyna - heparin
Hera - Héra f
herbaciany - čajový
herbarz - herbář
herbata - čaj m
Herkules - Herkules
Hermes - Hermes m
Hermon - Hermon m
Herod - Herodes m
herpetologia - herpetologie f
herpetologiczny - herpetologický
Hestia - Hestia f
hiacynt - hyacint m
Hiady - Hyády
hidźra - hidžra
hierarchiczny - hierarchický
Hieronim - Jeroným
Higieja - Hygieia f
hindi - hindština
hinduizm - hinduismus
Hindukusz - Hindúkuš
Hindus - Ind m
Hinduska - Indka
hinduski - indický
Hiob - Jób
hiobowa wieść - Jobova zvěst
hiperonim - hyperonymum n
hipo- - hypo-
hipologia - hipologie
hipologiczny - hypologický
hiponim - hyponymum n
hipopotam - hroch m
hipotermia - hypotermie
hipotetyczny - hypotetický
hipoteza - hypotéza f
Hiroszima - Hirošima f
histeria - hysterie f
histo- - histo-
historia - dějiny, historie f, příběh m
historiozofia - filosofie dějin f
historyczka - historička f
historyk - historik m
Hiszpania - Španělsko n
hiszpański - španělština
hodować - chovat
hodowla - chov m
hokej - hokej m
hokejkryja - hokejka f, hůl f
holajza - dláto n
Holandia - Nizozemsko n, Holandsko n
Holandyja - Nizozemsko n, Holandsko n
Holender - Holanďan m
Holenderka - Holanďanka f
holenderski - nizozemština
holm - holmium
holonim - holonymum n
homeopatia - homeopatie
homeostaza - homeostáza f
homiletyka - homiletika f
homilia - homilie f
homoseksualistka - homosexuálka f
Honduras - Honduras
Hongkong - Hongkong
Honiara - Honiara
hoplita - hoplít m
hormon - hormon m
hormonozależny - závislý na hormonech
Horus - Hor m
hostessa - hosteska f
hotel - hotel
hulajnoga - koloběžka f
humerał - humerál m, amiktus m
humor - nálada
humorystyczny - humoristický
huncwot - darebák
hungaryzm - hungarismus m, hungarizmus m
huśtawka - houpačka
husycki - husitský
husyta - husita m
huta - huť f, sklárna f
hydrologia - hydrologie f
hydroplan - hydroplán m
hydroponika - hydroponie f
hydrostatyka - hydrostatika
Hypnos - Hypnos m
i - a
ibis - ibis m
ichtio- - ichtyo-
ichtiologiczny - ichtiologický
Ida - Ida f
idea - nápad m
idealny - ideální
idiom - idiom
igła - jehla
Igława - Jihlava
iglicznia - dřezovec
Ignacy - Ignác
igrać z ogniem - hrát si s ohněm
ikona - ikona
iloczas - kvantita f
ilustrator - ilustrátor m
imbir - zázvor m
imbirowy - zázvorový
imię - jméno n, křestní jméno
imieniny - jmeniny
imigracja - imigrace f
imigrant - imigrant
imperator - imperátor, císař
impresor - tiskař m
impreza - party, hov. akce, mejdlo, mejdan, spářka
ind - indium
Indie - Indie
indochiński - indočínský
Indochiny - Indočína f
indoeuropejski - indoevropský
indoktrynacja - indoktrinace
Indonezja - Indonésie
indonezyjski - indonéština
indris - indri
indyczę - krůtě
indyczka - krůta
indygowy - indigový
Indyk - Indický oceán
inhalacja - inhalace f
inkaski - incký
inkaso - inkaso
inkaust - inkoust m
inkszy - ostatní, jiný
inkunabuł - inkunábule
inny - ostatní, jiný
ino - jen, jenom, pouze
insekt - hmyz m
instruktor - instruktor
instrument - nástroj m, přístroj m
insulina - inzulin m
integralność - integrita f
intelekt - intelekt
interesować - zajímat
internet - internet
internetowy - internetový
inundacyja - povodeň, záplava
inwazja - invaze f
iny - ostatní, jiný
inżynier - inženýr m
Irak - Irák m
Iran - Írán
iranistyka - íránistika f
Irena - Irena
Ireneusz - Ireneus
Iris - Iris f
Irlandczyk - Ir m
Irlandia - Irsko
Irlandka - Irka f
irlandzki - irský
iryd - iridium n
Iryda - Iris f
iście - určitě
iść na skibę - krást
iskra - jiskra f
Islamabad - Islámábád
islamski - islámský
islandzki - islandský, islandština f
Itaka - Ithaka
italianizm - italianismus m, italismus m
Italok - Ital m
italski - italština
itd. - atd.
iterb - ytterbium
itr - yttrium
Iwan - Ivan m
Iwo - Ivo m
Iwona - Ivona
iż - že
izba - mír m, pokoj m
izba wytrzeźwień - záchytka f
ize - že
-izm - -ismus
izobara - izobara f
izokoszta - izokosta f
izokwanta - izokvanta f
izotop - izotop m
Izrael - Izrael
Izraelczyk - Izraelec m
Izraelka - Izraelka f
izraelski - izraelský
ja - já
jabłko - jablko n
jabłko Adama - Adamovo jablko n
jabłko niezgody - jablko sváru n
jabłoń - jabloň
jadać - jíst
jadalnia - jídelna f
jadowity - jedovatý
Jadwiga - Hedvika f
jagoda - brusnice borůvka, borůvka, tvář f
jajko - vejce, vajíčko n
jajo - vejce, vajíčko n
jaki - který
jaki pan, taki kram - jaký pán, takový krám
jakiś - nějaký
jakkolwiek - jakkoli
jakmiarz - úplně, naprosto, docela
Jakub - Jakub, Kuba
jałowiec - jalovec
Jamajka - Jamajka
jamraj - bandikut
Jamusukro - Yamoussoukro
Jan - Jan m, Ivan m, Johan m
jangryst - angrešt [{m}}
Janina - Jana f
jantar - jantar m
japa - díra f, jeskyně f
Japończyk - Japonec
Japonia - Japonsko
japonizm - japonismus m, japonizmus m, japanismus m
Japonka - Japonka
japoński - japonština
jara - tchyně f
jarecka - matka, máti, máma, maminka, mamička, mamka, mutra f
Jaromir - Jaromír m
jarosz - vegetarián m
jaskinia - jeskyně f
jaskółka - vlaštovka f
Jasna Góra - Jasná Hora
jasne jak słońce - jasné jako facka
jasnobłękitny - světleblankytný, světle blankytný
jasnobrązowy - světlehnědý, světle hnědý
jasnoczerwony - světlečervený, světle červený
jasnofioletowy - světlefialový, světle fialový
jasnokasztanowy - světlekaštanový, světle kaštanový
jasnoniebieski - světlemodrý, světle modrý
jasnopomarańczowy - světleoranžový, světle oranžový
jasnoróżowy - světlerůžový, světle růžový
jasnoszary - světlešedý, světle šedý
jasnozielony - světlezelený, světle zelený
jasnożółty - světležlutý, světle žlutý
jasny jak słońce - jasný jako facka
jastrząb - jestřáb m
jaszczurka - ještěr m
Jaworzno - Javořno
jazz - jazz
jeansy - džíny
jebać - šukat
jebadło - ložnice, postel f
jechać na jednym wózku - být spolu na jedné lodi
jedenastoletni - jedenáctiletý
jeden za wszystkich, wszyscy za jednego - jeden za všechny, všichni za jednoho
jedlina - jedle
jedna jaskółka wiosny nie czyni - jedna vlaštovka jaro nedělá
jednocześnie - současně, zaroveň
jednoczesny - současný
jednokomórkowy - jednobuněčný
jednooki - jednooký
jednopokojowy - jednopokojový
jednorożec - nosorožec m
jednosilnikowy - jednomotorový
Jędrzej - Ondřej m, Andrej m
jedwab - hedvábí n
jego - jeho
jej - její
Jelenia Góra - Jelení Hora
jelito - střevo n
jełop - blbec m
Jemen - Jemen
Jemeńczyk - Jemenec m
Jemenka - Jemenka
jemioła - jmelí n
jemiołuszka - brkoslav m
jen - jen
Jerozolima - Jeruzalém
jerozolimski - jeruzalémský
Jeruzalem - Jeruzalém
Jerycho - Jericho
Jerzy - Jiří m
jerzyk - rorýs
jeść - jíst
jesień - podzim m
jesion - jasan
jeśli - jestliže
jest - být
jeszcze - ještě
jeż - ježek m
jezdnia - vozovka
jeźdźczyni - jezdkyně f
jeździć - jezdit
jeżeli - jestliže
Jezioro Galilejskie - Tiberiadské jezero
Jezioro Tyberiadzkie - Tiberiadské jezero
jeżozwierz - dikobraz
jezuicki - jezuitský
Jezus - Ježíš m
Jezus Chrystus - Ježíš Kristus
język - jazyk m
język obcy - cizí jazyk m
język ojczysty - mateřský jazyk
jeżyna - ostružina
jiczyński - jičínský
jidysz - jidiš
Joachim - Jáchym m
jod - jod
jodła - jedle
joga - jóga f
Jokasta - Iokasté f, Iocaste f
jon - iont
Jonasz - Jonáš
Jordania - Jordánsko
jordański - jordánský
Jowisz - Jupiter m
Jozafat - Jóšafat m
Józef - Josef m, Jozef m
józefinizm - josefinismus m
Józefowy - Josefův, Jozefův
Józek - Pepík
jubiler - klenotník m
jubilerka - klenotnice f
jubilerski - klenotnický
Juda - Juda m
Judasz - Jidáš m
judo - judo n
Judyta - Judita f
jugol - Jugoslávec m
Jugosławia - Jugoslávie
Jugosłowianin - Jugoslávec m
Julia - Julie
juliański - juliánský
Juliusz - Julius, Július
juny - mladý
Jupiter - Jupiter m
Jur - Jiří m
Justyna - Justýna
juta - juta
jutro - zítra
Jutrzenka - Jitřenka f, Éós f, Eos f, Aurora f
już - juž
-ka - -ka
kaban - prase n, prasnice f
kabanina - vepřové n
kabanos - kabanos m
kabat - kamarád, kabát m
kablowy - kabelový
kabriolet - kabriolet m
Kabul - Kábul
kabza - kapsa f
kac - kocovina f
kacap - kacap m, blbec m
Kacper - Kašpar m
kaczan - blb, blbec
kaczątko - káče
kaczę - káče
kaczka - kachna f
kaczor - kačer m
kadm - kadmium
kadzidło - kadidlo
kadzielnica - kadidelnice
kafej - kavárna f
Kair - Káhira
kairczyk - Káhiřan m
kairka - Káhiřanka f
kairski - káhirský
kaj - kde
kajak - kajak
kajuta - kajuta f
kajuto - kajuta f
kakadu - kakadu
kaktus - kaktus m
kalafa - nos m, alkoholik m, obličej m, tvář f
kalafior - květák m
kałamarz - kalamář m
kalapitra - hlava f
kalejdoskop - kaleidoskop m, krasohled m
kalendarz - kalendář m
kalifat - chalífát m, kalifát m
kaliforn - kalifornium
Kalifornia - Kalifornie f
kalifornijski - kalifornský
kalina - kalina
kalkulator - kalkulačka
kalosz - galoše f
Kalwaria - Kalvárie f
kam - kam, kde
kamasz - bota
Kambodża - Kambodža
kambr - kambrium
kamczacki - kamčatský
kameleon - chameleon m, chameleón m
kamera - kamera
Kamerun - Kamerun
kamfora - kafr m
kamień spadł komuś z serca - někomu spadl kámen ze srdce
Kampala - Kampala
kampus - kampus
Kanada - Kanada
Kanał Sueski - Suezský průplav
kanapeczka - jednohubka f
kanapka - chlebíček m
kanarek - kanárek m
kandydat - kandidát m
kandydować - kandidovat
kangur - klokan m
kania - bedla f
kanion - kaňon m
kanka - džbánek m
kantor - směnárna f
kaolin - kaolín m, kaolin m
kapcylinder - klobouk m
kapeć - pneumatika f
kapeluch - klobouk m
kapelusz - klobouk m
kąpiel wodna - vodní lázeň f
kąpiółka - koupelna f
Kapitol - Kapitol m
kapituła - kapitula f
kaplica - kaple f
Kapsztad - Kapské Město
kapusta - zelí n, peníz m
kapusta chińska - čínské zelí
kara - trest
karaba - kočka f
karabin - puška
karabin maszynowy - kulomet
karate - karate n
karawana - karavana f
karawela - karavela f
karbowaniec - karbovanec m
karczoch - artyčok
kardio- - kardio-
kardiolog - kardiolog m
kardiologia - kardiologie
kariatyda - karyatida
karierowicz - kariérista m
kark - krk
karkonoski - krkonošský
Karkonosze - Krkonoše
Karlik - Karel
Karlowe Wary - Karlovy Vary
karlus - krasavec m, kluk m, chlapec m, hoch m
karman - peněženka f
karmelowy - karamelový
karmić - krmit, živit, kojit
karminowy - karmínový
karnawał - masopust m, karneval m
Karol - Karel
Karolina - Karolína
karp - kapr m
Karpaty - Karpaty
karta pocztowa - korespondenční lístek, pohlednice
kartel - kartel m
kartka - korespondenční lístek, pohlednice
kartkówka - písemka f, prověrka f, přepadovka
kartofel - brambor
kartoflany - bramborový
kartoflisko - brambořiště n
karuzela - kolotoč m
Karwat - Chorvát m
karykatura - karikatura f, karikování n
karykaturzysta - karikaturista m
karzeł - trpaslík m
Kasandra - Kasandra f, Kassandra f
kaseta magnetofonowa - audiokazeta f
kasjer - pokladník m
Kassandra - Kasandra f, Kassandra f
kastylijski - kastilský
kasza jaglana - jáhly
kaszalot - vorvaň m
kaszel - kašel m
kasztan - jírovec m
kasztan jadalny - kaštanovník jedlý m, kaštanovník setý m, jedlý kaštan m
kasztanowiec - jírovec m
kasztanowy - kaštanový
kaszubski - kašubština
kąt - úhel m
katabas - černoprdelník m
katafalk - katafalk
katakumby - katakomby
Katalonia - Katalánsko
kataloński - katalánský
katana - kocovina f
Katar - Katar
katarakta - katarakt
Katarzyna - Kateřina f
katastralny - katastrální
katastrofa - katastrofa
katechetka - katechetka f
katechizm - katechismus m
katedra - katedrála f
Katmandu - Káthmándú
katolicki - katolický
Katowice - Katovice
katus - puštík
Katyń - Katyň m, Katyňský masakr
katyński - katyňský
kaukaski - kavkazský
Kaukaz - Kavkaz
kawał - kousek, kus m
kawałek - kousek, kus m
kawiarka - moka, Moka Express, veka
kawiarnia - kavárna f
kawka - matka f, jeptiška f
kawowiec - kávovník m
kawowy - kávový
kazachski - kazaština
Kazachstan - Kazachstán
kazalnica - kazatelna
kazatelnica - kazatelna
każdy - každý
kazeina - kasein, kazeín
Kazimierz - Kazimír
kaznodzieja - kazatel m
kciuk - palec m
kebab - kebab
keczup - kečup m
kędy - kde
kefija - kefíja
kefir - kefír
kejter - pes m
kejza - sýr m
Kenia - Keňa f
keratynocyt - keratinocyt
khmerski - khmerština
kibuc - kibuc m
kicz - kýč m
kiecka - sukně f
kiedy - kdy, když, pokud
kiedyś - někdy
kiejda - kapsa f
kiełbasa - salám m, klobása f
kielczyć się - smát se
kiepeła - hlava f
kierat - žentour
kierować - řídit
kierowca - řidič m
kierunek - směr m
kieszeń - kapsa f
Kietrz - Ketř
Kigali - Kigali
kij - patro, podlaží n
kijanka - pulec m
kij hokejowy - hokejka f, hůl f
Kijów - Kyjev
kilogram - kilogram m
kilometr - kilometr m
kimono - spánek m, sen m
kino - kino n, biograf, kinematograf, bio, biák
kinol - nos m, alkoholik m
Kinszasa - Kinshasa
kintop - kino n, biograf, kinematograf, bio, biák
Kira - Kira f, Kyra f
kirchóf - hřbitov
kireja - kabát m
kirgiski - kyrgyzština
Kirgistan - Kyrgyzstán
Kiribati - Kiribati
kis - štěrk m
kiszka - střevo n, mléko n
Kiszyniów - Kišiněv
kit - lež f
kiur - curium
kiwi - kiwi
kłącze - oddenek m
klakson - klakson m
kłamać - lhát
kłamca - lhář
kłamczuch - lhář
klamka - klika f
kłamny - falešný
kłamstwem daleko się nie zajdzie - lež má krátké nohy
kłamstwo - lež f
kłamstwo ma krótkie nogi - lež má krátké nohy
kłapaczka - ústa
klapsznita - chlebíček m
klara - Slunce n
Klara - Klára
klarnet - klarinet m
kłaść - pokládat
klatka - klec f, hrudník m
klatka piersiowa - hrudník m
klaustrofobia - klaustrofobie
klecha - černoprdelník m
klej - lepidlo n
klekotun - čáp m
Kleopatra - Kleopatra f
klerykalizm - klerikalismus m
klęska - debakl m
kliber - nos m, alkoholik m
klient - zákazník m, klient m
klika - klika f
klincz - klinč m
Kłodzko - Kladsko
klon - javor
kloper - klepadlo
kłopot - starost f
klopsztanga - klepadlo
kłos - klas
klub - klub m
kluber - nos m, alkoholik m
kluka - nos m
klupać - hledat, bít
kłusownik - pytlák m
kluza - věznice f, vězení n
knedlik - knedlík
knefel - knoflík m, tlačitko n
knipa - kniha f
knot - knot m
koala - koala m
koati - nosál červený
kobalt - kobalt
kobaltowy - kobaltový
kobiecy - ženský
kobieta - žena f
kobieta lekkich obyczajów - žena lehkých mravů
kobra - kobra
koc - deka f
kochać - milovat
kochan - milenec m
kochanek - milenec m
kochanka - milenka f
kociamber - kočka f
kocie łby - kočičí hlavy
kociokwik - kocovina f
kocioł - kotel
kocioł parowy - parní kotel
koczkodan - kočkodan
koczowniczy - kočovný, kočovnický
kod kreskowy - čárový kód
koja - postel f
kojo - postel f
kojot - kojot m
kokosz - slepice f
kokoszka - slepice f, slípka zelenonohá
kokotek - kohoutek m, jeřáb m, výtah m
koks - koks
kolacja - večeře
kołacz - koláč m
kolano - koleno n
kołchoz - kolchoz
kolczasty - ostnatý
kolczyk - náušnice
kolęda - koleda f
kolega - kamarád
kolegium - kolegium
kolegówna - kolegyně f
kolej - železnice f
kolejarz - železničář m
kolejka - fronta f
kolejowy - železniční
kolekta - kolekta, vstupní modlitba f
kolektor - kolektor
kolendra - koriandr m
koleś - muž m
koleżanka - kolegyně f
koleżeński - kamarádský
koliber - kolibřík
koło - kruh m, kolo n
kołodziej - kolář m
koło garncarskie - hrnčířský kruh m
Kolombo - Kolombo
Kolonia - Kolín nad Rýnem
kolonializm - kolonialismus
kolonoskopia - koloskopie
kolor - barva
kolorowy - barevný
koło sterowe - kormidelní kolo
Kolumb - Kolumbus m
Kolumbia - Kolumbie
kołysanka - ukolébavka f
koma - čárka f
komar - komár m
komat - čárka f
kombajn - kombajn
komedia - komedie f
komentować - komentovat
kometa - kometa
komfort - komfort m
komiczność - komičnost f
komiks - komiks m
kominek - krb m
kominiarz - kominík m
komórka - mobilní telefon m
Komory - Komory
komp - počítač m
kompas - kompas
kompot - kompot m
kompromis - kompromis
kompromitacja - propadák m
komputer - počítač m
komuch - komunista m
komunista - komunista m
komunistka - komunistka f
komunistyczny - komunistický
koń - kůň, jezdec m, penis m, pyj m
kóń - kůň
Konakry - Conakry
koncentrować - soustředat se
koncepcja - koncepce f
koncert - koncert m
konchiologia - konchologie
koncyliaryzm - konciliarismus m
kończyć - končit
kończyna - končetina f
kondensacja - kondenzace f
kondensator - kondenzátor m
kondolencje - kondolence, soustrast
konduktor - průvodčí m
konduktorka - průvodčí f
kondygnacja - patro, podlaží n
konfesjonał - zpovědnice f
konflikt - konflikt
konformizm - konformismus m
Konfucjusz - Konfucius m
Kongo - Konžská republika f
Kongresówka - Kongresovka f
koniak - koňak m
konieczny - nutný
konklawe - konkláve n
konkordat - konkordát
konny - koňský
konopny - konopný
konsekwencja - důsledek m
Konstancja - Konstancie f, Kostnice
konstelacja - souhvězdí
konsumpcja - spotřeba
kontekst - kontext m
kontrabas - kontrabas
koń trojański - trojský kůň m
kontrowersyjny - kontroverzní
kontrreformacja - protireformace f
kontrrewolucja - kontrarevoluce
kontrwywiad - kontrarozvědka f
kontur - kontura, obrys
kontynent - kontinent, světadíl m
konwalia - konvalinka
kopalnia - důl m
koparka - rypadlo
Kopenhaga - Kodaň
koper - kopr
Kopernik - Koperník m
kopnąć w kalendarz - natáhnout bačkory
kopra - kopra
kopruch - komár m
kopuła - kopule f
kora - kůra f
koral - korál
Koran - Korán m
korbol - dýně f, panděro
Korea - Korea
Koreańczyk - Korejec
Koreanka - Korejka
Koreańska Republika Demokratyczna - Korejská lidově demokratická republika
koreański - korejský, korejština f
Korea Północna - Severní Korea
Korea Południowa - Jižní Korea
korek - dopravní zácpa
korona - koruna f
Koror - Koror
korrida - korida f, býčí zápasy
Korsyka - Korsika f
korupcja - korupce f
korytarz - chodba f
kos - kos m
Kos - Kós
kosa - nůž m
kość - kost f, kostka f
kościół - kostel m
Kościół - církev f, náboženská společnost f
kosmita - mimozemšťan m, ufon m, vesmířan m
kosmitka - mimozemšťanka f
kosmodrom - kosmodrom
kosmopolita - kosmopolita m
Kostaryka - Kostarika f
kostka Rubika - Rubikova kostka
kosz - košíková
kosztować - chutnat
kosztowny - drahý
Koszyce - Košice
koszykówka - košíková
kot - kočka f
kotlet - vepřový řízek
kotlina - kotlina f
kot perski - perská kočka f
kot syjamski - siamská kočka f
kowadło - kovadlina f
Kowadło - Kovadlina f
kowal - kovář m
kowalno - kovadlina f
koza - koza f
kozioł - kozel
kozioł ofiarny - obětní beránek m
Koziorożec - Kozoroh m
koźlak - kozák m, klouzek obecný m
koźlarz - kozák m
koźlarz babka - kozák březový m
koźlarz czerwony - křemenáč osikový m
kozłek - kozlík
kozłek lekarski - baldrián, čertikus, kočičí kořen, kozlík lékařský, odolen
krab - krab m
krach - krach
Kraina - Kraňsko
kraj - stát
krajać - krást
krajobraz - krajina f
Kraj Sudetów - Sudety, Sudetsko, Sudetská země, pohraniční území
Kraków - Krakov
krakowski - krakovský
kran - kohoutek m, jeřáb m, výtah m
krancek - kousek, kus m
kraść - krást
krasula - kráva f
kratek - kostka f
kratka - kostka f
krawat - oprátka f
krawatka - oprátka f
kreda - křída f
kredyt - kredit m, úvěr m
krem - krém m
krematorium - krematorium n
krepel - kobliha f, koblih m
kret - krtek
Kreta - Kréta f
krętogłów - krutihlav
krew - krev f
Krista - Kristýna f
KRLD - KLDR
KRL-D - KLDR
kroczyć - kráčet
kroić - krást
krok - chůze f
krokus - krokus
krokus spiski - šafrán spišský m
król - král m
królestwo - království n
królewicz - králevic m, kralevic m
królewski - královský
królowa - královna f
kronika - kronika f
kropka - tečka f
kropla - kapka f
krople - kapka f
krowa - kráva f
krowa, która dużo ryczy, mało mleka daje - pes, který štěká, nekouše
krowi - kraví, kravský
krtań - hrtan
krucyfiks - krucifix
kruczy - havraní
kruk - krkavec m
kruk krukowi oka nie wykole - vrána vráně oči nevyklove
krwiomocz - hematurie
krwotoczny - hemoragický
krwotok - krvácení
krybuny - kříž m
krykiet - kriket
Krym - Krym m
kryminał - věznice f, vězení n
krypta - krypta f
kryptografia - kryptografie f
krypton - krypton m
Kryspin - Kryšpín m
Krystian - Kristián
Krystyna - Kristýna f
krytyk - kritik m
krzeczek - křeček m
krzem - křemík
krzesło - židle m
krzesny - kmotr m
krzyczeć - křičet
krzyk - křik m
krzykliwy - ukřičený
Krzysztof - Kryštof m
krzywa - křivka
krzywica - křivice
krzywousty - křivoústý
krzyż - kříž m
krzyżyk - vysoký
Ksenia - Xenie f
kseno- - xeno-
ksenofobia - xenofobie
ksenon - xenon
książka - kniha f
książka kucharska - kuchařka f
księga - kniha f
księgarnia - knihkupectví n
Księga Zachariasza - Kniha Zacharjáš f
księgozbiór - knihovna f
księżniczka - princezna f
księżyc - měsíc m, luna f, měsíček m
Księżyc - Měsíc m
księżycowy - měsíčný
ksylitol - xylitol m
kształt - tvar m
kto - kdo
kto chce żyć z swojej pracy, dolegać nie trzeba - ranní ptáče dál doskáče
kto ma ręce do pracy, ten się naje kołaczy - bez práce nejsou koláče
kto pod kim dołki kopie, sam w nie wpada - kdo jinému jámu kopá, sám do ní padá
kto późno przychodzi, sam sobie szkodzi - kdo pozdě chodí, sám sobě škodí
kto rano wstaje, temu Pan Bóg daje - ranní ptáče dál doskáče
który - který
któż - kdo
Kuba - Kuba
Kubańczyk - Kubánec m
Kubanka - Kubánka f
kubek - hrnek
kubizm - kubismus m
kucharz - kuchař m
kuchenka - sporák m
kuchenny - kuchyňský
kuć żelazo, póki gorące - kout železo, dokud je žhavé
kufel - holba f
kujot - kojot m
kukurydziany - kukuřičný
kula - noha f
kulig - koliha
kulik - koliha
kuloodporny - neprůstřelný
kulos - noha f
kumkwat - kumquat
kumulacja - kumulace f
kuna - kuna f
kupować - kupovat
kupryt - kuprit
kura - slepice f
kurhan - kurhan
kurier - kurýr m
kurierka - kurýrka f
kurka - slípka zelenonohá, slepice f
kurka wodna - slípka zelenonohá
kurki - slípka zelenonohá, slepice f
kurkuma - kurkuma f
kurtyna - opona f
kurwa - kurva
kusić - strašit
kuśka - penis m, pyj m
kuskus - kuskus
kusy - ďábel m
kusza - kuše f
kutafon - chuj
kutas - chuj
Kuwejt - Kuvajt
kuzynka - sestřenice f
kwadrans - čtvrthodina f
kwadrat - čtverec m
kwadratowy - čtverečný
kwark - kvark m
kwartał - čtvrtletí
kwartet - kvarteto n
kwas - kyselina f
kwas akrylowy - kyselina akrylová
kwas chlebowy - kvas m
kwas foliowy - kyselina listová
kwaśny - kyselý
kwas siarkowy - kyselina sírová f
kwazar - kvazar
Kwiatosław - Květoslav m
Kwiatosława - Květoslava f
kwiatostan - květenství n
kwiecień - duben m
kwietno niedziela - Květná neděle f
Kwietosław - Květoslav m
Kwietosława - Květoslava f
Łaba - Labe
łabęć - labuť f
łabędź - labuť f
Łabędź - Labuť f
łabędzi śpiew - labutí píseň
labializacja - labializace
lać - lít, smát se
łacina - latina
łacny - snadný
lacz - hlava f, penis m, pyj m, policista m
ład - pořádek
ładnie - hesky
ładunek - bombička f
laga - patro, podlaží n
laguna - laguna
lajbik - podprsenka f
łajno - trus m
łąka - louka f
lakier do paznokci - lak na nehty
lakmus - lakmus m
laktaza - laktáza f
lala - panenka f, loutka f, holka f, dívka f, přítelkyně f
lalka - panenka f, loutka f
łamać sobie głowę - lámat si hlavu
łamaniec językowy - jazykolam
łamistrajk - stávkokaz
lampa - lampa f
lampart - levhart m
łańcuch pokarmowy - potravní řetězec m
land - vesnice, ves f
łania - laň f
lantan - lanthan m
Laos - Laos
laotański - laoština
łapać - lapat, chytat
laparotomia - laparotomie f
łapka - past f
Laponia - Laponsko n
larmo - poplach
las - les m
laser - laser
łaska - milost f
łaska pańska na pstrym koniu jeździ - panská láska po zajících skáče
laski - lašský
laskonogi - tenkonohý
Laszczyzna - Lašsko n
lat - rok m
lata - rok m, sukně f
latać - létat
latarnia morska - maják m
latawiec - drak
lato - léto n
łatwo - snadno
łatwy - snadný
latynizm - latinismus m, latinizmus m
lawenda - levandule f
lawendowy - levandulový
ławka - lavice f
łazanki - flíčky
łazienka - koupelna f
lazuryt - lazurit m
le - ale
lebera - jitrnice
leberka - jitrnice
leberwuszt - paštika
Lech - Lech m
łechtaczka - poštěváček, klitoris
lecieć - letět
lecz - ale
leczniczy - léčivý
Leda - Léda f, Leda f
lędźwiowy - bederní
Legnica - Lehnice
lekarz - lékař m
lekarz choroby chorób kobiecych - ženský lékař
lekka atletyka - atletika f, lehká atletika f
lekki - lehký
lekkoatletyka - atletika f, lehká atletika f
leksykologia - lexikologie f
lemur - lemur
len - len m
leń - lenoch m
Lena - Lenka
leniuch - lenoch m
leniwiec - lenoch m
leniwy - líný
leopard - levhart m
łepetyna - hlava f
lepidopterologia - lepidopterologie f
lepszy rydz niż nic - lepší něco než nic
lepszy wróbel w garści niż gołąb na dachu - lepší vrabec v hrsti nežli holub na střeše
lesbijka - lesbička f, lesba f, lesbičanka f
lesisty - lesnatý
leśny - partyzán m
Lesotho - Lesotho n
letni - letní
lew - lev
Lew - Lev m
lewica - levice f
leworęczny - levák m
lewszun - levák m
leżak - lehátko
łgać - lhát
łgarz - lhář
Liban - Libanon
Liberec - Liberec
Liberia - Libérie
Libia - Libye
liceum - gymnázium
lichenologia - lichenologie
licho nie śpi - čert nikdy nespí
liczba atomowa - atomové číslo n
liczba całkowita - celé číslo n
liczba niewymierna - iracionální číslo n
liczba pierwsza - prvočíslo n
liczba podwójna - dvojné číslo n
liczba pojedyncza - číslo jednotné n
liczi chińskie - liči čínské
liczyć - počítat
Lidia - Lýdie
likier - likér m
likwidacja - likvidace
likwidować - likvidovat
lila - liliový, lila, lilový, šeříkový
lilak - šeřík m
liliowy - liliový, lila, lilový, šeříkový
Lima - Lima f
limfocyt - lymfocyt
linie lotnicze - aerolinky
linijka - pravítko n
linoleum - linoleum
linuksowy - linuxový
lipa - lípa
lipcowy - červencový
lipiec - červenec m
lipień - lipan
Lipsk - Lipsko
Lira - Lyra f
lis - liška f
list - dopis m
lista - seznam m
listonosz - listonoš m
listopad - listopad m
listopadowy - listopadový
lit - lithium n
litania - litanie
litera - písmeno n
literacki - literární, spisovný
litewski - litevština
litkup - litkup
Litomierzyce - Litoměřice
liturgia - liturgie f
liturgiczny - liturgický
liturgika - liturgika f
Litwa - Litva
Litwin - Litevec m
Litwinka - Litevka f
liza - lýza f
Lizbona - Lisabon
lizus - patolízal m
lizuska - patolízalka f
Loara - Loira
łobuz - darebák
lód - led m, zmrzlina f
lodowiec - ledovec m
lodówka - lednička f
łodyga - stonek m
łódź - člun, loď
Łódź - Lodž
logarytm - logaritmus m
-logia - -logie
logiczny - logický
lojalność - loajalita f, loajálnost f
lokalizacja - lokalizace f
lokalny - lokální, místní
lokatiwus - lokativ m, lokál m, šestý pád m
łokieć - loket m
lokomotywa - lokomotiva f
lokówka - kulma
lola - holka f, dívka f, přítelkyně f, patro, podlaží n
Lombardia - Lombardie
Londyn - Londýn m
londyńczyk - Londýňan
łopatologicznie - polopaticky, polopatě
lorens - lawrencium n
lori - lori
lornetka - dalekohled m
los - osud m
łoś - los m
łososiowy - lososí, lososový
łosprawiać - vyprávět
łotewski - lotyština
lotnisko - letiště
lotokot - letucha
lotos - lotos m
lotos orzechodajny - lotos ořechonosný m
lotus - lotos m
Łotwa - Lotyšsko
Lozanna - Lausanne
łoże - postel f
łóżko - postel f
Luanda - Luanda
lub - nebo
lubić - mít rád
Lublana - Lublaň
Lublin - Lublin
Lucerna - Lucern
Łucja - Lucie f
łucznictwo - lukostřelba f
Ludmiła - Ludmila f
ludność - populace f
Ludwik - Ludvík
łudzikwiat - duben m
Łukasz - Lukáš m
Luksemburg - Lucembursko, Lucemburk
luksus - luxus m
lulka - cigareta f
lumbago - ústřel m
luna - luna f, měsíc m, měsíček m
lunapark - lunapark m
lunatyk - lunatik m, náměsíčník m, somnambul m
luńt - kousek, kus m, pes m
lupa - lupa f
łupież - lupy
Lusaka - Lusaka
lustro - zrcadlo, zrcadlovka f
lustrzanka - zrcadlovka f
łuszczyca - psoriáza, lupénka
lutet - lutecium n
lutnia - loutna f
Lutnia - Lyra f
lutować - bít
lutowy - únorový
luty - únor m, studený
Łużyce - Lužice
lwia część - lví podíl
lwiatka - lvíček
lwica - lvice f
Lwów - Lvov
łydka - lýtko n
łyska - lyska
łysy - plešatý
łza - slza f
łża - lež f
mać - matka, máti, máma, maminka, mamička, mamka, mutra f
Macedonia - Makedonie
macedoński - makedonština
macica - děloha
Maciej - Matěj m
Maciejowy - Matějův
maciek - panděro
macierz - matice
mączka - pudr
mączny - moučný
Madagaskar - Madagaskar
Madera - Madeira
Madryt - Madrid
madziaryzm - hungarismus m, hungarizmus m
MAEA - MAAE
mafia - mafie f
mafijny - mafiánský
mafioso - mafián m
Magdalena - Magdalena f, Magdaléna f
magiczny - magický
magiel - mandl m
magnetofon - magnetofon m
magnetofon kasetowy - páskový magnetofon m
magnez - hořčík m
magnolia - magnólie
magulanka - rvačka f
mahonia - mahónie f
maj - květen m
majański - mayský
majątek - majetek m
majonez - majonéza f
majtki - kalhotky
mak - mák m
makak - makak
makro - makro
Malabo - Malabo
Malachiasz - Malachiáš m
malachit - malachit m
malachitowy - malachitový
malajski - malajština
malakologia - malakologie
Mała Niedźwiedzica - Malý medvěd m
malarstwo - malířství n
Malawi - Malawi
Male - Male
Malediwy - Maledivy
Malezja - Malajsie
malezyjski - malajsijský
Małgorzata - Markéta f
Mali - Mali
malin - malina
malina - malina
malinka - cucflek
Małopolska - Malopolsko
malować - malovat
małpa - opičák m, opice f, zavináč m
małpi - opičí
Malta - Malta
mały - malý
Mały Lew - Malý lev m
mały palec - malíček m
małż - mlž m
małżeński - manželský
małżonka - manželka f, žena
mam - máma, maminka, mamička, mamka, mutra f
mama - máma, maminka, mamička, mamka, mutra f, tchyně f
mamka - kojná f
mammografia - mamografie f
mamut - mamut
Managua - Managua
Manama - Manáma
mandat - pokuta f
manekin - figurína f
mangan - mangan m
mango - mango
maniak - maniak
Manila - Manila
maniurka - holka f, dívka f, přítelkyně f
mańkut - levák m
manometr - manometr
mantel - kabát m
manuskrypt - rukopis m
mapa - mapa
Maputo - Maputo
maratończyk - maratónec
marcepan - marcipán m
marcepanowy - marcipánový
marchew - mrkev
marchewka - mrkev
Marcin - Martin m
Marcinowy - Martinův
marcowy - březnový
Marek - Marek
Maria - Marie f
mariański - mariánský
Marja - Marie f
marksizm - marxismus m
marmolada - marmeláda f
Maroko - Maroko n
Mars - Mars m
Marsjanin - Marťan m
Marsjanka - Marťanka f
Marsylianka - Marseillaisa f
Marta - Marta
Marto - Marta
martwy - mrtvý
Marty - Marta
Maryja - Marie f
Maryjka - Marie f
maryjny - mariánský
marynarka wojenna - válečné loďstvo
marynarz - námořník m, lodník m
marzec - březen m
marzenie - sen m
marzenie senne - spánek m, sen m
marzyć - snít
masajski - masajský
masakra - masakr m
masa krytyczna - kritické množství n
masara - moucha f, motýlek m
masaż - masáž f
maść - mast f
Maseru - Maseru
maska - obličej m, tvář f
Maskat - Maskat m
maskowy - maškarní
maślak pstry - klouzek strakoš m
maślak ziarnisty - klouzek zrnitý m
maślak żółty - klouzek sličný m
maślak zwyczajny - klouzek obecný m
maślanka - podmáslí n
masło - máslo n
mastaba - mastaba
maszyna do pisania - psací stroj m
maszyna do szycia - šicí stroj m
maszynista - strojvedoucí, strojvůdce
matematyczny - matematický
matematyka - matematika f, matika f
Matiasz - Matěj m
matka - matka, máti, máma, maminka, mamička, mamka, mutra f
matka chrzestna - kmotra f
matkojebca - mamrd m
matriarchat - matriarchát
matros - námořník m, lodník m
matura - maturita f
maturzysta - maturant m
maturzystka - maturantka f
Matuzal - Metuzalém m
Matuzalem - Metuzalém m
Mauretania - Mauritánie
Mauritius - Mauricius
mazak - obličej m, tvář f
mazojen - majonéza f
Mbabane - Mbabane
mdłość - slabost f
mdłości - mdloba f
mebel - nábytek m
mecenas - advokát m
mech - mech
mechaniczny - mechanický
mechanika - mechanika
mechatronika - mechatronika f
męczennik - mučedník m
meczet - mešita f
Medard - Medard m
Medardowy - Medardův
mediewalny - středověký
Mediolan - Milán m
mędrzec - mudrc m, mudřec m
medyk - lékař m
męgla - mandl m
meitner - meitnerium n
mejoza - meióza
Meksyk - Mexiko
Meksykanin - Mexičan
Meksykanka - Mexičanka
meksykański - mexický
melać - plivat
melatonina - melatonin
Melchior - Melichar m
melizmat - melisma f
melodyjny - melodický
Memfis - Memfis, Mennofer
Men - Mohan
mendel - mandel m
mendelew - mendelevium n
menora - menora f
mentalista - mentalismus m
mentalizm - mentalismus m
merdać - mýlit, plést
Merkury - Merkur m
Mesjasz - Mesiáš m
męski - pánský
meskineria - skoupost f
metafora - metafora f
metalowy - kovový
metan - metan m
metempsychoza - metempsychóza f
meteor - meteor
meteorologiczny - meteorologický
meteoryt - meteorit
metoda - metoda f
Metody - Metoděj m, Metod m, Metud m
metodyjski - metodějský
metr kwadratowy - metr čtvereční
metro - metro
metropolia - metropole f
Metuszelach - Metuzalém m
mewa - racek m
mężczyzna - muž m
MFW - MMF
mgła - mlha
mgławica - mlhovina f
mgr - Mgr.
miałki - povrchní
Miami - Miami n
mianownik - nominativ m, první pád m, jmenovatel m
miasto - město
miasto stołeczne - hlavní město
miau - mňau
miażdżyca - ateroskleróza f
miąższ - dužina f
micela - micela f
Michał - Michal m
Michałowy - Michalův
mieć dwie lewe ręce - mít obě ruce levé
mieć głowę na karku - mít něco v hlavě
mieć głowę nie od parady - mít něco v hlavě
mieć gzik w kolanach - bát se
mieć kogoś w garści - mít v hrsti
mieć na sumieniu - mít máslo na hlavě
mieć nosa - mít nos
mieć olej w głowie - mít něco v hlavě
mieć po dziurki w nosie - mít po krk
mieć powyżej uszu - mít po krk
mieć w mały małym palcu - mít v malíčku, mít v malíku
miecz - meč m
miecz Damoklesa - Damoklův meč
Mieczysława - Mečislava f
miedź - měď
miedza - mez
miedźwiedź - medvěd
Międzynarodowa Agencja Energii Atomowej - Mezinárodní agentura pro atomovou energii
Międzyrzec Podlaski - Podleské Meziříčí
miejsce - místo n
miejscownik - lokativ m, lokál m, šestý pád m
miejska legenda - současná pověst, městská pověst
miękkość - měkkost f
mielcuch - pivo m
miernik - měrka
mieśćce - místo n
mieśce - místo n
miesiąc - měsíc m, luna f, měsíček m
miesiąc miodowy - líbánky
miesiączek - měsíc m, luna f, měsíček m
miesięczny - měsíčný
mięsień - sval
mięsień krawiecki - sval krejčovský m
mięsopust - masopust m, karneval m, fašank m, fašangy, ostatky
mięsopustnik - únor m, studený
mięsożerca - masožravec m
mięsożerny - masožravý
mieszkać - bydlet
mieszkaniec - obyvatel m
mieszkanka - obyvatelka f
mięta - máta f
migdałowy - mandlový
migotanie przedsionków - fibrilace síní
Mikołaj - Mikuláš
mikologia - mykologie f
Mikołów - Mikulov
mikrocefalia - mikrocefalie f
mikrofon - mikrofon
Mikronezja - Mikronésie
mikroskop - mikroskop
Mila - Emílie, Emilia
milczeć jak grób - mlčet jako hrob, mlčet jako němý
Milena - Milena f
miligram - miligram m
milimetr - milimetr m
milimetrowy - milimetrový
milioner - milionář m
militaryzm - militarismus m
miłość - láska f
miłosierdzie - milosrdenství n
miłośnica - milenka f
mimo - kruh m, kolo n
mimowolny - mimovolný
minaret - minaret m
Minerwa - Minerva f
minimalista - minimalista m
ministra - ministryně f
ministrant - ministrant m
Minos - Minos m, Minós m
Mińsk - Minsk
miód - med, medovina f
miodownik - medovník m
miodowy - medový
miód pitny - medovina f
Miranda - Miranda f
Mirosława - Miroslava
mirra - myrha
misjonarz - misionář m
Miśnia - Míšeň
mistrzostwa - mistrovství n
mistyk - mystik m
mitologia - bájesloví
mleko - mléko n
młody - mladý
młodzie - kvasinka, droždí
młodziec - nemluvně n
młot - kladivo n
młotek - kladivo n
młynarz - mlynář m
mnich - řeholník
mnogdy - často
moabicki - moabština f
mobilizacja - mobilizace f
moc - moc f
móc - moct
model - model
modelka - manekýnka f, modelka f
modlitewnik - modlitby
modlitwa - modlitba f
modny - módní
modrakowy - modrý, blankytný
modry - modrý, blankytný
modrzew - modřín
modrzewnica - kyhanka f
modrzyć - barvit
modystka - kloboučník m
Mogadiszu - Mogadišu
Moguncja - Mohuč f
Mojmir - Mojmír m
Mojżesz - Mojžíš
mól - mol
Mołdawia - Moldavsko
mołdawski - moldavština
molibden - molybden m
Monachium - Mnichov
Monako - Monako
moneta - mince
Mongolia - Mongolsko
mongolski - mongolština
monocykl - jednokolka f, monocykl m
monofizytyzm - monofyzitismus
monogamiczny - monogamní, monogamický
monografia - monografie f
monopol - monopol m
Monrovia - Monrovia
monstrancja - monstrance
Montevideo - Montevideo
mora - přízrak, duše, duch
Morawa - Morava f
morawski - moravský
Morawy - Morava
mord - vražda f, mord m
morderstwo - vražda f, mord m
mordować - zabít, přibít
morela - meruňka f
Morfeusz - Morfeus m
morkwa - mrkev
Moroni - Moroni
mors - mrož m
morski - mořský, námořní
morze - moře n
Morze Adriatyckie - Jaderské moře
Morze Bałtyckie - Baltské moře
Morze Białe - Bílé moře
Morze Czarne - Černé moře
Morze Czerwone - Rudé moře n
Morze Kaspijskie - Kaspické moře
Morze Martwe - Mrtvé moře
Morze Północne - Severní moře
Morze Śródziemne - Středozemní moře
mosiądz - mince
moskitiera - moskytiéra
Moskwa - Moskva
most - most m
Mostar - Mostar
moszna - šourek m
motocyklista - motocyklista
motor - motor
motyka - motyka f
motyl - motýl m
Mount Everest - Mount Everest
mowa - jazyk m
mowa jest srebrem, a milczenie złotem - mluviti stříbro, mlčeti zlato
mówić - mluvit
mozaika - mozaika f
Mozambik - Mosambik
może - možná, snad, moct
mózg - mozek m
możliwość - možnost f
mrowisko - mraveniště n
mrówka - mravenec m
mrównik - hrabáč kapský (hrabáč takaru) m
mruczeć - příst
Ms - lokativ m, lokál m, šestý pád m
MSZ - MZV
msza - mše
mszał - misál m
mszalny - mešní
mucha - moucha f, motýlek m
muchomor - muchomůrka f
muchomór - muchomůrka f
muchomor cytrynowy - muchomůrka citrónová f
muchomor czerwieniejący - muchomůrka růžovka f
muchomor czerwonawy - muchomůrka růžovka f
muchomor czerwony - muchomůrka červená f
muchomor jadowity - muchomůrka jízlivá f
muchomor plamisty - muchomůrka tygrovaná f
muchomor sromotnikowy - muchomůrka zelená f
muchomor twardawy - muchomůrka šedivka f
muchomor zielonawy - muchomůrka zelená f
mućka - kráva f
mudżahedin - mudžáhid m
mufka - rukávník m
mundur - uniforma
mundurowy - policista m
muraszka - mravenec m
musieć - muset
muślin - mušelín m
musztarda - hořčice
muza - Múza f, múza f
mużyk - muž m
muzyka - hudba f
my - my
mydło - mýdlo n
myjna - ofina f
mykita - liška f
mykologia - mykologie f
mylić - mýlit, plést
myrdyrda - jíška f, zásmažka f, zápražka f
myrmekologia - myrmekologie f
mysikrólik - králíček
myśleć - myslet
mysz - myš
Myszka Miki - Myšák Mickey m
myszoskoczek - pískomil m
myszy tańcują, gdy kota nie czują - když není kocour doma, myši mají pré
N - instrumentál m, sedmý pád m
nabój - bombička f
naciskać - mačkat, tisknout
nacjonalista - nacionalista m
nacjonalizować - znárodňovat
naczyniak - angiom
naczyniak krwionośny - hemangiom
naczynie - nádoba, nádobí
naczyniowy - cévní
nadawca - odesílatel m
naddunajski - podunajský
Nadia - Naďa f
nadwaga - nadváha f
nadwzroczność - dalekozrakost f
nadzieja - naděje
Nadzieja - Naděžda
nadzienie - nádivka f
nadzór - dohled m
naftalen - naftalen m
naftalina - naftalen m
nagietek - měsíček m
nagietkowy - měsíčkový
nagle - najednou
nagrobek - náhrobek m
Nahum - Nahum m
Nairobi - Nairobi
naleśnik - palačinka f
należeć - patřit
nalot - razie
nalot dywanowy - kobercové bombardování
Namibia - Namibie
namiot - stan
naonczas - tehdy
na pamięć - nazpaměť
na pewno - určitě
napisy końcowe - závěrečné titulky
napiwek - spropitné n
napletek - předkožka
naprany - opilý, opilec m
naprawa - oprava
naprawdę - opravdu
na przykład - například
naraz - naráz, najednou
na razie - zatím, zatím!
narba - jizva f
narciarski - lyžařský
narciarz - lyžař m
narkomanka - narkomanka f
narkotyk - droga f
narodowy socjalizm - nacionální socialismus m
narychtować - připravit
narzędnik - instrumentál m, sedmý pád m
Nassau - Nassau
nastolatek - teenager
na sto procent - určitě
nastrój - nálada f
nasz - náš
na szczęście - naštěstí
Natasza - Nataša
natenczas - tehdy
natomiast - zatímco
natron - natron
naturalizacja - naturalizace
natychmiast - okamžitě
natychmiastowo - okamžitě
nauczyciel - učitel m
nauczycielka - učitelka f
Nauru - Nauru
nawa - loď
Nawakszut - Nuakšott
nawet - dokonce
nawilżać - hydratovat
nawyk - zvyk m
nazad - zpět, zpátky
Nazaret - Nazaret m
na zdrowie - na zdraví
nazista - nacista m, nácek m
nazod - zpět, zpátky
nazwisko - příjmení n
Ndżamena - Ndžamena
neandertalczyk - neandertálec m
neandertalski - neandertálský
Neapol - Neapol
negatywny - negativní
nekrolog - nekrolog m
nektaryna - nektarinka f
nektarynka - nektarinka f
neodym - neodym m
neon - neon m
neonatologia - neonatologie f
Nepal - Nepál m
neptun - neptunium n
Neptun - Neptun m
nerwowy - nervózní
nestorianizm - nestoriánství n, nestorianismus m
neurobiologia - neurověda f
neurotoksyna - neurotoxin m
neutrino - neutrino
neutron - neutron
ni - ný, ani, ne
niacyna - niacin
Niamey - Niamey
nic - nic
nić Ariadny - Ariadnina nit f
nicielnica - nitěnka f
nicnierobienie - nicnedělání
Niderlandy - Nizozemsko n, Holandsko n
nie - ne
niebezpieczeństwo - nebezpečí n
niebieski - modrý, blankytný
niebieskofioletowy - modrofialový
niebiosa - nebe, nebesa
niebo - nebe, nebesa
nieboszczyk - nebožtík m
niech - nechť
niechętnie - nerad
nie chwal dnia przed zachodem słońca - nechval dne před večerem
niech żyje - ať žije!
niedaleko pada jabłko od jabłoni - jablko nepadá daleko od stromu
niedokrwienie - ischemie
niedokrwistość - chudokrevnost f
niedopałek - nedopalek m
nie dospać trzeba, kto chce dostać chleba - ranní ptáče dál doskáče
niedostatek - nedostatek
nieduch - nemoc
niedziela - neděle f
Niedziela Palmowa - Květná neděle f
niedzielny - nedělní
niedźwiedź - medvěd
niedźwiedzi - medvědí
nieestetyczny - neestetický
nieetyczny - neetický
niegdyś - někdy
niegrzeczny - nezdvořilý
niejasność - nejasnost f
nieliczny - nečetný
niełupka - nažka
nie ma róży bez kolców - není růže bez trní
Niemcy - Německo n
Niemen - Němen
Niemiec - Němec m
nie mieć - ne
Niemiecka Republika Demokratyczna - Německá demokratická republika
niemiecki - německý, němčina
Niemka - Němka f
niemowlę - nemluvně n
niemożliwy - nemožný
nieodwracalny - nevratný
nieoficjalny - neoficiální
nieostrożny - neopatrný
niepoczytalność - nepříčetnost f
niepodległość - nezávislost f, samostatnost f
niepodważalny - nevyvratitelný
niepokalane poczęcie - neposkvrněné početí n
nieposłuszny - neposlušný
niepotrzebny - zbytečný
nieprawda - nepravda f
nieprzemakalny - nepromokavý
nieprzewidywalny - nepředvídatelný
niereformowalny - nereformovatelný
nierówność - nerovnice f, nerovnost f
nieruchomość - nemovitost
nie samym chlebem człowiek żyje - niejenom chlebem živ je člověk
nieść - nést
nieściora - sestřenice f
nieskończony - nekonečný
niestety - bohužel
nieszczelny - netěsný
niewdzięcznik - nevděčník m
niewdzięczność - nevděk m, nevděčnost f
niewdzięczny - nevděčný
niewiasta - žena f
niewiastka - snacha f
niewinny - nevinný
niewolniczy - otrocký
nie wszystko złoto, co się świeci - není všechno zlato co se třpytí, navrch huj, vespod fuj
niewyobrażalny - nepředstavitelný
niewystarczający - nedostatečný
niezapominajka - pomněnka f
niezatapialny - nepotopitelný
niezbędny - nutný
nieznany - neznámý
niezniszczalny - nezničitelný
niezwłocznie - neprodleně, neodkladně
niezwyciężony - neporazitelný, nepřemožitelný
nieżyczliwy - zlomyslný
nigdy - nikdy
nigdzie - nikde
Niger - Niger
Nigeria - Nigérie
nihilista - nihilista m
nihilizm - nihilismus m
nikaj - nikde
Nikaragua - Nikaragua
nikiel - nikl m
nikotyna - nikotin m
Nikozja - Nikósie
nilowy - nilský
nim - on, ono
nimfa - nymfa f
niob - niob m
NIP - DIČ n (daňové identifikační číslo)
ni pies, ni wydra - ani ryba, ani rak
ni rak, ni ryba - ani ryba, ani rak
niszczyć - ničit
niszczyciel - ničitel m, torpédoborec m
niż - než
niża - nížina f
nizina - nížina f
ni z pierza, ni z mięsa - ani ryba, ani rak
NLPZ - NSA
no - ano
nobel - nobelium n
noc - noc f
noga - noha f
nogawice - kalhoty
nominacja - nominace f
nonkonformizm - nonkonformismus m
nonsens - nesmysl
nora - pelech m
Norbert - Norbert m
normalny - normální
Norweg - Nor m
Norwegia - Norsko
norweski - norština
Norweżka - Norka f
Norymberga - Norimberk m
nos - nos m, alkoholik m
nosić - nosit
nosorożec - nosorožec m
Nowak - Novák m
Nowa Ruda - Nová Ruda f
Nowa Zelandia - Nový Zéland
Nowe Delhi - Nové Dillí
nowenna - novéna f
nowicjat - noviciát m
nowojorski - newyorský
noworoczny - novoroční
nowotwór - novotvar
nowożytny - novověký
Nowy Rok - Nový rok
Nowy Testament - Nový zákon m
nóż - nůž m
nóż do masła - nůž na màslo m
nożyce - nůžky f
nożyczki - nůžky f
np. - např.
NRD - NDR
nudelzupa - polévka f
nudny - nudný
Nuku'alofa - Nuku'alofa
numer identyfikacji podatkowej - daňové identifikační číslo
nurek - potápěč
nutria - nutrie
ny - ný
nyga - komár m
nylon - nylon
oaza - oáza f
obcas - podpatek m
obecność - přítomnost f
obecny - přítomný
obelisk - obelisk m
oberżyna - oberžina f
oberżynowy - lilkový, baklažánový
obiad - oběd m
obiecać - slíbit
obiecadło - abeceda
obiecanki cacanki - sliby chyby
obiekt - objekt m
obierać - loupat, bít
oblężenie - obležení n
obłok - oblak m
obłuda - pokrytectví n
obły - oblý
obój - hoboj m
obojczyk - klíční kost
obolewiec - levák m
obora - kravín m
obowiązek - povinnost f
obraz - film m
obrażać - uražet
obrazić - urazit
obrotnica - točna f
obrus - ubrus m
obrzydliwy - hnusný, odporný
obrzym - obr m
obserwować - pozorovat
obszar chronionego krajobrazu - přírodní park m
obywatel - občan m
obywatelka - občanka f
obywatelstwo - občanství n
Ocean Atlantycki - Atlantský oceán m
Oceania - Oceánie
Ocean Indyjski - Indický oceán
Ocean Spokojny - Tichý oceán m
oceniać - oceňovat, hodnotit
ochy i achy - achich ouvej
ociec - otec, táta, tatínek, taťka, fotr m
oczodół - očnice f
oczywiście - samozřejmě
od - od, z
oda - óda f
odcień - odstín m
odcisk palca - otisk prstu
odczucie - pocit m
oddech - oddech, oddych
oddychać - dýchat
oddzielić ziarno od plew - oddělit zrno od plev
oddzielić ziarno od plewy - oddělit zrno od plev
ode - od, z
odejmowanie - odčítání, odečítání
Odessa - Oděsa f
odezwać się - ozvat se
odkażanie - dezinfekce f
odkupienie - vykoupení n
odkurzacz - vysavač
odmiana - druh m, typ m, rod m, žánr m, varianta f
odpoczynek - odpočinek m, oddech m
odpowiadać - odpovídat, vyhovovat
odpowiedź - odpověď
odprowadzać - doprovázet
odra - spalničky
Odra - Odra
odtrutka - protijed m
odwet - odplata f, odveta f, represe f
odwieczny - odvěký
odwiedzać - navštěvovat
odwiedzić - navštívit
odwracalny - vratný
odwrotny - opačný
odżywka - kondicionér m
ofiara - oběť f
oftalmologiczny - oftalmologický
ognie świętego Elma - Eliášův oheň m, oheň svatého Eliáše m
ogniskowa - průvodič m
ogólniak - gympl m
ogórek - okurka f
ogr - zlobr
ogród - zahrada f
ogród botaniczny - botanická zahrada f
ogrodnik - zahradník m
ogrodzenie - ohrada
ogród zoologiczny - zoologická zahrada f
OIOM - JIP
ojciec - otec, táta, tatínek, taťka, fotr m
ojciec chrzestny - kmotr m
ojciec święty - Svatý otec m
ojczyc - syn
ojczym - otčím m, nevlastní otec m
ojczyzna - vlast f
Ojgen - Evžen m
ojla - sova f
okazja - příležitost f
okazja czyni złodzieja - příležitost dělá zloděje
okładka - vazba f
okłamywać - lhát
okno - okno
oko - oko n
okop - příkop
okostna - okostice f
okrąg - kruh m
okrągły - kruhový, kulatý
okraść - vykrást
okręt - loď
okręt liniowy - řadová loď
okręt podwodny - ponorka f
oksza - sekera f, sekyra f
oktan - oktan
okulary - brýle
okulary przeciwsłoneczne - sluneční brýle
okulista - oční lékař m, oftalmolog m
okulistyczny - oftalmologický
okultyzm - okultismus m
okupant - okupant m
olbrzym - obr m
olcha - olše f
olej - olej m
olej słonecznikowy - slunečnicový olej m
Olga - Olga
Olimpia - Olympie f
olmecki - olmécký
Ołomuniec - Olomouc
ołów - olovo
ołówek - tužka f
ołtarz - oltář m
Ołtarz - Oltář m
Olza - Olše, Olza
oma - babička f
Oman - Omán
omen - omen n
omieszkać - ne
omlet - omeleta f
on - on
onager - onager
oni - oni
onkologiczny - onkologický
ono - ono
ontologiczny - ontologický
ONZ - OSN
opal - opál
opat - opat m
Opawa - Opava f
opawski - opavský
operowy - operní
Opole - Opolí n
opona - pneumatika f
oportunista - oportunista m
oportunistyczny - oportunistický, oportunný
opowiadać - vyprávět
oprócz - kromě, mimo
optymalny - optimální
oraz - a
orbita - orbita f, očnice f
orchestrion - orchestrion m
orchidea - orchidea f, orchidej f
ordnung - pořádek
ordynariusz - ordinář m
ordynator - primář m
organista - varhaník m
orgazm - orgasmus m
orientalistyka - orientalistika f
orientalny - orientální
Orion - Orion m
orlab - dovolená
Ormianka - Arménka f
ornament - ornament m
ornitolog - ornitolog m
ornitologia - ornitologie f
ornitologiczny - ornitologický
orogeneza - orogeneze f
ortodoksyjny - ortodoxní
ortograficzny - pravopisný
ortoreksja - orthorexie f
orzech - ořech
orzeł - orel, žádanka f
Orzeł - Orel m
oset - bodlák m
osiągać - dosáhnout
osiemdziesięcioletni - osmdesátiletý
osiemnastoletni - osmnáctiletý
osiemsetletni - osmisetletý
osika - osika
oślica - oslice f
Oslo - Oslo
osm - osmium
ośmioletni - osmiletý
osoba - osoba f
osobliwy - osobitý
Osobłoga - Osoblaha f, Petrovický potok m (do zbiegu ze strumieniem Muszlow)
osobłoski - osoblažský
ostatki - fašank m, fašangy, ostatky
osteo- - osteo-
osteoporoza - osteoporóza
Ostrawa - Ostrava f
ostrężyna - ostružina
ostrokrzew - cesmína f
ostrokrzew kolczasty - cesmína ostrolistá f
ostrosłup - jehlan m
ostry - ostrý, palivý
ostrzytko - ořezávátko n
Oświęcim - Osvětim
oszukańczy - podvodný
oszust - podvodník m
otawa - otava f
otocjon - pes ušatý
Ottawa - Ottawa
otwierać - otevírat
otwór - otvor m
otworzyć - otevřít
-owa - -ová
owad - hmyz m
owadoznawstwo - entomologie f
owca - ovce f
owies - oves m
owłosiony - chlupatý
owoc - ovoce n
owocnia - oplodí, perikarp
owulacja - ovulace f
ożarty - opilý, opilec m
ożyna - ostružina
pacan - blbec m
pacha - podpaží n
pachniarz - nos m
pachnidło - parfém m
pacholę - kluk m, chlapec m, hoch m
paciuk - krysa, potkan
Pacyfik - Tichý oceán m
pacynka - maňásek m
paczek - balík
pączek - kobliha f, koblih m
paczka - balík
padać - mluvit
padlinożerca - mrchožrout
pająk - pavouk m
pajęcznik - září n, říjen m, listopad m
pajęczyna - pavučina
pajucina - pavučina
Pakistan - Pákistán
pakli - jestliže
pała - hlava f, penis m, pyj m, policista m
palacz - řidič m
palant - vůl m
Palatyn - Palatin m
Palau - Palau
pale - hlava f, penis m, pyj m, policista m
palec - prst m
palec wskazujący - ukazovák m, ukazováček m
paleo- - paleo-, pale-, pal-
paleontolog - paleontolog m
paleontologia - paleontologie f
Palermo - Palermo m
Palestyna - Palestinská autonomie f
paliatywny - paliativní
palić - palit, kouřit
palić za sobą mosty - spálit za sebou všechny mosty
Palikir - Palikir
palindrom - palindrom
paliowy - světležlutý, světle žlutý
pallad - palladium
pamiątka - památka f
pamięć - paměť
pana - pneumatika f
Panama - Panama
panew - pánev f
panikować - panikařit
Pankracy - Pankrác m
pan młody - ženich m
panna - slečna f
Panna - Panna f
państwo - stát
pantera - levhart m
pantomima - pantomima f
papier - papír m
papieros - cigareta f
papier ścierny - smirkový papír
papier toaletowy - toaletní papír m
papieski - papežský
papież - papež m
paproć - kapraďorost m
papryka - paprika f
Papua-Nowa Gwinea - Papua-Nová Guinea
papuć - bota
para - vodní pára
parabola - parabola f
parafia - fara f, farnost f
parafialny - farní
parafianka - farnice f
paragon - paragon
paragraf - paragraf m
Paragwaj - Paraguay
Paramaribo - Paramaribo
parapet - parapet
parapetówa - kolaudačka
parapetówka - kolaudačka
parasol - deštník m, slunečnik m
Pardubice - Pardubice
park - park
parking - parkoviště n
park krajobrazowy - chráněná krajinná oblast f
park narodowy - národní park m
parochija - fara f, farnost f
parodia - parodie f
parostatek - parník m
parter - přízemí n
partykuła - částice
partytura - partitura f
partyzant - partyzán m
Parys - Paris m
Paryż - Paříž
pasjans - pasiáns m
pasować - slušet
pasożyt - parazit m, cizopasník m
pasta - pasta f
pasta do zębów - zubní pasta f
pastylka - tableta f
pasywny - pasivní
pasza - paša, krmivo
paszcza - tlama f
paszport - pas, cestovní pas m
pasztet - paštika
pasztet strasburski - foie gras
pątnik - poutník m
patria - vlast f
patriotyczny - vlastenecký
patriotyzm - patriotismus
Patryk - Patrik
patrzałki - brýle
patrzeć - divat se
patrzyć - divat se
Paulek - Pavel m
paw - páv m
Paweł - Pavel m
pawęża - štít
październik - říjen m
październikowy - říjnový
paździerzeń - říjen m
paznokieć - nehet
pazura - ruka
pchła - blecha f
pech - smůla f
pecka - pecka f
pediatra - dětský lékař m
pedo- - pedo-
pedofil - pedofil m
pedofilia - pedofilie f
pędzel - štětec m
peeling - peeling m
Pegaz - Pegas m
peja - veš
pejoratywny - pejorativní
pekator - penis m, pyj m
Pekin - Peking
pełny - plný
pendżabski - paňdžábský
penis - penis m, pyj m
pensjonat - penzion
pępek - pupek m
Pepik - Čech m
peptyd - peptid m
peregrynacja - pouť f
perfumeria - voňavkářství n
perfumy - parfém m, voňavka f
pergola - pergola f
perka - brambor
perkoz - potápka
perliczka - perlička f
Perseusz - Perseus m
perski - perština
persona - osoba f
Peruwiańczyk - Peruánec m
Peruwianka - Peruánka f
perykopa - perikopa f
peryskop - periskop
pęseta - pinzeta f, pinseta f
pestka - pecka f
pesymista - pesimista
petronelka - beruška f
pewien - jistě
pewny - jistě
piana - pivo m
pianista - pianista m
pianistka - pianistka f
piaskownica - pískoviště n
piaszczysty - písčitý
piąta kolumna - pátá kolona f
piątek - pátek m
piątkowy - páteční
pić jak szewc - pít jako duha
piczka - píča f
pidżama - pyžamo n
piec - pec, péci
pięćdziesięcioletni - padesátiletý
piechota - pěšky
pięciobój - pětiboj m
pięcioletni - pětiletý
pięcioosobowy - pětimístný
pięciopokojowy - pětipokojový
pięćsetletni - pětisetletý
pieczara - jeskyně f
pieczarka - pečárka f
pieczęć - pečeť
pieczętować - pečetit
piedestał - piedestal m
piegża - pěnice
piekielny - pekelný
piekło - peklo
piękność - krasavice f, kráska f
pielęgniarka - zdravotní sestra f
pielgrzym - poutník m
pielgrzymka - pouť f
pieluszka - plenka f
pień - kmen m
pieniądz - peníz m
pieniński - pieninský
Pieniny - Pieniny
pieprzyć - pepřit, mlít, kecat, mrdat, šukat, šoustat, prcat
pierdnięcie - prd m
pierdzieć - prdziet
pieróg - piroh m
pierogi - piroh m
pierścionek - prsten m
pierwotniak - prvok m
pierwsza pomoc - první pomoc
pierwszorzędny - prvotřídní
pies - pes m
pięść - pěst f
pięściarstwo - box
pieski - psí
pies ogrodnika - žába na prameni
pieszo - pěšky
pięta Achillesa - Achillova pata f
pięta achillesowa - Achillova pata f
piętnastoletni - patnáctiletý
piętro - patro, podlaží n
pietruszka - petržel
pietruziel - petržel
pigularz - lékárník m
pigwa - kdoule
pijany - opilý, opilec m
pijawa - duha f
pikawa - srdce
piksel - pixel
piła - pila f
piłka - míč f, balón m
piłka nożna - fotbal
piłkarka - fotbalistka
piłkarzyki - stolní fotbal m
Pilzno - Plzeň f
pingwin - tučňák
piołun - pelyněk m
pion - pěšec m
pionek - pěšec m
piorun - blesk
piosenka - píseň f, písnička f
Piotr - Petr m
Piotra - Petra f
pipa - píča f
piramida - pyramida f
pirat - pirát
pirenejski - pyrenejský
piromania - pyromanie f, pyrománie f
pirydoksyna - pyridoxin m
piryt - pyrit m
pisać - psát
pisanka - kraslice f
pisklę - pískle n
pismo - písmo, abeceda
pistacja - pistácie
pistolet maszynowy - samopal
pisuar - pisoár m
piszczeć - pipat
piterka - peněženka f
Pittsburgh - Pittsburgh m
piwiarnia - pivnice f
piwnica - sklep
piwo - pivo m
piżama - pyžamo n
pizda - pizda f, píča f
pizgać - bít, šukat
piznąć - uhodit
pizza - pizza f
pizzeria - pizzerie f
Pjongjang - Pchjongjang
plac budowy - staveniště n
płacić - platit
plagiator - plagiátor m
plajster - náplast
płakać - plakat
płakać nad rozlanym mlekiem - plakat nad rozlitým mlékem
plama - skvrna f
planeta - planeta f
planetarium - planetárium n
plankton - plankton
planować - plánovat
płaski - plochý
płaskowyż - plošina f
plastelina - plastelína f
plaster - náplast
plastyk - výtvarník m
płaszcz - kabát m
płaszczyk - kabátek
płaszczyzna - plocha f, rovina
platan - platan m
plateau - plošina f
płatek śniegu - sněhová vločka f
platyna - platina
plaża - pláž
plazma - plazma
plecak - batoh
plecówka - plec
Plejady - Plejády, Kuřátka n
plejstocen - pleistocén
plemię - plemeno n
plemienny - plemenný
pleść androny - hlasát bludy, kázat bludy
pleśń - plíseň
pliszka - konipas m
płot - plot m
pluć - plivat
płucnica islandzka - pukléřka islandská
płuco - plíce f
pług - ruchadlo m, pluh m
pluskolec - znakoplavka
pluskwiak - ploštice f
pluton - plutonium m, četa f
Pluton - Pluto m
płyn Lugola - Lugolův roztok
płynny - plynný, likvidní, kapalný, tekutý
pływać - plavat
PNA - PSČ
pobój - bojiště n
pobojowisko - bojiště n
pobyt - pobyt
pocałunek z języczkiem - francouzák m
pocestny - cestovatel m
pochodzenie - původ m
POChP - CHOPN
pochwa - pochva
pociąg - vlak
początkowo - zpočátku
początkowy - počáteční
poczta - pošta
pocztówka - korespondenční lístek, pohlednice
pocztowy - poštovní
poczytalność - příčetnost f
podarunek - dárek m
podatkowy - daňový
podatnik - poplatník m
podciąć skrzydła - přistřihnout křídla
poddasze - podkroví n
Podgorica - Podgorica
podkarpacki - podkarpatský
podkolanówka - podkolenka f
podkoszulek - tričko n, nátělník m
podkoszulka - tričko n, nátělník m
podkowa - podkova f
Podlasie - Podlesí
podłoga - podlaha f
podnosić do potęgi - mocnit
podobieństwo - podoba f
podobny - podobný
podówczas - tehdy
podpisać - podepsat
podpłomyk - podplamenice f
podpułkownik - podplukovník m
podróżnik - cestovatel m
podróżować - cestovat
podrzucać - vycházovat na horu
podstawa - základ m
podstawówka - základní škola f
podstawowy - základní
poduszka - polštář m
poduszka powietrzna - airbag m
poduszkowiec - vznášedlo n
podwiązka - podvazek m
podwozie - podvozek m
poezja - básnictví n, poezie f
poganka - pohanka
pogaństwo - pohanství n
pogoda - počasí n
pogromca - přemožitel m
pogróżka - pohrůžka f
poić - pojit
pojazd - vozidlo n
pojedynek - souboj m
pojutrze - pozítří
pokój - mír m, pokoj m
pokrzewka piegża - pěnice
pokrzywowy - kopřivový
pokuta - pokání n
pokutnik - kajícník
Polak - Polák m
Polak, Węgier – dwa bratanki, i do szabli, i do szklanki - Polák, Maďar, dva bratři, v šavli i ve sklenici
polarny - polární
polder - polder
polegać - spoléhat
poleku - pomalu, zvolna
polemika - polemika
policja - policie
policjant - policista m
policjantka - policistka f
policzek - tvář f
policzyć - spočítat
poligamia - polygamie f
poliglota - polyglot m
poliptyk - polyptych m
politolog - politolog m
polityka - politika
półnagi - polonahý
północnoamerykański - severoamerický
północno-wschodni - severovýchodní
połóg - šestinedělí, porod
polon - polonium
polonizm - polonismus m, polonizmus m
połowa - polovina f
półowa - polovina f
polować - lovit
położenie - umístění n
położyć - položit, lehnout si
Polska - Polsko n
polski - polský, polština f
półudenyk - oběd m
południe - poledne, jih
południk - poledník
południowoamerykański - jihoamerický
Półwysep Kolski - Kola f, Kolský poloostrov m
Półwysep Krymski - Krymský poloostrov m
połykać - polykat
pomagać - pomáhat, pomoct
pomarańcza - pomeranč m
pomarańczowoczerwony - oranžovočervený
pomarańczowożółty - oranžověžlutý
pomarańczowy - pomerančový, oranžový
pomidor - rajče n
pomidorówka - rajská polévka f
pomnik - památník m, monument m
pomnik przyrody - přírodní památka
pomoc - pomoc f
Pomorze - Pomořansko
pompka - hustilka f
pomrzeć - zemřít
pomysł - nápad m
pomysłowy - nápaditý
poniedziałek - pondělí n
poniedziałkowy - pondělní
ponieważ - protože
pontyfikat - pontifikát m
popiersie - poprsí n, busta f
popojutrze - popozítří
poprawnie - správně
poprawność polityczna - politická korektnost f
poprawny - správný
popularność - oblíbenost f
popularyzować - popularizovat
popyt - poptávka f
por - pórek
pora roku - roční období n
porcja - porce
pornografia - pornografie f
pornograficzny - pornografický
poród - porod
porozmawiać - pomluvit, pomluvit si
portfel - peněženka f
portki - kalhoty
Portugalia - Portugalsko
portugalski - portugalština
porucznik - nadporučík m
poruta - stud m, propadák m
porwanie - únos m
porządek - pořádek
porzeczka - rybíz
porzućcie wszelką nadzieję, wy, którzy tu wchodzicie - zanechte veškeré naděje, vy, kteří vcházíte
pościć - postit se
Posejdon - Poseidón m
poseł - poslanec m
posesor - vlastník m, majitel m
posiłek - svačina f
posłać do diabła - poslat k čertu
posłać do wszystkich diabłów - poslat k čertu
pośladek - hýždě
posłanka - poslankyně f
pośmiertny - posmrtný
posowa - strop m
pośpiech - kvap m
posprzątać - uklidit
pośrednik - zprostředkovatel m
pośrześć - setkat se
postać - podoba f
postępowy - pokrokový
potas - draslík m
potek - kmotr m
potka - kmotra f
potmanyj - peněženka f
potoczny - hovorový
potrafić - dokázat
powątpiewać - pochybovat
powiadać - vyprávět
powidła - povidla
powiedzieć - říct
powierzchnia - plocha f
powierzchowny - povrchní
powieść - román m
powieściopisarz - romanopisec m
powiestka - jméno n, křestní jméno, titul
powietrze - vzduch m
powódź - povodeň, záplava
powoli - pomalu, zvolna
powtarzać - opakovat
poza - kromě, mimo
pozamałżeński - mimomanželský
pozawczoraj - předevčírem
pozaziemski - mimozemský
poziom - hladina f, úroveň f
poziomica - vodováha n
Poznań - Poznaň
późno - pozdě
pozór - pozor
pozostawiać - nechat
pożyczka - půjčka f
pożyczyć - půjčit
pożyteczny idiota - užitečný idiot m
PP - PP
praca - práce f
praca domowa - domácí úkol
prącie - penis m, pyj m
pracodawca - zaměstnavatel m
pracoholiczka - workoholička f
pracoholik - workoholik m
pracować - pracovat
pracowity - pracný, pracovitý
praczka - pradlena f
Praga - Praha
pragnąć - dychtit, toužit
pragnienie - žízeň f
pralka - pračka f
pralnia - prádelna f
prasować - žehlit
prawak - hřib smrkový m
prawa ręka - ruka
prawa zwierząt - práva zvířat
prawda - pravda f
prawdopodobnie - pravděpodobně
prawdopodobny - pravděpodobný
prawdziwek - hřib smrkový m
prawdziwy - skutečný
prawdziwych przyjaciół poznaje się w biedzie - v nouzi poznáš přítele
prawica - pravice f
prawie - teměř, skoro
prawko - řidičský průkaz
prawniczy - právnický
prawnik - právník
prawnuczka - pravnučka f
Prawo i Sprawiedliwość - Právo a spravedlnost n
prawo jazdy - řidičský průkaz
prazeodym - praseodym
prelegent - přednášející
Preszów - Prešov m
pretor - prétor m
Pretoria - Pretoria
prezbiter - presbyter
prezbiterium - kněžiště
prezent - dárek m
prezydent - prezident m
prezydentka - prezidentka f
problematyczny - problematický
proboszcz - farář m
próbować - zkoušet, chutnat
probówka - zkumavka f
próbówka - zkumavka f
procesja - procesí n
prócz - kromě, mimo
prodiż - remoska f
proletariusz - proletář m
prom - trajekt m
promet - promethium
propan - propan
proponować - nabízet, navrhovat
propozycja - propozice f
prorokini - prorokyně
prosię ziemne - hrabáč kapský (hrabáč takaru) m
proso - proso
prosta - přímka
prostoduszny - bezelstný
prostokąt - obdélník m
prostokątny - obdélníkový
proszę - prosím
proszek - prášek
protaktyn - protaktinium
protein - bílek m, bělima f, oční bělmo n, bílkovina f
proteina - bílek m, bělima f, oční bělmo n, bílkovina f
protestant - protestant m
protestować - protestovat
protokolant - zapisovatel
proton - proton m
prowansalski - okcitánština, okcitánský
prowincjał - provinciál
prowizoryczny - provizorní
Prusy - Prusko
prymatologiczny - primatologický
prysznic - sprcha f
prywatny - soukromý
przać - milovat
przebiegłość - vykutálenost f
przebiśnieg - sněženka f
przebój - hit m
przeca - přece
przechadzka - procházka f
przeciąg - průvan
przeciętny - průměrný
przecież - přece
przecinek - čárka f
przeciwgorączkowy - protihorečnatý
przeciwlotniczy - protiletecký
przedawkowanie - předávkování n
przedmieście - předměstí
przedmiesiączkowy - premenstruační
przedostatni - předposlední
przedpokój - chodba f
przedpołudnie - dopoledne
przedsiębiorca - podnikatel m
przedsiębiorstwo - podnik m
przedstawiciel - zástupce m
przedszkole - mateřská škola f
przedwczoraj - předevčírem
przedwiośnie - předjaří n
przedwojenny - předválečný
przedwyborczy - předvolební
przedział - kupé n
przegłos - přehláska
przegrać - prohrát
przekaz - poukázka f
przekazywać - vyřidit
przekludzić - přestěhovat
przełącznik - přepínač m
przemówienie - projev
Przemyśl - Přemyšl
przemysł - průmysl m
przemyt - pašování n, kontraband m, pašeráctví n, podloudnictví n
przemytniczka - pašeračka f
przemytnik - pašerák m
przenośnia - metafora f
przepaść - propast
przepaska - bederní zástěrka f
przepaska biodrowa - bederní zástěrka f
przepiórka - křepelka f
przepraszam - promiňte
przeprowadzać - stěhovat
przeprowadzić - přestěhovat
przepust - propustek m
przerażający - děsivý, hrůzostrašný
przerośnięty - přerostlý
Przerów - Přerov
przerwa - přestávka f
przesądny - pověrčivý
przestawka - přesmyk m
przestępca - zločinec m
przestrzeń kosmiczna - kosmický prostor
przeszkadzać - rušit
przetarg - tendr
przewijanie - převíjení
przewlekły - chronický
przewodnik - průvodce
przewoźnik - dopravce m
przez - přes, skrz
przeze - přes, skrz
przezroczysty - průhledný
przeźroczysty - průhledný
przeżuwacz - přežvýkavec m
przoć - milovat
przycisk - tlačitko n, knoflík m
przygotować - připravit
przygotowywać - připravovat
przyimek - předložka
przyjąć - přijmout
przyjaciel - přítel m
przyjacielski - přátelský
przyjaciółka - přítelkyně f, milenka f
przyjaźń - přátelství n
przyjebać - uhodit
przyjęcie - přijetí n
przykazanie - přikázání n
przylot - přílet m
przymiotnik - přídavné jméno
przynieść - přinést
przypadek - náhoda f, pád m, případ m
przypadkiem - náhodou
przypadkowo - náhodou
przyroda - příroda f
przyrodniczy - přírodní
przyrostek - přípona f
przyrznia - pokosnice
przysięgać - přísahat
przystawka - předkrm m
przystojniak - krasavec m
przyszłość - budoucnost f
przytcza - náhoda f, pád m, případ m
przytomność - přítomnost f
przytośtać - přinést
przytulić - obejmout
przyzapuście - masopust m, karneval m
pseudonauka - pseudověda
pseudonim - pseudonym m
psi - psí
Psia Gwiazda - Sirius m
psiarnia - policie
psisko - pes m
psuć - kazit
psycholingwistyka - psycholingvistika f
psycholog - psycholog m, psycholožka f
psychologia - psychologie f
pszczelarstwo - včelařství n
pszczelarz - včelař m
pszczeli - včelí
pszczoła - včela f
Pszczyna - Pštína
Ptah - Ptah
ptak - penis m, pyj m
ptaszę - penis m, pyj m
ptaszek - ptáček m
publicystyka - publicistika f
publiczny - veřejný
puchar - číše, pohár
puchowy - pérový
pudełko - krabička f
puder - pudr
pudło - krabice f
pugilares - peněženka f
pukieltasia - batoh
pułapka - past f
pulares - peněženka f
pularysek - peněženka f
punkt - bod m
punktualny - přesný
purpurowy - purpurový, purpurný, nachový
puścić - pustit
puste - prázdný
pustka - prázdnota f
pusty - prázdný
pustynia - poušť
puszcza - prales m
puszczyk - puštík
puszka - plechovka f, věznice f, vězení n, pivo m
Pyjter - Petr m
pyra - brambor
pyrrusowe zwycięstwo - Pyrrhovo vítězství
pyta - penis m, pyj m
pytać - ptát se
pytanie - otázka f
rabarbar - rebarbora f, řeveň m
rabat - rabat
Rabat - Rabat
rabin - rabín m
rachatłukum - rahat, turecký med
Rachela - Ráchel f
rachować - počítat
raciądz - rytíř m, vítěz m
Racibórz - Ratiboř
racjonalista - racionalista m
racjonalizm - racionalismus m
racuch - lívanec m
raczej - raději
rad - radium
radar - radar
radio - rozhlas m, rádio n
radioaktywny - radioaktivní
radioodbiornik - radiopřijímač
radon - radon
rafineria - rafinerie f
rafinować - rafinovat
ragóżka - stěrač m
Rajch - Německo n
rajzować - cestovat
rak - rak m, rakovina f
Rak - Rak m
rakuski - rakouský
ramiączko - ramínko n
ramię - rameno n
randka - rande n, schůzka f
ranek - ráno
rano - ráno
raróg - raroh
rasa - rasa f
rasistowski - rasistický
rasizm - rasismus m, rasizmus m
ratusz - radnice f
razdziawa - krkavec m, vrána
razem - pospolu
raz na ruski rok - jednou za uherský rok
reakcjonista - reakcionář m
reaktor katalityczny - katalyzátor výfukových plynů
realizm - realismus m
rebeliant - rebel m
ręce do góry - ruce nahoru!
redaktor - redaktor m
redyska - ředkvička f
redźka - ředkvička f
refektarz - refektář
referencja - reference
reformacja - reformace f
reguła - pravidlo n
reinkarnacja - reinkarnace
rejon - rajón
ręka - ruka
rekin - žralok m
rekomendować - doporučit
rekrut - rekrut m
relatywnie - poměrně
relikwia - relikvie f
remis - remíza f, plichta f
ren - rhenium
reporter - reportér m
reprezentant - reprezentant m
republika bananowa - banánová republika f
Republika Czeska - Česká republika f
Republika Federalna Niemiec - Spolková republika Německo
Republika Konga - Konžská republika f
Republika Korei - Korejská republika
Republika Południowej Afryki - Jihoafrická republika
Republika Słowacka - Slovenská republika
Republika Środkowoafrykańska - Středoafrická republika
Republika Zielony Zielonego Przylądka - Kapverdy
respekt - respekt
restart - restart
reumatyzm - revmatizmus m
rewers - žádanka f
rewolucjonistka - revolucionářka f
rezeda - rezeda
RFN - SRN
rho - ró
Richad - Richard m
Rijad - Rijád
ring - ring
RNA - RNK f
ro - ró
robaczywy - červivý
Robert - Robert m
robić z igły widły - dělat z komára velblouda
robieniec - dělník m
robinsonada - robinzonáda
robot - robot
robotnik - dělník m
robotyka - robotika f
rock - rock, rock-and-roll, rokenrol
rocznica - výročí n
roczny - roční
rod - rhodium
rodzaj - druh m, typ m, rod m, žánr m
rodzeństwo - sourozenci
rodzicielski - rodičovský
rodzicielstwo - rodičovství
rodzina - rodina
rodzina językowa - jazyková rodina
rodzynek - rozinka
rodzynka - rozinka
roentgen - roentgenium
róg - roh m
róg Amaltei - roh hojnosti m
rogaty - rohatý
róg obfitości - roh hojnosti m
rogówka - rohovka f
rok - rok m, sukně f
Roksana - Roxana f
rolada - roláda f
Roland - Roland m
roleta - roleta
rolmops - zavináč m
rolnictwo - zemědělství n
Rom - Rom m
romantyzm - romantismus
romb - kosočtverec
rompelkamera - prádelna f
romski - romský, romština
rondo - kruhový objezd
ronić łzy - ronit slzy
ropowica - flegmóna f
ropucha - ropucha
rosarium - rosarium n, rozárium n
rosiczka - rosnatka f
Rosja - Rusko
roślinożerny - býložravý
rosyjski - ruský, ruština
rotmistrz - rotmistr m
rouza - růže f
Rouza - Růžena f
rower - kolo n
rowerzysta - cyklista m
równanie - rovnice
równanie stanu - stavovou rovnicí
również - též, také, taky
równonoc - rovnodennost f
równy - rovný
róża - růže f
Róża - Růžena f
róża dzika - růže šípková f, psí růže f, šípek m
róża herbaciana - růže čajová, čajovka
róża herbatnia - růže čajová, čajovka
różaniec - růženec m
różanka - hořavka f
rozbieżność - rozpor m, nesrovnalost f, diskrepance f
rozdroże - rozcestí n, křižovatka f
rozdział - kapitola f
rozeta - rezeda
rozmaity - rozmanitý
rozmaryn - rozmarýn m
rozmowa - rozhovor
rozmyślać - přemýšlet
różnorodność - rozmanitost f
różny - různý
różowy - růžový
rozpaczliwy - zoufalý
rozrzutny - rozhazovačný
rozsądny - rozumný
roztargniony - roztržitý
roztomaity - různý
roztwór - roztok m
rozumny - rozumný
rozważać - přemýšlet
różyczka - zarděnky
rtęć - rtuť f
rtm. - rtm.
rubid - rubidium
ruchliwy - čilý
ruchome schody - jezdící schody, pohyblivé schody, eskalátor m, pohyblivé schodiště n
ruchomy - movitý, mobilní
ruczaj - ručej m
ruda - ruda f
rudny - červený, rudý, komunista m
rudy - rezavý, ryšavý, zrzavý
rufa - hýždě
rugby - ragby n
Rumcajs - Rumcajs
rumianek - heřmánek m
Rumun - Rumun m
Rumunia - Rumunsko
Rumunka - Rumunka f
rumuński - rumunština
rupia - rupie
Rus - Rus m
rusałka - rusalka f
rusiński - rusínský
ruta - routa
ruten - ruthenium
rutherford - rutherfordium
Rwanda - Rwanda
ryba - ryba f
Ryba - Ryba f
rybi - rybí
rybitwa - rybák
Rybnik - Rybnik
rybny - rybí
Ryby - Ryby, Ryby f, Ryba f
rycerski - rytířský
rycerz - rytíř m, vítěz m
rychtować - připravovat
ryczeć - řvát
Ryga - Riga
Ryjza - Tereza f
ryma - chřipka f
rysować - kreslit
rysowniczka - kreslířka f
rysownik - kreslíř m
rysunek - kresba
Ryszard - Richard m
rywal - rival m, soupeř m
rywalizować - soutěžit, konkurovat
ryż - rýže f
ryzyko - riziko n
rząd - řada f
rzadny - ošklivý
rządzić - vládnout
rzecz - věc f
rzeczownik - podstatné jméno n
rzeczywisty - skutečný
rzeka - řeka f
rzemiosło - řemeslo n
rzęsa - řasa f
Rzeszów - Řešov
rzeżączka - kapavka
rzeźbiarka - sochařka f
rzeźbiarz - sochař m
rzić - prdel f, buchta f, roštěnka f
rzodkiewka - ředkvička f
rzucać kłoda pod kłody pod nogi - házet klacky pod nohy
rzucać perły przed wieprze - házet perly sviním
rzut - hod, vrh
rzut karny - pokutový kop m, penalta, desítka
rzut rożny - roh m
rzygać - zvracet
Rzym - Řím
Rzymianin - Říman m
Rzymianka - Římanka f
rzymski - římský
sadz - sádka f
sadzielnik - kominík m
safari - safari
sagan - hlava f
Sahara - Sahara
saharyjski - saharský
Saipan - Saipan
Saksonia - Sasko
sałata - salát m, taxi
sałatka - salát m
salceson - tlačenka f, policista m
salomonowy wyrok - šalamounské rozhodnutí
Saloniki - Soluň
Salwador - Salvador
samar - samarium
samica - samice f
samiec - samec m
Samoa - Samoa
samobójca - sebevrah m
samobójczyni - sebevražedkyně f
samobójstwo - sebevražda f
samochód - automobil m, auto n, vůz m
samodzielny - samostatný
samolot - letadlo n
samoobsługowy - samoobslužný
samouk - samouk m
samowar - samovar m
Sana - San'á
sanatorium - ozdravovna
sandacz - candát
sandałowiec - santal
Sandomierz - Sandoměř
sanskryt - sanskrt m
Santiago - Santiago de Chile
Santo Domingo - Santo Domingo
Sao Tomé - Sao Tomé
saper - sapér m
Sarajewo - Sarajevo
sarkofag - sarkofág m
sarkoidoza - sarkoidóza
sarna - srnec m
sarnapa - žirafa f
sąsiad - soused m
sąsiadka - sousedka f
saski - saský
satelita - satelit
Saturn - Saturn m
satyra - satira f
satysfakcja - souboj m
saudyjski - saúdskoarabský
Saxonija - Sasko
scenariusz - scénář m
schabowy - vepřový řízek
schadzka - dostaveníčko n
schody - schody
schody ruchome - jezdící schody, pohyblivé schody, eskalátor m, pohyblivé schodiště n
schyłek - sklonek
ścięgno - šlacha
ściemniać - lhát
Scyta - Skyt m, Skyth m
seaborg - seaborgium
segregator - šanon m
sękaty - sukovitý
sekretarka - sekretářka f, záznamnik m
seks oralny - orální sex
seksualność - sexualita f, pohlavnost f, sexuálnost f
sekunda - sekunda
selen - selen
Selene - Seléné f
Selenita - Měsíčňan m
Selenitka - Měsíčňanka f
selenografia - selenografie f
seler - celer
sen - spánek m, sen m
Senegal - Senegal
senność - ospalost
senny - ospalý
sens - smysl m
sęp - sup m
sepsa - sepse f
ser - sýr m
Serbia - Srbsko
Serbia i Czarnogóra - Srbsko a Černá Hora
Serbka - Srbka f
serbski - srbština
serce - srdce
serdce - srdce
serdeczny palec - prsteník m, prsteníček m
serduszko - srdíčko
serial - seriál m
sernik - kasein, kazeín
seroka - straka
serologia - sérologie
serwatka - syrovátka f
serwerownia - serverovna f
seryjny - sériový
Seszele - Seychely
Seul - Soul
sewilski - sevillský
sezonowy - sezónní
sfen - titanit
siano - seno n
siarka - síra
siarkowodór - sirovodík, sulfan
siąść - sednout, posadit se
się - se
sieć - síť
sieczeń - únor m
siedemdziesięcioletni - sedmdesátiletý
siedem grzechów głównych - sedm hlavních hříchů
siedemnastoletni - sedmnáctiletý
siedemsetletni - sedmsetletý
siedmioletni - sedmiletý
siedmioramienny - sedmiramenný
siedzenie - sedadlo n
siedzieć - sedět
siedzieć na dupie - sedět na prdeli
siekiera - sekera f, sekyra f
Siena - Siena f
sierociniec - sirotčinec
sierp - srp m
sierpień - srpen m
sierpik - srpek m
Sierra Leone - Sierra Leone
sierść - srst f
sikora - sýkora f
sikorka - sýkorka f
siłacz - silák m
sildenafil - sildenafil m
silnik - motor
silno - velmi
silos - silažní věž f
Singapur - Singapur m
siniak - modřina f
siodło - sedlo n
sioło - vesnice, ves f
siostra - sestra f, ségra f, jeptiška
siostrzenica - neteř f
sirpień - srpen m
sitko - mikrofon
sitwa - klika f
skała - hornina f, skála f
skalpel - skalpel
Skały Adrszpaskie - Adršpašské skály
Skały Adrszpasko-Cieplickie - Adršpašsko-Teplické skály, Adršpašskoteplické skály
Skały Adrszpasko-Teplickie - Adršpašsko-Teplické skály, Adršpašskoteplické skály
skand - skandium
skąpstwo - skoupost f
skarbonka - pokladnička f
skarga - žaloba f
skarpeta - ponožka f
skasować - zrušit
skibać - krást
skład - obchod, sklep, strop m
sklep - obchod, sklep, strop m
skoczek - jezdec m
skok o tyczce - skok o tyči
skończony - končit
Skop - Beran m
Skopje - Skopje
skóra - slupka f
skorpion - štír
Skorpion - Štír m
skowronek - skřivan m
skra - jiskra f
skrepnąć - zemřít
skrobia - škrob m
skromność - skromnost f
skroń - spánek m
skrótowiec - akronym m, akronymum
skrucha - zkroušenost f
skrytka pocztowa - poštovní přihrádka f
skrzydlaty - okřídlený
skrzydłówka - křídlovka
skrzynka - schránka f
skrzynka pocztowa - poštovní schránka f
skrzypce - housle
skrzyp polny - přeslička rolní
skurwysyn - zkurvysyn
skuter - skútr m
słabość - slabost f
sładnie - snadno, hesky
Śląsk - Slezsko n
Śląsk Cieszyński - Těšínsko, Těšínské Slezsko n
śląski - slezský
Śląsk Opolski - Opolské Slezsko
sława - sláva f
slawistyka - slavistika f
slawizm - slavismus m, slavizmus m
śledź - oprátka f
śledziona - slezina
ślepa babka - slepá bába, na slepou bábu
ślepa uliczka - slepá ulička
ślepota - slepota f
śleptać - plakat
ślepucha - slepice f
ślimak - plž
ślina - slina f
ślips - oprátka f
śliwka - švestka
śliwowica - slivovice f
słodki - sladký
słodzik - sladidlo n
słoma - sláma f
słomiany - slaměný
słomiany wdowiec - slaměný vdovec m
słoń - slon m
słońce - slunce n
Słońce - Slunce n
słonecznik - slunečnice f
słoniątko - slůně
słonica - slonice f
słony - slaný
Słowacja - Slovensko n
słowacki - slovenština
Słowaczka - Slovenka f
Słowak - Slovák m
Słowenia - Slovinsko
słoweński - slovinština
Słowianin - Slovan m
Słowianka - Slovanka f
słowiański - slovanský
słowik - slavík
słowik rdzawy - slavík obecný
słownik - slovník m, slovní zásoba f
słownikowy - slovníkový
ślub - svatba f, sňatek m
słuchawka - sluchátko n
sługa - sluha m
slup - šalupa
ślusarz - zámečník m
służba bezpieczeństwa - služba bezpečnosti f
słyszeć - slyšet
smacznego - dobrou chuť
smakować - chutnat
smerf - šmoula, šmoulové
śmiać się - smát se
śmiałym szczęście sprzyja - odvážnému štěstí přeje
śmierć - smrt f
śmietana - smetana f (kyselá)
śmietanka - smetana
śmigać - běhat
smok - drak m
Smok - Drak m
smrodyla - černý rybíz m
smutniak - chléb m
smyczek - smyčec m
snecha - snacha f
śniadanie - snídaně
śniadanko - snídáníčko n
śnić - snít
śnieg - sníh m
Śnieżka - Sněžka, Sněhurka
Śnieżnik - Králický Sněžník m
śnieżyć - sněžit
sobaczy - psí
sobaka - pes m
soból - sobol m
sobota - sobota f
sobotni - sobotní
socjalista - socialista
socjalizm - socialismus m
socjolingwistyka - sociolingvistika f
socjologia - sociologie
soczewica - čočka f
sód - sodík m
Sofia - Sofie
sójka - sojka
sojusznik - spojenec m
sok - džus m
sokół - sokol
sokowirówka - odšťavňovač
Sol - Sol m
solniczka - slánka f, solnička f
Solon - Solón m
Somalia - Somálsko n
Somalijczyk - Somálec
somalijski - somálština
somsiad - soused m
sopel - rampouch m, střechýl m
Sopot - Sopoty
sos - omáčka
sosna - borovice
sos sojowy - sójová omáčka
sowa - sova f
sozologia - environmentalistika
spacer - procházka f
spać jak kamień - spát jako pařez, spát jako dub, spát jako dudek
spać jak suseł - spát jako pařez, spát jako dub, spát jako dudek
spadochroniarz - parašutista m
spaghetti - špagety
spalić za sobą mosty - spálit za sebou všechny mosty
spaliny - zplodiny
spam - spam
specjalność - specialita f
spędzać - trávit
spędzić - strávit
spekulant - spekulant m
sperma - sperma n
spichlerz - sýpka f
spichrz - sýpka f
śpieszyć - spěchat, pospíchat, chvátat
śpiew - zpěv m
śpiewać - zpívat
śpiewaczka - zpěvačka
śpiewak - zpěvák m
spiker - hlasatel m, speaker
śpioch - ospalec
spis - seznam m
spis rzeczy - obsah m
spis treści - obsah m
spiżarnia - spižírna f
spódnica - sukně f
spodnie - kalhoty
spojówka - spojivka
społeczeństwo - společnost
spolegliwość - spolehlivost f
spolegliwy - spolehlivý
sport - sport
spotkać - setkat se
spotkanie - setkání n
spowiednia - zpovědnice f
spowiedź - zpověď
spragniony - žíznivý
spróbować - zkusit, chutnat
sprzątać - uklízet
sprzątaczka - uklízečka f
sprzedawać - prodávat
sp. z o.o. - s.r.o.
srać - srát
sraczka - sračka f
sraka - sračka f
srebrna - stříbrný
srebrny - stříbrný
srebro - stříbro n
średni - střední, průměrný
średnica - průměr m
średniowiecze - středověk m
średniowieczny - středověký
Sri Lanka - Šrí Lanka
ŚRK - SRC
środa - středa f
środkowy - střední
środowy - středeční
śródziemny - středozemní
sroka - straka
śruba - šroub m
ssak - savec
stabilność - stabilita f
stacja - stanice f
stacja benzynowa - benzínová pumpa f
stacja kolejowa - železniční stanice f, stanice f, nádraží n
stajnia Augiasza - Augiášův chlév
stalagmit - stalagmit m
stalaktyt - stalaktit m
stalinizm - stalinismus
stanik - podprsenka f
Stanisław - Stanislav m
Stany - Spojené státy americké
Stany Zjednoczone - Spojené státy americké
Stany Zjednoczone Ameryki - Spojené státy americké
stara miłość nie rdzewieje - stará láska nerezaví
stara panna - stará panna f
Stare Bielsko - Staré Bílsko
starek - dědeček m, děd m, děda m, děda
stare miasto - starý, město
starka - babička f
starość - stáří n
starosek - dědeček m, děd m, děda m, děda
staroszek - dědeček m, děd m, děda m, děda
starszy - otec, táta, tatínek, taťka, fotr m
stary - starý
starzyk - dědeček m, děd m, děda m, děda
statek - loď f
statki - nádoba, nádobí
statory - nádoba, nádobí
statyw - stativ m
staw - rybník m, kloub m
stawiać - stavět
staw łokciowy - loket m
stęchlizna - ztuchlina f
Stefan - Stefan
stefka - stevardka f, letuška f
Stela - Stela f
Stella - Stella f
step - step f, step m
stewardesa - stevardka f, letuška f
stodoła - stodola f
stojak - stojan
stokrotka - sedmikráska f, sedmikrása f
stół - stůl m
stolarz - truhlář
stolica - hlavní město
stołówka - menza f, jídelna f
stołowy - stolní, jídelna f
stomatolog - zubař m
stomatologia - stomatologie f
stonka - mandelinka
stonka ziemniaczana - mandelinka bramborová f
stoper - stoper
stopień - stupeň m
stopniowo - postupně
stosować - používat
stosunek - poměr m, pohlavní styk
stosunek płciowy - pohlavní styk
strach - strach m, strašák, strašák do zelí
strach ma wielkie oczy - strach má velké oči
strach na wróble - strach m, strašák, strašák do zelí
strajk - stávka f
strajkować - stávkovat
strąpacz - únor m, studený
straszyć - strašit
strażak - hasič m
Strefa Gazy - Pásmo Gazy
stres - stres
strit - postupka f
stront - stroncium
strugać - strouhat
struktur - struktura f
struktura - struktura f
struna głosowa - hlasivka f
strup - strup
stryczek - oprátka f
stryj - strýc m
stryjek - strýc m
strzała - šíp m
strzec jak oka w głowie - střežit jako oko v hlavě, chránit jako oko v hlavě, chovat jako oko v hlavě, opatrovat jako oko v hlavě
strzec jak źrenicy oka - střežit jako oko v hlavě, chránit jako oko v hlavě, chovat jako oko v hlavě, opatrovat jako oko v hlavě
strzelanina - střelba f
strzelba - puška f
Strzelec - Střelec m
student - student
studentka - studentka f
studnia - studna
stuła - štóla f
stuletni - stoletý
stwórca - tvůrce m, stvořitel m
styczeń - leden m
styczniowy - lednový
suchar - suchar m
Sudan - Súdán
sudecki - sudetský
sudeckoniemiecki - sudetoněmecký
Sudety - Sudety, Krkonošsko-jesenická subprovincie, Krkonošsko-jesenická soustava, Sudetská soustava
sufit - strop m
sufizm - súfismus
sugilit - sugilit
suka - fena f
sukces - úspěch m, zdar m
sułtanat - sultanát m
sumienie - svědomí n
Surinam - Surinam
surowiec - surovina f
suseł - sysel
suszarka do włosów - fén
sutek - bradavka f
swędzić - svědět
świat arabski - arabský svět m
świątek - svátek m
światło - světlo n
światopogląd - světonázor m
światowy - světový
świątynia - chrám m
Świdnica - Svídnice
świecę - svítit
świecić - svítit
świekier - tchán m
świekra - tchyně f
świerk - smrk
świerzb - svrab
świeść - švagrová, tchyně f
Świetlana - Světlana f
świetny - skvělý
święto - svátek m
świętojański - svatojánský
Święty Hufiec - Svatý oddíl m
święty Marcin - svatý Martin m
święty mikołaj - Mikuláš m
Święty Zastęp - Svatý oddíl m
świeży - čerstvý
Świna - Svina
świnia - prase n, prasnice f
Świnica - Svinica f
świnka morska - morče
świostka - švagrová, tchyně f
świt - svítání, úsvit
świtanie - svítání, úsvit
swok - strýc m
Syberia - Sibiř f
syfilis - syfilis f, příjice f
sygnaturka - sanktusník
syjam - siamská kočka f
Syjon - Sijón m
syjonistyczny - sionistický
sylwek - silvestr m
sylwester - silvestr m
Sylwester - Silvestr m
symbol - symbol
syn - syn
synapsa - synapse
syndrom miodowy miodowego miesiąca - syndrom líbánek m
synek - kluk m, chlapec m, hoch m
synkretyczny - synkretický
syn marnotrawny - marnotratný syn m
synowa - snacha f
synteza - syntéza f
sypialnia - ložnice
syra - noha f
Syria - Sýrie f
Syriusz - Sirius m
Syryjczyk - Syřan m
Syryjka - Syřanka f
syryjski - syrský
system operacyjny - operační systém
sytość - sytost f
sytuacja - situace f
syzyfowa praca - Sisyfovská práce
szabas - šábes m
szabaśny - šábesový
szabasowy - šábesový
szabat - šábes m
szabatowy - šábesový
szafir - safír
szafran - krokus
szafranowy - šafránový
szajs - hovno
szal - šátek
szałamaja - šalmaj
szalik - šála f
szałwia - šalvěj f
szaman - šaman m
szamanizm - šamanismus m
szampan - šampaňské n
szampon - šampon m
szanować - vážit si
szantaż - vyděračství n
szantażować - vydírat
szantażysta - vyděrač m
szantażystka - vyděračka f
szaszłyk - šašlik
Szczecin - Štětín
szczególny - zvláštní, neobvyklý, speciální výjimečný
szczegółowy - podrobný
szczęka - čelist f
szczekać - štěkat
szczekuszka - pišťucha
szczepionka - vakcína
szczerk - štěrk m
szczęście - štěstí n
szczewik - bota
szczodry - štědrý
szczoteczka do zębów - kartáček na zuby m, zubní kartáček m
szczotka - kartáč m
szczur - krysa, potkan
szczygieł - stehlík
szczyt - orgasmus m
szept - šepot m
szeptać - šeptat
szermierka - šerm m
szermierz - šermíř
szeroki - široký
szerokokątny - širokoúhlý
sześćdziesięcioletni - šedesátiletý
sześciokąt - šestiúhelník
sześcioletni - šestiletý
szesnastoletni - šestnáctiletý
szew - lebeční šev, šev, sešití, steh, sutura
szkarłatny - šarlatový, šarlatný
szkielet - kostra
szkira - holka f, dívka f, přítelkyně f
szkita - noha f
szklanka - sklenice f
szklarnia - skleník m
szklistka - sklivec m
Szkocja - Skotsko n
szkocki - skotský
szkodzić - škodit
szkoła podstawowa - základní škola f
szkoła powszechna - základní škola f
szkoła średnia - střední škola f
szkop - Skopčák, Němec m
Szkot - Skot m
Szkotka - Skotka f
szlaban - závora, šraňka, zarach, domácí vězení
szlag - úder m
szlajfa - stuha f
Szląsk - Slezsko n
szlauch - had m
szlips - oprátka f
szlug - cigareta f
szmaja - levák m
szmania - levák m
szminka - rtěnka f
szmuglerka - pašeračka f, pašování n, kontraband m, pašeráctví n, podloudnictví n
szneka - obličej m, tvář f
szogun - šógun m
szok - šok m
szósty zmysł - šestý smysl
szowinista - šovinista m
szowinistka - šovinistka f
szpak - špaček
szpiegostwo - špionáž f
szpinak - špenát m
szpital - nemocnice
szrapnel - šrapnel
sztabka - slitek m
sztetl - štetl m
Sztokholm - Stockholm
sztrof - trest
sztrofa - trest
sztuczna szczęka - umělý chrup
sztuczne ognie - ohňostroj
sztuczny - umělý
sztuka - umění n, hra f, holka f, dívka f, přítelkyně f
szukać - hledat
szukać dziury w całym - hledat na všem hnidy
szukać igły w stogu siana - hledat jehlu v kupce sena
szukam człowieka - hledám člověka
szulak - jestřáb m
szum - šum
szwab - Skopčák, Němec m
Szwabia - Švábsko
szwagierka - švagrová
szwaja - noha f
Szwajcaria - Švýcarsko
Szwajcarka - Švýcarka f
Szwecja - Švédsko
Szwecyjo - Švédsko
Szwed - Švéd m
Szwedka - Švédka f
szwedzki - švédština
szwestera - sestra f, ségra f, jeptiška
szyja - krk m, šíje f
szykanowanie - šikana
szykowny - elegantní
szyna - dlaha f
szynal - hřebík
szypszyna - růže šípková f, psí růže f, šípek m
szyszka - šiška f, vzácný pták m
tabla - tabla
tablet - grafický tablet m, tablet m, digitalizačný tablet m, tabletový digitalizátor m, digitizér m, digitalizátor m, snímacia tabuľka f
tabletka - tableta f
tablica rejestracyjna - registrační značka
tabliczka - násobilka f
tabliczka mnożenia - násobilka f
tachykardia - tachykardie f
tacik - otec, táta, tatínek, taťka, fotr m, dědeček m, děd m, děda m, děda
Tadeusz - Tadeáš
tadżycki - tádžičtina
Tadżykistan - Tádžikistán
Tajlandia - Thajsko
tak - ano
taksonomia - taxonomie f
taksówka - taxi
taktyka - taktika
także - též, také, taky
tal - thallium
talizman - talisman
Tallinn - Tallinn
tam - tam
Tamara - Tamara
tamdotąd - tam
tamilski - tamilština f
Tamiza - Temže f
tangens - tangens
tango - tango n
tani - levný
taniec świętego Wita - tanec svatého Víta
tank - tank m
tanksztela - benzínová pumpa f
tantal - tantal
Tanzania - Tanzanie
taoizm - taoismus m
tarcza - štít, ciferník m, obličej m, tvář f, protiraketová obrana, předvěst
tarcza antyrakietowa - protiraketová obrana
tarcza krystaliczna - štít
tarcza ostrzegawcza - předvěst
tarcza strzelecka - štít, ciferník m, obličej m, tvář f, protiraketová obrana, předvěst
tarcza szkolna - štít
tarczyca - štítná žláza f
targ - trh m
Tarnów - Tarnov
tarpan - tarpan
taśka - kabelka f, sáček m
taśma perforowana - děrná páska
taśtać - nést
Taszkent - Taškent, Toškent
tata - táta, tatínek, taťka
taternictwo - horolezectví
tato - táta, tatínek, taťka
Tatry - Tatry
tatrzański - tatranský
Tbilisi - Tbilisi
tchórzliwy - zbabělý
teatr - divadlo n
technet - technecium
technolog - technolog m
technologia - technologie f
technologiczny - technologický
tęcza - duha f
tęczówka - duhovka f
tęgoskór cytrynowy - pestřec obecný m
Tegucigalpa - Tegucigalpa
Teheran - Teherán
tej - ty
teksasy - džíny
tela - tolik
Tel Awiw - Tel Aviv m
telefon - telefon
telefon komórkowy - mobilní telefon m
telefonować - telefonovat
telegram - telegram
teleobiektyw - teleobjektiv m
telewizja - televize f
telewizor - televizor m, televize f
telewizyjny - televizní
tellur - tellur
temat - téma
temperówka - ořezávátko n
tender - tendr
tenis - tenis
ten śmiać się śmieje, kto śmiać się śmieje ostatni - kdo se směje naposledy, ten se směje nejlépe, kdo se směje naposled, ten se směje nejlépe
Teodor - Teodor m
teolog - teolog m
teologia - teologie
teologiczny - teologický
Teplickie Skalne Miasto - Teplické skalní město
tępy - tupý
teraz - nyní, teď
terb - terbium
Teresa - Tereza f
teriologiczny - teriologický
terminologiczny - terminologický
termit - všekaz, termit
termodynamika - termika
terrarium - terárium n
terroryzm - terorismus m
teść - tchán m
teściowa - tchyně f
tęsknić - toužit
tęsknota - tužba, touha
testament - závěť f
teszarz - truhlář
tetum - tetum
też - též, také, taky
tezaurus - tezaurus m
Tezeusz - Théseus m
tik - tik
Timor Wschodni - Východní Timor
Tirana - Tirana
tisztuch - ubrus m
tiul - tyl m
tkać - tkát
tkactwo - tkaní n
tkacz - tkadlec m
tkanka tłuszczowa - tuková tkáň f
tlen - kyslík
tobie - ty
Togo - Togo
tokijski - tokijský
tokoferol - tokoferol m
toksyna - toxin m
Tomisław - Tomislav m, Tom m, Toma m
toń - tůň n
tondo - tondo
tonfa - tonfa f
Tonga - Tonga
topola - topol
tor - thorium, izolovaná skála, tor, izolovené skalisko, mrazový suk
torebka - kabelka f, sáček m
torf - rašelina
torfowisko - rašeliniště n
tornado - tornádo
tors - hrudník m
tort - dort m
Toruń - Toruň
tory - thorium, izolovaná skála, tor, izolovené skalisko, mrazový suk
totalitaryzm - totalita
totem - totem m
towar - zboží n
towarzysz - soudruh m
trąd - lepra f
tradycja - tradice f
tradycyjny - tradiční
trądzik - akné f
traf - náhoda f, pád m, případ m
trafić trafiło się ślepej kurze ziarno - i slepá slepice někdy zrnko najde
trafika - trafika f
traktor - traktor
trambimba - tramvaj f
trampkarz - dorostenec m
tramwaj - tramvaj f
tramwajka - tramvaj f
transakcja - transakce
transparentny - průhledný
transport - doprava f
transseksualistka - transsexuálka f
transsubstancjacja - transsubstanciace
tranzystor - rozhlas m, rádio n
trąt - trubec
trawienie - trávení
trawnik - trávník m
tren - vlečka f
trena - vlečka f
Trenczyn - Trenčín m
trend - trend m
trenodja - vlečka f
treser - krotitel m
triolet - triolet m
Trnawa - Trnava f
tróhła - rakev f
trójkąt - trojúhelník
Trójmiasto - Trojměstí
trójsilnikowy - třímotorový
trójskok - trojskok m
trolejbus - trolejbus
truchło - mrtvola f
trumna - rakev f
trunek - alkoholický nápoj
trup - mrtvola f
truskawka - jahodník m, jahoda f
truskawkowy - jahodový
truteń - trubec
trybalizm - tribalismus
Trynidad i Tobago - Trinidad a Tobago
Trypolis - Tripolis
trywialny - triviální
trzask - třesk m
trzcina - třtina f
trzcina cukrowa - cukrová třtina f
Trzej Królowie - tři králové
trzepak - klepadlo
trzęsidupa - sračka f
trzęsienie ziemi - zemětřesení n
trzmiel - čmelák m
trznadel zwyczajny - strnad obecný
trzydziestoletni - třicetiletý
trzyletni - tříletý
trzymać - držet
trzymać język za zębami - držet jazyk za zuby
trzymać kciuki - držet palce
trzynastoletni - třináctiletý
trzypokojowy - třípokojový
trzystuletni - třísetletý
tu - tady
tudzież - a
tukej - tady
tul - thulium
tu leży pies pogrzebany - tady je zakopaný pes
tulipan - tulipán m
tulp - tulipán m
tundra - tundra f
Tunezja - Tunisko n
tunezyjski - tuniský
tungsten - wolfram
Tunis - Tunis
tur - tur
turbina - turbína f
Turcja - Turecko
turecki - turečtina
Turkmenistan - Turkmenistán
turkmeński - turkmenština
turkusowy - tyrkysový
turmalinowy - turmalínový
Turyn - Turín
turysta - turista m
turystyka - turistika f
tusz - inkoust m
tutaj - tady
Tuvalu - Tuvalu
tuż - skoro, téměř
tuzin - tucet m
twardość - tvrdost f
twardziel - tvrďák m
twaróg - tvaroh m
twarz - obličej m, tvář f
twierdzić - tvrdit
ty - ty
tybetański - tibetský
tyć - tloustnout
tydzień - týden m
tygrysica - tygřice f
tyj - čaj m
Tyjuś - Teodor m
tyle - tolik
tylko - jen, jenom, pouze
tymczasem - zatímco, zatím
tymianek - tymián m
tyn - plot m
typ - typ m
typografia - typografie
tyrania - krutovláda f, tyranie f
Tyrteusz - Tyrtaios m
tyrystor - tyristor m
tysiącletni - tisíciletý
tytan - titan m
tytanit - titanit
tytuł - titul
tzw. - tzv. (= tak zvaný, takzvaný)
ubezpieczenie - pojištění n
ubiór - oděv
ucho - ucho n
uderzenie - úder m
uderzyć - uhodit
udziec - stehno
UE - EU
ufnal - hřebík
Uganda - Uganda
uj - strýc m
ujec - strýc m
ujednoznacznienie - desambiguace f
ujek - strýc m
ukamienowanie - kamenování n
układ nerwowy - nervová soustava f
układ okresowy - periodická tabulka
układ okresowy pierwiastków - periodická tabulka
Układ Słoneczny - sluneční soustava f
Ukraina - Ukrajina f
Ukrainka - Ukrajinka f
ukraiński - ukrajinština
ukrzyżowanie - ukřižování n
ul - úl m
ul. - ul.
Ułan Bator - Ulánbátar
ulica - ulice f
ulotka - leták m
Ulryk - Oldřich, Ulrik
umarlec - nebožtík m
umfal - nehoda f
umowa - úmluva f
umrzeć - zemřít
umywalka - umyvadlo n
unia - unie f
Unia Europejska - Evropská unie f
uón - on
upić - opít se
upiec dwie pieczenie na jednym ogniu - zabít dvě mouchy jednou ranou
upokarzać - ponížit
upór - tvrdohlavost f
Ural - Ural
uran - uran m
Uran - Uran m, Uranos m
Uranos - Uran m, Uranos m
Urban - Urban m
Urbanowy - Urbanův
urlop - dovolená
urna - urna
uroczystość - slavnost f
urodziny - narozeniny
urologia - urologie f
urologiczny - urologický
Urszula - Uršula
Urugwaj - Uruguay
Uście nad Łabą - Ústí nad Labem
uskrzydlony - okřídlený
uśmiech - úsměv m
uśmiechać się - usmívat se
usta - ústa
ustalić - určit
uszny - ušní
utęsknienie - tužba, touha
uwaga - pozor
uzasadniać - zdůvodnit
uzasadnienie - opodstatnění n
uzbecki - uzbečtina
Uzbekistan - Uzbekistán
uznać - uznat
uznanie - uznání
użyteczny idiota - užitečný idiot m
użytkownik - uživatel m
używać - používat
V4 - V4
wacha - déšť m, moře n, voda f
Wag - Váh
Waga - Váhy, Váha f
wagon - vůz m
wajco - vejce, vajíčko n
wałach - valach m
Walburga - Valburga f
walcowaty - válcovitý
walczerz - prapor
walczyć - bojovat
Waldemar - Valdemar
waldryjan - kozlík
Walenty - Valentin m, Valentýn m
Walia - Wales
walka z wiatrakami - boj s větrnými mlýny
walkman - walkman
waluta - měna f, valuta f
wanad - vanad
wanienka - vanička f
wapń - vápník
waran - varan m
wardawy - levák m
warga - ret m, pysk m (stydký)
wariant - varianta f
wariat - blázen m
warkocz - cop m
Warkocz Bereniki - Vlasy Bereniky m
Warszawa - Varšava
warszawiak - Varšavan m
warszawianin - Varšavan m
Warta - Varta f
warto - být záhodno
wartość - hodnota f
warunek - podmínka f
warzyć - vařit
waserwaga - vodováha n
waserwaśka - vodováha n
waserwoga - vodováha n
wąski - úzký
Waszyngton - Washington
wata - vata f
wata cukrowa - cukrová vata f
wątpić - pochybovat
wątpliwość - pochybnost
wątroba - játra
wątrobianka - jitrnice
Watykan - Vatikán
Wawrzyńcowy - Vavřincův
Wawrzyniec - Vavřinec m
wąż - had m
ważyć - vážit, vážit si
wbrew - přes
wcześnie - dřív
wcześniej - dřív
wczoraj - včera
wczorajszy - včerejší, nedávný, dnešní
w cztery oczy - mezi čtyřma očima
wdzięczność - vděčnost f
wędkarz - rybář m
Wega - Vega f
weganin - vegan m
weganizm - veganství
wegański - veganský
wegetarianin - vegetarián m
wegetarianizm - vegetariánství
węgiel - uhlík
węgiel kamienny - černé uhlí, kamenné uhlí n, černé uhlí n
Węgier - Maďar m
Węgierka - Maďarka f
węgierski - maďarština
węglowodan - karbohydrát m
Węgry - Maďarsko n, Uhry
Wełtawa - Vltava f
Wenecja - Benátky
wenecki - benátský
Wenera - Venuše f
wenerologia - venerologie f
Wenezuela - Venezuela
wentroba - játra
Wenus - Venuše f
werdykt - verdikt
wernakularny - vernakulární
Weronika - Veronika f
Wesna - Vesna f
wesoło - vesele
Wesołych Świąt - Veselé Vánoce
Westa - Vesta f
western - western
wesz - veš
węszyć - čmuchat
węzeł - uzel m
węzeł gordyjski - gordický uzel
Wężownik - Hadonoš m
Wezuwiusz - Vesuv m
wezwanie - jméno n, křestní jméno, titul
wiać - vát, foukat
wiadomość - zpráva f
Wiara - Věra f
wiarygodność - hodnověrnost
wiatr - vítr m
wiatyk - viaticum
wiązadło - vazivo m
Wichta - Viktoria f, Viktorie f
widelec - vidlička f
widelec do porcjowania - vidliĉka porcovací f
wideoklip - videoklip
widołka - vidlička f
widz - divák
więc - tak, tedy, pak
wieczera - večeře
wieczerza - večeře
Wieczne Miasto - Věčné město n
wieczność - věčnost f
wieczór - večer
wieczorny - večerní
Wiedeń - Vídeň f
wiedzieć - vědět
wiejski - vesnický
większość - většina f
wiela - který
wielbłąd - velbloud m
wielbłądzi - velbloudí
Wielka Brytania - Velká Británie
Wielka Niedźwiedzica - Velká medvědice
Wielkanoc - Velikonoce
wielkanocny - velikonoční
Wielka Sobota - Bílá sobota f
Wielki Czwartek - Zelený čtvrtek m
Wielkie Równiny - Velké planiny
Wielki Piątek - Velký pátek m
wielkopiątkowy - velkopáteční
wielofunkcyjny - multifunkčný
wielokąt - mnohoúhelník m
wielokomórkowy - mnohobuněčný
wielokulturowy - multikulturní
wieloryb - velryba f
Wieloryb - Velryba f
wielotorbielowaty - polycystický
wieniec adwentowy - adventní věnec m
wieniec laurowy - laur m, vavřín m
Wientian - Vientiane
wieprzowina - vepřové n
wiercenie - vrtání
wierzba - vrba
wieś - vesnice, ves f
wieszak - věšák m
Wietnam - Vietnam
Wietnamczyk - Vietnamec m
Wietnamka - Vietnamka f
wietnamski - vietnamský, vietnamština
wietrzny - větrný
wiewiór - kapavka
wiewiórka - veverka f
wieża - věž
wieża Eiffla - Eiffelova věž f, ajfelovka f
więzienie - věznice f, vězení n
Wigilia - Štědrý den
wihara - vihára
wikariusz - vikář m
wikary - farní vikář
wiking - Viking
Wikipedia - Wikipedie
Wikisłownik - Wikcionář, Wikislovník m
Wikiźródła - Wikizdroje
Wiktor - Viktor
Wiktoria - Viktoria f, Viktorie f
wilga - žluva f
wilgoć - vlhkost f
wilgotność - vlhkost f
wilgotny - vlhký
wilk - vlk m
wilk morski - mořský vlk m
wilkołak - vlkodlak m
wilk w owczej skórze - vlk v beránčím rouše m
willa - vila f
Wilno - Vilnius
winda - výtah m
winiarstwo - vinařství n
winnica - vinice
winobranie - vinobraní
winograd - vinice
winogrodnictwo - vinohradnictví n
winogrodniczka - vinohradnice f
winogrodnik - vinohradník m
wiosenny - jarní
wioska - vesnice, ves f
wiosna - jaro f, vesna f
Wirakocza - Virakoča m
wirus - virus m, vir m
wirusologia - virologie f
wiskacza - viskača
wiśnia - višeň f
wiszczeć - křičet
Wisznu - Višnu m
Wit - Vít m
witalność - vitalita f, vitálnost f
witaminowy - vitaminový
witraż - vitráž f, vitraj f
wiwianit - vivianit
wiza - vízum n
wizjer - mířidlo n, zaměřovač m, hledáček m, dativ m, třetí pád m
wizyta - návštěva f
wkładka - vložka f, příloha f
włączać - zapínat
włączyć - zapnout
właściciel - vlastník m, majitel m
właściwy - vhodný, správný
włazić w dupę - lézt do prdele
Włoch - Ital m
Włochy - Itálie
Włocławek - Włocławek
Włodzimierz - Vladimír
włókno - vlákno n
włos - vlas
włoski - italština
Włoszka - Italka f
wnętrze - interiér
woda - voda f
woda kolońska - kolínská voda
woda mineralna - minerální voda f
wodniczka - rákosník ostřicový m
Wodnik - Vodnář m
wodnopłat - hydroplán m
wodolot - křídlová loď, křídlový člun
wodór - vodík
wodospad - vodopád
wodzić za nos - tahat za nos
Wojciech - Vojtěch
województwo - vojvodství, kraj
wojna - válka f
wojna trojańska - trojská válka
wokabularz - slovník m, slovní zásoba f
wołacz - vokativ m, pátý pád m
Wolarz - Pastýř m
wolfram - wolfram
Wołga - Volha f
Wołgograd - Volgograd m
wolna miłość - volná láska f
wołoski - valašský
Wołoszczyzna - Valašsko n
wołowina - hovězí n
worek - pytel, vak m, výběžek m
wóz - vůz m
wóz drabiniasty - žebřiňák m
wózek dziecięcy - kočárek
wózek sklepowy - nákupní vozík m
wozić żyto na Zawiśle - nosit dříví do lesa, nosit sovy do Atén
wrażenie - dojem m
Wrocław - Vratislav f, Wrocław f
wróg - nepřítel m
wrogi - nepřátelský
wrona - vrána
wróżka - víla f
wrzeć - vařit
wrzesień - září n
wschód - východ
Wschód - Blízký východ m
wścibski - všetečný
wścieklizna - vzteklina f
współcześnie - současně
współczesny - současný
współczucie - soustrast f, soucit f
współlokator - spolubydlící m
wspólnie - pospolu
współpraca - spolupráce f
wstążka - stuha f, pás karet
wstęga - stuha f
wstyd - stud m
wszak - přece
wszechobecny - všudypřítomný
wszechstronny - všestranný
wszystkie drogi prowadzą do Rzymu - všechny cesty vedou do Říma
wtedy - tehdy
wtenczas - tehdy
wtorek - úterý n
wtorkowy - úterní
wuj - strýc m
wujek - strýc m
wujko - strýc m
wujo - strýc m
wulkan - sopka f, vulkán
Wulkan - Vulkán m
wuszt - salám m, klobása f
wy - vy
wybierać - vybírat, volit
wybrać - vybrat, zvolit
Wybrzeże kość Kości Słoniowej - Pobřeží slonoviny
wybuchowy - výbušný
wychodzić z założenia - předpokládat
wychudzony - vyhublý
wycieraczka - stěrač m
wydarzenie - událost f
wydatkować - utrácet
wydawać - utrácet
wydma - duna f
wydra - vydra f
wygląd - podoba f
wygrana - cena f
wyjątek - výjimka f
wyjec - vřešťan
wyjść po angielsku - zmizet po anglicku, prásknout do bot
wykrzyknik - vykřičník m, citoslovce n
wykształcenie - vzdělaní n
wykusz - arkýř
wylać dziecko z kąpielą - vylít vaničku i s dítětem
wyłączać - vypínat
wyłączyć - vypnout
wymiotować - zvracet
wymowa - výslovnost f
wynalazca - vynálezce m
wynalazek - vynález m
wypadek - nehoda f
wypełniać - vyplňovat
wypełnić - vyplnit
wyposażenie - zařízení
wypowiedzenie - výpověď f
wyprzedaż - výprodej m
wyrychtować - připravit
wyrzygiwać - zvracet
wysiadać - vystupovat
wysiąść - vystoupit
wysoki - vysoký m, vysoká f, vysoké n
wyspa - ostrov m
Wyspa Bożego Narodzenia - Vánoční ostrov m
Wyspa Króla Jerzego - Ostrov krále Jiřího f
Wyspa Świętego Wyspy Świętego Tomasza i Wyspa Książęca - Svatý Tomáš a Princův ostrov
wyspiarz - ostrovan m
Wyspy Kanaryjskie - Kanárské ostrovy
Wyspy Marshalla - Marshallovy ostrovy
Wyspy Owcze - Faerské ostrovy
Wyspy Salomona - Šalamounovy ostrovy
wystarczający - dostatečný
wystarczyć - stačit
występować - vystupovat
wyświetlacz - displej m
wysyłać - posílat
wyszehradzki - visegrádský
wytrzeźwiałka - záchytka f
wywiad - interview m, rozhovor m
wywielga - žluva f
wzdłuż - podle, podél
wzdręga grecka - perlín peloponéský
Yjduś - Eduard m
-yzm - -ismus
za - odbyt m, příliš
ząb - zub
zabaczyć - zapomenout
żabie oczko - pomněnka f
zabijać - zabít, přibít
zabijak - vrah
zabójca - vrah
zabójczyni - vražedkyně f
zabójstwo - vražda f, mord m
zabytek - památka
Zachariasz - Zachariáš m
zachłanny - chamtivý
zachód - západ
Zachodni Brzeg - Západní břeh m, Západní břeh Jordánu m, Předjordánsko n
Zachodni Brzeg Jordanu - Západní břeh Jordánu m, Západní břeh m, Předjordánsko n
zachodniosłowiański - západoslovanský
zachód słońca - západ slunce m
zachorować - onemocnět
zachowywać - chovat se
zaćmienie - zatmění n
zadanie domowe - domácí úkol
żądło - žihadlo n
zadowolenie - spokojenost f
zadupie - prdel světa f
zagadka - hádanka f
Żagań - Záhaň
zagłada - vyhlazení n
zagranica - cizina f
zagrożony - ohrožený
Zagrzeb - Záhřeb
zaimek - zájmeno n
zajebać - uhodit
zajebisty - hustý, cool, super, perfektní, vymazlený
zajmować - zabývat se
zakalec - zákalec m, zákal m, brousek m
zakarpacki - zakarpatský
zakaz - zákaz m
zakładać - předpokládat
zakładka - záložka f
zakład karny - věznice f, vězení n
żako - žako m, papoušek šedý m
zakochany - zamilovaný
zakonnica - matka f, jeptiška f
zakonnik - řeholník
zakręt - zatáčka f
zakrystian - sakristán m
żal - smutek, žal
zalany - opilý, opilec m
zaleta - klad
zalotka - kleštičky
żałować - litovat
założyciel - zakladatel m
zamach stanu - puč m, převrat m
Zambia - Zambie
zamek - hrad m, zámek m, zip m
zamężna - vdaná f
zamiennik - náhrada f
zamorski - zámořský
zamówienie - objednání, objednávka f, zakázka f
zamożność - bohatství
Zaolzie - Záolší, Záolží, Zaolzí, Českotěšínsko
zapad - západ
zapalenie płuc - zápal plic
zapalenie wyrostek wyrostka robaczkowego - apendicitida
zapałka - zápalka, sirka
zapiekanka - zapekané
zapierdolić - uhodit
zapominać - zapomínat
zapominalski - zapomnětlivý
zapomnieć - zapomenout
zaproponować - nabídnout, navrhnout
zaprosić - pozvat
zaproszenie - pozvání n
zaprzeczenie - zápor m, negace f
zapusty - fašank m, fašangy, ostatky
zapytać - zeptat se
zaręczyny - zasnoubení
zarękawek - rukávník m
żarliwy - vroucí
żarłok - žrout m
zarodek - embryo n, zárodek m
żart - vtip m, žert m
zasłonak - pavučinec m
zasługiwać - zasluhovat
zasłużyć - zasloužit
zasmażka - jíška f, zásmažka f, zápražka f
zasnąć - usínat
zaspa - závěj f
zastępca - zástupce m, náhradník m
zastrużka - ořezávátko n
zaświaty - podsvětí n, záhrobí n
zatrzymać - zastavit, zastavovat, zatýkat
zatrzymywać - zastavovat, zatýkat
zawał - infarkt m
zawiść - závist f
zawistny - závistivý
zawodowy - profesionální
zawór bezpieczeństwa - pojistný ventil
zawrzeć - vařit
zawsze - vždy, vždycky
zawżdy - vždy, vždycky
zazulka - beruška f
zbawienie - spása
zbiornik - nádrž f
zbłąkana owieczka - bludná ovce f
zbliżenie - pohlavní styk
zboczeniec - úchylák m
zbór - sbor
zbrodnia katyńska - Katyňský masakr
zbyt - odbyt m, příliš
zdanie - věta f, názor m
zdarzenie - událost f
zdjęcie - fotografie f
zdradzić - zradit
zdradziecki - zrádný
zdrajczyni - zrádkyně f
zdrowie - zdraví n
zdrowy - zdravý
zdrzadło - zrcadlo, zrcadlovka f
Żdżar nad Sazawą - Žďár nad Sázavou
zdziwienie - úžas m
że - že
żeberko - žebírko n
zebra - zebra f
zebranie - mítink m
zebroid - zebroid
żeby - aby
żeby mieć kołaczy, trzeba użyć pracy - bez práce nejsou koláče
żec - palit, kouřit
zefir - zefýr m, zefír m
Zefir - Zefyros m
zegarek - hodinky
zegarmistrz - hodinář m
zegar słoneczny - sluneční hodiny
żegleń - uhlík
żel - gel m
żelazko - žehlička f
żelazo - železo n
żelazobeton - železobeton m
żelazomangan - feromangan
żelbet - železobeton m
zelter - minerální voda f
zelżywość - hanba f, ostuda f
zemsta - msta f
żenąć - běžet
żeńczyna - žena f
żentyca - žinčice f
zespół napięcia przedmiesiączkowego - premenstruační syndrom
zespół Sjögrena - Sjögrenův syndrom m
żeton - žeton m
żętyca - žinčice f
Zgierz - Zgierz
Zgorzelec - Zhořelec
zgubić - hubit
zic - sedadlo n
zięba - pěnkava f
zielarstwo - bylinkářství n
ziele angielskie - nové koření n
zielnik - herbář
Zielona Góra - Zelená Hora
zielonooki - zelenooký
zielony - zelený
Ziemia - Země f
Ziemianin - pozemšťan m
Ziemianka - pozemšťanka f
Ziemia Święta - Svatá země f, Svatá zem f
ziemniaczany - bramborový
ziemniak - brambor
ziemski - zemský
ziewnięcie - zívnutí n
zima - zima
Zimbabwe - Zimbabwe n
zimno - zima
zimny - studený
zimorodek - ledňáček říční
zioła prowansalskie - provensálské koření
ziołolecznictwo - fytoterapie f
ziom - krajan m
ziomek - krajan m
ziomkostwo - krajanské sdružení n, landsmanšaft m
zista - babička f
Zjednoczone Emiraty Arabskie - Spojené arabské emiráty
zjeżdżalnia - skluzavka f
źle - špatně
złe nie śpi - čert nikdy nespí
złodziej - zloděj m
złośliwość - zlomyslnost f
złotniczka - zlatnice f
złotnik - zlatník m
złoto - zlato n
zły - špatný, nesprávný
zmarszczka - vráska f
zmartwienie - starost
zmieniać - měnit
żmija - zmije f
zmoknąć do suchej nitki - promoknout až na kost
znachor - mastičkář m
znachorka - mastičkářka f
znać jak własną kieszeń - znát jako své boty
znać się jak kura na pieprzu - rozumět něčemu jako koza petrželi
znajda - nalezenec m
znajdować - nacházet, nacházet se
znajomy - známý
znak astronomiczny - astronomický symbol m
znakomity - skvělý
znak wodny - průsvitka
znak zodiaku - znamení zvěrokruhu n
znalazca - nálezce m
znaleźć - najít
znienacka - najednou
znieść - zrušit
żniwa - žeň f, žně
znośny - snesitelný
zodiak - zvěrokruh m, zvířetník m, zodiak m, zodiakus m
Zofia - Žofie f
zoisyt - zoisit
zol - podlaha f
zola - podlaha f
żołądek - žaludek m
żółć - žluč, žlutý
żołnierka - vojna f, vojákyně f, vojačka f
żółty - žlutý
żółw - želva f
żołwica - švagrová
żona - žena
żongler - žonglér m
zoo- - zoo-
zoogeografia - zoogeografie
zoolog - zoologická zahrada f
zoologia - zoologie f
zoologiczny - zoologický
zooplankton - zooplankton m
Zora - Zora f
zorza - záře f
zostać - zůstat
zostawiać - nechat
z poważaniem - s pozdravem
z powodu - kvůli
z powrotem - zpět, zpátky
żrący - žíravý, leptavý
zrękowiny - zasnoubení
źrenica - panenka f, zornice f, pupila f, oko n
źródło - pramen
ZSRR - SSSR
żuć - žvýkat
ZUM - IMC
zupa - polévka f
zupełny - úplný
zupka chińska - vietnamská polévka f
żuraw - jeřáb m, jeřáb
żurawina - brusinka
żurnal - časopis
żurnalistka - novinářka f
Zurych - Curych
zwiadowca - průzkumník m
zwiastun - trailer, kinoupoutávka, kinotrailer
Związek Socjalistycznych Republik Radzieckich - Svaz sovětských socialistických republik
zwieracz - svěrač
zwierciadło - zrcadlo, zrcadlovka f
zwierzak - živočich m, zvíře n
zwierzę - živočich m, zvíře n
żwir - štěrk m
zwłaszcza - zejména
zwłoki - mrtvola f
zwolenniczka - přívrženkyně f, stoupenkyně f
zwolić - vybrat, zvolit
zwolnienie lekarskie - neschopenka f
zwrotnica - výhybka
z wyjątkiem - kromě, mimo
zwykle - obvykle
z wyłączeniem - kromě, mimo
żybura - žinčice f
życie - život
żyć na wysokiej stopie - žít na vysoké noze
życzenie - přání n
życzliwy - benevolentní
żyd - žid m
Żyd - Žid m
żydowski - židovský
żydożerstwo - antisemitismus m
żyła - žíla
żyletka - žiletka f
Żylina - Žilina f
zymft - hořčice
żymła - žemle f
żyniaczka - svatba f, sňatek m
żynich - ženich m
zyntyca - žinčice f
żyrafa - žirafa f
Żytawa - Žitava
żywe srebro - živé stříbro n, rtuť f
żywić - živit, jíst
żywokost - kostival m
żywokostowy - kostivalový
z zamkniętymi oczami - se zavřenýma očima
