abdykacja - абдикация f
abdykować - отказвам се от престола | абдикирам
abfal - грешка f
Abidżan - Абиджан m
Abisynia - Абисиния f
abo - или
absurdalny - абсурден
abzac - токче n
Adam - Адам m
Adelina - Аделина
administracja - администрация f
Adonis - Адонис
adwentnik - декември m
adwokat diabła - адвокат на дявола
aerodrom - летище
afa - кльомба
afelzina - портокал
Afganistan - Афганистан
Afryka - Африка f
agat - ахат
agrarny - аграрен
akcent - акцент m
akrobatka - акробатка f
akt - акт m
aktyn - актиний m
aktynomikoza - актиномикоза f
akuszer - акушер m
akwedukt - акведукт
Alaska - Аляска f
Albańczyk - албанец m
Albania - Албания
Albanka - албанка f
albański - албански | албански език | шкип
Alberta - Албърта
albo - или
aleja - алея f
algebra - алгебра f
algebraiczny - алгебричен
Algieria - Алжир
Allach - Аллах m
Allah - Аллах m
alleluja - алелуя | алилуя
alokacja - разпределение | отпускане
alpinizm - алпинизъм m
aluminiowy - алуминиев
aluminium - алуминий m
amajza - мравка f
ambirz - джинджифил
ameba - амеба
ameryk - америций m
Amerykanka - американка
Ameryka Północna - Северна Америка f
Ameryka Południowa - Южна Америка f
Amman - Аман
amnestia - амнистия f
amnestyja - амнистия f
amper - ампер m
Amu-daria - Амударя
Andromeda - Андромеда
Andrzej - Андрей
Andy - Анди
aneksja - анексия f
Anglia - Англия f
anglicyzm - англицизъм m
Anglija - Англия f
Angola - Ангола
anioł - ангел m
anjoł - ангел m
anoda - анод
Antares - Антарес
Antarktyda - Антарктида f
Antigua i Barbuda - Антигуа и Барбуда
Antonia - Антония f
antrejka - коридор (koridór) m
antropomorfizm - антропоморфизъм m
antryj - коридор (koridór) m
antydepresant - антидепресант m
antyfaszyzm - антифашизъм m
antyklerykalizm - антиклерикализъм m
antykomunizm - антикомунизъм m
Antyle Holenderskie - Нидерландски Антили
antymon - антимон m
apetyt - апетит
apetyt rośnie w miarę jedzenia - апетитът идва с яденето
Apia - Апия
apluzyna - портокал
apostata - вероотстъпник m
aprykoza - кайсия f
apryl - април m
apsik - апчиху! | апчих!
a psik - апчиху! | апчих!
Arab - арабин
Arabia Saudyjska - Саудитска Арабия
arabus - арабин
Ararat - Арарат m
archaiczny - архаичен
archimandryta - архимандрит m
archipelag - архипелаг m
Argentyna - Аржентина
argon - аргон m
argumentacja - аргументация f
arktyczny - арктичен
Arktyka - Арктика f
Armenia - Армения f
armia - армия (armija) f | войска (vojska) f
armijo - армия (armija) f | войска (vojska) f
arsen - арсен m
artykuł - статия | член m
Aruba - Аруба
arystokrata - аристократ m
arystokratka - аристократка f
asceta - аскет m
aseksualizm - асексуалност f
asfalt - асфалт (asfalt) m
asfaltować - асфалтирам
aspiryna - аспирин m
astat - астатин m | астат m
astma oskrzelowa - бронхиална астма f
astrofizyka - астрофизика f
Asyria - Асирия
aszynbecher - пепелник m
atak serca - инфаркт на миокарда
ateistyczny - атеистки
Atlantyk - Атлантически океан m
atol - атол m
Augiasz - Авгий m
australijski pies pasterski - австралийско пастирско куче | австралийски кетълдог
Austria - Австрия
austriacki - австрийски
Austriak - австриец m
autentyczny - автентичен
autobana - магистрала f
autograf - автограф m
autoklaw - автоклав
automobilista - автомобилист m
autostrada - магистрала f
awokado - авокадо n
Azerbejdżan - Азербайджан
Azja - Азия f
Azja Mniejsza - Мала Азия f
Azory - Азорски острови
azot - азот m
Baba Jaga - Баба Яга f
babcia - баба
babka - баба
Badenia-Wirtembergia - Баден-Вюртемберг
bądź - или
Bahamy - Бахамски острови
Bahrajn - Бахрейн
bąk - земна пчела f
bakałarz - учител m
baklawa - баклава f
balet - балет
Bałtyk - Балтийско море
bałwan - снежен човек | идол | кумир
bana - трамвай m
banał - баналност
bandzioch - корем
banerka - кутия f
Bangladesz - Бангладеш m
bania - тиква f | глава f
baniak - глава f
banka - трамвай m
baptyzm - баптизъм m
bar - барий m
Barabasz - Варава m
barabola - картоф m
baran - овен m
Baran - Овен
bardzo - много | по
bark - барк
barki - барк
barok - барок
Bartłomiej - Вартоломей m
barzej - много | по
bas - корем
basarunek - обезщетение n | компенсация f
basetla - басетля f
basior - бич m
baskijski - баскски
batalion - батальон m
bażant - фазан m
bazylia - босилек m
bebech - корем | стомах m
bęben - корем
bedki - гъба f | микоза f
bejm - пара f
bekwarek - северен славей
belfer - учител m
Belgia - Белгия
Belize - Белиз
Benin - Бенин
berbela - водка
berga - камък
Bergamo - Бергамо
berkel - берклий m
Berlin Zachodni - Западен Берлин
Bermudy - Бермудски острови
beryl - берилий m
bezbożnik - атеист m
bezkrwawy - безкръвен
bezkrytyczny - безкритичен
bezosobowy - безличен
bezpieczny - безопасен
bezpłatny - безплатен
bezsporny - безспорен
bezwstydny - безсрамен
Bhutan - Бутан
Białoruś - Беларус
biały - бял
Białystok - Бялисток (Bialistok)
Biblia - Библия f
biblioteka - библиотека f
bicz - бич m
biedny - беден
biglosko - ютия
biksa - кутия f
bilet - билет (bilet)
bilirubina - билирубин
bimba - трамвай m
binder - вратовръзка f
bindka - вратовръзка f
biograficzny - биографически
biologia - биология f
Birma - Бирма f
biseksualizm - бисексуалност
biskup - епископ m | владика m
bitwa pod Termopilami - битка при Термопилите
biurko - бюро n
biuro podróży - туристическа агенция f
Bizancjum - Византия f
bizmut - бисмут m
błąd - грешка f
błąd poznawczy - когнитивно отклонение n
blisko - близо
Bliźnięta - Близнаци
blumkol - карфиол m
bo - защото (zaštoto) | тъй като (tǎj kato) | понеже (poneže)
bóbr - бобър m
bocian - щъркел m
bóg - бог m
Bóg - Бог
bogaty - богат
bohr - борий m
bojaźliwy - боязлив
bojownik - батальон m
boleć - боля
boleściwy - скръбен
Boliwijczyk - боливиец
bombka - халба f
bor - бор m
borowik szlachetny - обикновена манатарка f
borówka - синя боровинка | буза f | шамар m | плесница f | пързалка f
Borys - Борис
Bośnia - Босна f
Bośnia i Hercegowina - Босна и Херцеговина
Botswana - Ботсвана f
boźdór - момче (momče) n
brachol - брат m
bracieniec - брат m
bransoleta - гривна f
brat - брат m
brązowy - кафяв
Brazylia - Бразилия f
brazyliana - кафе n
brew - вежда f
briftreger - пощальон
broda - брада f
brom - бром m
broń - оръжие
browar - бира f
bruk - паваж m
Brunei - Бруней
brydż - бридж m
bryka - кола f
brzemię - бреме
brzmienie - звук
brzoskwinia - праскова f
brzuch - корем
buc - кур | хуй
buda - училище f
Budapeszt - Будапеща
buła - хлебче n
bulba - картоф m
Bułgaria - България
bułgarski - български | български език m
bułka - хлебче n
bulwa - картоф m
burak - цвекло
Burgundia - Бургундия f
Burkina Faso - Буркина Фасо
Burundi - Бурунди
burzowiny - бира f
być - съм
byk - бик m
Byk - Телец
Była Jugosłowiańska Republika Macedonii - Бившата Югославска Република Македония
bździągwa - дървеница
całki - цял
całkiem - доста
cały - цял
car - цар m
Cardiff - Кардиф
cel - цел f
celtycki - келтски
cent - цент
cer - церий m
cera - дъщеря f
ceramika - керамика f
cerkiew - църква f
certacja - борба f (borba)
cez - цезий m
chachoł - врат m
chałwa - халва f
chamera - облак m
chan - хан | кан
charakterystyczny - характерен
charakterystyka - характеристика f
chciwość - алчност
Chile - Чили n
Chińska Republika Ludowa - Китайска народна република
chiński - китайски
Chiny - Китай m
chira - водка
chlać - пия
chleb - хляб m
chłopak - момче (momče) n
chlor - хлор m
chmiel - хмел m | бира f
chmura - облак m
choinka - коледна елха f
chójk - коледна елха f
chomik - хомяк m | хамстер m
choroba - болест
Chorwacja - Хърватска
chów wsobny - близкородствено размножаване n
chrom - хром m
Chrystus - Христос m
chrześcijanin - християнин m
chrześcijanka - християнка f
chuj - кур | хуй
chwost - опашка f
ciasto - тесто n | сладкиш m
ciebie - ти | Вие
cień - сянка
cienki - тънък
ciepło - топло
ciga - коза f
ciocia - леля f
cipa - пичка | путка
cis - тис
ciśnienie tętnicze - кръвно налягане
ćmaga - водка
co - какво (kakwo)
cołki - цял
córa - дъщеря f
córczysko - дъщеря f
córka - дъщеря f
coś - нещо
ćpać - ям
cudzokrain - чужденец m
cudzoziemiec - чужденец m
cudzysłów - кавички
cukier - захар
cukinia - тиквичка
cyferblat - лице (lice) n | лик (lik) m | образ (obraz) m
cyga - земна пчела f
cyklon - циклон m
cyna - калай m
cynamon - канела f
cynk - цинк m
Cypr - Кипър
cyrkiel - пергел m
cyrkon - цирконий m
cytryna - лимон m
cytrynat - лимон m
Czad - Чад
czaj - чай m
czajnik - глава f
czarna dziura - черна дупка
czarna jagoda - синя боровинка
czarna porzeczka - касис m
czarne złoto - черно злато n
Czarnogóra - Черна гора f
czarny - черен
czarownica - вещица f
czas - време n
czasownik - глагол m
czasowy - временен
czas to pieniądz - времето е пари
czaszka - череп m
czciciel - поклонник m
Czechosłowacja - Чехословакия f
Czecho-Słowacja - Чехословакия f
czekan - пикел
czekolada - шоколад m
czekoladowy - шоколадов
czereśnia - череша
czernica - синя боровинка | къпина
czerwiec - юни m
czerwona porzeczka - червен касис m
czerwony - червен
czerwony olbrzym - червен гигант m
cześć - здравей (do jednej osoby) | здравейте (do wielu osób) | здрасти
cześnia - череша
Częstochowa - Ченстохова
częstoskurcz - тахикардия f
człowiek - човек m
czołg - танк m
czoło - чело n
czorny - черен
czujny - бдителен
czwartek - четвъртък m
czyhunka - торий m
czyrwiec - юни m
czyrwień - юни m
czysło - число n
czystek - цистус m
czytelnik - читател m
Dafne - Дафне
Dagestan - Дагестан
dalece - много | по
dalekowzroczność - далекогледство n
dalmatyńczyk - далматин
darmowy - безплатен
darmsztadt - дармщадтий
dekiel - глава f
delfin - делфин m
Demokratyczna Republika Konga - Демократична република Конго
Demokratyczna Republika Wyspy Świętego Tomasza i Wysp Świętego Tomasza i Książęcej - Демократична република Сао Томе и Принсипи
demokratyczny - демократичен
departament - департамент
dereń - дрян m
deser - десерт m
detonator - детонатор m
dezerter - беглец m
dezinformacja - дезинформация f
dialekt - диалект
diament - диамант m | елмаз m
dietetyczny - диетичен
dioda - диод
Diogenes - Диоген m | Диоген m (Синопски)
dla - за
długi - дълъг
długopis - химикалка f
Dniepr - Днепър m
doberman - доберман
dobranoc - лека нощ
dobry - добър
dobry wieczór - добър вечер (dobyr weczer)
dogmatyzm - догматизъм m
dokładność - точност f
doktor - лекар m
doktryna - доктрина f
dokument - документ m
dolar - долар m
dolmen - долмен
dolnołużycki - долнолужишки
dom - къща f
Dominika - Доминика f
Dominikana - Доминиканска република | Доминикана f
domowej roboty - домашно приготвен
doradca - съветник m
dostać - получа | придобия
dostatecznie - достатъчно
dostawać - получавам | придобивам | хващам | прихващам | заразявам се с | стигам | достигам
dostojnik - сановник m
dotykać - допра
do widzenia - довиждане
do zobaczenia - довиждане
dreszcz - тръпка f
drewniany - дървен
droga - път m | пътуване n | маршрут m
Droga Mleczna - Млечен път
drogi - скъп m | драг m
drogocenny - драгоценен
drozd - дрозд m
druh - приятел m
drzewo - дърво n
duch - призрак | фантом | душа | дух
dudek - папуняк
dudlać - пия
Dunaj - Дунав
dupa - гъз m | задник m
dupek - задник m
dusza - призрак | фантом | душа | дух
dutek - пара f
dychawica oskrzelowa - бронхиална астма f
dycht - доста
dyktator - диктатор m
dynia - тиква f
dyplom - диплома f
dysfagia - дисфагия f
dyskretny - дискретен
dysleksja - дислексия f
dysproz - диспросий m
dysputacja - спор m
dżdżownica - дъждовен червей m
dziadek - дядо m
działać - действам
dziąsło - венец m
Dżibuti - Джибути
dziecinny - детски m | инфантилен m
dziela - за
dzień - ден m
dzień dobry - добър ден | добро утро
dziennikarstwo - журналистика f
dziesięciolecie - десетилетие n
dżihadysta - муджахидин m
dżinn - джин m
dziś - днес
dzisiaj - днес
dżistać - пърдя
dziurkacz - перфоратор за офис m
dziurkacz biurowy - перфоратор за офис m
dziwny - странен
dżungla - джунгла f (dzhungla)
EBOiR - ЕБВР
EBOR - ЕБВР
echolalia - ехолалия f
Egina - Егина f
Egipt - Египет
egoizm - егоизъм m
einstein - айнщайний
ejber - момче (momče) n
ekologia - екология
ekologio - екология
ekosystem - екосистема
eksplozja - експлозия f
Ekwador - Еквадор m
ekwiwalent - еквивалент m
elefant - слон m
elegancki - елегантен
elektryczność - електричество n
emigracja - емиграция f
emir - емир
emu - ему m
encyklopedia - енциклопедия f
epikureizm - епикурейство n
epruwetka - епруветка f
era paleozoiczna - палеозойската ера
erb - ербий m
erotyka - еротика f
Erytrea - Еритрея
Erywań - Ереван m
ESBC - ЕСЦБ
eskalator - ескалатор m
eskulap - лекар m
esperanto - есперанто
estetyka - естетика f
Estonia - Естония f
Etiopia - Етиопия f
etniczny - етнически
etyka - етика f
etymologia - етимология f
Europa - Европа f
eż - че (če)
facet - мъж m
facetka - жена f
facjata - лице (lice) n | лик (lik) m | образ (obraz) m
fakt - факт m
falset - фалцет m
fałszywy - фалшив
familio - семейство n
famuła - семейство n
fan - фен m
fantastyczny - фантастичен
faryna - захар
fasola - фасоль f
faszyzm - фашизъм m
fazan - фазан m
Federacja Rosyjska - Руска федерация f
fedrować - работя
felinologia - фелинология f
ferska - праскова f
fest - много | по
fetor - смрад m
fez - фес m
fezeła - пчела f
Fidżi - Фиджи
figa - смокиня f
figowiec - смокиня f
fikus - смокиня f
filatelistyka - филателия f
Filipiny - Филипини
filiżanka - чаша f (порцеланова) | чаша f
film - филм m
filok - химикалка f
filozofia dziejów - философия на историята f
filozofia historii - философия на историята f
Finlandia - Финландия f
fioletowy - виолетов | лилав
fiord - фиорд m
fiut - кур | хуй
fiżon - фасоль f
flecista - флейтист m
flep - документ m
flet - кур | хуй
Florencja - Флоренция
fluor - флуор m
fonetyka - фонетика f
foryster - чужденец m
fosfor - фосфор m
fotel - фотьойл m
frans - франций m
fryzura - прическа
fura - кола f
fusbal - футбол
futbol - футбол
futbolista - футболист
Gabon - Габон
gad - влечуго n
gadolin - годолиний m
gała - око n | футбол | сива врана
galaktyka - галактика f
gałka muszkatołowa - индийско орехче n
Gambia - Гамбия
ganc - доста
gapa - сива врана
gara - сън m
garaż - гараж
gardło - гърло n
gdyż - защото (zaštoto) | тъй като (tǎj kato) | понеже (poneže)
gdzie - къде | където
gdzieś - около
generał - генерал m
generał broni - генерал-лейтенант m
generał dywizji - генерал-майор m
genialny - гениален
geologia - геология
gęś - гъска f | патка f
Ghana - Гана
gibki - бърз
Gibraltar - Гибралтар m
ginekologia - гинекология f
gira - крак f
glacok - плешив
glajza - торий m
glapa - сива врана
glaska - чаша f (стъклена)
glin - алуминий m
glina - полицай m
gliniarz - полицай m
glista - дъждовен червей m
glizda - дъждовен червей m
globus - глава f
głowa - глава f
głupi - глупав
głuszec - глухар m
gnat - зар m
gniazdo - гнездо
gnu - гну
gnuśny - мързалив
godka - език m
godzina - час m
godzinnik - часовник m
gołąb - гълъб m
golem - голем m
górnik - миньор
Górny Śląsk - Горна Силезия f
goryl - горила
gorzałka - водка
gorzki - горчив
gorzoła - водка
graba - ръка f
grabarz - гробокопач m | гробар m
gracz - играч m | плейър m
grad - град m
grajcarek - тирбушон
gramatyka - граматика f
granat - граната f | ръчна бомба f | нар m
granatowy - тъмносин
graniczyć - гранича
gratulacja - поздравление
Grecja - Гърция f
grejpfrut - грейпфрут m
Grenada - Гренада f
Grenlandia - Гренландия f
grób - гроб
gróbarz - гробокопач m | гробар m
gronostaj - сибирска белка f
grudzień - декември m
gruszka - круша f
grycha - хлебче n
gryf - грифон
grzebień - гребен m
grzech - грях m
grzeszny - грешен
grzyb - гъба f | микоза f
grzybowy - гъбен
Gujana - Гвиана | Гаяна f
guła - пуйка f
gułag - ГУЛАГ
gularz - пуйка f
guli - защото (zaštoto) | тъй като (tǎj kato) | понеже (poneže)
Gwadelupa - Гваделупа f
Gwatemala - Гватемала f
gwiazda - звезда f (zvezda)
gwiazdka - Бъдни вечер
Gwinea - Гвинея f
Gwinea Bissau - Гвинея-Бисау f
Gwinea Równikowa - Екваториална Гвинея
gzub - корем
hafn - хафний m
hajtok - нож m
hamburger - хамбургер
hangar - хангар
haplotyp - хаплотип m
hara - водка
harfista - арфист m
has - хасий m
hau - бау | джаф
haubica - гаубица
haw - там
hawerz - сапьор m
hę - какво (kakwo)
hebdow - коприна f
hedonizm - хедонизъм m
heksa - вещица f
hel - хелий m
Helios - Хелиос m
Hellada - Гърция f
hemisfera - полукълбо n
heparyna - хепарин
herb - герб m
herbarz - хербарий
herbata - чай m
Herod - Ирод m
heroiczny - героичен
hiacynt - зюмбюл m
Hindukusz - Хиндукуш
hirsutyzm - хирзутизъм m
historiozofia - философия на историята f
hiszpański - испански
hokej - хокей m
Holandia - Холандия f | Нидерландия f
Holandyja - Холандия f | Нидерландия f
holenderski - холандски
holm - холмий m
homeopatia - хомеопатия f
homiletyka - омилетика f
homilia - хомилия f
Hongkong - Хонг Конг
Honolulu - Хонолулу
hotel - хотел
huragan - ураган m
hydrologia - хидрология f
i - и (i)
IKEA - ИКЕА
imam - имам m
imbir - джинджифил
ind - индий m
Indie - Индия f
indoktrynacja - индоктринация
Indonezja - Индонезия f
indyferentny - индиферентен
indyk - пуйка f
Indyk - Индийски океан m
insulina - инсулин m
inundacyja - наводнение
inżynieria - инженерство
Irak - Ирак m
Iran - Иран m
Irańczyk - иранец m
Irlandia - Ирландия
Irlandia Północna - Северна Ирландия f
iryd - иридий m
islamski - ислямски
istny - жених m
Itaka - Итака
iterb - итербий m
Iwan - Иван m
iż - че (če)
ize - че (če)
izokoszta - изокоста f
Izrael - Израел m
ja - аз
jabłko - ябълка f
jabłoń - ябълката
jadać - ям
jagoda - синя боровинка | буза f | шамар m | плесница f | пързалка f
Jahwe - Яхве m
jajecznica - бъркани яйца
jajko - яйце n (jajce)
jajo - яйце n
jajówa - бъркани яйца
jakmiarz - доста
jałówka - юница f
Jan - Иван
Japończyk - японец m
japoński - японски
jarecka - майка f
jarosz - вегетарианец m
jarząbek - лещарка f
jarzmo - хомот m | иго n
jastrząb - ястреб m
jaszczurka - гущер m
Jaworzno - Явожно
jebadło - легло n
jeden za wszystkich, wszyscy za jednego - един за всички, всички за един
jednorożec - носорог m
Jędrzej - Андрей
jedwab - коприна f
jedwabnik - копринена пеперуда f (motyl) | копринена буба f (gąsienica)
jego - негов
jelonek rogacz - бръмбар рогач
Jemen - Йемен m
jemeński - йеменски
Jerzy - Георги (Georgi) m
jeść - ям
jesień - есен f
jeśli - ако (ako)
jest - съм
jeż - таралеж (taralež)
jeżeli - ако (ako)
Jezus - Исус m
Jezus Chrystus - Исус Христос
język - език m
jeżyna - къпина
jidysz - идиш
jod - йод m
Jordania - Йордания f
Jugosławia - Югославия (jugoslavija)
juny - млад (mlad)
Jur - Георги (Georgi) m
jutro - утре
kabaczek - тиквичка
kaban - свиня f
kaczka - патица f
Kafarnaum - Капернаум
kaffa - кафе n
kaj - къде | където
kajak - каякът
kajman - крокодил m
Kajmany - Кайманови острови | Каймански острови
kakadu - какаду
kalafa - нос m | лице (lice) n | лик (lik) m | образ (obraz) m
kalafior - карфиол m
kalapitra - глава f
kalfas - корем
kalifat - халифат m
kaliforn - калифорний m
kam - къде | където
Kambodża - Камбоджа f
Kamerun - Камерун
kamień - камък
kamieniarz - каменар m
Kanada - Канада f
kaolin - каолин
kapusta - зеле n | пара f
karaba - котка f
karczoch - артишок
kardamon - кардамон m
kariatyda - кариатида
kark - врат m
karkołomny - главоломен
karmel - карамел m
karotenoid - каротиноид
karp - шаран m
karta kredytowa - кредитна карта f
karta pocztowa - пощенска картичка f
kartka - пощенска картичка f
kartofel - картоф m
kaszalot - кашалот
katalog - каталог m
kataloński - каталонски (katalonski)
Katar - Катар
katolicki - католически
kaval - кавал m
kawa - кафе n
kawka - чавка | сестра f
Kazachstan - Казахстан m
każdy - всеки
kaznodzieja - проповедник m
kciuk - палец m
kędy - къде | където
kejter - куче n (kucze)
Kenia - Кения (Kenija)
keta - синджир m
kiepeła - глава f
kierowca - водач
kimono - сън m
kinol - нос m
kira - водка
kiszka - мляко n
kitajski - китайски
kłamny - фалшив
klamot - камък
kłapaczka - уста
klara - Слънце
klarnet - кларинет m
klasztorny - манастирски
klekotun - щъркел m
klerykalizm - клерикализъм m
kliber - нос m
kluber - нос m
kluka - нос m
klupać - търся
knipa - книга f (kniga)
koafiura - прическа
kobalt - кобалт m
kobieta - жена f
kociamber - котка f
kod kreskowy - баркод m
koja - легло n
kojo - легло n
kolano - коляно n | завой m
kolendra - кориандър
koleś - мъж m
koło - колело n | около
Kolonia - Кьолн
Kolumb - Колумб m
komar - комар (komar) m
komentować - коментирам
komfortowy - комфортен
Komory - Коморски острови
komp - компютър m
kompania - рота f
kompas - компас
komputer - компютър m
komunizm - комунизъм m
koń - кон m
kóń - кон m
kondensator - кондензатор m
konfitura - конфитюр m
konformizm - конформизъм m
Kongo - Конго
konieczność - необходимост f
kontent - доволен
kontrwywiad - контраразузнаване n
kontynent - континент m
kopala - гробокопач m | гробар m
Kopenhaga - Копенхаген
kopruch - комар (komar) m
Koran - Коран m
korbol - тиква f
Koreańska Republika Demokratyczna - Корейска народнодемократична република f
koreański - корейски
Korea Północna - Северна Корея f
Korea Południowa - Южна Корея f | Република Корея f
korespondencja - кореспонденция
korkociąg - тирбушон
Korsyka - Корсика f
kosa - нож m
kość - зар m
kosmetyczny - козметичен
Kostaryka - Коста Рика f
kostka - костица f | кокълче n | глезен m | перце n | паве n
kostka Rubika - куб на Рубик
kosztowny - скъп m | драг m
kot - котка f
koza - коза f
Kozak - казак m
Koziorożec - Козирог
koźlak - обикновена масловка f
kraj - страна f | край m | държава | страна
Kraków - Краков
krasula - скот | крава f
krauza - буркан m
krawat - вратовръзка f
krawatka - вратовръзка f
kręgosłup - гръбнак m
krew - кръв f
krokodyl - крокодил m
królestwo - кралство n
królewski - кралски
królowa - кралица f
krowa - скот | крава f
krtań - ларинкс
krucjata - кръстоносен поход
krybuny - кръст m
krypel - църква f
krypton - криптон m
krytyk - критик m
krzeczek - хомяк m | хамстер m
krzem - силиций
Krzysztof - Христо
krzyż - кръст m
Ksenia - Аксиния f
książka - книга f (kniga)
księgarnia - книжарница f
księgozbiór - библиотека f
Księżyc - Луна
kto - кой
któż - кой
kubek - чаша f
kubizm - кубизъм m
kucharz - готвач
kuchnia - кухния f
kufel - халба f
kula - крак f
kulos - крак f
kupować - купя
kuriozalny - куриозен
Kurówka - Куровка
kurwacik - вратовръзка f
kurz - прах m
kusiciel - изкусител m
kuskus - кускус
kutafon - кур | хуй
kutas - кур | хуй
Kuwejt - Кувейт m
kwas akrylowy - акриловата киселина
kwas chlebowy - квас m
kwas foliowy - фолиева киселина f
kwas hialuronowy - хиалуронова киселина f
kwiat - цвят m | цвете n | саксийно растение n
kwiecień - април m
kwitnąć - цъфтя
kynologia - кинология
łabęć - лебед m
łabędź - лебед m
labrys - двойна брадва
lacz - глава f | полицай m
lakier do paznokci - лак за нокти
laktaza - лактаза f
łańcuch - синджир m
łańcuch pokarmowy - хранителна верига
land - село
lantan - лантан m
Laos - Лаос m
laptop - лаптоп m
las - гора f
laska - бастун m | пръчка f | мацка f | свирка f
lato - лято n
lebo - или
lecieć - летя
lekarz - лекар m
lekkoatleta - лекоатлет m
lekkoatletyczny - лекоатлетически
leniwy - мързалив
łepetyna - глава f
leśny - партизанин m
Lesotho - Лесото
lew - лъв | лев
Lew - Лъв
Liban - Ливан m
Liberia - Либерия
Libia - Либия
liczba - число n
lina - въже n
lipiec - юли m
listonosz - пощальон
listopad - ноември m
lit - литий m
literat - писател
liturgiczny - богослужебен
lód - лед m | сладолед m
lodówka - хладилник m
łokieć - лакът m
Londyn - Лондон m
lorens - лоуренсий m
lotnisko - летище
łoże - легло n
łoże śmierci - смъртно легло n
łóżko - легло n
lub - или
lucerna - люцерна f
łucznictwo - стрелба с лък f
ludowy - народен
łudzikwiat - април m
łuk - лък m
Luksemburg - Люксембург
luńt - куче n (kucze)
lutet - лутеций m
luty - февруари m
łyska - лиска f
łysy - плешив
mać - майка f
macica - седеф m
maciek - корем
macierz - матрица
mączka - пудра
Madagaskar - Мадагаскар
Madera - Мадейра f
MAEA - МААЕ
Maghreb - Магреб
magnez - магнезий m
maj - май m
Majotta - Майот
mak - мак m
Malawi - Малави
Malediwy - Малдиви
Malezja - Малайзия f
Mali - Мали
malin - малина f
malina - малина f
małpa - кльомба
Malta - Малта
mały palec - малък пръст m | кутре n | кутле n
małżonek - съпруг m | мъж m
małżonka - жена f
mam - имам | трябва
mangan - манган m
manierka - манерка f
marchew - морков m
marchewka - морков m
marksizm - марксизъм m
marmolada - мармалад m
Maroko - Мароко
Mars - Марс m
marzec - март m
marzenie senne - сън m
masa perłowa - седеф m
maska - лице (lice) n | лик (lik) m | образ (obraz) m
maślak - масловка f
maślak sitarz - кравешка масловка f
maślak ziarnisty - зърнеста масловка f
maślak żółty - елегантна масловка f
maślak zwyczajny - обикновена масловка f
maślarz - масловка f
masło - масло
maszyna do szycia - шевна машина f
matematyk - математик
matka - майка f
Mauretania - Мавритания f
Mauritius - Мавриций
mąż - мъж m | съпруг m
mazak - лице (lice) n | лик (lik) m | образ (obraz) m
meczet - джамия f
medycyna - медицина f
medyk - лекар m
meitner - майтнерий m
Meksyk - Мексико
melizmat - мелизъм m
melodyjny - мелодичен
mendelew - менделеевий m
Merkury - Меркурий (Merkúrij) m
metafora - метафора
meteor - метеор
meteoryt - метеорит
metr kwadratowy - квадратен метър m
mężczyzna - мъж m
Miami - Маями
mianownik - именителен падеж | знаменател m
miasto - град m
miasto stołeczne - столица f
miau - мяу
miażdżyca - атеросклероза f
mieć - имам | трябва
miecznik - косатка
miejska legenda - градска легенда
mielcuch - бира f
mieli - имам | трябва
miesiąc - месец m
mięsopustnik - февруари m
mikologia - микология f
milimetr - милиметър
miłość - любов f
miły - вежлив
minaret - минаре n
minister - министър
miód - мед m
misjonarz - мисионер m
Mistra - Мистра
mleko - мляко n
młody - млад (mlad)
młotek - чук m
mnich - брат m
modrakowy - син
modry - син
mój - мой
Mojżesz - Моисей
Mołdawia - Молдова f
Mołdawianin - молдовец m
molibden - молибден m
Monako - Монако
monarchia - монархия
Mongolia - Монголия f
mora - призрак | фантом | душа | дух
mordować - убия
morela - кайсия f
morkwa - морков m
morze - море (móre) n
Morze Bałtyckie - Балтийско море
Morze Czerwone - Червено море n
Morze Karaibskie - Карибско море
Morze Śródziemne - Средиземно море n
mosiądz - месинг m
motorniczy - ватман m
motorowy - ватман m
motyl - пеперуда f
Mount Everest - Еверест
mowa - език m
Mozambik - Мозамбик
mózg - мозък m
mrówka - мравка f
mrównik - мравояд m
muchomor - мухоморка f
muchomór - мухоморка f
muchomor czerwieniejący - бисерна гъба f
muchomor czerwonawy - бисерна гъба f
muchomor czerwony - червена мухоморка f
muchomor jadowity - бяла мухоморка f
muchomor plamisty - пантерка f
muchomor sromotnikowy - зелена мухоморка f
muchomor zielonawy - зелена мухоморка f
mućka - скот | крава f
mundurowy - полицай m
muraszka - мравка f
muzyczny - музикален
mużyk - мъж m
my - ние
mydło - сапун
mykologia - микология f
myrmekologia - мирмекология f
myśleć - мисля
myśliwiec - изтребител m
mysz - мишка f
nacja - народ m
nadawca - адресант m
Naddniestrze - Приднестровие n
nadwzroczność - далекогледство n
nadziany - богат
nadzieja - надежда f
Nairobi - Найроби
naj- - най
Namibia - Намибия
napisać - напиша
naprawdę - наистина
na razie - засега | за момента | до скоро
naród - народ m
narodowy socjalizm - националсоциализъм m
narzeczony - жених m
nasz - наш
NATO - НАТО
nauczyciel - учител m
nauka - наука f
nazizm - нацизъм m
neodym - неодим m
neofaszyzm - неофашизъм m
neon - неон m
neonatologia - неонатология f
neptun - нептуний
Neptun - Нептун m
nerka - бъбрек m
ni - не
nic - нищо
Niderlandy - Холандия f | Нидерландия f
nie - не
niebezpieczny - опасен
niebieski - син
niebiosa - небе n
niebo - небе n
niedopałek - фас m
niedostatek - недостиг m
nieduch - болест
niedziela - неделя f
niegdysiejszy - бивш
niemal - почти
nie mieć - не | имам | трябва
Niemiecka Republika Demokratyczna - Германска демократична република | Германска демократическа република
niemożliwy - невъзможен
nie od razu Kraków zbudowano - Хубавите неща стават бавно
niepodległość - независимост f (nezavisimost)
niepodległy - независим
niepotrzebny - ненужен
nieprawdopodobny - неправдоподобен
nietolerancja - нетолерантност f
nieuprzejmy - невежлив
niewiasta - жена f
nie wszystko złoto, co się świeci - не всичко, което блести, е злато
niewystarczający - недостатъчен
niezależność - независимост f
niezależny - независим
nigdy - никога
Niger - Нигер m
Nigeria - Нигерия
nigeryjski - нигерийски
Nikaragua - Никарагуа f
nikiel - никел m
nim - той
niob - ниобий m
Nix - Никс
NLPZ - НСПВС
no - да
nobel - нобелий m
noc - нощ f (noszt)
noga - крак f
nonteizm - нетеизъм m
Norweżka - норвежка f
nos - нос m
nosorożec - носорог m
Nowa Zelandia - Нова Зеландия
nowotwór - новообразувание
nowy - нов
Nowy Rok - Нова Година
nóż - нож m
nożyce - ножица (nožica) f
nożyczki - ножица (nožica) f
nudysta - нудист m
Numidia - Нумидия f
nyga - комар (komar) m
oaza - оазис m
obcas - токче n
obcokrajowiec - чужденец m
obelisk - обелиск m
obiekt - обект m
obiektywny - обективен
obłok - облак m
obłudnik - лицемер m
obój - обой m
obojczyk - ключица
obraz - картина f | филм m
Ocean Atlantycki - Атлантически океан m
Ocean Indyjski - Индийски океан m
Ocean Spokojny - Тихи океан m
ocet - оцет m
ociec - баща m | отец m
od - от
ode - от
odmiana - сорт m | род m
odór - смрад m
odszkodowanie - обезщетение n | компенсация f
oficjalny - официално | официален
ogier - жребец m
oglądać - гледам
ogon - опашка f
ogórek - краставица f
ogród zoologiczny - зоологическа градина f
ojciec - баща m | отец m
ojczyc - син m
ojczyzna - отечество n
ojla - сова f
okapi - окапи n
okładka - корица f
okno - прозорец m
oko - око n
około - около
okręt podwodny - подводница f
okultyzm - окултизъм m
olcha - елша
olej - олио n
oligarcha - олигарх m
oliwa - зехтин m
oma - баба
Oman - Оман
omieszkać - не
on - той
ONZ - ООН
opal - опал m
oraz - и (i)
organizacja - организация f
organizm - организъм m
orgazm - оргазъм m
orka - косатка
Ormianin - арменец m
Ormianka - арменка f
orzba - косатка
orzeł - орел m
ósemka - осмица f
osioł - магаре n
osm - осмий m
ośmiornica - октопод
osoba - лице
Ostia - Остия f
ostrężyna - къпина
ostry - остър | лют
owulacja - овулация f
ożyna - къпина
pachniarz - нос m
paciuk - плъх (płych)
Pacyfik - Тихи океан m
pagórek - хълм
pajęcznik - септември m | октомври m | ноември m
Pakistan - Пакистан m
pakli - ако (ako)
pała - глава f | полицай m
palacz - водач
pale - глава f | полицай m
palec wskazujący - показалец m
paleoantropologia - палеоантропология f
paleontologia - палеонтология f
Palestyna - Палестина f
palindrom - палиндром
paliwo - гориво n
pallad - паладий m
pandemia - пандемия f
Panna - Дева
papier - хартия f
papuga - папагал
para - двойка f | чифт m | водна пара
Paragwaj - Парагвай m
parówka - кренвирш m
partyzant - партизанин m
Paryż - Париж
pasieka - пчелин m
paszenog - баджанак m
patria - отечество n
patriota - патриот m | родолюбец m
patriotka - патриотка f
patriotyzm - патриотизъм m
pawęża - щит
październik - октомври m
paździerzeń - октомври m
paznokieć - нокът m
pazura - ръка f
pederastia - педерастия f
pedofilia - педофилия f
pełen - пълен
pełny - пълен
pępek - пъп m
perka - картоф m
persona - лице
Peru - Перу
piana - бира f
piątek - петък m
pić - пия
piczka - пичка | путка
piekło - смола f
pieniądz - пара f
pierdzieć - пърдя
pies - куче n (kucze)
pieśń - песен f
pies policyjny - полицейско куче
pigwa - дюля f
pijawa - дъга f
pikawa - сърце n
pilaw - пилаф m
piłka nożna - футбол
piłka ręczna - хандбал m
piłkarz - футболист
piłkarzyki - футбол на маса
pióro - перо
piorun - мълния f
Piotr - Петър m
Piotra - Петра f
pipa - пичка | путка
Pireneje - Пиренеи
pisarz - писател
pistacja - шам фъстък
pistolet maszynowy - картечен пистолет
Pittsburgh - Питсбърг m
piwo - бира f
pizda - пичка | путка
pizza - пица f
pizzeria - пицария
planeta - планета
planta - растение n
plaża - плаж m
plecak - раница
plik - сноп m | вързоп m (dokumentów) | пачка f (banknotów) | файл m
pluskwa - дървеница
pluton - плутоний m | чета f
płynny - течност
płyta - плоча m | диск | оптичен диск m (dysk optyczny) | плоча | грамофонна плоча f (płyta gramofonowa)
pływać - плувам
pocieszyciel - утешител m
początkowy - първоначален
poczta - поща f
pocztówka - пощенска картичка f
podobać się - харесвам
poganin - поганец | езичник m
pojutrze - вдругиден
poleku - бавно
policjant - полицай m
policzek - буза f | шамар m | плесница f | пързалка f
polityczny - политически
polityka - политика (polítika) f
półkula - полукълбо n
polon - полоний
połowa - половина f
półowa - половина f
położenie - място n
położnik - акушер m
Polska - Полша f
południe - юг
południowy - южен
półwysep - полуостров m
Półwysep Bałkański - Балкански полуостров
pomagać - помагам
pomarańcza - портокал
poniedziałek - понеделник m
ponieważ - защото (zaštoto) | тъй като (tǎj kato) | понеже (poneže)
pop - поп
popadia - попадия f
popielniczka - пепелник m
poprawność polityczna - политическа коректност f
por - праз m
pornografia - порнография f
pornograficzny - порнографичен
poseł - депутат m
posiadać - имам
pośladek - задник m
pospolity - обикновен
potas - калий m
potop - наводнение
potrafić - зная | знам
potrawa - ястие n
potrzeba - нужда f
potrzebizna - нужда f
potrzebny - нужен
powiedzieć - кажа
powieka - клепач m
powiestka - титла
powietrze - въздух m
powódź - наводнение
powoli - бавно
poza - освен
pozawczoraj - завчера
pracować - работя
pracowitość - работливост f | трудолюбие n
pracowity - работен
Praga - Прага
praktyczny - практичен
prawak - обикновена манатарка f
prawa ręka - ръка f
prawdziwek - обикновена манатарка f
prawdziwy - истински
prawdziwych przyjaciół poznaje się w biedzie - приятел в нужда се познава
prazeodym - празеодим m
prefiks - представка f
premier - министър-председател m
pretensjonalny - претенциозен
prezydent - президент
probówka - епруветка f
próbówka - епруветка f
proch - прах m
produkować - произвеждам | продуцирам
prom - ферибот m
promet - прометий m
promienica - актиномикоза f
prosię ziemne - мравояд m
prostokątny - правоъгълен
proszek - прах m
protaktyn - протактиний m
prowansalski - Октански
Prusy - Прусия f
przebiśnieg - кокиче n
przebój - хит m | шла́гер m
przeciwciało - антитяло
przeciwnik - противник m
przed - пред
przede - пред
przedimek - член m
przedpokój - коридор (koridór) m
przedrostek - представка f
przedsiębiorstwo - предприятие n | фирма f
przedsięwzięcie - предприятие n
przedwczoraj - завчера
przemysł - индустрия f
przenośnia - метафора
przepiórka - пъдпъдък m
przestrzeń kosmiczna - космическо пространство
przeszłość - минало n
przewlekły - хроничен
przewód - проводник m | кабел m | тръба f | канал m | тракт m | процес m (съдебен)
przeznaczony - предназначен
przychylnie - благосклонно
przyjaciel - приятел m
przynęta - примамка f
przypadek - случай m | падеж m
przypadkiem - случайно
przypadkowo - случайно
przyroda - природа f
przyrodniczy - природен
przyrostek - наставка f
przysięgać - заклевам се (zaklevam se)
przytcza - случай m | падеж m
psisko - куче n (kucze)
psy szczekają, karawana idzie dalej - кучетата лаят, керванът си върви
pszczoła - пчела f
ptasia grypa - птичият грип
publicystyka - публицистика f
puchacz - бухал m
puder - пудра
pukieltasia - раница
pulmonologia - пулмология f
pultok - пуйка f
purpurowy - пурпурен
pustułka - керкенез m
pusty - глупав
puszka - кутия f | бира f
puter - пуйка f
Pyjter - Петър m
pyra - картоф m
pysk - муцуна f
pytanie - въпрос m
pytanie retoryczne - реторичен въпрос
rachatłukum - локум
raciądz - рицар m
rad - радий m
radon - радон
radziecki - съветски
raj - рай m
rak - рак m
Rak - Рак (Rak)
rakuski - австрийски
ramadan - рамазан
rasizm - расизъм m
razdziawa - сива врана
ręce do góry - ръце нагоре!
ręczna - хандбал m
ręczyć - гарантирам
redyska - репичка f
redźka - репичка f
refren - рефрен m
ręka - ръка f
rękaw - ръкав
rekin - акула (akula) f
reklama - реклама f
ren - рений m
Republika Federalna Niemiec - Федерална Република Германия (Federalna Republika Germanija)
Republika Korei - Република Корея
Republika Południowej Afryki - Република Южна Африка | Южноафриканска република
Republika Słowacka - Словашка република
Republika Środkowoafrykańska - Централноафриканска република
Republika Zielony Zielonego Przylądka - Кабо Верде | Република Кабо Верде | Република Зелени нос
restauracja - ресторант m
rewolucja - революция
rezerwuar - резервоар m
rezolucja - резолюция f
RNA - РНК f
robić - правя
robotyka - роботика f
rod - родий m
rodzaj - сорт m | род m
rodzajnik - член m
rodzicielski - родителски
rodzina - семейство n
rogal - кифла f
rolniczy - аграрен
romantyzm - романтизъм m
ropień - абсцес
Rosja - Русия f
roślina - растение n
roślinność - растителност f
rouza - роза f
rower - колело n
również - също
równoważny - равнозначен
róża - роза f
rozdział - глава f
rożek - кифла f
rozkład - расписание n
różowy - розов
rtęć - живак m
rubid - рубидий m
rubin - рубин m
ruchome schody - ескалатор m
rudny - червен
rufa - задник m
rugby - ръгби m
Rumun - румънец m
Rumunia - Румъния f
rura - тръба f | пилон m
rurociąg - тръбопровод m
ruten - рутений m
rutherford - ръдърфордий m
Rwanda - Руанда f
ryba - риба f
rybitwa - рибарка f
Ryby - Риби
rycerz - рицар m
rywal - съперник m
ryż - ориз m
rzadko - рядко
rzeciądz - синджир m
rzecz - вещ f | предмет m | тема f
rzeka - река
rzęsa - ресница f
rzeżączka - гонорея
rzić - гъз m | задник m
rzodkiewka - репичка f
Rzym - Рим
sagan - глава f
Saipan - Сайпан
salamandra - дъждовник m
sałatka - салата f
salceson - полицай m
Salwador - Салвадор
samar - самарий m
Samarkanda - Самарканд m
samochód - кола f
samotny - самотен
samowar - самовар m
saper - сапьор m
sarna - сърна f
schizofrenia - шизофрения f
schizofreniczka - шизофреничка f
schody - стълбище
schody ruchome - ескалатор m
ścięgno - сухожилие n
ścierać - бърша
Scylla - Сцила f
seaborg - зеаборгий m
seks oralny - орален секс
seksuologia - сексология f
selen - селен m
sen - сън m
sęp - лешояд m
Serbia - Сърбия f
Serbia i Czarnogóra - Сърбия и Черна гора
serce - сърце n
serdce - сърце n
serdeczny palec - безимен пръст m
seroka - сврака f
serwatka - суроватка f
seter szkocki - шотландски сетер
siano - сено n
siarka - сяра f
siarkowodór - сероводород
się - се
sieczeń - февруари m
siedem grzechów głównych - седемте смъртни гряха
sierpień - август m
sikora - синигер m
silno - много | по
Singapur - Сингапур m
sinologia - синология f | китаистика f
sioło - село
siostra - сестра f
sirpień - август m
skąd - откъде
skała - скала
skand - скандий m
skandynawski - скандинавски
skład - магазин m
sklep - магазин m
skocznia narciarska - шанца f
Skop - Овен
skóra - кожа f
Skorpion - Скорпион
skowronek - чучулига f
skrobia - нишесте n
skromność - скромност f
skrzyp polny - полски хвощ
slawistyka - славянознание n | славистика f
śleboda - свобода f
śledź - вратовръзка f
śledziona - слезка
ślimak - охлюв m
ślips - вратовръзка f
śliwa - слива
śliwka - слива f
słodki - сладък (sladǎk) m | сладка (sladka) f | сладко (sladko) n
słoik - буркан m
słoń - слон m
Słońce - Слънце
słonecznik - слънчоглед m
słony - солен
słowa - дума f
Słowenia - Словения (Slovenija)
Słowianin - славянин m
słowik szary - северен славей
słownik - m речник
słowo - дума f
słuchać - слушам
Słupsk - Слупск m
smażonka - бъркани яйца
śmierć - смърт f
smoła - смола f
smród - смрад m
smrodyla - касис m
smutniak - хляб m
smutny - тъжен
śnieg - сняг m
sobaka - куче n (kucze)
sobota - събота f
socjalizm - социализъм m
socjologia - социология f
soczysty - сочен
sód - натрий m
Sofia - София
sójka - сойка f
sok - сок m
sokół - сокол m
Solon - Солон
Somalia - Сомалия f
Sopot - Сопот m
sosyska - кренвирш m
sowa - сова f
śpieszyć - бързам
śpiewać - пея
spokojny - спокоен
spór - спор m
sport - спорт m
spotkanie - среща f
sprzeciwnik - противник m
srebrna - сребърен
srebrny - сребърен
srebro - сребро n
średniowiecze - Средновековие
środa - сряда f
śródziemnomorski - средиземноморски
sroka - сврака f
stabilny - стабилен
stać - стоя
stadion - стадион m
stal - стомана
stan - щат m
stan wyjątkowy - извънредно положение
Stany - Съединени американски щати | САЩ
Stany Zjednoczone - Съединени американски щати | САЩ
Stany Zjednoczone Ameryki - Съединени американски щати | САЩ
stara panna - стара мома f
starek - дядо m
stare miasto - стар | град m
starka - баба
starosek - дядо m
staroszek - дядо m
starożytny - античен
starszy - баща m | отец m
starszy kapral - ефрейтор
stary - стар
starzyk - дядо m
staw - става f
sterczeć - стоя
stojeć - стоя
stolica - столица f
stonka - колорадски бръмбар
strachliwy - страхлив
strąpacz - февруари m
strona - страница f
strona internetowa - сайт m
stront - стронций m
struś - щраус m
strzała - стрела f
Strzelec - Стрелец
student - студент m
stwór - чудовище n
styczeń - януари m
styl - стил m
stypendium - стипендия f
suahili - суахили
subiektywny - субективен
sugilit - сугилит
sukmana - сукман m
Surinam - Суринам
suseł - лалугер m
Svalbard - Свалбард m
świat - свят (swjat) m
światowy - световен
świeca - свещ f
świecę - свещ f
Świetlana - Светлана f
święty mikołaj - Дядо Коледа m
świeży - пресен
świnia - свиня f
syjonistyczny - ционистки
symbol - символ
syn - син m
synapsa - синапс
synogarlica senegalska - сенегалска гургулица
syntagma - синтагма f
syra - крак f
systematyzacja - систематизация f
szac - жених m
szachy - шахмат m | шах m
szamot - муцуна f
szczaw - киселец m
Szczecin - Шчечин
szczerze - честно
szczur - плъх (płych)
szczygieł - кадънка
szczypiorniak - хандбал m
szczyt - оргазъм m
szept - шепот m
szermierka - фехтовка f
sześciokąt - шестоъгълник
szkita - крак f
szklanka - чаша f (стъклена)
szkło - стъкло n
Szkocja - Шотландия f
szkoła - училище f
szlauch - змия f | маркуч m
szlips - вратовръзка f
szmaragd - изумруд m
szneka - лице (lice) n | лик (lik) m | образ (obraz) m
szolka - чаша f (порцеланова) | чаша f
szpak - скорец m
szpiegostwo - шпионаж m
szpilka - карфица f | високо токче n | игличка f | шпилка f
szpinak - спанак m
szpital - болница f
szpuk - гълъб m
sztuka - изкуство | бройка | пиеса
szuflada - чекмедже n
szukać - търся
szulak - ястреб m
Szwabia - Швабия f
szwaja - крак f
Szwajcaria - Швейцария
Szwecja - Швеция
Szwecyjo - Швеция
Szwed - швед m
Szwedka - шведка f
szwestera - сестра f
szybki - бърз
szyja - шия f
szykowny - елегантен
szynka - шунка f
tachykardia - тахикардия f
tacik - баща m | отец m | дядо m
Tadżykistan - Таджикистан
tajemnica poliszynela - обществена тайна f | публична тайна f
Tajlandia - Тайланд
tajski - тайски
Tajwan - Тайван m
tak - да
także - също
tal - талий
tam - там
tamdotąd - там
tank - танк m
tantal - тантал
Tanzania - Танзания
tarcza - щит | лице (lice) n | лик (lik) m | образ (obraz) m
tarcza krystaliczna - щит
tarcza strzelecka - щит | лице (lice) n | лик (lik) m | образ (obraz) m
tarcza szkolna - щит
taternictwo - алпинизъм m
technet - технеций m
technologia - технология f
tęcza - дъга f
tęgoskór cytrynowy - брадавичеста пърхутка f
tej - ти | Вие
telewizor - телевизор m
tellur - телур m
temat - тема f
temperatura - температура f
ten śmiać się śmieje, kto śmiać się śmieje ostatni - който се смее последен, се смее най-добре
terb - тербий m
Termopile - Термопили
tetum - тетун
też - също
Timor Wschodni - Източен Тимор m
tkanka - тъкан
tkanka tłuszczowa - мастна тъкан f
tlen - кислород m
tobie - ти | Вие
Togo - Того
tolerować - толерирам
tonfa - тонфа
topaz - топаз m
tor - торий m
tort - торта f
tory - торий m
traf - случай m | падеж m
trambimba - трамвай m
tramwaj - трамвай m
tramwajka - трамвай m
trójząb - тризъбец m
trolejbus - тролейбус
trujący - отровен
trup - труп m
truskawka - ягода f
trybuszon - тирбушон
tryktrak - табла f
Trynidad i Tobago - Тринидад и Тобаго
trzęsienie ziemi - земетресение n
trzmiel - земна пчела f
trznadel zwyczajny - Жълта овесарка
trzustka - панкреас m
tudzież - и (i)
Tunezja - Тунис
Turcja - Турция
Turkmenistan - Туркменистан
tuż - почти
twardy - твърд
twarz - лице (lice) n | лик (lik) m | образ (obraz) m
twój - твой
twórca - баща m
ty - ти | Вие
tydzień - седмица f
tyfus - тиф m
tyj - чай m
typografia - типография f
typowy - типичен
Tyrteusz - Тиртей m
tytan - титан m
tytuł - титла
ubiór - облекло n
ucho - ухо n
uczciwie - честно
Uganda - Уганда
uj - чичо m | вуйчо m
ujec - чичо m | вуйчо m
ujek - чичо m | вуйчо m
układ okresowy - периодична таблица
Ukraina - Украйна f
ul - кошер m
umieć - зная | знам
umiejętność - вещина
umywalka - умивалник m
Unia Europejska - Европейски съюз f
unikalny - уникален
uón - той
urlopowicz - летовник m
urologia - урология f
usta - уста
uzależnienie - зависимост | пристрастеност
uzasadniać - оправдаят
Uzbekistan - Узбекистан
użytkownik - потребител
w - на
wacha - море (móre) n | вода f
Waga - Везни
wajco - яйце n (jajce)
walczerz - батальон m
walka - борба f (borba)
wandalizm - вандализъм m
wapń - калций m
waran - варан m
warga - бърна f
wąski - тесен (tesen)
wata cukrowa - захарен памук
Watykan - Ватикан
wąż - змия f | маркуч m
ważka - водно конче n
wczoraj - вчера
we - на
wegetarianin - вегетарианец m
wegetarianizm - вегетарианство n
węgiel - въглерод m
węgorz - змиорка
wena - вдъхновение
Wenera - Венера f
Wenezuela - Венецуела f
wenezuelski - венецуелски
Wenus - Венера f
wersja - версия f
wesoło - весело
Wesołych Świąt - Весела Коледа | Честита Коледа
wezwanie - титла
widzieć - виждам
Wiedeń - Виена f
wiedzieć - зная | знам
wielbłąd - камила f
Wielkanoc - Великден (wielikden) m | Възкресение Христово n (Vŭzkresenie Khristovo) | Пасха f (Pascha)
wielokulturowość - мултикултурализъм m
wielokulturowy - междукултурен
wierzyciel - кредитор m
wieś - село
wiewiór - гонорея
wiewiórka - катерица f
Wigilia - Бъдни вечер
Wikipedia - Уикипедия
Wikisłownik - Уикиречник (Oeïkiretsjnik)
Wikiźródła - Уикиизточник
wilga - авлига f
wilgotność - влажност f
wilgotny - влажен
wilk - вълк m
wilk syty i owca cała - и вълкът сит и агнето цяло
willa - вила f
wioska - село
wiosna - пролет f
Wirakocza - Виракоча m
wirusologia - вирусология f
Wisła - Висла
wiśnia - вишна
witraż - витраж m
wiza - виза f
wnęk - внук m
wnęka - внучка f
wnęta - примамка f
wnuczka - внучка f
wnuk - внук m
woda - вода f
wóda - водка
wódka - водка
Wodnik - Водолей
wodór - водород m
wojna domowa - гражданска война
wokabularz - m речник
Wołgograd - Волгоград m
wolna miłość - свободна любов f
wolność - свобода f
wolność słowa - свобода на словото f
wolny - свободен | бавен
wołowina - говеждо месо
woniączka - водка
wóz - каруца f
wróbel - врабче n
wróg - враг m | неприятел m
wrona - сива врана
wrzesień - септември m
wszechobecny - вездесъщ
wtorek - вторник m
w tym - на
wuj - чичо m | вуйчо m
wujek - чичо m | вуйчо m
wujko - чичо m | вуйчо m
wujo - чичо m | вуйчо m
wulgarny - вулгарен
wulkan - вулкан m
wulkaniczny - вулканичен
wybrzeże - крайбрежие n
Wybrzeże kość Kości Słoniowej - Кот д'Ивоар
wydma - дюна f
wygodny - удобен
wyjeżdżać - заминавам
wykusz - еркер
wyraz - дума f
wysoki - висок
wyspa - остров m
Wyspa Świętego Wyspy Świętego Tomasza i Wyspa Książęca - Сао Томе и Принсипи
Wyspy Alandzkie - Аландски острови
Wyspy Kanaryjskie - Канарски острови
Wyspy Marshalla - Маршалови острови (Maršalovi ostrovi)
Wyspy Normandzkie - Нормандски острови
Wyspy Owcze - Фарьорски острови
wystarczać - стигам
wystarczający - достатъчен
wywielga - авлига f
wyżłobienie - жлеб m
z - от | с | със
za - зад | след | за
ząb - зъб m
żaba - жаба f
zabijać - убия
zabyły - глупав
Zachód - Запада
zachodni - западен
zachód słońca - залез m
zaćmienie - затъмнение n
zacząć - започна
zaczynać - започвам
zadowolony - доволен
zakażenie - инфекция f
żako - жако
zakonnica - сестра f
zakonnik - брат m
zakręt - завой m
żal - мъка
Zambia - Замбия f
zamorski - задморски
żandarm - заптие m
zapalenie płuc - пневмония
zapałka - клечка f | кибрит m
zapraszać - каня
żargon - жаргон
zawartość - предмет
zbiór - сноп m | вързоп m (dokumentów) | пачка f (banknotów) | файл m
zdanie - изречение n | мнение n
zdrowie - здраве n
ze - от | с | със
że - че (če)
zegar - часовник m
żegleń - въглерод m
żelazko - ютия
żelazo - желязо (željazo) n
żeńczyna - жена f
zez - от | с | със
ziele angielskie - бахар m
zielnik - хербарий
Ziemia - Земя f
ziemniak - картоф m
zima - зима f
Zimbabwe - Зимбабве
zimno - студено (studeno)
zimorodek - земеродно рибарче
zista - баба
Zjednoczone Emiraty Arabskie - Обединени арабски емирства
zjeżdżalnia - пързалка
złoto - злато n
zmarszczka - бръчка f
żołądek - стомах m
żółw - костенурка
żona - жена f
zoo- - зоо-
zoolog - зоологическа градина f
zoologiczny - зоологически
zooplankton - зоопланктон m
źrenica - зеница f | око n
zrozumienie - понятие n
Zurych - Цюрих
Związek Socjalistycznych Republik Radzieckich - Съюз на Съветските Социалистически Републики
zwierzak - животно (životno) n
zwierzątko - животинка f | животинче n
zwierzę - животно (životno) n
życie - живот m
żyła - вена f
żymła - хлебче n
żywe srebro - живак m
żywić - ям
