abak - abaks
abakus - abaks
abecadło - abėcėlė f | alfabetas m
Abelard - Abelardas
abfal - anomalija f
Abidżan - Abidžanas m
abiecadło - abėcėlė f | alfabetas m
ablegierek - vaikas m
abolicja - abolicija f
abonament - abonementas m
abonamentowy - abonementinis
abonent - abonentas m
abonentka - abonentė f
ABS - ABS
absencja - neatvykimas m | nebuvimas m | nedalyvavimas m
absolwent - absolventas m
absolwentka - absolventė
Adam - Adomas
Adelajda - Adelaidė f
adiunkt - adjunktas
administracja - administracija | valdyba | administravimas
administracyjny - administracinis | administracijos | valdymo
administrator - administratorius m | valdytojas m
administratorka - administratorė f
administrować - administruoti | valdyti
adnotacja - anotacija | išnaša
Adonis - Adonis
adopcja - adopcija f | įvaikinimas m
adoptować - įvaikinti
adresować - adresuoti
Adriatyk - Adrijos jūra
adwentnik - gruodis
ady - bet | galų gale
afa - beždžionė f
afelzina - apelsinas m
Afgańczyk - afganas m
afganiec - afganas m
Afganistan - Afganistanas m
Afganka - afganė f
afgański - afganiškas
agitacja - agitacija
agitator - agitatorius m
agnostyk - agnostikas
agresja - agresija f
agroturystyczny - agroturistinis
ajmer - kibiras m
akceptacja - akceptacija f
akcja - veiksmas | akcija
aktualnie - šiomis dienomis | dabartinis | dabar | esamas
akumulator - akumuliatorius m
akwedukt - akvedukas
Akwizgran - Achenas
alabaster - alebastras m
Alaska - Aliaska f
Albańczyk - albanas m
Albania - Albanija f
Albanka - albanė f
albański - albaniškas
alczyk - mažoji alka
aldosteron - aldosteronas m
Aleksander - Aleksandras
alergiczny - alerginis
alfabet - abėcėlė f | alfabetas m
alfabetu - abėcėlė f | alfabetas m
algebraiczny - algebrinis
Algieria - Alžyras
alpinizm - alpinizmas m
aluminium - aliuminis m
Alzacja - Elzasas m
amajza - skruzdėlė f
ambasada - ambasada f
ameba - ameba f
Amerykanka - amerikietė
amerykański - amerikiečių
amnestia - amnestija
amnestyja - amnestija
amputacja - amputacija
Amu-daria - Amudarja
analfabetyzm - analfabetizmas m
ananas - ananasas m
anarchizm - anarchizmas
anatomia - anatomija f
Andora - Andora f
Andromeda - Andromeda
Andy - Andai
Angielka - anglė f
angielski - angliškas
angielskojęzyczny - anglakalbis
Anglia - Anglija f
Anglija - Anglija f
Anglik - anglas m
anglikanin - anglikonas m
anglojęzyczny - anglakalbis
angol - anglas m | angliškas
Angol - anglas m
Angola - Angola f
anielski - angeliškas
anioł - angelas m
Anioł Stróż - Angelas Sargas m
aniżeli - negu
anjoł - angelas m
Ankara - Ankara f
ankieta - apklausa f | anketa f
ankieter - apžvalgininkas m
anoda - anodas
anomalia - anomalija f
anonimowy - anoniminis | anonimiškas
Antananarywa - Antananaryvas
Antares - Antaris
Antarktyda - Antarktida
antena - antena f
Antoni - Antanas m
Antonina - Antanina f
antonówka - antaniniai
Antwerpia - Antverpenas
antybakteryjny - antibakterinis
antykoncepcja - kontracepcija f
Antyle Holenderskie - Nyderlandų Antilai
antylopa - antilopė f
Anzelm - Anzelmas
aparatczyk - aparatčikas m
apasz - nusikaltėlis m
Apeniny - Apeninai
apetyczny - apetitiškas
apluzyna - apelsinas m
aprykoza - abrikosmedis m | abrikosas m
apryl - balandis
Arabia Saudyjska - Saudo Arabija
arabskojęzyczny - arabakalbis
arbiter - arbitras m
arbuz - arbūzas
archaiczny - archajiškas
archanioł - arkangelas
archeolog - archeologas m
Argentyna - Argentina f
Argentyńczyk - argentinietis m
Argentynka - argentinietė f
argentyński - argentiniškas
argon - argonas m
Armenia - Armėnija f
armia - armija f
armijo - armija f
arsen - arsenas m
Aruba - Aruba f
astenosfera - astenosfera f
astrofizyka - astrofizika f
Asyria - Asirijos imperija
ateistyczny - ateistinis
Ateny - Atėnai
audiencja - audiencija f
Augustów - Augustavas m
Australia - Australija f
Australijczyk - australas m
Australijka - australė f
australijski - australiškas
Austria - Austrija f
austriacki - austriškas
Austriaczka - austrė f
Austriak - austras m
autobana - autostrada f
autobiografia - autobiografija
autobus - autobusas m
autoklaw - autoklavas
autokracja - autokratija
autokratyzm - autokratija
automatyczny - automatiškas | automatinis
autostrada - autostrada f
awangardowy - avangardinis
awaryjny - avarinis
awokado - avokadas m
Azerbejdżan - Azerbaidžanas m
Azja - Azija f
Azja Mniejsza - Mažoji Azija f
Azjata - azijietis m
Azjatka - azijietė f
azjatycki - Azijos
azot - azotas m
Badenia-Wirtembergia - Badenas-Viurtembergas
badminton - badmintonas
bagaż - bagažas
bagażnik - bagažinė f
bajer - melas m
bajerować - meluoti
bajtel - vaikas m
bąk - kamanė
bakałarz - mokytojas
bakłażan - baklažanas
bakteriologia - bakteriologija f
Baku - Baku
bala - kamuolys m
balanga - šou | vakarėlis m | pramoga f
balet - baletas
Bałtyk - Baltijos jūra f
Bałtyka - Baltika f
balustrada - baliustrada f
balustrado - baliustrada f
bana - tramvajus m
banał - banalybė f
banan - bananas m
banana - bananas m
bananowy - bananų
bania - galva f
baniak - galva f
banka - tramvajus m
barabola - bulvė f
Baran - Avinas m
Bartoszyce - Barštynas
barykada - barikada f
barzej - daug
basta - pakankamai užtektinai | gana
bażant - fazanas m
bazgrać - keverzoti
Bazylea - Bazelis
bazylia - bazilikas m
Beatrycze - Beatričė f
bebech - skrandis m
bedki - grybas m
bejca - beicas
bekwarek - lakštingala
beletrystyka - beletristika f
belfer - mokytojas
Belg - belgas m
Belgia - Belgija f
Belgijka - belgė f
belgijski - belgiškas | belgų
Belgrad - Belgradas
Benin - Beninas m
berać - pasakyti
berbela - degtinė f | vodka f
berga - akmuo m
Bergamo - Bergamas
Berlin - Berlynas
beryl - berilis m
Beskidy - Beskidai
bety - pižama
bezczelność - įžūlumas m
bezczynność - neveikimas
bezdzietność - bevaikystė f
bezkształtny - beformis
bezokolicznik - bendratis f
bezosobowy - beasmenis
bezpotomność - bevaikystė f
bezrobocie - nedarbas
bezwietrzny - bevėjis
bezzębny - bedantis
Białoruś - Baltarusija f
Białorusin - baltarusis m
Białorusinka - baltarusė f
białoruski - baltarusiškas | baltarusių
biały - baltas
Białystok - Balstogė
Biblia - Biblija
biblioteka - biblioteka f
bibliotekarka - bibliotekininkė f
bibliotekarz - bibliotekininkas m
bida - skurdas m
bieda - skurdas m
biedak - skurdžius m | skurdeiva m
biedny - skurdus
biedronka - boružė f
biegać - bėgti
biegacz - bėgikas | bėgūnas
bieganie - bėgti
biegus - bėgikas m
biegus rdzawy - islandinis bėgikas
Bielsk Podlaski - Belskas m
bilirubina - bilirubinas
bimba - tramvajus m
binia - merga f | mergina f | mergaitė f
biochemia - biochemija
biocybernetyka - biokibernetika f
biolog - biologas
biologia - biologija f
Birma - Birma f
bishalter - liemenėlė f
biskup - vyskupas m
bitwa - mūšis m
biurko - rakstāmgalds m
biuro podróży - kelionių agentūra f
biusthalter - liemenėlė f
biustonosz - liemenėlė f
bizantyjski - bizantiškas
bizantyński - bizantiškas
bizmut - bismutas m
biżuteria - bižuterija f
blacha - skarda f
blaga - melas m
błecha - blusa f
Bliźnięta - Dvyniai
bluźnierstwo - piktžodžiavimas | blevyzga
boba - kepurė f
bóbr - bebras f
Bóg - Dievas m
Bogota - Bogota f
Bohemia - Čekija f
boisko - aikštė f
bójka - peštynės | muštynės
Boliwia - Bolivija f
bomba atomowa - atominė bomba f
bombarda - bombarda
bombel - vaikas m
bonsai - bonsai
bor - boras m
bordo - bordo
bordowy - bordo
borowik szlachetny - tikrinis baravykas
borówka - žandas m
Bośnia - Bosnija f
bośniacki - bosniškas
Bośniaczka - bosnė f
Bośnia i Hercegowina - Bosnija ir Hercegovina
Bośniak - bosnis m
bowiem - todėl kad | tam
boża krówka - boružė f
brama - vartai
bramka - vartai
bramkarz - vartininkas
bratanica - dukterėčia f
braterski - broliškas
bratni - broliškas
brązowy - bronzas | bronzinis
Brazylia - Brazilija f
Brazylijczyk - brazilas m
Brazylijka - brazilė f
brazylijski - braziliškas
briftasza - aplankas, portfelis, rankinė
briftreger - paštininkas
brodziec pławny - kūdrinis tilvikas
brom - bromas m
broń - ginklas
browar - alus
browarz - aludaris m
brydż - bridžas m
brylant - briliantas
brzęczeć - zirzenti | zirzeti | zirzti | zvimbauti | zvimbti
brzęczenie - zirzesys | zvimbesys
brzmienie - garso
brzytwa - skustuvas
buda - mokykla f | vartai
budować - stato
budynek - pastatas m
buła - raumuo m
bulba - bulvė f
Bułgar - bulgaras m
Bułgaria - Bulgarija f
Bułgarka - bulgarė f
bułgarski - bulgariškas
bułka - raumuo m
bulwa - bulvė f
bulwersować - piktinti | piktintis
bursztyn - gintaras
burzowiny - alus
być - būti
być w siódmym niebie - jaustis kaip septintame danguje
Bydgoszcz - Bydgoščius
Byk - Tauras
Była Jugosłowiańska Republika Macedonii - Buvusia Jugoslavijos Respublika Makedonija
bywać - buvoti
bzykać - zirzenti | zirzeti | zirzti | zvimbauti | zvimbti
bzykanie - zirzesys
cal - colis m
cegła - plyta f
centryzm - centrisms m
cepelin - cepelinas | didžkukulis
cera - duktė f
cętka - šlakas
chabanina - mėsa f
chabas - mėsa f
chachoł - sprandas m
chamski - vulgarus
Charków - Charkovas m
charlać - koseti
chciejstwo - tikėjimas iš troškimo
chemia biologiczna - biochemija
Chile - Čilė f
Chińczyk - kinas m
chiński - kiniškas
Chiny - Kinija f
chira - degtinė f | vodka f
chleb - duona f
chlor - chloras m
chmiel - alus
choćby - bent jau
chodzić - vaikščioti
chojna - pušis f
chomik - žiurkėnas m
chore - ligonis m
choroba - liga
Chorwacja - Kroatija f
chorwacki - kroatiškas
Chorwat - kroatas m
Chorwatka - kroatė f
chory - ligonis m
chrom - chromas m
chromosfera - chromosfera f
chruścik - apsiuva
chrystianizm - krikščionybė f
chrząstka - kremzlė f
chrząszcz - vabalas m
chrześcijaństwo - krikščionybė f
chrzestna - krikštamotė f
chrzestny - krikštatėvis m
chudoba - skurdas m
churchać - koseti
ciągle - nuolatos
ciąża - nėštumas m
cięgiem - nuolatos
ciemny - tamsus
ciepło - šiluma f
cierpiarz - taksistas m
cieść - uošvis m | marti f
cieszyć - mėgautis
ciga - ožka f
cikcak - zigzagas m
ciocia - teta f | dėdienė f
cipa - pyzda f
cis - maumedis m
ciśnienie - spiediens m | kraujospūdis
ciupa - kalėjimas
ciurma - kalėjimas
ćmaga - degtinė f | vodka f
ćmik - cigaretė f
ćmy - tamsus
codziennie - kasdieninis | kasdien
codzienność - kasdienybė
córa - duktė f
córczysko - duktė f
córka - duktė f
cos - cos
cotygodniowy - kassavaitinis
ćpać - valgyti
ctg - ctg
cug - skersvėjis m
cukier - cukrus m
cukrownia - cukraus fabrikas
cupać - koseti
cychalter - liemenėlė f
cyferblat - seja f | veidas m
cyga - kamanė
Cygan - čigonas m
cygareta - cigaretė f
cygaretka - cigaretė f
cynk - cinkas m
Cypr - Kipras m
Cypryjczyk - kiprietis m
Cypryjka - kiprietė f
cypryjski - kiprietiškas
cytadela - citadelė f
czajnik - galva f
czapka - kepurė f
czarna dziura - juodoji skylė
Czarnogóra - Juodkalnija
czarny - juodas
czarodziej - burtininkas m
czasownik - veiksmažodis
Czech - čekas m
Czechosłowacja - Čekoslovakija f
Czecho-Słowacja - Čekoslovakija f
Czechy - Čekija f
czędo - vaikas m
czemu - kodėl
czerwiec - birželis m
czerwona kartka - raudona kortelė f
Czerwony Krzyż - Raudonasis Kryžius m
czerwony olbrzym - raudonoji milžinė
cześć - labas | sveikas | sveiki
część - detalė f | dalis
czeski - čekiškas
często - dažnai
Częstochowa - Čenstakava
częstoskurcz - tachikardija f
Czeszka - čekė f
czkawka - žagsėjimas
człowiek - žmogus m
człowiek człowiekowi wilkiem - žmogus žmogui - vilkas
czoło - kakta f
czorny - juodas
czwartek - ketvirtadienis
czwartorzęd - Kvarteras
czyhunka - toris
czyr - čyras
czyrwiec - birželis m
czyrwień - birželis m
czysło - skaičius | skaitmuo
czytelnik - skaitytojas m
dąb - ąžuolas m
Dafne - Dafnė f
Dagestan - Dagestanas
dalas - skurdas m
dalekowzroczność - toliaregystė f
damski - moteriškas
Dania - Danija f
darmohardy - pasipūtęs | arogantiškas
dawka - davinys
dbać - rūpintis | įsimylėti
dekiel - galva f
deknąć - vožti
delfin - delfinas m
delikatność - delikatumas m
demokracja - demokratija f
Demokratyczna Republika Wyspy Świętego Tomasza i Wysp Świętego Tomasza i Książęcej - San Tomė ir Prinsipės Demokratinė Respublika
destylacja - distiliacija
deszcz - Lietus m
deżdż - Lietus m
dezelować - naikinti
dezinformacja - dezinformacija f
Diogenes - Diogenas m | Diogenas m (Sinopietis)
dla - dėl
dlaczego - kodėl
dmuchać - pūsti
Dniepr - Dniepras m
dobranoc - labos nakties
dobry - geras
dobry wieczór - labas vakaras
doktryna - doktrina f
dołek - liūdesys
dolmen - dolmenas
dom - namas m
domagać się - reikalauti
dom dziecka - vaikų namai
Dominika - Dominika f
domofon - domofonas
Donieck - Doneckas m
dopiero - tik tai
doradca - patarėjas m
doś - kiek | daug
dość - pakankamai užtektinai | gana
doskonale - puikiai
dosyć - pakankamai užtektinai | gana
do widzenia - viso gero
dowódca - vadas m | vadeiva m
do zobaczenia - viso gero
dręczyciel - kankintojas m
droga - kelias | kelionė | trasa
Droga Mleczna - Paukščių Takas
drozd - strazdas m
druch - nuolatos
drumla - dambrelis m
drużyna - komanda f
dryndziorz - taksistas m
drzewo - medis m
drzewo iglaste - spygliuoti medžiai | spygliuotis
Duńczyk - danas m
Dunka - danė f
duński - daniškas
dupek - šikna
durś - nuolatos
dużo - daug
dwojaki - dvigubas
dyć - bet | galų gale
dycki - visada
dymbcok - ąžuolas m
dysk twardy - standusis diskas m | kietasis diskas m
dżampreza - šou | vakarėlis m | pramoga f
dziadek - senelis m
dzięcioł trójpalczasty - tripirštis genys m
dzieciszczko - vaikas m
dziecko - vaikas m
dziękówa - dėkoju | ačiū
dziękówka - dėkoju | ačiū
dziękuję - dėkoju | ačiū
dziela - dėl
dzieło - kūrinys m | veikalas m
dziennikarstwo - žurnalistika f
dziesięciolecie - dešimtmetis m
dziesięcioletni - dešimtmetis
dziewa - merga f | mergina f | mergaitė f
dziewczę - mergaitė f | merga f | mergina f
dziewczyna - merga f | mergina f | mergaitė f
dziewczynka - mergaitė f
dziewięćdziesięciolecie - devyniasdešimtmetis m
dziewięciolatek - devynmetis m
dziewiętnastolatek - devyniolikmetis m
dzik - šernas m
dziobak - ančiasnapis m
dziołcha - merga f | mergina f | mergaitė f
dziopa - merga f | mergina f | mergaitė f
dżistać - persti
dziunia - merga f | mergina f | mergaitė f
dziurkacz - caurumotājs m | biroja caurumotājs m
dziurkacz biurowy - caurumotājs m | biroja caurumotājs m
dżungla - džiunglės
dźwięk - garsas m
dźwig - liftas
EBOiR - ERPB
EBOR - ERPB
echo - aidas m
edyficjum - pastatas m
Egipt - Egiptas m
ejakulacja - ejakuliacija
ekipa - komanda f
ekohydrologia - ekohidrogeologija | ekologinė hidrogeologija
ekologia - ekologija f
ekologio - ekologija f
ekosystem - ekosistema
elefant - dramblys m
elektronika - elektronika f
Ełk - Lukas
Emili - Emilė | Emilija | Emilia f
Emilia - Emilė | Emilija | Emilia f
energia - energija
entropia - entropiju
epidemia - epidemija f
epidemio - epidemija f
epoka - epokė
era - era
erekcja - erekcija f
Eris - Eridė
Eryda - Eridė
ESBC - ECBS
esperanto - esperanto m
Estończyk - estas m
Estonia - Estija f
Estonka - estė f
estoński - estiškas
Etiopia - Etiopija f
etyczny - etiškas | etinis
eurodeputowany - europarlamentaras m
Europa - Europa f
europarlamentarzysta - europarlamentaras m
Europejczyk - europietis m
Europejka - europietė f
europejski - europietiškas
europoseł - europarlamentaras m
Ewaryst - Evaristas m
Ezdrasz - Ezra
Ezop - Ezopas m
facetka - moteris f
facjata - seja f | veidas m
fajek - cigaretė f
fajerwer - cigaretė f
fajka - cigaretė f
fajny - gražus
fakt - faktas m
fala - banga f
fandzolić - meluoti
faryna - cukrus m
fazan - fazanas m
felieton - feljetonas m
fezeła - bitė f
filip - kiškis | zuikis
film - filmas m
filozofia dziejów - istorijos filosofija
filozofia historii - istorijos filosofija
Fin - suomis m
Finka - suomė f
Finlandia - Suomija f
finlandzki - suomiškas
fiński - suomiškas
fioletowy - violetinis
fizyka Słońca - heliofizika f
fluor - fluoras m
folga - palengvėjimas
fort - fortas m
forta - vartai
fosfor - fosforas m
Francja - Prancūzija f
francuski - prancūziškas
francuski pocałunek - prancūziškasis bučinys
Francuz - prancūzas m
Francuzka - prancūzė f
frechowny - pasipūtęs | arogantiškas
frela - merga f | mergina f | mergaitė f
fresk - freska
fryc - vokietis m
Fryc - vokietis m
fulać - meluoti
furdygarnia - kalėjimas
fusbal - futbolas m
fusekla - kojinė f (puskojinė)
futbol - futbolas m
gadanina - zauna
gaduła - zaunius | zvėga
gal - galis m
gała - akis f | futbolas m | kranklys m | kovas m | varna
galancie - daug
Galia - Galija f
Galicja - Galicija
gapa - kranklys m | kovas m | varna
gapić się - zauksoti
garncarz - puodžius m
gasa - gatvė f
gasnąć - gesti | užgesti
gaśniczy - Priešgaisrinis
gawron - kovas m
Gdańsk - Gdanskas m
gdzie - kur
gdzie kucharek sześć, tam nie ma co jeść - devynios auklės, vaikas be galvos
gędźba - muzika f
gelender - baliustrada f
Genewa - Ženeva f
geografia - geografija f
geologia - geologija
geriatria - geriatrija
german - germanis m
germański - vokiškas
giez - sparva
ginekologia - ginekologija f
gira - koja f
gitara - gitara f
glajza - toris
glapa - kovas m | varna
głęboki - gili
glin - aliuminis m
globus - galva f
głód - badas m
głóg - gudobelė
głos - balsas m
głośny - garsiai
głowa - galva f
głową muru nie przebijesz - galva sienos nepramuši
głuchota - kurtumas
gnat - kaulo | kauliukas
gnejs - gneisas
gniazdo - lizdas m
gniew - pyktis | įniršis
gnot - vaikas m
gnu - gnu
godka - liežuvis m
gołąb - karvelis m
góra - kalnas m
górą - kalnas m
Górny Śląsk - Aukštutinė Silezija f
gorzałka - degtinė f | vodka f
gorzoła - degtinė f | vodka f
gościniec - zuikio pyragas
graba - ranka f
gracz - žaidėjas
grad - kruša f
gramatyka - gramatika
granatowy - tamsiai mėlynas
Grażyna - Gražina
Grecja - Graikija f
grecki - graikiškas
greckojęzyczny - graikakalbis
Greczynka - graikė f
Grek - graikas m
greka - graikiškas
Grodno - Gardinas
gronostaj - šermuonėlis m
grudzień - gruodis
grusza - kriaušė f
gruszka - kriaušė f
Gruzin - gruzinas m
Gruzinka - gruzinė f
gruziński - gruziniškas
Gruzja - Gruzija f
gryf - grifas
gryfny - gražus
grzebień - šukos
Grzegorz - Grigalius m
grzyb - grybas m
guła - kalakutas m
gularz - kalakutas m
gwiazda - žvaigždė f
gwizdać - zvimbauti | zvimbti
gwizdek - švilpukas m
gwizdnąć - vožti
gżegżółka - gegužė f
gzub - vaikas m
habit - abitas m
Haga - Haga f
Haiti - Haitis m
hajtok - peilis m
halucynacja - haliucinacija f
hara - degtinė f | vodka f
harcerstwo - skautija f
hau - au
haubica - haubica f
hazard - lošimas
hedonizm - hedonizmas m
hel - helis m
heliofizyka - heliofizika f
Hellada - Graikija f
herbarz - herbariumas
heroiczny - didvyriškas
herszt - vadas m | vadukas m
hessonit - hesonitas
hidżab - hidžabas
Hieronim - Jeronimas
Hindukusz - Hindukušas
hipopotam - begemotas m
hirsutyzm - hirsutizmas
historiozofia - istorijos filosofija
Hiszpan - ispanas m
Hiszpania - Ispanija f
Hiszpanka - ispanė f
hiszpański - ispaniškas
Hiuma - Hyjuma
homeopatia - homeopatija f
homeostaza - homeostazė f
Hongkong - Honkongas
Horus - Horas
horyzont - horizontas
hydrologia - hidrologija f
i - ir
ile - kiek
imadło - griebtuvas m | spaustuvai
impreza - šou | vakarėlis m | pramoga f
indoeuropejski - indoeuropiečių
Indonezja - Indonezija f
Indonezyjczyk - indonezietis m
Indonezyjka - indonezietė f
indonezyjski - indoneziškas
indor - kalakutas
indyk - kalakutas m
Inflanty - Infliantai
infrastruktura - infrastruktūra
inkubator - inkubatorius m
insekt - vabzdys m
instynkt - instinktas
insulina - insulinas
Irak - Irakas m
Iran - Iranas m
Irlandczyk - airis m
Irlandia - Airija f
Irlandia Północna - Šiaurės Airija f
Irlandka - airė f
irlandzki - airiškas
iryd - iridis
islam - islamas m
Islandczyk - islandas m
Islandia - Islandija f
Islandka - islandė f
islandzki - islandiškas
istnieć - būti | egzistuoti
Itaka - Itakė
Italok - italas m
italski - itališkas
itd. - ir t.t.
itr - itris m
Izrael - Izraelis m
Izraelczyk - izraelietis m
Izraelka - izraelietė f
izraelski - izraelietiškas
ja - aš
jabłko - obuolys m
jabłoń - obelis f
Jaćwież - Dainava f | Jotva f
jadać - valgyti
jagoda - žandas m
jajko - kiaušinis m
jajnik - kiaušidė f
jajo - kiaušialąstė f | kiaušinis m
jajowód - kiaušintakis m
jak - kaip
jako - kaip
jałowiec - kadagys
jałówka - telyčia f
jantar - gintaras
Japończyk - japonas m
Japonia - Japonija f
Japonka - japonė f
japoński - japoniškas
jara - uošvė f
jaskółka - kregždė f
jastrząb - vanagas m
Jaworzno - Javožnas
jebadło - lova f
jednak - tačiau | kaip bebūtų
jednakowoż - tačiau | kaip bebūtų
jednorożec - vienaragis | raganosis m
Jerycho - Jerichas
Jerzy - Jurgis
jeść - valgyti
jeśli - jei
jest - būti
jeż - ežys m
jeżeli - jei
jezioro - ežeras m
Jezus - Jėzus m
Jezus Chrystus - Jėzus Kristus
język - liežuvis m
język obcy - užsienio kalba
język ojczysty - gimtoji kalba
jidysz - Žydų
Jugosławia - Jugoslavija
juny - jaunas
Jur - Jurgis
jutro - rytoj | rytdiena
kaban - kiaulė f
kabat - klasiokas (kolega ze szkoły)
kaczka - antis
kafej - kavinė f
kaj - kur
kajman - krokodilas m
kalafa - seja f | veidas m
kałakutas - kalakutas m
kalapitra - galva f
kaleka - luošys m
kalifat - kalifatas m
kalina - putinas m
kam - kur
kamień - akmuo m
kamieniarz - akmentašys m
Kanada - Kanada f
Kanadyjczyk - kanadietis m
kanonizacja - kanonizacija f
kapitan - kapitonas m
kaplica - koplyčia f
Kapsztad - Keiptaunas
kara - bauda f
karaba - katė f
karakan - tarakonas m
karaluch - tarakonas m
karczoch - artišokas
kark - sprandas m
karta kredytowa - kredito kortelė
kartofel - bulvė f
Karwat - kroatas m
kaszleć - koseti
Kaszmir - Kašmyras
Katalonia - Katalonija
kataloński - katalonų
Katarzyna - Kotryna f | Katryna f | Katryne f | Katarina f | Katre f
katoliczka - katalikė f
katowicki - Katovicų
Katyń - Katynė
kawiarnia - kavinė f
kawon - arbūzas
Kazach - kazachas m
kazachski - kazachiškas
Kazachstan - Kazachstanas m
Kazaszka - kazachė
kaznodzieja - skelbėjas m
kciuk - nykštys m
kędy - kur
kejter - šuo m
kejza - sūris m
kelnerka - padavėja f
kibic - sirgalius m
kiełbasa - dešra f
kiepeła - galva f
kierownik - vadybininkas m | vadovas m
kierunek - kryptis
kij - meškerė f
Kijów - Kijevas m
kira - degtinė f | vodka f
Kirgistan - Kirgizstanas m | Kirgizija f
kiszka - pienas m
kit - melas m
kitajski - kiniškas
klajdać - aprengti | užmauti (buty, rękawiczki) | apsirengti | apsivilkti
kłamać - meluoti
kłamca - melagis
kłamczuch - melagis m | melagis
klamot - akmuo m
kłamstwem daleko się nie zajdzie - melo trumpos kojos
kłamstwo - melas m
kłamstwo ma krótkie nogi - melo trumpos kojos
klara - Saulė
klon - klevas m
kluza - kalėjimas
knipa - knyga f
koala - koala f
kobalt - kobaltas m
kobiecy - moteriškas
kobieta - moteris f
kochać - mylėti
kociamber - katė f
kocioł - katilas
kocur - katinas m
kod kreskowy - brūkšninis kodas
koja - lova f
kojo - lova f
kokotek - liftas
kołchoz - kolūkis
kolczyk - auskaras m
kolega - klasiokas (kolega ze szkoły)
kolektywizacja - kolektyvizacija f
Kolonia - Kelnas
komar - uodas m | kuisys ) | varmas )
kominiarz - kaminkrėtys m
komórka - mobilusis telefonas m
komp - kompiuteris m
komputer - kompiuteris m
koń - arklys
kóń - arklys
koniuszy - žirgininkas m
koń ma cztery nogi i też potknąć się potknie - arklys turi keturias kojas ir tai kartais suklumpa
kontrwywiad - kontržvalgyba
Kopenhaga - Kopenhaga f
koper - krapas
kopruch - uodas m | kuisys ) | varmas )
Koran - Koranas m
kord - kardas
Korona Południowa - Pietų Vainikas
kosa - peilis m
kość - kaulo | kauliukas
Kościan - Koscianas m
kościelny - zakristijonas m
Kościuszko - Kosciuška m
kosmetyczny - kosmetinis
kosmos - kosmosas
koszary - kareivinės
koszt - kaina
kosztować - kainuoti
kot - katė f
kotka - katė f
kowal - kalvis
koza - ožka f
Koziorożec - Ožiaragis
Kraków - Krokuva
kran - liftas
krasula - karvė
krawiec - siuvėjas m
kręcić - sukti | kratyti
kripel - luošys m
krokodyl - krokodilas m
król - karalius m
królik - triušis m
kronika - kronika f
krótki - trumpas
krowa - karvė
krtań - gerklos
krucjata - kryžiaus žygiai
kruk - kranklys m
krwiopijca - kraugerys m
krybuny - kryžius m
kryminał - kalėjimas
krynica - versmė f
krypton - kriptonas m
Kryspin - Krispinas m
krytyk - kritikas m
krytyka - kritika f
krzeczek - žiurkėnas m
krzem - silicis m
krzesny - krikštatėvis m
Krzysztof - Kristaps m
krzywa - kreivė
krzywousty - kreivaburnis
krzyż - kryžius m
książka - knyga f
książka kucharska - patiekalų knyga f
księgozbiór - biblioteka f
Księżyc - Mėnulis
ksylitol - ksilitas m
kucać - koseti
kuć żelazo, póki gorące - kalk geležį, kol karšta
kukułka - gegužė f
kula - kamuolys m | koja f
kulka - kamuolys m
kulos - koja f
kupryt - kupritas
kuskus - kuskusas
kuzynka - pusseserė f
kwas akrylowy - akrilo rūgštis
kwas foliowy - folio rūgštis | folatas
kwiat - gėlė f
kwiecień - balandis
kworum - kvorumas m
kwota - suma
kynologia - kinologija
łabęć - gulbė f
łabędź - gulbė f
łabędzi śpiew - gulbės giesmė f
łabędź niemy - gulbė nebylė
lacz - galva f
ładny - gražus
laga - meškerė f
lajbik - liemenėlė f
laktaza - laktazės
lala - lėlė | merga f | mergina f | mergaitė f
lalka - lėlė
łapówka - kyšis m
laska - merga f
łazanki - skryliai
łechtaczka - varputė f | klitoris m
leczniczy - gydomasis
ledwo - vos
lekceważyć - menkinti
lekcja - pamoka
łepetyna - galva f
leszcz - karšis m
lew - liūtas m
Lew - Liūtas
łgać - meluoti
łgarz - melagis
lgota - palengvėjimas
liczba - skaičius | skaitmuo
limuzyna - limuzinas m
lipiec - liepa f
listonosz - paštininkas
listopad - lapkritis m
lit - litis m | litas m
litania - litanija
litewskojęzyczny - lietuvakalbis
litość - gailestis
Litwa - Lietuva f
łobocyć - matyti | žiūrėti
lód - ledas m
lodołamacz - ledlaužis m
lodowiec - ledynas m
lola - merga f | mergina f | mergaitė f | meškerė f
Londyn - Londonas m
łosoś - lašiša f
łosprawiać - pasakyti
łotewski - latviškas
lotos - lotosas m
lotus - lotosas m
Łotwa - Latvija f
Łotysz - latvis m
Łotyszka - latvė f
łoże - lova f
łóżko - lova f
łóżko polowe - kareiviška lovelė | sudedamoji lova
lub - arba
łucznik - lankininkas m
łudzikwiat - balandis
luksemburczyk - liuksemburgietis m
Luksemburczyk - liuksemburgietis m
Luksemburg - Liuksemburgas m
luksemburka - liuksemburgietė f
Luksemburka - liuksemburgietė f
luksemburski - liuksemburgietiškas
lulka - cigaretė f
luńt - šuo m
lustro - veidrodis m
luty - vasaris m
Lwów - Lvovas m
łyżka - šaukštas m
łza - ašara f
łża - melas m
Macedończyk - makedonas m
Macedonia - Makedonija f
Macedonka - makedonė f
macedoński - makedoniškas
macha - mina f
mączka - pudra f
Maghreb - Magribas
magister - vadas m | vadeiva m
magnez - magnis m
magulanka - peštynės | muštynės
maj - gegužis m | gegužė f
majluft - gegužinė malda f
majówka - gegužinė malda f
makolągwa - čivylis m
Małopolska - Mazpolija
małpa - beždžionė f
Malta - Malta
Maltańczyk - maltietis m
małżeństwo - santuoka f
mam - turėti | mama | motina
mama - mama | motina | uošvė f
mandat - bauda f
manewr - manevras m
manewry - manevrai
mangan - manganas m
Manila - Manila f
maniurka - merga f | mergina f | mergaitė f
manometr - manometers
marny - skurdus
martwy - miręs
Martyna - Martyna f
Marycha - Seina f
marzec - kovas m
masara - musė f
maska - seja f | veidas m
maślak lepki - pilkasis kazlėkas
mątewka - menturis
matka chrzestna - krikštamotė f
mazak - seja f | veidas m
Mazowsze - Mazovija
mecz - rungtynės
męczennik - kankinys m
meczet - mečetė f
mediana - mediana
melatonina - melatoninas
melodyjny - melodingas
menadżer - vadybininkas m | vadovas m
Merkury - Merkurijus m
metempsychoza - metempsichozė f
meteoryt - meteoritas
metr kwadratowy - kvadratinis metras
MFW - TVF
mgła - rūkas m
Miami - Majamis
mianownik - vardininkas
miasto - miestas m
Michał - Mikolas m
mieć - turėti
mieć gdzieś - menkinti
miecz - kalavijas m
Mieczysław - Mečislovas
miedź - varis m
miedźwiedź - lokys m
międzynarodowy - tarptautinis
Międzyrzec Podlaski - Palenkės Mendzižecas
miejski - miestas
mielcarz - aludaris m
mielcuch - alus
mieli - turėti
mięsień - raumuo m
mięso - mėsa f
mięsopustnik - vasaris m
mieszkać - giventi
mięta - mėta f
Mila - Emilė | Emilija | Emilia f
miłość - meilė
mina - mina f
minuta - minutė f
miś - meška f
misiek - meška f
mistrzostwa - čempionatas m
mistrzostwo - čempionatas m
mleko - pienas m
młody - jaunas
mnogdy - dažnai
móc - galėti
modlitwa - malda f
modrakowy - mėlynas
modry - mėlynas
modrzew - maumedis m
mój - mano
Mojżesz - Mozė
mól - kandis
Mołdawia - Moldavija f
Mołdawianin - moldavas m
Mołdawianka - moldavė f
mołdawski - moldaviškas
molo - molas
monarchia - monarchija
moneta - moneta f
monopol - monopolija f
monstrancja - monstrancija
morela - abrikosmedis m | abrikosas m
Morskie Oko - Morske Okas
morze - jūra f | marios f
Morze Adriatyckie - Adrijos jūra
Morze Arabskie - Arabijos jūra
Morze Azowskie - Azovo jūra
Morze Bałtyckie - Baltijos jūra f
Morze Barentsa - Barenco jūra
Morze Białe - Baltoji jūra
Morze Czarne - Juodoji jūra
Morze Czerwone - Raudonoji jūra f
Morze Egejskie - Egėjo jūra
Morze Irlandzkie - Airijos jūra
Morze Jońskie - Jonijos jūra
Morze Karaibskie - Karibų jūra
Morze Kaspijskie - Kaspijos jūra
Morze Koralowe - Koralų jūra
Morze Martwe - Negyvoji jūra
Morze Norweskie - Norvegijos jūra
Morze Ochockie - Ochotsko jūra
Morze Północne - Šiaurės jūra
Morze Południowochińskie - Pietų Kinijos jūra
Morze Śródziemne - Viduržemio jūra f
Morze Tyrreńskie - Tirėnų jūra
Morze Żółte - Geltonoji jūra
mosiądz - moneta f
mosiężny - žalvarinis
most - tiltas
moszna - kapšelis m
motyl - drugys m
Mount Everest - Everestas
mowa - liežuvis m
może - galėti
mózg - smegenys
mrówka - skruzdėlė f
mucha - musė f
muchomor mglejarka - bevainikė musmirė
muchomor twardawy - pilkoji musmirė
mućka - karvė
mur - siena f
muraszka - skruzdėlė f
muzeum - muziejus m
muzyka - muzika f
my - mes
mycka - kepurė f
mydło - muilas
myślenie magiczne - maginis mąstymas
myślenie życzeniowe - tikėjimas iš troškimo
mysz - pelė f
Myszka Miki - Peliukas Mikis m
nabożeństwo majowe - gegužinė malda f
naciskać - paspausti
nadbaba - prosenelė f
nadwzroczność - toliaregystė f
nagość - nuogumas m
nagota - nuogumas m
Nairobi - Nairobis
nareszcie - pagaliau | galiausiai
narkolepsja - narkolepsija f
narzekać - dejuoti | skųstis
następny - kitas | sekantis
natomiast - o
nauczać - mokyti | mokytojauti | mokytis
nauczyciel - mokytojas
naukowy - mokslinis | moksliškas
nazwisko - pavardė
Neapol - Neapolis
nędza - skurdas m
nędzny - elgetiškas | skurdus
neon - neonas m
ni - ne
nic - niekas
nie - ne
nieaktualny - neaktualus
niebieski - mėlynas
niebiosa - dangus m
niebo - dangus m
niedaleko pada jabłko od jabłoni - obuolys nuo obels netoli terieda
niedawno - [neseniai]]
niedostatek - trūkumas m
nieduch - liga
niedziela - sekmadienis
niedźwiedź - lokys m
niedźwiedzica - lokė f
niedźwiedź polarny - baltasis lokys m
nie ma - nėra
nie ma róży bez kolców - nėra rožių be dyglių
Niemcy - Vokietija f
Niemen - Nemunas
Niemiec - vokietis m
nie mieć - ne | turėti
Niemiecka Republika Demokratyczna - Vokietijos Demokratinė Respublika
niemiecki - vokiškas
niemieckojęzyczny - vokietakalbis
Niemka - vokietė f
nie od razu Kraków zbudowano - Roma nebuvo pastatyta per dieną
niepodległość - nepriklausomumas | nepriklausomybė f
niepotrzebny - nereikalingas
niepowtarzalny - ypatingas
nieściora - pusseserė f
nieśmiały - jautrus
niespodzianka - staigmena f
niesprawiedliwość - neteisingumas
nie święci garnki lepią - ne šventieji puodus lipdo
nieszczęścia chodzą parami - bėda viena nevaikšto
niewiasta - moteris f
niewiastka - marti f
niewolnictwo - vergovė f
niewolnik - vergas m
niezapominajka - neužmirštuolė f
nigdy - niekada
nihilizm - nihilizmas m
nikiel - nikelis m
niski - žemas
niszczyć - naikinti
niż - negu
no - taip
noc - naktis f
noga - koja f
nornica - pelėnai
Norweg - norvegas m
Norwegia - Norvegija f
norweski - norvegiškas
Norweżka - norvegė f
nosorożec - raganosis m
nowość - naujiena f | naujumas m
nowotwór - neoplazma
Nowy Rok - Naujieji metai
nóż - peilis m
nudelzupa - sriuba f
nur czarnoszyi - juodakaklis naras
nurniczek krasnodzioby - dailiasnapė alkelė
nyga - uodas m | kuisys ) | varmas )
oaza - oazė f
obaj - abu
obecnie - šiomis dienomis | dabartinis | dabar | esamas
obelisk - obeliskas m
oberchabka - kyšis m
oberżyna - baklažanas
obiecadło - abėcėlė f | alfabetas m
obiekt - objektas m
obierać - lukštenti | lupti | skusti | skutinėti
obłok - debesis m
obraz - filmas m
obrazki - aronas m
obrońca - gynėjas m
ocean - okeanas m | vandenynas m
ochota - Noras m
oczodół - akiduobė
oddychać - kvėpuoti
oddział - komanda f
odmiana - gentis f
odpowiadać - atsakinėti
odpowiedź - atsakymas m
ogół - visi | visuma f
ogórek - agurkas
ogród zoologiczny - zoologijos sodas
ogrzewanie - šildymas
ojciec chrzestny - krikštatėvis m
ojla - pelėda f
okaryna - okarina f
okazja - galimybė f | proga f
okłamywać - meluoti
oko - akis f
okoliczność - aplinkybė f
okoń - ešerys m
oko za oko, ząb za ząb - akis už akį, dantis už dantį
okręt - laivas m
okręt podwodny - povandeninis laivas
okultyzm - okultizmas m
okupacja - okupacija f
olej - alyva f
olejek eteryczny - eterinis aliejus
Olgierd - Algirdas m
Olimpia - Olimpija
Olsztyn - Olštynas
Olza - Olsa
omal - vos
o mały włos - per plauką
omieszkać - ne
omlet - omletas
opal - opalas
opium - opijus
opłatek - kalėdaitis
opowiadać - pasakyti
oracz - artojas m
oraz - ir
ordynarny - vulgarus
oregano - oregano
orgazm - orgazmas m
orientalistyka - orientalistika
Ormianin - armėnas m
Ormianka - armėnė f
ormiański - armėniškas
orzeł - erelis m
osiemnastolatek - aštuoniolikmetis m
osierdzie - širdiplėvė
osika - drebulė f
ośmiornica - aštuonkojis
osoba - asmuo
Oświęcim - Osvencimas | Aušvicas
owad - vabzdys m
owca - avis f
owies - aviža f
o wilku mowa, a wilk tu - vilką minime, vilkas čia
owulacja - ovuliacija f
ozdoba - papuošalas m
pacha - pažastis m
paciuk - žiurkė f
pacjent - ligonis m
padać - lyti
pagórek - kalva f | kauburys m
pagórkowaty - kauburiuotas
pająk - voras m
pajęcznik - rugsėjis m | spalis m | lapkritis m
pajęczy - voriškas
pajęczyna - voratinklis
pajucina - voratinklis
Pakistan - Pakistanas m
pakli - jei
pała - galva f
pale - galva f
palec boży - Dievo pirštas
Palestyna - Palestina f
Palestyńczyk - palestinietis m
Palestynka - palestinietė f
palestyński - palestiniškas
palladianizm - paladianizmas
Panna - Mergelė
państwowość - valstybingumas m
papier - popierius m
papieros - cigaretė f
papier wartościowy - vertybinis popierius m
papież - popiežius m
paplanina - zauna f
partyzana - partizanas
pawęża - skydas
październik - spalis m
paździerzeń - spalis m
paznokieć - nagas m
pazur - nagas m
pazura - ranka f
pchła - blusa f
pełny - pilnas
peniak - šeškas
Pepik - čekas m
perka - bulvė f
perkoz dwuczuby - ausuotasis kragas
persona - asmuo
Peru - Peru m
petrografia - petrografija
petronelka - boružė f
piana - alus
pianino - pianinas m
piątek - penktadienis
piczka - pyzda f
pidżama - pižama
piec - kepti
pieczarka - pievagrybis
piekarz - kepėjas m
piękny - gražus | dalius
pień - liemuo m
Pieniny - Pieninai
pierdzieć - persti
pies - šuo m
pięść - kumštis m
pieśń - daina f | giesmė f
pijawa - vaivorykštė f
pijawka - dėlė f
pikawa - širdis
piłka - kamuolys m
piłka nożna - futbolas m
piłka ręczna - rankinis
piorun - žaibas m
piosenka - dainelė f | daina f
piosenkarka - dainininkė f | giesmininkė f
piosenkarz - dainininkas m | giesmininkas m
pipa - pyzda f
pisanka - margutis
pisemny - parašytas | rašytinis
pismo - abėcėlė f | alfabetas m
Pittsburgh - Pitsburgas m
piwiarnia - aludė f
piwo - alus
piwowar - aludaris m
piżama - pižama
pizda - pyzda f
piznąć - vožti
PKB - BVP
plac - aikštė f
planeta - planeta f
planta - augalas m
płatek śniegu - sniegulė̃
platynki - bižuterija f
plaża - pliažas m
plejstocen - pleistocenas
plemię - kiltis f
pliszka górska - kalninė kielė
płot - žiogris
płyn Lugola - Liugolio tirpalas
płynny - skystas | skystis
pływak - plaukikas m
po - po
pobyt - pabuvimas | viešėjimas
pocałunek z języczkiem - prancūziškasis bučinys
pocestny - keliautojas
POChP - LOPL
pod - po | ties
pode - po | ties
podejrzenie - įtarimas m
pod gołym niebem - po atviru dangumi
Podgorica - Podgorica f
Podlasie - Palenkė
podróbka - padirbinys
podróżnik - keliautojas
podsumowanie - santrauka f
podwijać - atraityti
pogaństwo - pagonybė f
pogoda - oras m
pojedynczy - vieninis
pojutrze - poryt
Polak - lenkas m
poleku - lėtai
policja - policija f
policzek - žandas m
poliptyk - poliptikas
Polka - lenkė f
północ - vidurnaktis
polon - polonis
polonizacja - polonizacija f
Polska - Lenkija f
polski - lenkiškas | lenkų
polskojęzyczny - lenkakalbis
polskość - lenkystė f
pomarańcza - apelsinas m
pomarańczowy - apelsininis | apelsinų | oranžinis
pomoc - pagalba f
pomyłka - klaida f
pomyślność - sėkmė f
pomysłodawca - sumanytojas m
pończocha - kojinė f
poniedziałek - pirmadienis m
popołudnie - popietė f
pora roku - metų laikas m
pornografia - pornografija f
pornograficzny - pornografinis | pornografiškas
Portoryko - Puerto Rikas
Portugalczyk - portugalas m
Portugalia - Portugalija f
Portugalka - portugalė f
portugalski - portugališkas
porucznik - vyresnysis leitenantas
posiadać - turėti
posiadacz - savininkas m
pośladek - žandas m
pot - prakaitas m
potas - kalis m
potek - krikštatėvis m
potka - krikštamotė f
powiadać - pasakyti
powieka - blakstiena f
powieść - novelė f | apsakymas {{m}, romanas {{m}
powiestka - pašaukimas | šaukimas
powietrze - oras m
powód - priežastis
powoli - lėtai
pozawczoraj - užvakar
pozew - skundas m
poziom - lygis m | aukštas m
poznać - susitikti
Poznań - Poznanė
pozostały - atliekamas, likęs, likutinis
prababcia - prosenelė f
prababka - prosenelė f
praca - darbas m
praca domowa - namų darbai
prawak - tikrinis baravykas
prawa ręka - ranka f
prawda - tiesa | teisybė f
prawdopodobieństwo - tikimybė f
prawdziwek - tikrinis baravykas
pręcik - kuokelis m
prezydent - prezidentas m
produkować - produkuoti
produkt krajowy brutto - bendrasis vidaus produktas
profesor - profesorius m
prosić - prašyti
prowansalski - Provansalų
prowiant - maistas m
pruć - ardyti
Prusy - Prūsija
przać - mylėti
przeca - bet | galų gale
przeciąg - skersvėjis m
przecież - bet | galų gale
przeciwlotniczy - zenitinis
przedsięwzięcie - verslas m
przedszkole - darželis m
przedwczoraj - užvakar
przekaz - pervedimas m
przekonanie - tikėjimas m | nuomonė f
przełyk - stemplė f
przepiórka - putpelė
przestępca - nusikaltėlis m
przestrzeń kosmiczna - kosminė erdvė
przewoźnik - pervežėjas m | vežėjas m | vežiotojas m | keltininkas m
przoć - mylėti
przychodnia - klinika
przyjaciółka - bičiulė f | draugė f
przyjaźń - draugystė f
przyjebać - vožti
przyjęcie - priėmimas m | vakarėlis m
przyjść - ateiti
przymiotnik - būdvardis m
przymus - vertimas m | privertimas m
przynajmniej - bent jau
przyroda - gamta f
przysadka mózgowa - hipofizė | posmegininė liauka
przysięga - priesaika f
przyszłość - ateitis
przytośtać - ateiti
przywódca - vadas m | vadeiva m | karvedys m
psiarnia - policija f
psisko - šuo m
psor - profesorius m
pszczoła - bitė f
ptak - paukštis m
ptasia grypa - paukščių gripas
ptaszę - paukštis m
puder - pudra f
pultok - kalakutas m
purpurowy - purpurinis
puszczyk uralski - uralinė pelėda
puszka - kalėjimas | alus
puter - kalakutas m
putnia - kibiras m
pyra - bulvė f
quorum - kvorumas m
rabin - rabinas m
Racibórz - Raciboža
racja - teisybė | davinys
radon - radonas
Rajch - Vokietija f
Rak - Vėžys
rakuski - austriškas
ramię w ramię - petys petin
rasizm - rasizmas m
razdziawa - kranklys m | kovas m | varna
rdza - rūdys m
ręczna - rankinis
ręka - ranka f
reklama - reklama
rękopis - rankraštis
relikwia - relikvija f
rentowny - rentabilus
Republika Federalna Niemiec - Vokietijos Federalinė Respublika
Republika Karelia - Karelijos Respublika
Republika Słowacka - Slovakijos Respublika
respekt - pagarba
rewolucjonista - revoliucionierius m
rewolucjonistka - revoliucionierė f
reżyser - režisierius m
robieniec - darbininkas m
robotnik - darbininkas m
rodzaj - gentis f
rok przestępny - keliamieji metai
rok szkolny - mokslo metai
ropień - abscesas m
ropowica - pūlynas | flegmona f
rosa - rasa f
Rosja - Rusija f
Rosjanin - rusas m
Rosjanka - rusė f
roślina - augalas m
roso - rasa f
rosomak - ernis m
rosyjskojęzyczny - rusakalbis
rotmistrz - rotmistras m
rouza - rožė f
równak - tačiau | kaip bebūtų
równanie - lygtis
również - taip pat
róża - rožė f
rozeznanie - įžvalgos | žinios | supratimas
rózga - rykštė f
rozkaz - komanda f
różowy - rožinis
rozsierdzie - pyktis | įniršis
rubid - rubidis m
rufa - žandas m
rugby - regbis m
Rumun - rumunas m
Rumunia - Rumunija f
Rumunka - rumunė f
rumuński - rumuniškas
ruten - rutenis
ryba - žuvis f
Ryby - Žuvys
Ryga - Ryga f
rytuał - ritualas
rywal - konkurentas m
rządzić - valdyti
rzeczownik - daiktavardis m
Rzeczpospolita - Žečpospolita f
rzeka - upė f
rzępolić - zirzinti
rzeźbiarz - skulptorius m
rzut karny - baudinys m
rzut rożny - kampinis smūgis m
SA - AB
sadzielnik - kaminkrėtys m
sagan - galva f
Saipan - Saipanas
sałaciarz - taksistas m
sałata - taksi
samar - samaris
samogłoska - balsis
Sana - Sana f
Sardynia - Sardinija
sarkofag - sarkofagas m
sarnapa - žirafa f
sąsiad - kaimynas m
sąsiadka - kaimynė f
sąsiedztwo - kaimynystė f
sauna - sauna f
śćdza - takelis m
schyłek - smukimas | pabaiga
ściana - siena f
ściany mają uszy - ir sienos turi ausis
ściemniać - meluoti
ścieżka - takelis m
śdza - takelis m
seaborg - syborgis
sędzia - arbitras m
Sejm - Seimas
seksualność - seksualumas m
seksuologia - seksologija
selen - selenas m
seler - salieras
senny - miegustas m
ser - sūris m
Serb - serbas m
Serbia - Serbija f
Serbka - serbė f
serbski - serbiškas
serce - širdis
serdce - širdis
serdeczny - nuoširdus
serweta - staltiesė f
siano - šienas m
siarka - siera f
siarkowodór - sieros vandenilis
sieczeń - vasaris m
siedzieć - sėdėti
sierociniec - vaikų namai
sierpień - rugpjūtis m
sikora - zylė f
sikorka - zylė f
silnia - faktorialas
sin - sin
Singapur - Singapūras
siodło - balnas m
siostra - sesuo
sirpień - rugpjūtis m
siurpryza - staigmena f
skand - skandis m
skarpeta - kojinė f (puskojinė)
skarzyk - korys | karzyk
Skop - Avinas m
skóra - oda f
Skorpion - Skorpionas
skrzyp polny - dirvinis asiūklis
śledziona - blužnis
ślimak - sraigė f
słodki - gėlas (o wodzie) | saldinis | saldus
słoń - dramblys m
Słońce - Saulė
słonecznik - saulėgrąža f
słony - sūrus
słowa - žodis m
Słowacja - Slovakija f
słowacki - slovakiškas
Słowaczka - slovakė f
Słowak - slovakas m
Słowenia - Slovėnija f
Słoweniec - slovėnas m
Słowenka - slovėnė f
słoweński - slovėniškas
Słowianin - slavas m
słowik szary - lakštingala
słownik - žodynas m
słowo - žodis m
słuch - ausis m
smacznego - gero apetito
smerf - Smurfas | Smurfai
śmiech - juokas
śmierć - mirtis f
śmieszka - rudagalvis kiras
śmigać - bėgti
smutek - liūdesys
smutniak - duona f
snecha - marti f
śnieg - sniegas m
śnieżka - sniego gniūžtė f
śnieżynka - snaigė f
sobaka - šuo m
sobota - šeštadienis
socjologia - sociologija f
sód - natris m
soda - soda f
sójka syberyjska - sibirinis kėkštas m
sójka złowroga - sibirinis kėkštas m
sokół - sakalas m
Sokrates - Sokratas m
solniczka - druskinė
Solon - Solonas m
somsiad - kaimynas m
sondowanie - zondavimas m
Sopot - Sopoto
sosna - pušis f
sos sojowy - sojų padažas
sowa - pelėda f
sowa śnieżna - baltoji pelėda
spaść z nieba - nukristi kaip iš dangaus
spawacz - suvirintojas m
sperma - sperma f
śpiący - mieguistas
śpiew - dainavimas m
śpiewać - dainuoti | giedoti
śpiewaczka - dainininkė f | giesmininkė f
śpiewak - dainininkas m | giesmininkas m
społeczność - bendruomenė
spółgłoska - priebalsis
spowiedź - išpažintis
sprawa - reikalas m | atvejis m
sprawozdanie - ataskaita f
sprawozdawca - apžvalgininkas m
sprawozdawczość - atskaitomybė f
sprawozdawczy - ataskaitinis
sprzęt - įranga f
srebro - sidabras m
średniowiecze - Viduramžiai
Sri Lanka - Šri Lanka
środa - trečiadienis
środek - centras m | vidus
śrubstag - griebtuvas m | spaustuvai
ssak - žinduolis m
stadion - stadionas m
stado - banda f
stała - konstanta
stanik - liemenėlė f
starek - senelis m
stare miasto - miestas m
Stargard Szczeciński - Stargarda
starosek - senelis m
staroszek - senelis m
Starowieś - Staroviešas
starzyk - senelis m
statek - laivas m
statyczny - statinis | rimtas
staw - sąnarys m | sąnaris m
staw łokciowy - alkūnė
stopa - pėda f
stopień najwyższy - aukščiausiasis laipsnis
stopień wyższy - aukštesnysis laipsnis
strąpacz - vasaris m
strawa - kaina
strit - eilė
strona - puslapis m
stront - stroncis m
struś - strutis m
strzała - strėlė f
strzelec - šaulys
Strzelec - Šaulys m
strzykwa - jūrų agurkas m
styczeń - sausis
Sudety - Sudetai
sumienie - sąžinė f
sumienny - sąžiningas
światopogląd - pasaulėžiūra f
świątynia - šventykla f
świeca - žvakė f
świecę - žvakė f
świekier - uošvis m
świekra - uošvė f
świerk - eglė f
świeść - moša | svainė | uošvė f
świetlik - jonvabalis m
świetlik lekarski - pievinė akišveitė
świętość - šventybė
świeży - šviežias
świnia - kiaulė f
świostka - moša | svainė | uošvė f
świstun - cyplė
synagoga - sinagoga
synowa - marti f
syra - koja f
syrop klonowy - klevo sirupas
szafka - spintelė
szariat - Šariah | Šariatas
szaszok - šeškas
Szczecin - Ščecinas
szczelina - plyšys
szczeniak - šuniukas
szczenię - šuniukas
szczęśliwego Nowy Nowego Roku - laimingų Naujųjų Metų
szczur - žiurkė f
szczypiorniak - rankinis
szczyt - orgazmas m
szept - šnabždesys m
szeroki - platus
szerszeń - širšė f
szkira - merga f | mergina f | mergaitė f
szkita - koja f
Szkocja - Škotija f
szkocki - škotiškas
szkoła - mokykla f
szkolny - mokyklinis
szkop - vokietis m
Szkot - škotas m
Szkotka - škotė f
szlauch - gyvatė f
szlug - cigaretė f
szneka - seja f | veidas m
sznurowadło - raištis m
sznurówka - raištis m
szpon - nagas m
szpuk - karvelis m
szrobsztok - griebtuvas m | spaustuvai
sztrof - bauda f
sztrofa - bauda f
sztuka - merga f | mergina f | mergaitė f
szulak - vanagas m
szwab - vokietis m
Szwabia - Švabija f
szwagierka - moša | svainė
szwaja - koja f
Szwajcaria - Šveicarija f
Szwajcarka - šveicarė f
Szwecja - Švedija f
Szwecyjo - Švedija f
Szwed - švedas m
Szwedka - švedė f
szwedzki - švediškas
szwestera - sesuo
szyć - siūti
szyja - kaklas m
szykowny - gražus
tabliczka - daugybos lentelė f
tabliczka mnożenia - daugybos lentelė f
tachykardia - tachikardija f
tacik - senelis m
Tadeusz - Tadas m
Tadżykistan - Tadžikija
tak - taip
taksówka - taksi
taksówkarz - taksistas m
także - taip pat
tal - talis
Tallinn - Talinas m
tamten - tas | šitas
tantal - tantalas
tarcza - skydas | seja f | veidas m
tarcza krystaliczna - skydas
tarcza strzelecka - skydas | seja f | veidas m
tarcza szkolna - skydas
tasza - rankinė f | krepšys m
taternictwo - alpinizmas m
Taurogi - Tauragė
tchórz - šeškas
technet - technecis
tęcza - vaivorykštė f
teczka - aplankas, portfelis, rankinė
tektoniczny - tektotinis
telefon komórkowy - mobilusis telefonas m
tellur - telūras
temat - tema
ten śmiać się śmieje, kto śmiać się śmieje ostatni - juokiasi tas, kas juokiasi paskutinis
terb - terbis
termit - termitas m
termodynamika - termodinamika
Termopile - Termopilų perėja
teść - uošvis m
teściowa - uošvė f
tetum - tetum kalba
też - taip pat
tg - tg
Tirana - Tirana f
tkactwo - audimas
tkanka - audinys m
tlen - deguonis m
Tonga - Tonga f
topola - tuopa f
tor - toris
Tora - Tora f
torba - rankinė f | krepšys m
tory - toris
totalitaryzm - totalitarizmas
totem - totemas m
towarzysz - draugas m | partneris m | kompanionas m
towarzyszyć - lydėti
tożsamość - identitetas
trambimba - tramvajus m
tramwaj - tramvajus m
tramwajka - tramvajus m
trawa - žolė f
trener - treneris m
Tripoli - Tripolė
trójskok - trišuolis
trolejbus - troleibusas
trwać - trukti
trzask - traškesys m
trzeć - tarkuoti | trinti | zulinti
trzmiel - kamanė
trznadel zwyczajny - geltonoji starta
trzydziestolatek - trisdešimtmetis m
trzydziestolecie - trisdešimtmetis m
trzymać język za zębami - liežuvi valdyti
tudzież - ir
Tunezja - Tunisas
Turcja - Turkija f
Turczynka - turkė f
turecki - turkiškas
Turek - turkas m
Tuvalu - Tuvalu m
twardziel - rinoskleroma | standusis diskas m | kietasis diskas m
twarz - seja f | veidas m
twierdza - tvirtovė f
twór - kūrinys m
tydzień - savaitė f
tyn - siena f | žiogris
tysiąclecie - tūkstantmetis m
tysiącletni - tūkstantmetis
tytan - titanas m
ubierać - aprengti | užmauti (buty, rękawiczki) | apsirengti | apsivilkti
ubiór - drabužiai
ubóstwo - skurdas m
ucho - ausis m
uczelnia - mokykla f | akademija f | universitetas m | kolegija f
uczeń - mokinys m
uczennica - mokinė f
uczestnik - dalyvis m
uczyć - mokyti | mokytojauti | mokytis
uderzyć - vožti
układ okresowy - periodinė elementų lentelė
układ okresowy pierwiastków - periodinė elementų lentelė
Ukraina - Ukraina f
Ukrainiec - ukrainietis m
Ukrainka - ukrainietė f
ukraiński - ukrainietiškas
ulga - palengvėjimas
ulica - gatvė f
Unia Europejska - Europos Sąjunga
unicestwiać - sunaikinti
upijać - pasigerti | prisigerti
upiór - šmėkla f
upór - užsispyrimas m
uprawa - auginimas m | kultūra f
uprawiać - užsiimti | praktikuoti
urępny - gražus | dalius
urodziwy - gražus
uśmiech - šypsena f
uśmiechać się - šypsotis
utwór - kūrinys m | veikalas m
wacha - Lietus m | sargyba f | jūra f | marios f | vanduo m
Waga - Svarstyklės
wajco - kiaušinis m
waliza - lagaminas m
walizka - lagaminas m
waltornia - valtorna f
wanad - vanadis m
wanilia - vanilė
wapń - kalcis m
waran - varanas m
warta - sargyba f
wąski - siauras
wątpliwy - abejotinas
Watykan - Vatikanas
wąż - gyvatė f
ważka - laumžirgis m
węborek - kibiras m
wędka - meškerė f
weganizm - veganizmas m
wegetarianizm - vegetarizmas
węgiel - anglis
Węgier - vengras m
Węgierka - vengrė f
węgierski - vengriškas
Węgry - Vengrija f
Wenecja - Venecija f
wesoły - džiaugsmingas
Wesołych Świąt - Linksmų Kalėdų
węszyć - uosti
wezwanie - pašaukimas | šaukimas
wiadro - kibiras m
widelec - šakutė f
widnokrąg - horizontas
widołka - šakutė f
wieczność - amžinybė f
wiedzieć - žinoti
wiela - kiek
wielbłąd - kupranugaris m
wiele - daug | daugybė
Wielkanoc - Velykos
wiem - todėl kad | tam
Wieruszów - Verušuva
wiewióreczka - voveraitė f
wiewiórka - voverė f
więzienie - kalėjimas
wiking - vikingas
Wikisłownik - Vikižodynas
Wikiźródła - Vikišaltiniai
wiktoria - pergalė f
wileński - vilnietiškas
Wileńszczyzna - Vilniaus kraštas
wilga - volungė f
wilgoć - drėgmė
wilk - vilkas m
wilkołak - vilktakas m | vilkolakis m
wilk syty i owca cała - ir vilkas sotus, ir avis sveika
wilk w owczej skórze - vilkas avies kailyje m
wilnianin - vilnietis m
wilnianka - vilnietė f
wilniuk - vilnietis m
Wilno - Vilnius m
winda - liftas
wino - vynas m
winograd - vynas m
wiosna - pavasaris m
wirusologia - virusologija f
Wisła - Vysla
wiwenda - maistas m
w końcu - pagaliau | galiausiai
Władywostok - Vladivostokas m
Włoch - italas m
Włochy - Italija f
włos - plaukas m
włoski - itališkas
Włoszka - italė f
woda - vanduo m
wóda - degtinė f | vodka f
wódka - degtinė f | vodka f
Wodnik - Vandenis
wodór - vandenilis m
wodospad - krioklys m
wódz - vadas m
wojak - kareiva | kareivis m
wojskowy - kareiviškas | kareivis m
wokabularz - žodynas m
wół - jautis m
wolt - voltas m
woniączka - degtinė f | vodka f
worek sercowy - širdiplėvė
wrażliwy - jautrus | trapus
wreszcie - pagaliau | galiausiai
Wrocław - Vroclavas m
wrona - varna
wrzesień - rugsėjis m
wrzód - votis f | opa f
wścieklizna - pasiutligė
współczucie - gailestis
wspólny - bendrai | drauge
wstydzić się - Drovėtis
wszystkie drogi prowadzą do Rzymu - visi keliai veda į Romą
wtorek - antradienis
wulgarny - vulgarus
wulgaryzm - vulgarizmas m | vulgarybė f
wulkan - ugnikalnis m | vulkanas m
wulkaniczny - vulkaninis
wuszt - dešra f
wybierać - pasirinkti
wybór - pasirinkimas
wyborca - balsuotojas m
wybrzeże - pajūris
wydma - kopa
wygrana - prizas m | pergalė f | triumfas m
wyjątek - išimtis m
wyjątek potwierdza regułę - išimtis patvirtina taisyklę
wyjazd - išvykimas
wyjść na jaw - išeiti aikštėn
wykusz - erkeris
wymagać - reikalauti
wynalazca - išradėjas
wynik - rezultatas | effektas
wyraz - žodis m
wysiółek - vysiulekas
wysoki - aukštas
Wyspa Bożego Narodzenia - Kalėdų sala f
Wyspa Świętego Wyspy Świętego Tomasza i Wyspa Książęca - San Tomė ir Prinsipė
Wyspy Kanaryjskie - Kanarų salos
wystarczający - ganėtinas
wytłumaczyć - paaiškinti
wytrysk - ejakuliacija
wywielga - volungė f
ząb - dantis m
żaba - varlė f
żabie oczko - neužmirštuolė f
zabijak - žudikas m
zabójca - žudikas m
zachód słońca - saulėlydis m | vakaras m
zaćmienie - užtemimas
zacząć - pradėti
zaczynać - pradėti
żądać - reikalauti
żądanie - reikalavimas
zadanie domowe - namų darbai
żądło - geluonis m
zagadka - mįslė f
zaimek - įvardis
zając - kiškis | zuikis
zajączek - zuikelis | zuikiukas | zuikutis | kiškelis
zajebać - vožti
zakażenie - infekcija f
zakład - cechas | lažybos
zakład karny - kalėjimas
zakrystia - zakristija f
zakrystian - zakristijonas m
żal - sielvartas m | gailestis m | gailėjimas m
załącznik - kyšis m
zaleta - privalumas m | gera [ypatybė]] f
żałosny - skurdus
żałować - gailėtis
zamek - pilis f | spyna f
zamieć - pūga f
zamówić - užsakyti
zamówienie - paraiška {{f | užsakymas }
zamsz - zomša f
zamykać - vožti
zapalenie oskrzeli - bronchitas
zapalenie płuc - plaučių uždegimas
zapierdolić - vožti
zapis - užrašymas | įrašas
zaraza - epidemija f
żargon - žargonas
żargonowy - žargoniškas
zarodek - embrionas m
zarozumiały - pasipūtęs | arogantiškas
zarządzać - valdyti
zasłonak - nuosėdis
zaszczytciel - gynėjas m
zawody - konkurencija f
zawsze - visada
zawżdy - visada
zazdrosny - pavydus
zazula - gegužė f
zazulka - boružė f
zboczeniec - iškrypėlis
zboże - javai
zderzak - buferis m
zdradzać - atskleisti | išduoti | apgauti
zdrój - versmė f
zdrzadło - veidrodis m
zebra - zebras m
żebraczka - elgeta f
żebrak - elgeta m | skurdžius m
zefir - zefyras m
żegleń - anglis
że ho ho - daug | daugybė
żelazo - geležis f
żeńczyna - moteris f
zenit - zenitas m
żeński - moteriškas
zez - žvairumas
Zgierz - Zgežas
zielnik - herbariumas
zielonooki - žaliaãkis
zielony - žalias
ziemniak - bulvė f
zieziulka - gegužė f
zima - žiema f
zimorodek - tulžys
ziołolecznictwo - žolininkystė
Zjednoczone Królestwo - Jungtinė Karalystė
złapać zająca - zuikį pagauti
żłobek - vaikų lopšelis
złotnik - auksakalys m
złoto - auksas m
złotopióry - auksaplunksnis
złotówa - taksistas m
złotówka - zlotas m
złoty - zlotas m
zmiana - pakeitimas | pokytis
zmierzch - prieblanda f
znaczenie - svarba
znajomy - pažintys | kontaktai | socialinis kapitalas
zobaczyć - matyti | žiūrėti
żołądek - skrandis m
żółć - tulžis f | geltonas
żołnierz - kareivis m
żółta kartka - geltona kortelė f
żółty - geltonas
żołwica - moša | svainė
żółw lamparci - panterinis vėžlys
zoolog - zoologas m | zoologė f | zoologijos sodas
zoologia - zoologija
zoologiczny - zoologinis
zootechnika - zootechnika f
zozula - gegužė f
źrenica - vyzdys m | akis f
zrobić - padaryti
źródlany - versminis
źródło - šaltinis | versmė
zrozumiały - suprantamas
zrywka - rankinė f | krepšys m
zupa - sriuba f
żurawina - paprastoji spanguolė
Związek Socjalistycznych Republik Radzieckich - Tarybų Socialistinių Respublikų Sąjunga
zwierciadło - veidrodis m
zwierzak - gyvūnas m
zwierzę - gyvūnas m
zwycięstwo - pergalė f
żyć jak pies z kotem - gyventi kaip šuo su kate
życzyć - linkėti
żydaczowski - židačivas
zygzak - zigzagas m
żyrafa - žirafa f
żywić - valgyti
