abasiofilia - アベイショフィリア, 身体障害性愛
abdykacja - 退位
abfal - 廃物, 敢えて
Abidżan - アビジャン
ablegierek - 子供 (こども, kodomo), 子 (こ, ko)
abolicjonizm - 奴隷廃止運動, 奴隷制度廃止運動
aborcja - 人工妊娠中絶
absolutnie - 絶対
Adam - アダム
Addis Abeba - アディスアベバ
Adelajda - アデレード
adipocyt - 脂肪細胞 (しぼうさいぼう)
adnotacja - 注釈, 付記
adres - 住所
adwentnik - 12月, 十二月
adwokacja - 世話
aerodynamika - 空気力学
aeroplan - 飛行機, 機
afazja - 失語症 (しつごしょう)
Afganistan - アフガニスタン (afuganisutan)
afgański - アフガニスタンの
afisz - ポスター
Afryka - アフリカ (afurika)
afrykanerski - アフリカーンス語
agape - アガペー
Agata - アガタ
agnostycyzm - 不可知論
agroturystyka - アグリツーリズム
aikido - 合気道 (あいきどう), 合氣道
ajmer - バケツ (baketsu)
ajnfachowy - 普段の
akacja - アカシア
akademia - アカデメイア, アカデミー, 大学
akademie - アカデメイア, アカデミー, 大学
akcent - 強勢 (kyōsei), ストレス
akceptacja - 承認 (しょうにん)
akcja - 株式 (かぶしき, kabushiki)
akordeon - アコーディオン
aktor - 役者
aktorka - 女優
aktyn - アクチニウム (akuchiniumu)
akwarela - 水彩画
akwedukt - 用水路
Akwitania - アキテーヌ地域圏
Alaska - アラスカ州
Albania - アルバニア (arubania)
album - アルバム, 写真帳
alchemia - 錬金術
alchemik - 錬金術師
al dente - アルデンテ
ale - ね
Aleksandria - アレクサンドリア
alergia - アレルギー
ależ - ね
Alghero - アルゲーロ
Algier - アルジェ
Algieria - アルジェリア (arujeria)
algorytm - アルゴリズム
Alicja - アリス (Arisu)
alkohol - アルコール, 酒, お酒, 御酒
alkoholizm - アルコール依存症
alleluja - ハレルヤ
Alpy - アルプス山脈
ałsztojer - 持参金 (jisankin)
alternator - オルタネーター
aluminium - アルミニウム
amajza - 蟻, あり
Amazonka - アマゾン川 (Amazon gawa)
ambirz - 生姜 (しょうが, shōga)
ambona - 講壇
ambulans - 救急車
Amerykanin - アメリカ人 (amerika-jin)
amfa - アンフェタミン
amfetamina - アンフェタミン
Amman - アンマン
Amos - アモス
amplitud - 振幅
amplituda - 振幅
analityczny - 分析的, 分析 の
ancug - 背広 (せびろ)
Andora - アンドラ, アンドラ・ラ・ベリャ
anemia - 貧血
angielski - イギリスの, 英国 の, 英語
angina - 扁桃炎
Anglia - イングランド (ingurando), 英国 (えいこく, eikoku)
Anglija - イングランド (ingurando), 英国 (えいこく, eikoku)
Anglik - イギリス人
angol - イギリス人, イギリスの, 英国 の, 英語
Angol - イギリス人
Angola - アンゴラ
animacja - アニメーション, 動画
anime - アニメ
anioł - 天使
Anioł Stróż - 守護天使 (しゅごてんし)
anjoł - 天使
ankieta - アンケート
Antares - アンタレス
antena - アンテナ
Antigua i Barbuda - アンティグア・バーブーダ
antrejka - 廊下 (rōka), 回廊 (kairō)
antropolog - 人類学者
antryj - 廊下 (rōka), 回廊 (kairō)
antybakteryjny - 抗菌性
antyczny - 古
antyk - 古代, 骨董品
antyklerykalizm - 反教権主義
antymateria - 反物質
antyoksydant - 抗酸化物質
antyutleniacz - 抗酸化物質
anyż gwiazdkowy - トウシキミ
anyż gwiaździsty - トウシキミ
aparat fotograficzny - カメラ
apasz - 刑事
Apeniny - アペニン山脈
apetyczny - 甘い
apetyt - 食欲, 欲望
apoptoza - アポトーシス
apostoł - 使徒, ハイイロツチスドリ
apryl - ４月 (しがつ, shigatsu)
apryl-apryl - 万愚節 (ばんぐせつ), エイプリルフール
apsik - ハクション!
a psik - ハクション!
apteczka pierwsza pierwszej pomocy - 救急箱
aptek - 薬屋 (kusuriya)
apteka - 薬屋 (kusuriya)
Arab - アラビア人
Arabia Saudyjska - サウジアラビア
arabski - アラビア語
arabus - アラビア人
Aragonia - アラゴン州
arak - アラック
arbuz - 水瓜
archanioł - 大天使
archeologia - 考古学
archipelag - 列島
Argentyna - アルゼンチン (Aruzenchin)
aria - アリア
armia - 軍 (ぐん, gun), 軍隊 (ぐんたい, guntai), 陸軍 (りくぐん, rikugun)
armijo - 軍 (ぐん, gun), 軍隊 (ぐんたい, guntai), 陸軍 (りくぐん, rikugun)
artykuł - 冠詞
artysta - 芸術家
as - エース (ēsu)
asafetyda - アサフェティダ
asceza - 禁欲主義
aseksualizm - 非性愛
aspiryna - アスピリン
asta - 枝 (えだ)
asterysk - アステリスク
astronomia - 天文学
astronomio - 天文学
atak serca - 心筋梗塞 (しんきんこうそく)
ateista - 無神論者 (むしんろんしゃ, mushinronsha)
ateistyczny - 無神論の
ateizm - 無神論 (mushinron)
Atena - アテーナー, アテナ, アテネ
Ateny - アテネ
ateusz - 無神論者 (むしんろんしゃ, mushinronsha)
Atlantyk - 大西洋
atlas - 地図帳
atmosfera - くうき, 空気, 雰囲気
atom - 原子
atrament - インク
atrybucja - 帰属
audycja - 番組
aukcja - 競売, オークション
Australia - 豪州
australijski pies pasterski - オーストラリアン・キャトル・ドッグ
Austria - オーストリア (ōsutoria)
austriacki - オーストリアの
auto - 車, 自動車
autobus - バス
autopsja - 検死 (kenshi)
autostopowicz - 便乗者
autyzm - 自閉症
awatar - 天降 (amakudari)
aż - ～ほど
Azerbejdżan - アゼルバイジャン
Azja - アジア (Ajia)
Azja Mniejsza - 小アジア
azot - 窒素 (ちっそ, chisso)
babcia - お祖母さん, 御祖母さん, 祖母, お婆さん, 御婆さん
babka - お祖母さん, 御祖母さん, 祖母, お婆さん, 御婆さん
bachraty - 厚い
bada - 研究 する, 診察 する
badać - 研究 する, 診察 する
badian właściwy - トウシキミ
badyl - 雑草 (ざっそう, zassō)
baglama - サズ
bajer - 嘘
bajerować - 嘘を吐く (うそをつく, usowotsuku)
bajt - バイト
bajtel - 子供 (こども, kodomo), 子 (こ, ko)
bakałarz - 先生, 教師
bakłażan - ナス
bala - ボール
bałabajka - バラライカ
bałabuch - クッキー
bałałajka - バラライカ
baletnica - バレリーナ
balkon - バルコニー
balneologia - 温泉療法 (おんせんりょうほう)
Bałtyk - バルト海
Bałtyka - バルティカ大陸
bambus - 竹
bana - 列車, 路面電車
banan - バナナ
banana - バナナ
bandzioch - 御腹
Bangkok - バンコク
bania - 頭 (atama)
baniak - 頭 (atama)
bank - 銀行 (ぎんこう, ginkō)
banka - 路面電車
baptyzm - バプテスト教会
bar - バー
barabola - ジャガイモ
baran - 牡羊, 雄羊, 馬鹿
Baranek Boży - 神の子羊, 神の小羊
barbeta - バーベット (baabetto)
bardzo - とても (totemo),　大変 (taihen),　非常に (hijou ni), ずいぶん
barter - バーター (bātā)
barwa - 色, 色彩
barwienie - 着色
barzej - とても (totemo),　大変 (taihen),　非常に (hijou ni), ずいぶん
bas - 御腹
basen - プール
basset - バセットハウンド
basza - パシャ, 飼料
batki - パンツ, パンティー
batuta - 指揮棒 (shikibō)
bazylia - バジル
bebech - 御腹, 胃
bęben - 御腹
bębenek - 鼓膜 (こまく)
beczeć - 泣く (なく, naku)
bejm - お金 (okane), 貨幣
Bejrut - ベイルート
bele kaj - どこでも
belfer - 先生, 教師
Belgia - ベルギー (berugī)
Benin - ベナン
benzyna - ガソリン
berbela - おさけ, さけ, 酒, お酒, 御酒
berbelucha - 密造酒
berga - 石 (いし), 歯石 (しせき, )
Berlin - ベルリン, 伯林
beryl - ベリリウム (beririumu)
bety - パジャマ, 寝間着, 寝巻き, 寝巻
bezczelny - 厚かましい
bezpieczeństwo - 安全
bezpiecznik - 電力ヒューズ
bezpieczny - 安全
bezpośredni - 直接
bezpośredniość - 直接
bezrobocie - 失業
bezrobotny - 失業者
bezsenność - 不眠症 (ふみんしょう)
bezsensowny - 馬鹿げた, 無意味
bezstronność - 公平, 中立
beztroski - 気楽
bezwarunkowo - 絶対
bezwzględny - 薄情
bezzwłocznie - 至急 (しきゅう)
białaczka - 白血病, はっけつびょう
Białoruś - ベラルーシ (berarūshi)
biały - 白い
Białystok - ビャウィストク
Biblia - 聖書 (Seisho)
bibliografia - 書誌学
bida - 貧乏 • 貧しさ
biec - 走る
bieda - 貧乏 • 貧しさ
biedermeier - ビーダーマイヤー
biedny - 貧しい • 貧乏, 貧しい
biedronka - テントウムシ
biegać - 走る
biegnąć - 走る
bieg płotkarski - 障害走
bieg przez płotki - 障害走
biegunka - 痢
biel - 白, 白色
bierne palenie - 受動喫煙
bieżeć - 走る
bigel - 遊び
bigiel - 遊び
biglosko - アイロン
bigos - ビゴス
bimba - 路面電車
bimber - 密造酒
bindasz - ペニス, 男根, 陰茎
binder - ネクタイ (nekutai)
bindka - ネクタイ (nekutai)
biochemia - 生化学
biotyna - ビオチン
Birma - ミャンマー
biseksualny - バイセクシュアル
bishalter - ブラジャー
biskup - 主教
bita śmietana - クリーム
biurko - 机
biuro podróży - 旅行代理店 (りょこうだいりてん)
biusthalter - ブラジャー
biustonosz - ブラジャー
bizmut - ビスマス
biżuteria - 玉
błąd poznawczy - 認知バイアス
blady - 青白い
blaga - 嘘
błędne koło - 悪循環
Bliski Wschód - 近東
blog - ブログ
blok - マンション
blok mieszkalny - マンション
błona bębenkowa - 鼓膜 (こまく)
blumkol - カリフラワー
błyskawica - 稲妻, 雷光, 雷
bo - なぜなら (názenara), だって (datte), から
bodo - ボド語
Bóg - 神様 (かみさま, kamisama), 神 (かみ, kami)
bogać ta - ね
bogacz - 財産家
Bohemia - チェコ (cheko)
bohr - ボーリウム (bōriumu)
bojtel - 袋
boks - ボクシング
bokser - ボクサー
ból - 痛
bolesny - 痛い (itai)
Boliwia - ボリビア
bomba - 爆弾
bombel - 子供 (こども, kodomo), 子 (こ, ko)
bómbón - 飴
bonsai - 盆栽
bor - ホウ素 (ほうそ, hōso)
Bośnia i Hercegowina - ボスニア・ヘルツェゴビナ
boża krówka - テントウムシ
boźdór - 男の子, 少年, 彼, カレ, 彼氏, カレシ
Boże Ciało - 聖体の祝日
Boże Narodzenie - クリスマス
brachol - 兄, 弟
bracieniec - 兄, 弟
brama - 鳥居
brat - 兄, 弟
bratanek - 甥
brauza - シャワー
Brazylia - ブラジル (Burajiru), ブラジル連邦共和国 (Burajiru renpō-kyōwakoku)
brazyliana - コーヒーの木 (kōhī-no-ki), コーヒー, 珈琲 (kōhī)
Bretania - ブルターニュ地域圏
briftasza - かばん, ファイル
briftreger - 郵便配達
bród - 浅瀬 (あさせ)
broda - 髭
brokuł - ブロッコリー
broń - 武器
broń biała - 冷兵器
broń biologiczna - 生物兵器
browar - 麦酒 (ビール, bīru), ビア (bia)
brudny - 汚
brusić - 研ぐ (togu)
brutalny - 荒い
brydż - コントラクトブリッジ
brygantyna - ブリガンティン
bryka - 車 (くるま, kuruma), 自動車 (じどうしゃ, jidōsha), カー
bryła - 立体
brylant - ブリリアント
brzeg - 岸, 磯, 縁
brzmienie - のサウンド (no saundo)
brzoza - 樺
brzuch - 御腹
bubek - ジャック
buda - 犬小屋 (いぬごや, inugoya), 学校
Budapeszt - ブダペスト
budda - 仏, 仏像
buddyzm - 仏教
budowanie - 建立
budynek - 建築物, 建物
budzić - 起こす, 起きる
buła - 立体
bulba - ジャガイモ
buldog francuski - フレンチ・ブルドッグ
bulterier - ブルテリア
bulwa - ジャガイモ
bunraku - 文楽, 人形浄瑠璃
burak - カブ, 大根
burderz - ダガー
burdesz - ダガー
burmistrz - 首長
burza - 雷雨 (らいう)
burzowiny - 麦酒 (ビール, bīru), ビア (bia)
bustrofedon - 牛耕式
butersznyt - サンドイッチ
buzi - キス (kisu), 接吻 (seppun)
być - だ (da, ), です (desu, )
byk - 雄牛 (o'ushi)
były - 元彼
bzybzać - 切
cacyki - ザジキ
cajtung - 新聞 (shinbun)
cal - 吋
całka - 積分 (sekibun)
całość - 全体
całus - キス (kisu), 接吻 (seppun)
cellulit - セルライト
cel uświęca środki - 目的のためには手段を選ばない
cena - 値段
cenotaf - 慰霊碑
centurion - ケントゥリオ
cera - 娘 (むすめ, musume)
certacja - ファイト
cesarz - 天皇
cez - セシウム (seshiumu)
chachoł - 項
chałwa - ハルヴァ
chan - ハーン
charcik włoski - イタリアン・グレイハウンド
chart afrykański - アザワク
chemia - 化学 (かがく, kagaku)
chemia biologiczna - 生化学
chemia organiczna - 有機化学 (ゆうきかがく, yūkikagaku)
chemiczny - 化学～ (かがく, kagaku), 化学的 (かがくてき, kagaku-teki)
chemik - 化学者
Cheronea - カイロネイア
Cheroneja - カイロネイア
chętny - 真剣
chinina - キニーネ
chira - おさけ, さけ, 酒, お酒, 御酒
chitozan - キトサン
chlać - 飲む, 上がる
chleb - パン (pan)
chłopak - 男の子, 少年, 彼, カレ, 彼氏, カレシ
chłopiec - 少年 (shōnen)
chłopyszek - 少年 (shōnen)
chlor - 塩素 (enso)
chloroaceton - クロロアセトン
chmiel - 麦酒 (ビール, bīru), ビア (bia)
choinka - クリスマスツリー
chójk - クリスマスツリー
choroba - 病気 (びょうき, byōki)
choroba Alzheimera - アルツハイマー型認知症
choroba morska - 船酔い
chorwacki - クロアチアの, クロアチア語
chów wsobny - 近親交配
chrystianizm - キリスト教
Chrystus - キリスト
chrześcijaństwo - キリスト教
chudoba - 貧乏 • 貧しさ
chustka - スカーフ (sukāfu), ハンカチ (hankachi)
chwast - 雑草 (ざっそう, zassō)
chwila - 瞬間
chwost - 雑草 (ざっそう, zassō), 尻尾
chytry - 腹黒い
ciąć - 切
ciągnąć - 引く (ひく, hiku)
ciągnięcie - 引き
ciało - 体, 身体, 人体, 死体, 物質
ciastko - クッキー
ciasto - ケーキ, お菓子
ciebie - 君 (きみ, kimi), おまえ (おまえ, omae)
ciecierzyca - ヒヨコマメ
ciekawy - 面白い
ciemnia - 暗室
ciemnia fotograficzna - 暗室
ciemny - 暗い (くらい, kurai), 浅黒い (あさぐろい, asaguroi), 黒い (くろい, kuroi), 愚昧な (ぐまいな, gumai na), ヤミの (yami no)
cień - 影
cienki - 薄い
ciepło - 熱
cierpienie - 苦痛, 苦
cieść - 舅 (しゅうと, shūto)
ciężki - 重い (おもい, omoi)
ciocia - おば (oba)
cipka - バン
cis - イチイ属
cis japoński - イチイ
ciśnienie - 圧力, 気圧, 血圧, 重圧
cis pospolity - ヨーロッパイチイ
ciupa - 刑務所
ciurlocek - ペニス, 男根, 陰茎
ciurma - 刑務所
ćma - 蛾 (が, ga)
ćmaga - おさけ, さけ, 酒, お酒, 御酒
ćmić - 焼く, 焼ける
ćmy - 暗い (くらい, kurai), 浅黒い (あさぐろい, asaguroi), 黒い (くろい, kuroi), 愚昧な (ぐまいな, gumai na), ヤミの (yami no)
codziennie - 毎日
córa - 娘 (むすめ, musume)
córczysko - 娘 (むすめ, musume)
córka - 娘 (むすめ, musume)
cos - cos
co z oczu, to z serca - 去る者は日々に疎し
ćpać - たべる, 食べる (taberu), 上がる
ctg - cot
cud - 奇跡, ミラクル, 不思議
cudowny - 不思議
cudzokrain - 外人
cudzoziemiec - 外人
cug - 隙間風 (すきまかぜ), 列車
cukier - シュガー (sugar)
cukierek - 飴
cukiernia - 菓子屋
cukinia - ズッキーニ
cukrowiec lekarski - サトウキビ
ćwierćnuta - 4分音符
cychalter - ブラジャー
cyferblat - 顔 (かお, kao)
cyfra - 数字
cynk - 亜鉛
Cypr - キプロス (Kipurosu)
cyrk - サーカス
cyrkiel - コンパス
cyrkon - ジルコニウム (jirukoniumu)
cysorz - 天皇
cytat - 引用
cytologia - 細胞生物学
cytryna - レモン
cytrynat - レモン
czador - チャードル
czaj - 茶 (ちゃ, cha), お茶 (おちゃ, o cha )
czajnik - 頭 (atama)
czarna dziura - ブラックホール (burakkuhōru)
czarna owca - 厄介者
czarno-biały - 白黒
Czarnogóra - モンテネグロ
czarny - 黒い (kuroi)
czarny rynek - 闇市 (やみいち)
czarownica - 魔女
czary - 魔法
czas - 時間, 時, 一瞬, 時制, テンス
czasami - 時々, 時
czasem - 時々, 時
czasopismo - 雑誌 (ざっし)
czasownik - 動詞 (doushi)
czas to pieniądz - 時は金なり
czcionka - フォント
Czechy - チェコ (cheko)
Czeczenia - チェチェン共和国
czędo - 子供 (こども, kodomo), 子 (こ, ko)
czekać - 待
czekolada - チョコレート (chokorēto)
czemu - どうして (dōshite), なんで (nande), 何故 (なぜ, naze, なにゆえ, naniyue)
czerń - 黒, 黒色
czernica - 黒苺 (kuroichigo)
Czerniowce - チェルニウツィー
czerwiec - 六月 (ろくがつ, rokugatsu)
czerwony - 赤い
Czerwony Krzyż - 赤十字
cześć - おはよう (ohayō)
często - 屡
częstoskurcz - 頻脈 (hinmyaku)
czkawka - しゃっくり
członek - ペニス, 男根, 陰茎
człowiek - 人間 (にんげん, ningen) 人 (ひと, hito)
czołg - 戦車 (せんしゃ, sensha)
czoło - 額
czopek - 座薬 lub 坐薬 (zayaku)
czorny - 黒い (kuroi), 汚
czosnek - 大蒜 (にんにく) ninniku
czuwać - 起きる
czwartek - 木曜日 (もくようび, mokuyōbi)
czwartorzęd - 第四紀
czyhunka - トリウム
czyrak gromadny - カーバンクル 癰
czyrak mnogi - カーバンクル 癰
czyrwiec - 六月 (ろくがつ, rokugatsu)
czyrwień - 六月 (ろくがつ, rokugatsu)
czyściec - 煉獄
czysło - 数字, 数
czytać - 読
czyżyk - 少年 (shōnen)
dać - 上げる, やる
Dagda - ダグザ
daktyl - 棗椰子 (なつめやし, natsumeyashi)
dała - 上げる, やる
dalece - とても (totemo),　大変 (taihen),　非常に (hijou ni), ずいぶん
daleki - 遠
dalmatyńczyk - ダルメシアン
dama - クイーン, ヘトマン
dana - 上げる, やる
dane - データ
Dania - デンマーク (denmāku), デンマーク王国 (denmāku-ōkoku)
Daniel - ダニエル
dany - 上げる, やる
dao - 道
dawać - 上げる
dawno - ずっと
decydować - 決める, 決まる
deficyt - 赤字
dekiel - 頭 (atama)
deklinacja - 格変化, 曲用, 赤緯
delta - 三角州
demokracja - 民主主義
dentysta - 歯医者 (はいしゃ, haisha)
depok - ボタン
deptać - 踏む
deska rozdzielcza - ダッシュボード
deskorolka - スケートボード
destylacja - 蒸留 (じょうりゅう, jouryuu)
deszcz - 雨 (あめ, ame), 雨水 (うすい, usui, あまみず, amamizu)
deżdż - 雨 (あめ, ame), 雨水 (うすい, usui, あまみず, amamizu)
dezelować - 破る, 破壊する, 壊す, 粉砕する, 破れる
dezodorant - デオドラント
diabeł - あく, あくま, 悪魔
diabelski młyn - 観覧車 (かんらんしゃ)
dialekt - 方言 (ほうげん, hōgen)
diament - 金剛石, ダイヤモンド
didaskalia - ト書 (とがき)
didaskalium - ト書 (とがき)
dioda - ダイオード
diplodok - ディプロドクス (dipurodokusu)
dlaczego - どうして (dōshite), なんで (nande), 何故 (なぜ, naze, なにゆえ, naniyue)
długi - 長い (ながい, nagai)
długopis - ボールペン (bōrupen)
dłuto - 鑿 (のみ, nomi), 鏨 (たがね, tagane)
dmuchać - 吹く
Dniepr - ドニエプル川
do - へ
doberman - ドーベルマン
dobranoc - おやすみなさい (oyasumi nasai), おやすみ (oyasumi)
dobrobyt - 福祉
dobry - 良, 善良
dobry wieczór - 今晩は (こんばんは, konban wa)
dojrzewanie - 青年期
doktor - 医者, 医師
dokument - 文書
dolar - ドル
dołek - 悲しみ
dolina - 谷
dolmen - 支石墓
dom - (うち, uchi)
dom dziecka - 孤児院
domofon - インターホン
doping - ドーピング
doradca - 顧問 (komon}
doręczyciel - 郵便配達
doskonałość - 丸
dostęp - アクセス (akusesu)
dostojnik - 高官 (kōkan)
doświadczenie - 経験, 実験
do trzech razy sztuka - 三度目の正直
dotykać - 触れる
do widzenia - さようなら (sayōnara), 失礼します (しつれいします, shitsurei shimasu), それでは (sore de wa), では (de wa), じゃあ (jā)
dowódca - 校
do zobaczenia - さようなら (sayōnara), 失礼します (しつれいします, shitsurei shimasu), それでは (sore de wa), では (de wa), じゃあ (jā)
drabinka - シチョウ
dreszczowiec - スリラー映画
drewno - 木部, 木 (ki), 木材
droga - 道 (michi)
Droga Mleczna - 銀河系, 銀漢, 天の川 (amanogawa), 天の川銀河
drogi - 高い
druga wojna światowa - 第二次世界大戦 (dainijisekaitaisen)
druh - 友達 (ともだち, tomodachi)
druk - 印刷, 印刷物, フォント
drukarka - プリンター (purintā)
drukarnia - 印刷所
drumla - 口琴 (こうきん, kōkin)
drwić - 嘲る (あざける, azakeru), 嘲笑う (あざわらう, azawarau), 嘲笑する (ちょうしょうする, chōshō suru)
drybling - ドリブル
drzeć - 破る 破れる
drzemka - 昼寝, 午睡
drżenie - 震い (furui)
drzewo - 木 (ki)
dubbing - 吹き替え
duch - 幽霊, 精神, たましい, 心, 霊
Duch Święty - 聖霊
dudlać - 泣く (なく, naku), 飲む, 上がる
dudy - 肺 (hai), 肺臓 (はいぞう, haizō)
dumny - 誇
duński - デンマーク語
dupek - 野郎 (yarō)
dusza - 魂 f (Tamashī), 幽霊, 精神, たましい, 心, 霊
dutek - お金 (okane), 貨幣
duży - 大
dwukropek - コロン (koron)
dwutlenek węgla - 二酸化炭素, 炭酸ガス
dybuk - ディブク
dycki - いつも (itsumo), 常に (tsuneni)
dydek - 乳首, 胸, 乳房, 乳
dygać - 走る
dyktator - 独裁者
dylać - 踊る (おどる)
dym - 煙
dymić - 煙
dyrygent - 指揮者 (しきしゃ)
dyskietka - フロッピー
dysproz - ジスプロシウム (jisupuroshiumu)
dysputacja - 紛争
dystrykt - 区
dywan - カーペット
dziabka - 鍬
Dżibuti - ジブチ (jibuti)
dzidziuś - 赤ちゃん
dzieciszczko - 子供 (こども, kodomo), 子 (こ, ko)
dziecko - 子供 (こども, kodomo), 子 (こ, ko)
dziękówa - 有難う
dziękówka - 有難う
dziękuję - 有難う
dziękuję bardzo - ありがとうございます
dzielny - 勇 (いさましい)
dzień - 日 (ひ, hi, にち, nichi)
dzień dobry - こんにちは (konnichi wa), おはようございます (ohayō gozaimasu), おはよう (ohayō)
dziennik - ニュース
dziennikarstwo - ジャーナリズム
dziennikarz - きしゃ
dziewczynka - 少女 (shōjo)
dziki - 野性的
dziób - 嘴
dziś - 今日 (きょう, kyō)
dzisiaj - 今日 (きょう, kyō)
dziwny - 不思議
dżoker - ジョーカー
dżudo - 柔道
dżungla - ジャングル (janguru)
dźwięk - 音
Edirne - エディルネ
edyficjum - 建築物, 建物
Edyta - エディータ
Egipt - エジプト (ejiputo)
egzamin - 試験
egzamin wstępny - 入学試験 (にゅうがくしけん, nyūgakushiken)
egzystencja - 存在
einstein - アインスタイニウム (ainsutainiumu)
ejakulacja - 射精
ejber - 男の子, 少年, 彼, カレ, 彼氏, カレシ
ekologia - 生態学
ekologio - 生態学
ekosystem - 生態系
ekran - 画面
ekspert - 家
eksperyment - 実験
ekstrawagancki - 強勢
ekstremalnie - 大変
Ekwador - エクアドル (Ekuadoru)
elektrownia - 発電所
elektrownia wodna - 水力発電所
elektryczność - 電気学, 電気, 電流
elita - エリート
e-mailowy - 電子メールの
Emili - エミリア
Emilia - エミリア
endokrynologia - 内分泌学
endonim - 内名
endorfina - エンドルフィン
entalpia - エンタルピー entarupii
entalpia swobodna - ギブズエネルギー Gibusu enerugii
entropia - エントロピー entorupii
entuzjazm - 熱意
epilepsja - てんかん
erekcja - 勃起 (ぼっき)
erupcja - 噴火
Erytrea - エリトリア (eritoria)
eskalator - エスカレーター
eskulap - 医者, 医師
esperanto - エスペラント
Estera - エステル
Estonia - エストニア (Esutonia)
estoński - エストニア語
Etiopia - エチオピア (echiopia)
etopozyd - エトポシド
etyka - 倫理学
etymologia - 語源学 (ごげんがく, gogengaku), 語源 (ごげん, gogen)
eufemizm - 婉曲法 (えんきょくほう)
Europa - ヨーロッパ, 欧州, ユローパ島
Europa Zachodnia - 西ヨーロッパ
eutanazja - 安楽死
ewolucjonista - 進化論者
Ezechiel - エゼキエル
facet - 男 (おとこ, otoko) / 男性 (だんせい, dansei)
facetka - 女 (おんな, onna) / 女性 (じょせい, josei)
facjata - 顔 (かお, kao)
fajfus - ペニス, 男根, 陰茎
faks - ファックス
faksymile - 複写
falafel - ファラフェル
familio - かぞく (kazoku)
familok - マンション
famuła - かぞく (kazoku)
fan - ファン
fanar - パンダ目
fanatyzm - 熱狂
fandzolić - 嘘を吐く (うそをつく, usowotsuku)
farmakologia - 薬理学
faryna - シュガー (sugar)
fasola - 荏
fatwa - ファトワー
faul - ファウル
fawela - ファヴェーラ
fedrować - 蹴る
fenek - フェネック
Fenicja - フェニキア
fermentacja - 酵
fest - とても (totemo),　大変 (taihen),　非常に (hijou ni), ずいぶん
festiwal - フェスティバル
feta - フェタチーズ, アンフェタミン
Fidżi - フィジー (fijī)
figiel - 悪戯
figura retoryczna - 修辞技法
Filip - フィリップ
Filipińczyk - フィリピン人
Filipiny - フィリピン
film - 映画 (eiga), フィルム
filok - ボールペン (bōrupen)
filozof - 哲学者
filtr - フィルター
Finlandia - フィンランド
fioł - スミレ
fiołek - スミレ
fiżon - 荏
flep - 文書
flet - フルート, 笛
fliger - 飛行機, 機
Florencja - フィレンツェ
fluid - ファンデーション
fluoksetyna - フルオキセチン
fluor - フッ素
fogelka - 遊園地
fojerman - 消防士 (shōbōshi)
folder - フォルダー
fonetyka - 音声学 (おんせいがく)
fontanna - 噴水
forhang - カーテン
forma - 外形 (がいけい, gaikei), 形 (かたち, katachi), 体調 (たいちょう, taichō), 型 (かた, kata), 形式 (けいしき, keishiki), ～形 (～けい, -kei)
formalny - フォーマル
formoterol - ホルモテロール
fort - 要塞 (ようさい, yōsai)
forta - 鳥居
forteklapa - ピアノ
fortepian - ピアノ
fortuna - 財産
forum - フォーラム
foryster - 外人
fosfor - リン, 燐
fotografia - 写真, フォト
fotografie - 写真, フォト
fotorealizm - スーパーリアリズム
fototropizm - 屈光性 (くっこうせい), 向日性 (こうじつせい, こうにちせい)
fowizm - フォーヴィスム
Francja - フランス (furansu)
francuski - フランス語, 仏語
francuski pocałunek - ディープ・キス
Francuz - フランス人 (furansujin)
frans - フランシウム (furanshiumu)
frechowny - 厚かましい
frutarianizm - 果実食主義
frytka - フライドポテト
fryzura - 髪型
Fudżi - 富士山
fulać - 嘘を吐く (うそをつく, usowotsuku)
fundamentalny - 基本
fundusz - ファンド
funkcja - 役
fura - 車 (くるま, kuruma), 自動車 (じどうしゃ, jidōsha), カー
furdygarnia - 刑務所
furgać - 飛
furosemid - フロセミド
fusbal - サッカー
futbol - サッカー
fyjderbiksa - 筆箱, 筆入れ
fyjderkasta - 筆箱, 筆入れ
fyrtel - 付近
Gabon - ガボン
Gad - ガド
gadałka - フェアリー
gadolin - ガドリニウム (gadoriumu)
gag - 冗談 (jōdan)
gajer - 背広 (せびろ)
gała - め (me), 目, アイ, サッカー, 烏 (からす, karasu)
galaktyka - 銀河系
gałąź - 枝 (えだ)
Galilea - ガリラヤ
galoty - ズボン
Gambia - ガンビア
gambit - ギャンビット
gangol - 背広 (せびろ)
gapa - 烏 (からす, karasu)
gara - 眠り (ねむり, nemuri), 夢 (ゆめ, yume), 希望 (きぼう, kibō), 望み (のぞみ, nozomi), 昼寝, 午睡
garnitur - 背広 (せびろ)
gasa - 道 (みち, michi), 道路 (どうろ, dōro)
gasnąć - 消える (きえる, kieru)
gatunkowizm - 種差別
gazeta - 新聞 (shinbun)
gdyby - なら, ならば
gdyż - なぜなら (názenara), だって (datte), から
gdzie - どこ, 何処, 奈辺
gdziekolwiek - どこでも
geburstag - 誕生日
gędźba - 音楽 (おんがく ongaku)
genetyka - 遺伝学
Genewa - ジュネーヴ (junēvu)
geografia - 地理学
geologia - 地質学
geomancja - ジオマンシー
geriatria - 老人医学
germański - ドイツの (doitsu no), 独- (doku-), ドイツ語 (doitsugo),　独語 (dokugo)
gęś - ガチョウ
Ghana - ガーナ
gibki - 速い, 急速
gibko - 速い
gierada - 持参金 (jisankin)
gimnastyka - 体操
ginekologia - 婦人科学
gira - 足
gitara - ギター
głąb - 深, ふかみ
glacok - 禿げ
glajza - トリウム
glapa - 烏 (からす, karasu)
głaskać - なでる
głębia - 深, ふかみ
głęboki - 深, 深 のある, 濃
głęboko - 深く
głębokość - 深さ • 深浅
glicerol - グリセリン
gliceryna - グリセリン
glin - アルミニウム
glina - 粘土, けいかん (keikan) 警官
gliniarz - けいかん (keikan) 警官
globus - 頭 (atama)
głód - 飢え
głowa - 頭 (atama)
główka - 死刑
głównie - 主に
głuchy - 耳 が聞
glukoza - グルコース
gmina - グミナ
gnat - 骨 (ほね, hone), 賽子,骰子 (さいころ, saikoró), サイコロ
gniazdo - 巣 (す, su), コンセント (konsento), スロット (surotto)
gnić - 腐敗する
gniew - 怒り
gnój - 厩肥
gnot - 子供 (こども, kodomo), 子 (こ, ko)
gnu - ヌー (nū)
go - 囲碁, 碁
goban - 碁盤
Godzilla - ゴジラ
godzina policyjna - 門限 (もんげん, mongen)
godzinnik - 時計 (tokei)
golem - ゴーレム
gongil - カタル, 風邪, 鼻水, 水っ洟
gonić - 追, 追掛
goniec - ビショップ
googlować - ググる • ググル • ぐぐる
gora - 火事 (かじ)
góra - 山 (サン / やま)
górą - 山 (サン / やま)
górnictwo - 鉱業
gorzała - アルコール, 酒, お酒, 御酒
gorzałka - おさけ, さけ, 酒, お酒, 御酒
gorzoła - おさけ, さけ, 酒, お酒, 御酒
gość - 客
gospodyni domowa - 主婦
gotyk - ゴシック
gra - ゲーム (gēmu)
graba - 手 (て, te), 手札 (てふだ, tefuda), ハンド (hando)
gracz - 選手 (せんしゅ, senshu)
grad - 氷雨 (ひさめ, hisame), 雹 (ひょう, hyō), 雨霰 (あめあられ, amearare), グラード (gurādo)
gram - グラム
granatowy - 紺
granica - 国境 (くにざかい, kunizakai, こっきょう, kokkyō)
grappa - グラッパ
grawiton - 重力子
Grecja - ギリシア, ギリシャ
grecki - ギリシア語
greka - ギリシア語
Grenlandia - グリーンランド
grobowiec - ピアノ
gromadzić - 集
gros - ダース
gruby - 厚い
grudzień - 12月, 十二月
grupa - 連
gryf - グリフォン
grzbiet - 尾
guglać - ググる • ググル • ぐぐる
Gujana Francuska - フランス領ギアナ
gułag - グラグ
guli - なぜなら (názenara), だって (datte), から
guma - コンドーム
gumka - |消しゴム, 輪ゴム, コンドーム
guzik - ボタン
gwałt - 暴力
gwałtowny - 急速
gwiazda - 星 (ほし, hoshi), 恒星 (こうせい, kōsei)
gwiazdka - クリスマス・イヴ
gwiazdozbiór - 星座
Gwinea Bissau - ギニアビサウ
Gwinea Równikowa - 赤道ギニア (せきどうギニア, sekidō ginia)
gzub - 子供 (こども, kodomo), 子 (こ, ko), 御腹
haczka - 鍬
hafn - ハフニウム (hafuniumu)
haiku - 俳句
Haiti - ハイチ (Haichi)
hajtok - ナイフ (naifu), 刃
hałaśliwy - うるさい, やかましい
halo - もしもし
hamburger - ハンバーガー
hańbić - 汚
handel - 商業
hara - おさけ, さけ, 酒, お酒, 御酒
haś - 廃物, 敢えて
hasło - パスワード
hau - ワン 'wan', キャン 'kyan'
Hawana - ハバナ
hazard - ギャンブル
haziel - 便所
heklować - 編む, あむ
heksa - 魔女
hel - ヘリウム (heriumu)
helikopter - ヘリコプター
Hellada - ギリシア, ギリシャ
Helsinki - ヘルシンキ
hemoliza - 溶血
heparyna - ヘパリン
herbata - 茶 (ちゃ, cha), お茶 (おちゃ, o cha )
Hestia - ヘスティアー
hetman - ヘトマン, クイーン
Hiacynt - ヤツェク (Yatsueku) m
hidżab - ヒジャブ, ヒジャーブ, ヘジャブ
hidźra - ヒジュラー
hiena - ハイエナ
Hieronim - ヒエロニムス
higroskopijność - 吸湿性
hinduizm - ヒンドゥー教
Hindukusz - ヒンドゥークシュ山脈
Hiob - ヨブ
hipokryzja - 偽善
hipoteza - 仮説
Hiroszima - 広島市
historia - 歴史
historyczny - 歴史的な
Hiszpania - スペイン (supein)
hiszpanka - スペインかぜ
hnet - 早速
holajza - 鑿 (のみ, nomi), 鏨 (たがね, tagane)
Holandia - オランダ (oranda)
Holandyja - オランダ (oranda)
holenderski - オランダ語
holm - ホルミウム (horumiumu)
homeopatia - ホメオパシー
homeostaza - 恒常性 (kōjōsei)
honor - 名誉
horyzont - 水平線
hotel - ホテル, 宿
hummus - フムス
huśtawka - ブランコ, ぶらんこ
hydroelektrownia - 水力発電所
i - と (to), かつ (katsu), とか (toka), や (ya)
ich - 彼らの (かれらの)
ichtiologia - 魚類学
idea - 思想
identyczny - 同
ideologia - イデオロギー
idiota - 莫迦
idol - アイドル
idole - アイドル
igła - 針
II wojna światowa - 第二次世界大戦 (dainijisekaitaisen)
ilustrator - イラストレーター (irasutorētā)
imbir - 生姜 (しょうが, shōga)
imię - 名前, ファーストネーム
imiesłów - 過去分詞 (kakobunsi)
imperator - 天皇
imperium - 帝国
implant - インプラント
imponować - 印象を与
impromptu - 即興曲 (そっきょうきょく)
i na żagiel, i na parę - バイセクシュアル
ind - インジウム (injiumu)
Indonezja - インドネシア
indonezyjski - インドネシア, インドネシア語
infekcja - 伝染 (でんせん, densen)
infrastruktura - インフラストラクチャー
inhalacja - 吸気
inkaust - インク
innymi słowy - 即ち
instrument - 楽器 (がっき), 器具 (きぐ), 器械 (きかい), 計器 (けいき)
instytucja - 機関
insulinooporność - インスリン抵抗性
inteligencja - 知力
intencja - 意思
interesujący - 面白い, 興味深い
introspekcja - 内省
inundacyja - 洪水 (こうずい, kouzui)
inwalida - 身障者 (しんしょうしゃ)
inżynier - 工兵 (kōhei)
inżynieria - 工学 (こうがく kougaku)
Irak - イラク
Iran - イラン
Irańczyk - イラン人
Irlandia Północna - 北アイルランド
irlandzki - アイルランド語
iryd - イリジウム
iście - 確かに
iskra - 火花
islam - イスラム教, イスラム
islamizacja - イスラム教化
islamizm - イスラム主義
Islandia - アイスランド (aisurando)
islandzki - アイスランドの (aisurando no), アイスランド語 (aisurando-go)
Itaka - イタキ島
italski - イタリア語
iterb - イッテルビウム (itchirubiumu)
I wojna światowa - 第一次世界大戦
Izajasz - イザヤ
izba - 平和, 部屋 (へや, heya)
izolacjonizm - 孤立主義
Izrael - イスラエル (isuraeru)
ja - 私 (わたし, watashi, わたくし, watakushi, わし, washi, あたし, atashi (f), あたい, atai (f))
jabłko - りんご (ringo) 林檎
Jacek - ヤツェク (Yatsueku) m
jadać - たべる, 食べる (taberu), 上がる
Jadwiga - ヤドヴィガ
Jagiellon - ヤギェウォ朝
jajko - 卵 (たまご, tamago)
jajko na twardo - 固ゆで卵
jajo - 卵 (たまご, tamago)
jałowiec - ジュニパー (junipā)
Jamajka - ジャマイカ (jamaika), ジャマイカ人 (ジャマイじん, jamaikajin) f, m
Jan - ヤン Yan
Japończyk - 日本人
Japonia - 日本 (にほん, nihon, にっぽん, nippon)
japoński - 日本の (にほんの, nihon no) 日本語
jara - 姑 (shūtome)
jarecka - お母さん (おかあさん, okāsan), 母 (はは, haha)
jarosz - ベジタリアン
jarski - 菜食主義の
jaskiniowiec - 穴居人
jaśmin - ジャスミン
jasnoniebieski - 水色い
jasny - 薄い, 明るい, 明らか
Jaworzno - ヤヴォジュノ
jebadło - 寝室 (shinshitsu), ベッド, 寝台
jechać - 走る
jęczmień - 物貰い
jeden - 一つ (ひとつ hitotsu), 一 (いち ichi)
jeden za wszystkich, wszyscy za jednego - 一人は皆の為に、皆は一人の為に
jednorożec - ユニコーン
jedza - 食べ物
jedzenie - 食べ物
jej - 彼女の (かのじょの)
Jemen - イエメン
jemiołuszka - 黄連雀
jeniec - 捕虜
Jeremiasz - エレミヤ
Jerycho - エリコ
jeść - たべる, 食べる (taberu), 上がる
jesień - 秋 (あき, aki)
jeśli - もし (móshi) • なら (nára) • だったら (dáttara) • ならば
jest - だ (da, ), です (desu, )
jeździec - ライダー
jeżeli - もし (móshi) • なら (nára) • だったら (dáttara) • ならば
Jezus - イエス (iesu)
Jezus Chrystus - イエス・キリスト
język obcy - 外国語
język ojczysty - 母語 (ぼご)
jeżyna - 黒苺 (kuroichigo)
jidysz - イディッシュ語
jod - ヨウ素 (yōso)
jogurt - ヨーグルト
Jonasz - ヨナ
Jordania - ヨルダン
Jowisz - 木星 (mokusei)
Jozue - ヨシュア
judo - 柔道
Judyta - ユディト
juglon - ジュグロン, ユグロン
Julian - ジュリアン
juny - 若い (わかい, wakai)
Jupiter - 木星 (mokusei)
jutro - 明日 (あした, ashita, あす, asu, みょうにち, myōnichi)
kabaczek - ズッキーニ
kaban - 豚 (ぶた)
kabat - コート (kōto)
kabuki - 歌舞伎
Kabul - カーブル
kaczan - 深, ふかみ
kaczka - 鴨 (kamo)
kadzidło - 香 (kō)
Kafarnaum - カペナウム
kafej - 喫茶店
kaffa - コーヒーの木 (kōhī-no-ki), コーヒー, 珈琲 (kōhī)
kaj - どこ, 何処, 奈辺
kajak - カヤック
kaki - かき (柿, kaki)
kalafa - 顔 (かお, kao)
kalafior - カリフラワー
kalapitra - 頭 (atama)
kalejdoskop - 万華鏡
kalfas - 御腹
kaliforn - カリホルニウム (karihoruniumu)
kaligrafia - カリグラフィー
kalkulator - 電卓, 計算機
kam - どこ, 何処, 奈辺
Kambodża - カンボジア
kamera - ビデオカメラ
Kamerun - カメルーン
kamfora - 樟脳
kamień - 石 (いし), 歯石 (しせき, )
Kanada - カナダ (kanada)
kanalizacja - 下水道
Kanał Sueski - スエズ運河 (スエズうんが)
kanapka - サンドイッチ
kangur - カンガルー
kanopa - カノプス壺
kąpać - 浴びる
kąpiółka - 風呂場 (furoba), 浴室 (yokushitsu)
kapitalizm - 資本主義
kapusta - キャベツ, お金 (okane), 貨幣
kara - 罰
karaba - 猫 (ねこ, neko)
karabin maszynowy - 機関銃
karakuł - カラクール
kara śmierci - 死刑
karbunkuł - カーバンクル 癰
kardamon - カルダモン
kardiolog - 心臓学医
kardiologia - 循環器学
kardynał - 枢機卿
karetka - 救急車
kark - 項
karlus - 少年 (shōnen)
karma - 餌 (えさ, esa), 業 (ごう, gō)
karo - ダイヤ
karta - トランプ
karta do gry - トランプ
karta graficzna - ビデオカード
kartofel - ジャガイモ
kasiarz - 財産家
kasyno - カジノ
Katalonia - カタルーニャ州
katana - 日本刀, 刀
katar - カタル, 風邪, 鼻水, 水っ洟
Katar - カタール
katastrofa - 災害
Katmandu - カトマンズ
Katyń - カティンの森事件
kawa - コーヒーの木 (kōhī-no-ki), コーヒー, 珈琲 (kōhī)
kawaler - 独身
kawiarnia - 喫茶店
kawon - 水瓜
kawowiec - コーヒーの木
Kazachstan - カザフスタン (kazafusutan)
kazalnica - 講壇
kazanie - 説教
kazatelnica - 講壇
kazeina - カゼイン
kciuk - 親指
kędy - どこ, 何処, 奈辺
kejter - 犬 (いぬ, inu)
kejza - チーズ
Kenia - ケニア (Kenia)
kenotaf - 慰霊碑
kenotafium - 慰霊碑
khmerski - クメール語
kiecka - ドレス
kieł - 犬歯
kiełbasa - ソーセージ (sōsēji)
kiepeła - 頭 (atama)
kier - ハート
kierownictwo - 弁理
kierz - 文字化け (もじばけ, mojibake)
kierzek - 文字化け (もじばけ, mojibake)
kij - バット (batto)
Kijów - キエフ
Kilimandżaro - キリマンジャロ
kilogram - キログラム
kimać - 寝る
kimono - 着物, 眠り (ねむり, nemuri), 夢 (ゆめ, yume), 希望 (きぼう, kibō), 望み (のぞみ, nozomi)
kino - 映画館 (えいがかん)
kintop - 映画館 (えいがかん), 遊び
kipiatok - お湯 (おゆ, oyu)
kira - おさけ, さけ, 酒, お酒, 御酒
kireja - コート (kōto)
Kirgistan - キルギス (Kirugisu)
kiszka - 牛乳 (ぎゅうにゅう, gyūnyū), ミルク (miruku)
kit - 嘘
kłąb - かせ
kłącze - リゾーム
klajdać - 身 に付ける, 着る, 履く
kłamać - 嘘を吐く (うそをつく, usowotsuku)
kłamca - 嘘吐き
kłamczuch - 嘘吐き
klamot - 石 (いし), 歯石 (しせき, )
kłamstwo - 嘘
kłapaczka - 口 (くち, kuchi)
klapsznita - サンドイッチ
klarnet - クラリネット
klasa - クラス
kłaść - 寝かせる, 寝かす, 寝る
klaser - アルバム
klaustrofobia - 閉所恐怖症
klej - 糊 (のり)
klimat - 気候
klisza - フィルム
kłócić - 争う
kłódka miłości - 愛の南京錠
klon - カエデ, クローン
kłótnia - 喧嘩, 口論, 口 喧嘩
kluć się - 孵る (kaeru), かえる
klucz - キーを (kī o)
kluft - 服 (fuku), 被服
kluza - 刑務所
knebel - 猿轡
knefel - ボタン
kniądz - 王子
knipa - 本　(ほん, hon)
koafiura - 髪型
kobalt - コバルト
kobiecy - 女性 の, 女 の, 女性 らしい, 女 らしい
kobieta - 女 (おんな, onna) / 女性 (じょせい, josei)
kochać - 恋する (koisuru), 愛する (aisuru)
kochan - 情夫
kochanek - 情夫
kochany - だいすき, 大好き
kociamber - 猫 (ねこ, neko)
kod kreskowy - バーコード
kofeina - カフェイン
kogeneracja - コジェネレーション
koja - ベッド, 寝台
kojo - ベッド, 寝台
kokoszka - バン
kołacz - カラーチ (karāchi)
kolano - 膝
kołchoz - コルホーズ
koleś - 男 (おとこ, otoko) / 男性 (だんせい, dansei)
koło - 円, 丸, 車輪, ウィール, ホイール
Kołobrzeg - コウォブジェク
kolor - 色, 色彩
koloryt - 色彩
Kolumbia - コロンビア (Koronbia)
Kolumbia Brytyjska - ブリティッシュコロンビア州
komar - 蚊 (か, ka)
komiks - 漫画 (manga)
komin - 煙突
komisariat - 警察署
komoku - 小目
komora - 房, 薬室
komp - コンピュータ (kompyūta), 計算機, パソコン (pasokon)
kompas - 羅針盤
kompromis - 和解
komputer - コンピュータ (kompyūta), 計算機, パソコン (pasokon)
komunizm - 共産主義
koń - 馬 (うま, uma), ナイト, ペニス, 男根, 陰茎
kóń - 馬 (うま, uma)
kończyna - 手足
kondom - コンドーム
konferencja - 会議
Konfucjusz - 孔子
konieczny - 不可欠
koń mechaniczny - 馬力
konsola - ゲーム機
konstelacja - 星座
konstytucja - 憲法
konsumpcja - 消費 (しょうひ)
kontrabas - コントラバス
kontrola - コントロール
kopać - 蹴る
Kopenhaga - コペンハーゲン
kopniak - 蹴
kopnięcie - 蹴
kopruch - 蚊 (か, ka)
kopyto - 蹄
kora - 樹皮
Koran - クルアーン
Koreanka - 韩国の女
Koreańska Republika Demokratyczna - 朝鮮民主主義人民共和国
Korea Północna - 北朝鮮
Korea Południowa - 韓国
koronka - ボビンレース, クラウン
kosa - ナイフ (naifu), 刃
kość - 骨 (ほね, hone), 賽子,骰子 (さいころ, saikoró), サイコロ
Kostaryka - コスタリカ
kosz - バスケットボール
kosztowny - 高い
koszykówka - バスケットボール
kot - 猫 (ねこ, neko)
Kotonu - コトヌー
kot perski - ペルシャ
Kozak - コサック
krajobraz - 景色, 風景
Kraków - クラクフ (kurakufu)
krasula - 牛 (うし, ushi)
krawat - ネクタイ (nekutai)
krawatka - ネクタイ (nekutai)
krawędź - 縁
kreda - チョーク
kremacja - 火葬
krew - 血 (ち, chi), 血液 (けつえき, ketsueki)
krewetka - 海老, 醤蝦
kripel - 身障者 (しんしょうしゃ)
król - 国王, 王様, キング
królowa - 女王, ヘトマン, クイーン
krosno - 機
krótki - 短い (みじかい, mijikai)
krowa - 牛 (うし, ushi)
krtań - 喉頭
kruczoczarny - 真っ黒
krwiodawca - 献血者
krwiomocz - 血尿
kryminał - 刑務所
kryptografia - 暗号論
Kryszna - クリシュナ
kryształ - クリスタル
kryzys - 危機, 不景気
krzak - 文字化け (もじばけ, mojibake)
krzem - ケイ素 (keiso)
krzesło - 椅子
krzew - 文字化け (もじばけ, mojibake)
krzyk - 悲鳴
krzywa - 曲線 (きょくせん, kyokusen)
krzywda - 不善 (ふぜん, fuzen), 曲事 (くせごと, kusegoto)
książę - 王子
książka - 本　(ほん, hon)
Księga Rodzaju - 創世記
księżniczka - 王女 王女
księżyc - 月
Księżyc - 月
ksylitol - キシリトール
kto - 誰
kto chce żyć z swojej pracy, dolegać nie trzeba - 早起きは三文の徳
kto rano wstaje, temu Pan Bóg daje - 早起きは三文の徳
ktoś - 誰
któż - 誰
Kuba - キューバ
kubek w kubek - 同
kucharz - コック, 料理人
kuchenka mikrofalowa - 電子レンジ
kuchnia - 台所
kukurydza - トウモロコシ, コーン
kula - 足
kuloodporny - 防弾
kulos - 足
kumkwat - キンカン (kinkan)
kupidło - 値段
kupować - 買う (かう, kau), 購入する (こうにゅうする)
kuraż - 勇気
kurka - バン
kurka wodna - バン
kurki - バン
kuropatwa - ヤマウズラ
kurtyzana - 遊女
kurwacik - ネクタイ (nekutai)
kusić - 起きる
kusik - キス (kisu), 接吻 (seppun)
kuśka - ペニス, 男根, 陰茎
kuskus - クスクス
kusy - あく, あくま, 悪魔
Kuwejt - クウェート
kuzaj - いとこ (itoko), 従兄弟 (itoko)
kuzyn - いとこ (itoko), 従兄弟 (itoko)
kuzynka - いとこ (itoko), 従姉妹 (itoko)
kwarantanna - けんえき
kwartalnik - 季刊雑誌
kwas akrylowy - アクリル酸
kwas foliowy - 葉酸
kwas krotonowy - クロトン酸
kwas mlekowy - 乳酸
kwatera - 宿
kwiat - 花 (はな)
kwiecień - ４月 (しがつ, shigatsu)
łabęć - 白鳥 (はくちょう, hakuchō)
łabędź - 白鳥 (はくちょう, hakuchō)
labija - 遊び
łacina - ラテン語
łacny - 易, 簡単
ląc się - 孵る (kaeru), かえる
lacz - 頭 (atama), ペニス, 男根, 陰茎, けいかん (keikan) 警官
ład - 秩序, 掃除, 順番
laga - バット (batto)
lajbik - ブラジャー
lakier do paznokci - ネールポリッシュ
laktaza - ラクターゼ (rakutāze)
łamać - 破れる
lampa - 電気, 灯, 電灯
land - 村, 田舎
laptop - ラップトップ
las - 森 (もり, mori), 林 (はやし, hayashi)
lat - 年 (ねん, nen, とし, toshi)
lata - 年 (ねん, nen, とし, toshi)
latać - 飛
lato - 夏 (なつ, natsu)
łatwość - 楽
łatwy - 易, 簡単
lawenda - ラベンダー
łazienka - 風呂場 (furoba), 浴室 (yokushitsu)
lazuryt - 瑠璃, ラピスラズリ
le - ね
łechtaczka - 陰核
lecz - ね
legalizacja - 合法化
legenda - 神話, 伝説
lęgnąć się - 孵る (kaeru), かえる
lekarka - 女医
lekarz - 医者, 医師
lekki - 軽
leksykon - 辞書
lektyka - 駕籠 (kago)
łepetyna - 頭 (atama)
lepszy wróbel w garści niż gołąb na dachu - 明日の百より今日の五十
lew - ライオン
lewica - 左党 (さとう)
lewy - ひだり
leżak - デッキチェア, 寝台
leżeć - 寝る
łgać - 嘘を吐く (うそをつく, usowotsuku)
łgarz - 嘘吐き
Lhasa - ラサ市 (ラサし), ラサ
licencja - ライセンス (raisensu)
liceum - 高校, 高等 学校
liczba - 数字, 数
liczba całkowita - 整数
liczba mnoga - 複数, 複数形 (ふくすうけい, fukusū-kei)
liczba pojedyncza - 単数
liczebnik - 数詞
liczi chińskie - レイシ
liczyć - 数, 計算する, 信頼する, 信用する
Liguria - リグーリア州
limit - 限界
limo - パンダ目
lingwistyka - 言語学
lipiec - ７月 (しちがつ, shichigatsu)
lis - 狐
liściokwiat garbnikowy - ユカン
lista dyskusyjna - メーリングリスト (mēringu risuto)
listonosz - 郵便配達
listopad - 11月, 十一月
list otwarty - 公開状 (こうかいじょう)
lit - リチウム (richiumu)
literatura - 文学
literaturoznawstwo - 文芸学
liturgia - 典礼
Litwa - リトアニア (ritoania)
liza - 溶菌
Lizbona - リスボン
lód - 氷, アイスクリーム
lodowiec - 氷河 (ひょうが)
logika - 論理学
logiko - 論理学
lokalizacja - 所 (ところ)
łokieć - 肘/肱/臂 (hiji), エル
lokomotywa - 機関車
lola - バット (batto)
Londyn - ロンドン
lorens - ローレンシウム (rōrenshiumu)
łosoś - 鮭 (さけ, sake, しゃけ, shake)
lot - フライト
lotniskowiec - 航空母艦
lotos - ハス科
lotus - ハス科
Łotwa - ラトビア (Ratobia), ラトヴィア (Ratovia)
łoże - ベッド, 寝台
łoże śmierci - 死の床 (shi no toko)
łóżko - ベッド, 寝台
lucerna - アルファルファ
ludobójstwo - ジェノサイド
Ludwik - ルドヴィコ
łudzikwiat - ４月 (しがつ, shigatsu)
łuk - 弓
Luksemburg - ルクセンブルク (rukusenburuku)
luna - 月
luńt - 犬 (いぬ, inu)
lusterko wsteczne - ドアミラー
lustro - 鏡 (かがみ, kagami)
lutet - ルテチウム (rutechiumu)
luty - ２月 (にがつ, nigatsu), 如月 (kisaragi)
łydka - 脹脛
łysy - 禿げ
łża - 嘘
mać - お母さん (おかあさん, okāsan), 母 (はは, haha)
macica - 子宮 (しきゅう)
maciek - 御腹
macierz - 行列 (ぎょうれつ, giouretsu)
mączka - ファンデーション
mafia - マフィア
Maghreb - マグリブ
magister - 校
magnetofon - テープレコーダー
magnez - マグネシウム (maguneshiumu)
magnolia - モクレン属
magnoliowate - モクレン科
maj - 五月/５月 (ごがつ, gogatsu)
majątek - 財産
majętny - お金持の
major - 少佐 (しょうさ)
majtki - パンツ, パンティー
makaron - パスタ
malarstwo - 絵画
malarz - 画家, がか
Malezja - マレーシア (mareshia)
malin - 木苺 (kiichigo)
malina - 木苺 (kiichigo)
małżeństwo - 夫婦
małżonek - 夫, 主人, ご主人, 御主人
małżonka - 夫人, 家内, 妻
mam - 母
mama - 母, 姑 (shūtome)
mammografia - マンモグラフィー
manga - (日本の)漫画 (にほんの]まんが)
manipulować - 御
mantel - コート (kōto)
mapa - 地図 (ちず, chizu)
maraton - マラソン
marka - 切手
marmurek - 大理石蛋糕
Mars - マールス, 火星
martwy - 死んでいる (shindeiru)
marzec - ３月 (さんがつ, sangatsu)
marzenie senne - 眠り (ねむり, nemuri), 夢 (ゆめ, yume), 希望 (きぼう, kibō), 望み (のぞみ, nozomi)
masa - 質量
masa krytyczna - 臨界量
mascara - マスカラ
maska - 顔 (かお, kao)
maślanka - バターミルク
masło maślane - 冗語 (じょうご)
masywny - 重い
maszyna - 機械, 機関, 機
maszyna do szycia - ミシン
maszynista - 機関士
matematyczny - 数学の
matematyk - 数学者
matematyka - 数学
materiał - 材料
matka - お母さん (おかあさん, okāsan), 母 (はは, haha)
Mauritius - モーリシャス
mąż - 夫, 主人, ご主人, 御主人
mazak - 顔 (かお, kao)
mechanika - 力学
mechanizm - 機構学
męczennik - 殉教者
meczet - モスク (mosuku)
mediana - 中間数
meduza - クラゲ
medycyna - 医学
medyk - 医者, 医師
meitner - マイトネリウム (maitoneriumu)
Meksyk - メキシコ
meksykanin - メキシコ人
melancholia - 憂鬱
melasa - 糖蜜
melatonina - メラトニン
melki - 飴
melodia - メロディ, メロディー
melodio - メロディ, メロディー
menda - 毛じらみ
mendelew - メンデレビウム (menderebiumu)
mendoweszka - 毛じらみ
Merkury - メルクリウス (merukuriusu), 水星 (すいせい, suisei)
metabolizm - 代謝
metafizyka - 形而上学
metafora - メタファー, 文
metan - メタン
metempsychoza - 輪廻 (rinne)
metoda - メソッド
metr - メートル (meetori)
metr sześcienny - 立方メートル
mewa - カモメ
mężczyzna - 男 (おとこ, otoko) / 男性 (だんせい, dansei)
miałki - 浅い
Miami - マイアミ
miasto - 都市
miażdżyca - 動脈硬化症, どうみゃくこうかしょう
micela - ミセル
Michał - マイケル (Hepburn: maikeru), ミカエル (Hepburn: mikaeru)
miecz - 剣
miecz Damoklesa - ダモクレスの剣 (damokuresu no ken)
miedźwiedź - くま (熊)
Międzynarodowa Agencja Energii Atomowej - 国際原子力機関
międzynarodowy - 国際
miejska legenda - 都市伝説
miękki - 軟らかい, 軟らか
mielcuch - 麦酒 (ビール, bīru), ビア (bia)
mierzyć - 計, 測, 試着 する, 狙
miesiąc - 月
miesiączek - 月
miesięcznik - 月刊誌, 月刊雑誌
mięso armatnie - 砲弾の餌食 (hōdan-no ejiki)
mięsopustnik - ２月 (にがつ, nigatsu), 如月 (kisaragi)
mięta - ミント
miętki - 軟らかい, 軟らか
migdał - アーモンド
migiem - たちま.ち
migotanie przedsionków - 心房細動 (shinbōsaidō)
mikrobiologia - 微生物学
mikrofalówka - 電子レンジ
Mila - エミリア
miliarder - 億万長者 (おくまんちょうじゃ, okumanchōja)
milioner - 大富豪
miłość - 愛 (あい, ai), 恋 (こい, koi), 恋愛 (れんあい, ren-ai), 愛情 (あいじょう, aijou)
miłośnik - ファン
miłostka - あいじょう
miły - 面白い
mimo - 円, 丸, 車輪, ウィール, ホイール
minerał - 鉱物
Minerwa - ミネルバ, ミネルウァ
minister - 大臣 (daijin)
minuta - 分
miód - 蜂蜜 (はちみつ, hachimitsu)
misa - ボール
misjonarz - 宣教師 (senkyōshi)
miska - ボール
Miśnia - マイセン
mistycyzm - 神秘主義
mistyka - 神秘主義
mit - 神話
mitologia - 神話学
mleko - 牛乳 (ぎゅうにゅう, gyūnyū), ミルク (miruku)
mleko sojowe - 豆乳
młody - 若い (わかい, wakai)
młodziec - 赤ちゃん, 赤ん坊
młyn - 製粉所
mnogdy - 屡
mnożyć - 増える
moda - ファッション
Modena - モデナ
modrakowy - 青い
modry - 青い
mój - 私の (わたしの)
Mojżesz - モーゼ
Mołdawia - モルドバ
molibden - モリブデン
Monako - モナコ
monarchia - 君主制
moneta - 硬貨 (こうか, kōka), コイン (koin)
monocykl - 一輪車
monopol - 独占
monopolowy - 酒店, 酒屋
monstrancja - 聖体顕示台
montować - 組み立てる
Montreal - モントリオール
moplik - モペッド, モペット, モーペッド
mora - 幽霊, 精神, たましい, 心, 霊
moralność - 道徳
morze - 海 (うみ, úmi)
Morze Adriatyckie - アドリア海 (adoriaumi)
Morze Bałtyckie - バルト海
mosiądz - 硬貨 (こうか, kōka), コイン (koin)
motocykl - オートバイ, モーターサイクル, バイク, 単車
motocyklista - モーターサイクリスト
motor - オートバイ, モーターサイクル, バイク, 単車, 機関, エンジン
motorower - モペッド, モペット, モーペッド
motorówka - モーターボート
motyka - 鍬
motyl - 蝶
motyw - 動機
Mount Everest - エベレスト
mózg - 脳 (nou)
mrówka - 蟻, あり
mrównik - ツチブタ, アリクイ
mućka - 牛 (うし, ushi)
mugol - マグル (maguru)
multyplikować - 増える
mumia - 木乃伊
mundurowy - けいかん (keikan) 警官
muraszka - 蟻, あり
Murzyn - 黒人
muza - ムーサ
muzeum - 博物館
muzyk - 音楽家
mużyk - 男 (おとこ, otoko) / 男性 (だんせい, dansei)
muzyka - 音楽 (おんがく ongaku)
my - 私達/私たち (わたくしたち, watakushi-tachi, わたしたち, watashi-tachi)
mydło - 石鹸 (せっけん, sekken)
mykita - 狐
myśl - 思考
myśleć - 考, 思
myślenie - 思考
mysz - 鼠 (ねずみ,, również szczur)
Myszka Miki - ミッキーマウス
myt - 神話
mżawka - 煙雨
nacja - 国民, 民, 国籍
naczalstwo - 弁理
naczyniak krwionośny - 血管腫 (kekkanshu)
nadzieja - 希望
nagle - 不意に
nagłówek - 題
Nairobi - ナイロビ
nalać - 破る
naloć - 破る
na pewno - 確かに
napój - のみもの (nomimono) 飲み物, 飲物
naprany - 酔っ払い (よっぱらい, yopparai), 酔っ払う (よっぱらう, yopparau), 酔い (よい, yoi), 酔う (よう, you)
naprawdę - 本当, マジで
narciarstwo - スキー
narkolepsja - ナルコレプシー
naród - 国民, 民
narodowość - 国籍
narodowy - 国家的,　国立
narodziny - うみ, 産み, 生み
narząd - 機関
na sto procent - 確かに
nastrój - 気持ち, 雰囲気
nasz - 私達の (わたしたちの)
natura - 気立て
natychmiast - 早速
natychmiastowo - 早速
nauczyciel - 先生, 教師
nauka - 科学
naukowiec - 科学者 (kagakusha)
naukowy - 科学的
nawilżać - 湿る
nazwa - 名前
nazwisko - 名前, 姓, 名字
Neapol - ナポリ
neologizm - 新語
neon - ネオン
neptun - ネプツニウム (neputsuniumu)
Neptun - 海王星
neutralność - 中立
neutralny - 中立の
neutrino - ニュートリノ
ni - いいえ(iie)
niacyna - ナイアシン
nic - 何もない
Niderlandy - オランダ (oranda)
nie - いいえ(iie)
niebawem - やがて
niebiańskie pnie - 十干
niebieski - 青い
nieć - いとこ (itoko), 従兄弟 (itoko)
niedawno - 最近
niedojrzały - 碧い, 蒼い
niedokrwienie - 虚血
niedokrwistość - 貧血
niedokrwistość tarczowatokrwinkowa - サラセミア
niedoskonałość - 不完全
nie dospać trzeba, kto chce dostać chleba - 早起きは三文の徳
niedostatek - 希少性 (kishō-sei), 不自由
niedożywienie - 栄養失調 (えいようしっちょう)
nieduch - 病気 (びょうき, byōki)
niedziela - 日曜日 (にちようび, nichiyōbi)
niedźwiedź - くま (熊)
niedźwiedzica - 雌 の熊
niedźwiedź polarny - ホッキョクグマ
niegodziwy - 浅ましい
niegrzeczny - 失礼
niehigieniczny - 不潔
nieistnienie - 非実在
niejasny - 不明
Niemcy - ドイツ (Doitsu)
nie mieć - いいえ(iie)
niemiecki - ドイツの (doitsu no), 独- (doku-), ドイツ語 (doitsugo),　独語 (dokugo)
niemiły - 不快
niemowlę - 赤ちゃん, 赤ん坊
niemożliwy - 不可能
nieoczekiwanie - 案外
nieoczekiwany - 思い掛けない, 案外
nieodpowiedni - 不便
nie od razu Kraków zbudowano - ローマは一日にして成らず (Rōma wa ichinichi ni shite narazu)
nieokreślony - 不安定
nieokrzesany - 荒い
nieostrożny - そそっかしい
niepełnosprawność - 不自由
niepewność - 不安定
niepewny - 危ない
niepodległość - 独立 (どくりつ, dokuritsu)
niepokój - 不安
niepotrzebny - 不必要
nieść - 持って行く, 運
nieściora - いとこ (itoko), 従姉妹 (itoko)
nieśmiałość - 人見知り
niespodziewanie - 不意に
niespodziewany - 思い掛けない, 案外
niespokojny - 荒い
niestabilny - 不安定
nieświadomie - 思わず
nieszczęśliwy - 不幸
nietaktowny - 失礼
nieuprzejmy - 薄情
nieurodzaj - 不作
nieuwaga - 不注意
niewiasta - 女 (おんな, onna) / 女性 (じょせい, josei)
niewiele - 少
niewolnik - 奴隷
nie wszystko złoto, co się świeci - 光る物必ずしも金ならず
niewyobrażalny - 考えられない, 思いもよらない
niewystarczający - 不十分
niezadowolenie - 不平, 不満
niezależność - 独立
niezbędny - 不可欠
niezbyt - あまり, あんまり
nieżonaty - 独身
nieźrzały - 碧い, 蒼い
niezwłocznie - 早速
niezwykle - 非常に
nigdy - 何時も (いつも, itsumo)
Nigeria - ナイジェリア
nihilizm - ニヒリズム
Nikaragua - ニカラグア
nikiel - ニッケル (nikkeru)
nikotyna - ニコチン
nikt - 誰も
nim - 彼, あの人
niski - 低い (ひくい, hikui), 質が低い (しつがひくい, shitsu ga hikui), 下等な (かとうな, katō-na)
niszczyć - 破る, 破壊する, 壊す, 粉砕する, 破れる
Nix - ニクス
no - はい (hai)
nobel - ノーベリウム (nōberiumu)
noc - 夜 (よる, yoru)
nocna zmiana - 夜勤
noga - 足
nogawice - ズボン
Norweg - ノルウェー人
Norwegia - ノルウェー (noruwē)
norweski - ノルウェーの, ノルウェー語
notatka - メモ, ノート
Nowa Zelandia - ニュージーランド (Nyū Jīrando)
nowicjat - ノビシャド
nowiutki - 新
nowotwór - 腫瘍 (shuyō)
nowy - 新
Nowy Jork - ニューヨーク
nóż - ナイフ (naifu), 刃
nożyce - 鋏 (はさみ, hasami)
nożyczki - 鋏 (はさみ, hasami)
nuda - 退屈
nudle - パスタ
nudny - 詰, 退屈
Numidia - ヌミディア
nuta - 音符
nuty - 楽譜
Nuuk - ヌーク
nyga - 蚊 (か, ka)
oaza - オアシス
obawa - 不安, 不安定
obcokrajowiec - 外人
oberżyna - ナス
obiecny - 普段の
obiektywność - 客観性 (kyakukansei)
obietnica - 約束
objaśniać - 説明 (せつめい.する)
objaw - 症候
oblewać - 浴びる
oblężenie - 包囲
obój - オーボエ
obraz - 絵画, 映像, 映画 (eiga), フィルム
obrona - 衛
obrzydliwy - 悪い, いや, 厭や, 憎い
obsługiwać - 操作する,　動かす
obywatelstwo - 市民権, 公民権, 国籍
ocean - 大洋 (たいよう), 海洋 (かいよう)
Ocean Atlantycki - 大西洋
Oceania - オセアニア
Ocean Spokojny - 太平洋
ocet - 酢
ociec - お父さん (おとうさん, otōsan), 父 (ちち, chichi)
oczywiście - もちろん
oczywisty - 明らか
od - から
oda - 頌歌
odcień - 深浅
ode - から
odmiana - クラス
odpadek - 廃物, 敢えて
odpowiedzialność - 責任
od razu - 早速
odtąd - これから, ここから
odwaga - 勇気
odwet - 復讐
odzież - 服 (fuku), 被服
ogień - 火 (hi)
ognie świętego Elma - セントエルモの火
ognisko - 焦点
ogon - 尻尾
ogórecznik lekarski - ルリジサ
ogórek - キュウリ (kyūri)
ogród - 庭 (niwa), 庭園 (teien)
ojciec - お父さん (おとうさん, otōsan), 父 (ちち, chichi)
ojczyc - 息子
ojla - 梟 (フクロウ, fukurō)
okaryna - オカリナ
okazja - 機会, 機
Okcydent - 欧米
okłamywać - 嘘を吐く (うそをつく, usowotsuku)
oko - め (me), 目, アイ
okolica - 付近
okręt podwodny - 潜水艦
okrutny - 薄情
Oksford - オックスフォード
oksiran - エチレンオキシド, オキシラン
okulary przeciwsłoneczne - サングラス
olej - 油
olejek eteryczny - 精油
olej sezamowy - 胡麻油
oliwka - オリーブ
Olsztyn - オルシュティン
oma - お祖母さん, 御祖母さん, 祖母, お婆さん, 御婆さん
Oman - オマーン
omieszkać - いいえ(iie)
omlet - オムレツ (omuretsu)
on - 彼, あの人
ona - 彼女 (かのじょ, kanojo)
one - 彼女
oni - 彼, あの人
ontologia - 存在論
oologia - 鳥卵学
opal - オパール
opalać - 焼ける
opcja - オプション
opieka - 世話
opinia - 意見
opinia publiczna - 世論
opłakać - 哀, いたむ, かなしむ, 悲
opłakiwać - 哀, いたむ, かなしむ, 悲
oprogramowanie - ソフトウェア
optymizm - 楽観, 楽観主義, 楽天主義, オプティミズム
opuszczać - 省く
Oran - オラン
oraz - と (to), かつ (katsu), とか (toka), や (ya)
ordalia - 神明裁判 (しんめいさいばん)
ordnung - 秩序, 掃除, 順番
organ - 機関
organizacja - 組織, 機関
orgazm - オルガスムス
origami - 折り紙
orkiestra - オーケストラ
ormiański - アルメニア語
orzeczenie - 述語 (じゅつご)
osa - 雀蜂
Osaka - 大阪市
ość - ほね
ósemka - 8分音符
osoba - 人
ostatnio - 最近
ostentacja - げんき
ostrężyna - 黒苺 (kuroichigo)
ostrzyć - 研ぐ (togu)
ostrzytko - 鉛筆削り (えんぴつけずり)
oszczerstwo - 冤
otwierać - 開ける
owca - 羊
owulacja - 排卵
ożarty - 酔っ払い (よっぱらい, yopparai), 酔っ払う (よっぱらう, yopparau), 酔い (よい, yoi), 酔う (よう, you)
ożyna - 黒苺 (kuroichigo)
pacha - 脇の下 (waki no shita), 腋下/腋窩 (ekika)
pacholę - 少年 (shōnen)
paciuk - 鼠 (ねずみ,, również mysz), ラット
Pacyfik - 太平洋
padaczka - てんかん
pająk - 蜘蛛 (くも, kumo)
pajęcznik - ９月 (くがつ, kugatsu), 10月 (じゅうがつ, jūgatsu), 11月, 十一月
pajęczyna - 蜘蛛の巣 (くものす)
pajucina - 蜘蛛の巣 (くものす)
Pakistan - パキスタン
pakli - もし (móshi) • なら (nára) • だったら (dáttara) • ならば
pakować - 包
pała - 頭 (atama), ペニス, 男根, 陰茎, けいかん (keikan) 警官
palacz - 喫煙者
pale - 頭 (atama), ペニス, 男根, 陰茎, けいかん (keikan) 警官
palec - 指
palenie - 喫煙
Palermo - パレルモ
Palestyńczyk - パレスチナ人
pali - パーリ語
palić - 焼く, 焼ける
pallad - パラジウム (parajiumu)
pamięć - 記憶, 思い出
pan - さん, 様 (さま)
Pan - 様 (さま)
Pan Bóg - 様 (さま)
pani - 夫人
panichida - パニヒダ
panienka - おねえさん
panna - 独身
państwowy - 国立
papeć - スリッパ
papier - 紙
papież - 教皇 (きょうこう, kyōkō)
paproć - 蕨类植物
paradygmat - パラダイム (paradaimu)
Paragwaj - パラグアイ
parasol - 傘 (かさ, kasa)
park - 公園
partner - 相手
Paryż - パリ
pasja - 受難
pasować - 合う - あう (au)
pasta do zębów - 歯磨剤
pasza - パシャ, 飼料
pasztet strasburski - フォアグラ
paw - 孔雀
pawęża - 盾, エスカッシャン, 楯状地
październik - 10月 (じゅうがつ, jūgatsu)
paździerzeń - 10月 (じゅうがつ, jūgatsu)
pazura - 手 (て, te), 手札 (てふだ, tefuda), ハンド (hando)
pedagogika - 教育学
pedofilia - ペドフィリア
pędzel - 絵筆, 筆
pejzaż - 風景画
pekator - ペニス, 男根, 陰茎
Pekin - 北京
penis - ペニス, 男根, 陰茎
pensjonat - 民宿
pępek - 臍
peptyd - ペプチド (pepuchido)
perka - ジャガイモ
perski - ペルシア語
persona - 人
perswazja - 説得
persymona - かき (柿, kaki)
Peru - ペルー
peruka - 鬘
petronelka - テントウムシ
piana - 麦酒 (ビール, bīru), ビア (bia)
pianino - ピアノ
piaskownica - 砂場
piątek - 金曜日 (きんようび, kinyōbi)
pić - 飲む, 上がる
pidżama - パジャマ, 寝間着, 寝巻き, 寝巻
piec - 焼く
piekarz - パン屋
piękno - 美 (び, bi)
piękność - 美 (び, bi)
piemontyt - 紅簾石
pień - 幹
pieniądz - お金 (okane), 貨幣
pierś - 乳首, 胸, 乳房, 乳
pierwsza pomoc - 応急処置(おうきゅうしょち)
pierwsza wojna światowa - 第一次世界大戦
pies - 犬 (いぬ, inu)
pięściarstwo - ボクシング
pieśń - 歌, 歌曲
pies policyjny - 警察犬
pies przewodnik - 盲導犬
pieszczota - 愛撫
pijany - 酔っ払い (よっぱらい, yopparai), 酔っ払う (よっぱらう, yopparau), 酔い (よい, yoi), 酔う (よう, you)
pijawa - 虹 (にじ)
pik - スペード
piksel - ピクセル
piłka - ボール
piłka nożna - サッカー
piłkarzyki - テーブル・フットボール
pinczer średni - ジャーマン・ピンシャー
pingwin - ペンギン
pionek - ポーン
piórnik - 筆箱, 筆入れ
pióro - ペン
piorun - 雷, 稲妻 (inazuma)
piosenka - 歌 (uta), 歌曲 (kakyoku)
piosenkarz - 歌手 (kashu)
Piotr - ピーター
Pireneje - ピレネー山脈
piromania - 放火癖
Pittsburgh - ピッツバーグ
piwo - 麦酒 (ビール, bīru), ビア (bia)
piżama - パジャマ, 寝間着, 寝巻き, 寝巻
Pjongjang - 平壌 (ピョンヤン)
plajster - ハニカム構造 (はにかむこうぞう, hanikamukōzō), 絆創膏 (ばんそうこう, bansōkō)
płakać - 泣く (なく, naku)
planeta - 惑星
planetarium - プラネタリウム
planista - 計画者
planta - 植物 (しょくぶつ, shokubutsu)
płaskostopie - 扁平足
plaster - ハニカム構造 (はにかむこうぞう, hanikamukōzō), 絆創膏 (ばんそうこう, bansōkō)
płaszcz - コート (kōto)
Platforma Obywatelska - 市民プラットフォーム
platfus - 扁平足
płatność - 支払い
platynki - 玉
płeć - 性別
plemię - 部族 (ぷぞく), 族 (ぞく)
plemnik - 精子
pleonazm - 冗語 (じょうご)
plik - ファイル
płonąć - 焼ける
płuco - 肺 (hai), 肺臓 (はいぞう, haizō)
pluton - プルトニウム (purutoniumu)
płynny - 液体
płyta główna - マザーボード
płytki - 浅い
po - から, ずつ
pobić - 破る
pocałunek - キス (kisu), 接吻 (seppun)
pocałunek z języczkiem - ディープ・キス
pochwa - 腟, 膣, まんこ, バギナ, ワギナ, 鞘
pociąg - 列車
poczta - 郵便, 郵便局
podanie - 申し込み (もうしこみ, mōshikomi), 出願 (しゅつがん, shutsugan), 志願 (しがん, shigan), 申請 (しんせい, shinsei), 願書 (がんしょ, gansho), 言い伝え (いいつたえ, iitsutae), 伝説 (でんせつ, densetsu), 物語 (ものがたり, monogatari)
podatek - 税金
podły - 浅ましい
podnosić - 上げる, 立つ
podnóże - 麓
podstawek - 受け皿 (うけざら, ukezara)
podstawka - 受け皿 (うけざら, ukezara)
podstawówka - 小学校 (shougakkou)
poduszka - ダイヤ
poduszka powietrzna - エアバッグ
podwozie - 脚
podwyższać - 上げる
pogaństwo - ペイガニズム
pogląd - 思想
pogranicze - 界
pojawiać się - 現れる
pojazd - 車 (kuruma)
pojutrze - 明後日
pokój - 平和, 部屋 (へや, heya)
pokonywać - 破る
polibuda - 理工学部
policja - 警察
policjant - けいかん (keikan) 警官
poliginia - 一夫多妻
poligynia - 一夫多妻
polistyren - ポリスチレン
politechnika - 理工学部
politeizm - 多神教
polityka - 政治 (seiji)
połóg - 分娩
polon - ポロニウム (poroniumu)
połowa - 半
półowa - 半
półsamogłoska - 半母音 (はんぼいん)
Polska - ポーランド (pōrando)
polski - ポーランドの, ポーランド語
południowy wschód - 南東 (なんとう)
pomidor - トマト (tomato)
pomijać - 省く
pomnik - モニュメント, 像
pomoc - 助
Pomorze - ポモージェ
pompka - 腕立て伏せ
pomysł - 思い付き, 思想
poniedziałek - 月曜日 (げつようび, getsuyōbi)
ponieważ - なぜなら (názenara), だって (datte), から
popołudnie - 午後 (ごご, gogo)
poprawny - 正
populizm - ポピュリズム
poród - 分娩
portki - ズボン
Portugalczyk - ポルトガル人
Portugalia - ポルトガル (porutogaru)
portugalski - ポルトガル語
poruszać - 動く
porządek - 秩序, 掃除, 順番
posag - 持参金 (jisankin)
postanawiać - 決める, 決まる
pot - 汗
potas - カリウム
potop szwedzki - 大洪水時代
potrzeba jest matką wynalazków - 必要は発明の母
potrzebować - 要る (いる), 必要とする (ひつようとする)
potwierdzenie - 承認
potwór - 怪物
powiat - 郡
powiestka - 名前, ファーストネーム
powietrze - 空気, 空中
powitanie - あいさつ
powód - 理由
powodować - 起こす
powódź - 洪水 (こうずい, kouzui)
powodzenia - がんばって (ganbatte)
powstanie warszawskie - ワルシャワ蜂起 (warushawahouki)
powstawać - 立つ
powstrzymywać - 押さえる
powtarzać - 復習する
pożar - 火事 (かじ)
pozawczoraj - 一昨日
pozdrawiać - あいさつする
pozdrowienie - あいさつ
pozostałość - 残り
pożywienie - 食べ物
praca - 労働
praca domowa - 宿題
prącie - ペニス, 男根, 陰茎
prąd - 電流, 電力, 水流, 水 の流, 傾向
pradziadek - 曾祖父 (そうそふ, sōsofu)
Praga - プラハ
pralka - 洗濯機 (せんたくき)
prawa człowieka - 人権
prawa ręka - 手 (て, te), 手札 (てふだ, tefuda), ハンド (hando)
prawa zwierząt - 動物の権利
prawda - 真理 (shinri), 実, 真実
prawda w oczy kole - 良薬は口に苦し
prawdziwych przyjaciół poznaje się w biedzie - まさかの友は真の友
prawie - ほとんど
prawo dżungli - 弱肉強食
Prawo i Sprawiedliwość - 法と正義
prazeodym - プラセオジム (puraseojimu)
prażyć - 焼, 炙,　ローストする,　炒
prędko - 速い
prefektura - 県
prekariat - プレカリアート
premier - 首相, 内閣総理大臣
prezentacja - プレゼンテーション
prezerwatywa - コンドーム
prezydent - 大統領 (daitōryō)
prima aprilis - 万愚節 (ばんぐせつ), エイプリルフール
primogenitura - 長子相続制 (ちょうしそうぞくせい)
problem - 問題
procek - プロセッサ
procesor - プロセッサ
produkcja - 製造業
program - 番組
prom - フェリー (ferii), フェリーボート
promenada - 遊歩道
promet - プロメチウム (puromechiumu)
promień - 半径 (hankei)
propanotriol - グリセリン
proroctwo - 予言
prorok - 予言者, 預言者
prosię ziemne - ツチブタ, アリクイ
prosty - 簡単
protaktyn - プロトアクチニウム (purotoakuchiniumu)
prowadzenie - 案内
prowadzić - 案内する
prowansalski - オック語
prowiant - 食料
próżnia - 真空
Prusy - プロイセン
prycza - 寝台
prysznic - シャワー
prywatny - 私立
przać - 恋する (koisuru), 愛する (aisuru)
przebiegły - 腹黒い
przebój - ヒット
przeciąg - 隙間風 (すきまかぜ)
przeciwutleniacz - 抗酸化物質
przede wszystkim - 主に
przedimek - 冠詞
przedpokój - 廊下 (rōka), 回廊 (kairō)
przedwczoraj - 一昨日
przegrywać - 敗れる, 負ける
przekaźnik - 継電器
przekonanie - 信念
przelewać - あふれる
przełożony - 上役
przemoc - 暴力
przemysł - 工業, 産業
przenośnia - メタファー, 文
przepiórka - ヨーロッパウズラ
przepowiednia - 予言
przepraszam - 御免 (gomen), すみません
przestępca - 刑事
przestępstwo - 犯罪
przeświadczenie - 信念
przeszczep - 移植
przeważność - 勇気
przewlekły - 慢性的
przewodnik - 案内人
przeziębienie - 風邪 (かぜ)
przeznaczenie - 運命
przoć - 恋する (koisuru), 愛する (aisuru)
przyczyna - 理由
przydomek - あだ名 (あだな)
przyjaciel - 友達 (ともだち, tomodachi)
przyjaźń - 友愛 (ゆうあい), 友好 (ゆうこう), 親善 (しんぜん), 友情 (ゆうじょう), 断金 (だんきん), フレンドシップ, 和親 (わしん), 友誼 (ゆうぎ), 親好 (しんこう)
przyjemny - 面白い
przyjmować - 服用する
przykazanie - 戒
przymiotnik - 形容詞 (kejiōsi)
przypominać - 思い出す
przypuszczać - 思う
przysadka mózgowa - 下垂体
przysięgać - 誓う (ちかう, chikau)
przysłówek - 副詞
przystanek autobusowy - バス停
pseudonauka - 疑似科学
pseudonim - 字, あざな
psiarnia - 警察
psisko - 犬 (いぬ, inu)
psowate - イヌ科
pstrąg - 鱒
psuć - 腐敗する
psychoza - 精神病
ptak - 鳥 (とり, tori), ペニス, 男根, 陰茎
ptasia grypa - トリインフルエンザ
ptaszę - 鳥 (とり, tori), ペニス, 男根, 陰茎
publiczny - 公立
puder - ファンデーション
pupa - お尻
purpuryna - プルプリン
puste - 空
pustka - 明き
pusty - 空
pustynia - 砂漠
puszka - 刑務所, 麦酒 (ビール, bīru), ビア (bia)
putnia - バケツ (baketsu)
pycha - 高慢 (kōman), 傲慢 (gōman)
Pyjter - ピーター
pyra - ジャガイモ
pyszny - おいしい, 美味しい
pyta - ペニス, 男根, 陰茎
pytanie - 問題
pytanie retoryczne - 反語
rąbek - スカーフ (sukāfu), ハンカチ (hankachi)
rachatłukum - 葛餅, くずもち, ロクム (kuzumochi)
rachować - 数, 計算する, 信頼する, 信用する
raciądz - 騎士
rad - ラジウム (rajiumu)
radio - ラジオ
Radom - ラドム
radon - ラドン
Rajch - ドイツ (Doitsu)
rakuski - オーストリアの
RAM - ラム
ramadan - ラマダーン
rana - 傷
rap - ラップ
rasizm - 人種差別, レイシズム
razdziawa - 烏 (からす, karasu)
reakcja - リアクション
reaktor - リアクター riakutaa
reaktor katalityczny - 三元触媒
ręce do góry - 手を上げろ
recesja - 不況, 不景気, 景気後退 (けいきこうたい)
ręcznik - タオル
reggae - レゲエ
ręka - 手 (て, te), 手札 (てふだ, tefuda), ハンド (hando)
rekin - 鮫 (サメ, same)
rekomendacja - 推薦
rekomendować - 推薦する
relacja - 関係
remiza - 消防署
ren - レニウム (reniumu)
reprezentacja - 代表
Republika Czeska - チェコ共和国 (チェコきょうわこく, cheko-kyowakoku)
Republika Korei - 大韓民国
respekt - 尊敬 (そんけい, sonkei)
rewolucja francuska - フランス革命
rezygnacja - 思い切り
reżyser - 監督
riksza - 人力車, 自転車タクシー
risotto - リゾット
robić - やる
robić na drutach - あむ
robotyka - ロボット工学 (ロボットこうがく)
rod - ロジウム (rojiumu)
rodzajnik - 冠詞
rodzić - 生む
rodzice - 親, 両親, 父母
rodzina - かぞく (kazoku)
rok - 年 (ねん, nen, とし, toshi)
rola - 役
romantyzm - ロマン主義 (ロマンしゅぎ)
rondo - ラウンドアバウト
Rosja - ロシア (roshia)
roślina - 植物 (しょくぶつ, shokubutsu)
rosyjski - ロシア語
rouza - 薔薇 (bara), バラ
równanie - 方程式 (hōteishiki)
również - また (mata), も (mo), やはり, やっぱり, やっぱ
równik - 赤道
równina - 平野 (へいや)
równowaga - 安定
róża - 薔薇 (bara), バラ
rozdzielać - はい, ふ
rozjaśnić - 明ける
rozkoszować się - 楽しむ
różnica - 差 (さ, sa)
rozsierdzie - 怒り
roztargniony - 上の空
rozważanie - 思考
rubid - ルビジウム
ruchome schody - エスカレーター
rudny - 赤い
Rudolf - ルドルフ
rugby - ラグビー
rumianek - カモミール, カモマイル
Rumunia - ルーマニア
ruszać - 動く
Rut - ルツ
ruten - ルテニウム
rutherford - ラザホージウム (razahōjiumu)
rutyna - ルチン
rwać - 破る 破れる
ryba - 魚 (さかな, sakana)
Ryby - 魚座 (うおざ, uoza)
rycerz - 騎士
ryma - カタル, 風邪, 鼻水, 水っ洟
rysować - 描
rysunek - 絵
rywal - ライバル
rywalizować - 争う
ryż - 御飯, 米穀
rzadko - 滅多に
rząd marionetkowy - 傀儡政権
rzeczownik - 名詞 (meishi)
rzeczywistość - 現実, 実在
rzeka - 川 (セン / かわ)
rzut karny - ペナルティーキック
Rzym - ローマ
sadzić - 植
sądzić - 思う
sagan - 頭 (atama)
Saipan - サイパン島
sałata - タクシー (takushī)
sałatka - サラダ
salceson - けいかん (keikan) 警官
Salwador - エルサルバドル (erusarubadoru)
samar - サマリウム (samariumu)
samiec - 雄/牡 (おす)
Samoa Amerykańskie - アメリカンサモア
samobójca - 自殺者 (jisatsusha)
samobójstwo - 自殺 (jisatsu)
samochód - 車 (くるま, kuruma), 自動車 (じどうしゃ, jidōsha), カー
samogon - 密造酒
samolot - 飛行機, 機
Samuel - サムエル
Sardynia - サルデーニャ島
sarnapa - キリン
sąsiedztwo - 付近, 界隈
Saturn - サターン
sceptycyzm - 懐疑主義
schody ruchome - エスカレーター
ścichapęk - 思い掛けない, 案外, 不意に
ściemniać - 嘘を吐く (うそをつく, usowotsuku)
seaborg - シーボーギウム (shibōgiumu)
sekret - 秘密, 機密
seksapil - 色気
seks oralny - オーラルセックス
seksualność - 人間の性
seksuologia - 性科学
selen - セレン
seler - セロリ (serori)
sen - 眠り (ねむり, nemuri), 夢 (ゆめ, yume), 希望 (きぼう, kibō), 望み (のぞみ, nozomi)
sencha - 煎茶
separatyzm - 分離主義
sepsa - 敗血症 (haiketsushō)
ser - チーズ
Serbia - セルビア
Serbia i Czarnogóra - セルビア・モンテネグロ (Serubia Monteneguro)
serdeczny - 厚い
sernik - カゼイン
serologia - 血清学
Seul - ソウル (souru)
siadać - 座る
siarka - 硫黄 (いおう)
siarkowodór - 硫化水素 (りゅうかすいそ)
siatkówka - バレーボール (bareebooru), 網膜 (moumaku)
sieć - 罔, 網, 下駄, ゲタ
sieczeń - ２月 (にがつ, nigatsu), 如月 (kisaragi)
siedem grzechów głównych - 七つの大罪
Siedlce - シェドルツェ
siedzieć - 座る
siedzieć po turecku - あぐらをかく
sierociniec - 孤児院
sierpień - ８月 (はちがつ, hachigatsu)
siestrzan - 甥
siestrzeniec - 甥
sikać - おしっこをする
sikh - シーク (shīku)
silnik - 機関, エンジン
silno - とても (totemo),　大変 (taihen),　非常に (hijou ni), ずいぶん
sin - sin
Singapur - シンガポール
siodło - 鞍 (くら, kura)
sioło - 村, 田舎
siostra - 姉妹 (しまい, shimai) / お姉さん (おねえさん, onēsan) (starsza siostra) / 妹 (いもうと, imōto) (młodsza siostra)
siostrzan - 甥
siostrzanek - 甥
siostrzeniec - 甥
sirpień - ８月 (はちがつ, hachigatsu)
siurać - おしっこをする
skand - スカンジウム
Skandynawia - スカンディナヴィア
skaner - イメージスキャナ
skarb - 宝
składać - 組み立てる
sklep monopolowy - 酒店, 酒屋
sklep rybny - 魚屋
skoczek - ナイト
skok wzwyż - 走高跳 (はしりたかとび)
skomplikowany - 複雑
skórka pomarańczowa - セルライト
skoro - なら • ならば
skra - 火花
skrucha - 反省
skrzynia biegów - トランスミッション
skrzyp polny - スギナ
skuter - スクーター
słaby - 薄い
śledź - ネクタイ (nekutai)
śledziona - 脾臓
śleptać - 泣く (なく, naku)
ślimak - 蝸牛 (katatsumuri), 舞舞 (maimai)
ślips - ネクタイ (nekutai)
słodki - 甘, 可愛い
słodkowodny - 淡水の
słojerz - カーテン
słomiany ogień - 竜頭蛇尾
słony - 塩辛い
słowa - 言葉 (ことば, kotoba)
Słowianin - スラブ人
słownik - 辞書 (じしょ, jisho), 辞典 (じてん, jiten)
słowo - 言葉 (ことば, kotoba)
ślub - 結婚式
smacznego - 召し上がれ（めしあがれ）
smartfon - スマホ
śmieć - 廃物, 敢えて
śmierć - 死 (し, shi), 死, 死神 (しにがみ, shinigami)
śmietana - クリーム
śmigać - 走る
smutek - 悲しみ
smutniak - パン (pan)
smutny - 悲 (かなしい)
śnieg - ゆき, 雪
śnieżnobiały - 真っ白い
sobaka - 犬 (いぬ, inu)
sobota - 土曜日 (どようび, doyōbi)
socjologia - 社会学
soczewka kontaktowa - コンタクトレンズ
sód - ナトリウム
soi - 大豆, ダイズ
soja - 大豆, ダイズ
sok - ジュース
Solon - ソロン
Somalia - ソマリア
Sopot - ソポト (Sopoto)
sos sojowy - 醤油
sowa - 梟 (フクロウ, fukurō)
sowa śnieżna - シロフクロウ
spać - 寝る
spacer - 散歩 (sanpo)
sperma - スペルマ, サーメン
śpieszyć - 急ぐ
śpiew - 歌唱
śpiewać - 歌う (うたう, utau)
śpioch - 朝寝坊
spironolakton - スピロノラクトン
spis rzeczy - 目次
spis treści - 目次
śpiwór - シュラフザック (shura-fuzakku)
spodek - 受け皿 (うけざら, ukezara)
spodenki - パンツ
spodnie - ズボン
spokój - 安心
spółdzielnia - 協同組合
społeczna odpowiedzialność biznesu - 企業の社会的責任 (きぎょうのしゃかいてきせきにん)
spontanicznie - 思わず
spór - 紛争
spowiedź - 自白
sprawowanie - 行動
sprzeczać się - 争う
sprzedawać - 売
sprzedawca - 売り手, 売り子, 店員
sraczka - 下痢
sraka - 下痢
srebro - 銀 (ぎん, gin, しろがね, shirogane)
średniowiecze - 中世
środa - 水曜日 (すいようび, suiyōbi)
stabilność - 安定
stać - 立つ
stagnacja - 不況
stal - 鉄鋼 (tekkō)
stanąć - 立ち上がる, 立ち止まる
stan cywilny - 婚姻の有無
stanik - ブラジャー
stanowczy - 強
stanowisko - 役, 立場
Stany - アメリカ合衆国 (Amerika Gasshuukoku), 米国 (べいこく, beikoku)
Stany Zjednoczone - アメリカ合衆国 (Amerika Gasshuukoku), 米国 (べいこく, beikoku)
Stany Zjednoczone Ameryki - アメリカ合衆国 (Amerika Gasshuukoku), 米国 (べいこく, beikoku)
stare miasto - 古, 都市
starka - お祖母さん, 御祖母さん, 祖母, お婆さん, 御婆さん
starorzecze - 三日月湖 (mikazukiko)
staroświecki - 古い, 古めかしい
starszy - お父さん (おとうさん, otōsan), 父 (ちち, chichi)
stary - 古
Stary Testament - 旧約聖書
staw - 池, 関節
stawiać - 立てる
sterczeć - 立つ
stężenie - 濃度
stojeć - 立つ
stół - テーブル
stolik - テーブル
stomatolog - 歯医者 (はいしゃ, haisha)
stosunek - 関係
stowarzyszenie - 組合
strach - 恐、恐怖
strach na wróble - 恐、恐怖
strajk - ストライキ
strąpacz - ２月 (にがつ, nigatsu), 如月 (kisaragi)
strażak - 消防士 (shōbōshi)
streszczenie - 要約 (ようやく, yōyaku)
strit - ストレート
strój - 服装
strona - 頁 (ページ, pēji), ～側 (～がわ, …gawa), 態 (たい, tai), 辺 (へん, hen), 陣営 (じんえい, jin'ei), 観点 (かんてん, kanten), 側面 (そくめん, sokumen), ウェブページ (webupēji)
stront - ストロンチウム (sutoronchiumu)
struktur - 組織
struktura - 組織
śtrykować - あむ
strzała - 矢
student - だいがくせい (daigakusei) 大学生
studnia - 井, 井戸
styczeń - １月 (いちがつ, ichigatsu)
subkontynent - 亜大陸
Sudan - スーダン
sufizm - スーフィズム
sugilit - 杉石
sukienka - ドレス
sumienie - 良心 (りょうしん, ryōshin)
sumo - 相撲
superbohater - スーパーヒーロー
surowiec - 原材料
surrealizm - シュルレアリスム
suszarka do włosów - ヘアドライヤー
sutek - 乳首
Svalbard - スヴァールバル諸島
świadomość - 意識
świat - かい (kai), 界 (kai)
światło - 明かり (akari),　光 (hikari)
Świdwin - シフィドヴィン
świeca - 蝋燭 (ろうそく, rōsoku), 燭 (しょく, shoku), 肩倒立 (かたとうりつ, kata tōritsu)
świecę - 蝋燭 (ろうそく, rōsoku), 燭 (しょく, shoku), 肩倒立 (かたとうりつ, kata tōritsu)
świekier - 舅 (しゅうと, shūto)
świekra - 姑 (shūtome)
świeść - 姑 (shūtome)
święto ruchome - 移動祝日 (idōshukujitsu)
święty - 聖者
święty mikołaj - サンタクロース
świnia - 豚 (ぶた)
świostka - 姑 (shūtome)
Sycylia - 日本語
syfilis - 梅毒
sygnał - 合図
Syjam - シャム, サイアム
sylwek - 大晦日
sylwester - 大晦日
symbol - シンボル, 符号
syn - 息子
synapsa - シナプス
synek - 少年 (shōnen)
synonim - 同義語
synowiec - 甥
sypialnia - 寝室 (shinshitsu)
syra - 足
syrena - 人魚 (にんぎょ, ningyo), サイレン (sairen), クラクション (kurakushon)
syrop klonowy - メープルシロップ
sytuacja - 場合
szachownica - チェスボード
szachy - チェス
szałwia - アキギリ属
szampon - シャンプー
szansa - 機会
szara strefa - 概要
szarpać - 破る
Szczecin - シュチェチン
szczepionka - ワクチン
szczęśliwego Nowy Nowego Roku - 明けましておめでとうございます
szczotka do włosów - ヘアブラシ
szczur - 鼠 (ねずみ,, również mysz), ラット
szczyt - オルガスムス
szeroki - 広い
szerszeń - 雀蜂
szerzyć - 普及する
szesnastka - 16分音符
szewc bez butów chodzi - 紺屋の白袴, 医者の不養生, 坊主の不信心
szkarłatny - 真っ赤
szkita - 足
Szkocja - スコットランド
szkoła - 学校
szkoła podstawowa - 小学校 (shougakkou)
szkoła powszechna - 小学校 (shougakkou)
szlauch - 蛇 (hebi)
szlifierka - グラインダー
szlips - ネクタイ (nekutai)
szminka - 口紅 (くちべに, kuchibeni), リップスティック (rippu-sutyikku)
szneka - 顔 (かお, kao)
szogun - 将軍, 征夷大将軍
szop pracz - 洗熊
szowinizm - 排外主義
szowinizm gatunkowy - 種差別
szpakami karmiony - 腹黒い
szpic fiński - フィニッシュ・スピッツ
szpic japoński - 日本スピッツ
szpieg - スパイ
szpital - 病院
sztof - 材料
sztrof - 罰
sztrofa - 罰
sztrom - 電流, 電力, 水流, 水 の流, 傾向
sztrykować - あむ
sztylet - ダガー
szwaja - 足
Szwajcaria - スイス
Szwecja - スウェーデン (suwēden)
Szwecyjo - スウェーデン (suwēden)
szwestera - 姉妹 (しまい, shimai) / お姉さん (おねえさん, onēsan) (starsza siostra) / 妹 (いもうと, imōto) (młodsza siostra)
szyberdach - サンルーフ
szybki - 速い, 急速
szybko - 速い
szydełkować - 編む, あむ
szyjka macicy - 子宮頸部
szynd - 暴力
szynobus - 気動車
ta - これ, それ, (kore, sore)
tabaka - タバコ
tablet - ペンタブレット
tablica - 黒板
tablica rejestracyjna - ナンバープレート
tabu - いみ, 忌み
tachykardia - 頻脈 (hinmyaku)
tacik - お父さん (おとうさん, otōsan), 父 (ちち, chichi)
tajemnica - 秘密, 機密
tajemnica poliszynela - 公然の秘密
tajemniczy - 不思議
tajfun - 台風
Tajlandia - タイ (Tai)
tajny - 秘密
tak - はい (hai)
tak czy owak - とにかく
taksówka - タクシー (takushī)
także - また (mata), も (mo), やはり, やっぱり, やっぱ
tak zwany - 所謂 (いわゆる, )
tal - タリウム
talasemia - サラセミア
Tallinn - タリン
tam i nazad - あちらこちら, あちこち
tańczyć - 踊る (おどる)
Tangier - タンジェ
tango - タンゴ, たんご
tank - 戦車 (せんしゃ, sensha)
tantal - タンタル
Tanzania - タンザニア (Tanzania)
taoizm - 道教
tarcza - 盾, エスカッシャン, 楯状地, 顔 (かお, kao), ミサイル防衛
tarcza antyrakietowa - ミサイル防衛
tarcza krystaliczna - 盾, エスカッシャン, 楯状地
tarcza strzelecka - 盾, エスカッシャン, 楯状地, 顔 (かお, kao), ミサイル防衛
tarcza szkolna - 盾, エスカッシャン, 楯状地
taśka - ハンドバッグ
taśma perforowana - 紙テープ
taśtać - 持って行く, 運
tasza - 袋
tchawica - 気管
tchórzostwo - 臆
technet - テクネチウム
technokracja - テクノクラート
technologia - 科学技術
tęcza - 虹 (にじ)
teczka - かばん, ファイル
tęczówka - 虹彩 (こうさい kōsai)
tej - 君 (きみ, kimi), おまえ (おまえ, omae)
tekst - 本文
telefon - 電話
telewizor - テレビ
tellur - テルル
temat - 主題, トピック
temperówka - 鉛筆削り (えんぴつけずり)
tengen - 天元
tenże - これ, それ, (kore, sore)
teologia - 神学
teoria - 理論
terb - テルビウム (terubiumu)
teren - 土地
terier - テリア
terier brazylijski - ブラジリアン・テリア
terier szkocki - スコティッシュ・テリア
termodynamika - 熱力学 (ねつりきがく, netsurikigaku)
Termopile - テルモピュレ
termopunktura - 灸 (きゅう, kyū)
teść - 舅 (しゅうと, shūto)
teściowa - 姑 (shūtome)
test - テスト
testament - 遺書 (いしょ), 遺言 (ゆいごん)
test ciążowy - 妊娠検査薬
tetum - テトゥン語
też - また (mata), も (mo), やはり, やっぱり, やっぱ
Tezeusz - テーセウス
tg - tan
thriller - スリラー映画
Timor Wschodni - 東ティモール (ひがしティモール, higashi-Timōru), 東チモール (ひがしチモール, higashi-Chimōru)
tkanka - 組織
tkanka tłuszczowa - 脂肪組織 (しぼうそしき)
tlen - 酸素
tlenek etylenu - エチレンオキシド, オキシラン
tło - 背景 (はいけい, haikei)
tłuczek - 碓
tłumić - 押さえる
toaleta - 便所
Tobiasz - トバイアス, トビアス
tobie - 君 (きみ, kimi), おまえ (おまえ, omae)
tofu - 豆腐 (tōfu)
Togo - トーゴ
Tokio - 東京都
toksykologia - 毒性学
tonfa - トンファー
topola - ポプラ
tor - トリウム
torba - 袋
torebka - ハンドバッグ
tort - トルテ
tory - トリウム
totalitaryzm - 全体主義
totem - トーテム
towarzyszyć - ついてくる (tsuitekuru), 随行する (ずいこうする, zuikō suru), 伴う (ともなう, tomonau)
trąba - 竜巻, 鼻, そそっかしい人, 間抜け
tracić - 失う
trąd - ハンセン病
tradycyjnie - 伝統的に (dentō-teki ni)
trafić trafiło się ślepej kurze ziarno - 犬も歩けば棒に当たる
trambimba - 路面電車
tramwaj - 路面電車
tramwajka - 路面電車
transmigracja - 転生
transport - 運送 (unsō), 輸送 (yusō)
tranzystor - ラジオ
trawnik - 芝生
trefl - クラブ
troć - 鱒
tróhła - 棺 (kan), 柩, 霊柩, 棺桶, 寝棺, コフィン
Troja - イリオス
trójskok - 三段跳 (sandantobi)
trolejbus - トロリーバス
trumna - 棺 (kan), 柩, 霊柩, 棺桶, 寝棺, コフィン
trunek - 酒
truskawka - イチゴ, 苺 (いちご)
Trynidad i Tobago - トリニダード・トバゴ
trzcina cukrowa - サトウキビ
Trzej Królowie - 東方の三博士
trznadel zwyczajny - キアオジ
tsunami - 津波 / 津浪 (つなみ, tsunami)
tu - ここ (koko)
tudzież - と (to), かつ (katsu), とか (toka), や (ya)
tukej - ここ (koko)
tulipan - チューリップ (chūrippu)
tulp - チューリップ (chūrippu)
Tunezja - チュニジア
turban - ターバン
turecki - トルコ語
Turkmenistan - トルクメニスタン
Turyn - トリノ
tusz do rzęs - マスカラ
tutaj - ここ (koko)
tuż - ほとんど (hotondo)
twardość - 硬度, 硬さ
twardy - 硬い
twarz - 顔 (かお, kao)
twierdza - 要塞
twój - あなたの
ty - 君 (きみ, kimi), おまえ (おまえ, omae)
Tybetańczyk - チベット人
tydzień - 週
tygodnik - 週刊雑誌
tyj - 茶 (ちゃ, cha), お茶 (おちゃ, o cha )
typografia - タイポグラフィ
Tyr - ティルス
tyrania - 独裁
tytoń - タバコ
ubezpieczenie - 保険, ほけん
ubierać - 身 に付ける, 着る, 履く
ubikacja - 便所
ubiór - 衣装 (ishō)
ubogi - 貧しい
ubóstwo - 貧 •貧困 (hinkon)
ubranie - 服, 服装
ucho - 耳 (みみ, mimi)
uciskać - あっする
uczeń - がくせい (gakusei) 学生
uczynek - 行為
ukamienowanie - 石打ち
ukazywać - 現れる
układ okresowy - 周期表
Ukraina - ウクライナ (ukuraina)
ukrop - お湯 (おゆ, oyu)
uląc się - 孵る (kaeru), かえる
ulęgać się - 孵る (kaeru), かえる
ulęgnąć się - 孵る (kaeru), かえる
ulica - 道 (みち, michi), 道路 (どうろ, dōro)
umierać - 死ぬ (しぬ)
Unia Europejska - 欧州連合 (おうしゅうれんごう, ōshū-rengō), ヨーロッパ連合 (ヨーロッパれんごう, yōroppa-rengō)
unikalny - 独特
uniwerek - 大学 (daigaku)
uniwersalny - 普遍的
uniwersytet - 大学 (daigaku)
uón - 彼, あの人
upadek - 下降 (かこう)
upiec dwie pieczenie na jednym ogniu - 一石二鳥
upiór - 吸血鬼
uprawiać - やる
Ural - ウラル山脈 (ウラルさんみゃく)
uran - ウラン (uran)
urna - 骨壺
urna kanopska - カノプス壺
urodziny - 誕生日
urologia - 泌尿器科
Urugwaj - ウルグアイ
urząd - 役
uśmiechać się - 微笑む
uspokajać - 安心する
usta - 口 (くち, kuchi)
usypiać - 寝かす
utrzymywać - やる
wacha - ガソリン, 雨 (あめ, ame), 雨水 (うすい, usui, あまみず, amamizu), 海 (うみ, úmi), 水, みず (mizu)
wajco - 卵 (たまご, tamago)
walet - ジャック
walka - ファイト
waluta - カレンシー
wampir - 吸血鬼 (kyūketsuki), バンパイア (bampaia), ヴァンパイア (vampaia)
wapń - カルシウム (karushiumu)
war - お湯 (おゆ, oyu)
waran - オオトカゲ (oo-tokage)
Warmia - ヴァルミア
Warszawa - ワルシャワ
wartość - 価
warzywniak - 八百屋
wąski - 狭い (せまい, semái)
wasz - 貴方達の (あなたたちの)
wątpliwość - 疑い
wątroba - 肝臓 (かんぞう, kanzou)
Watykan - バチカン
wąż - 蛇 (hebi)
wczoraj - 昨日 (きのう, kinō, さくじつ, sakujitsu)
wdowa - 未亡人 (miboujin)
wdowula - 未亡人 (miboujin)
wdzięczność - 感謝
węborek - バケツ (baketsu)
weganizm - ヴィーガニズム
wegetarianin - ベジタリアン
wegetarianizm - ベジタリアニズム
wegetariański - 菜食主義の
węgiel - 炭素
Węgier - ハンガリー人
Węgry - ハンガリー (Hangarī)
wehikuł - 車
wena - インスピレーション
Wenezuela - ベネズエラ
wentroba - 肝臓 (かんぞう, kanzou)
wesołe miasteczko - 遊園地
wesoły - 面白い
Wesołych Świąt - クリスマスおめでとう, メリークリスマス
Westerplatte - ヴェステルプラッテ
węzeł - 結び目, ノット
wezwanie - 名前, ファーストネーム
wgłębienie - 孔
wiać - 吹く
wiadomości - ニュース
wiadro - バケツ (baketsu)
wiatr - 風 (かぜ, kaze), 気流 (きりゅう, kiryū)
widelec - フォーク
widnokrąg - 水平線
widok - 景色
widołka - フォーク
widzieć - 見
wieczność - 永久 (eikyuu)
wieczór - 夕方 (ゆうがた)
Wiedeń - ウィーン (uiin)
Wielka Brytania - ブリテン (Buriten), イギリス (Igirisu), グレートブリテン島 (Gureito Buriten-tou)
Wielkanoc - 復活祭 (ふっかつさい, fukkatsusai), イースター (Īsutā)
Wielkie Antyle - 大アンティル諸島
Wielki Wybuch - ビッグバン
wielokulturowość - 多文化主義
wielożeństwo - 一夫多妻
Wieluń - ヴィエルニ
wiersz - 歌
wierzba - 柳 (ヤナギ)
wieś - 村, 田舎
wiesiołek - 月見草
Wietnam - ベトナム
wietnamski - ベトナムの
wieża - タワー (tawā), ルーク
więzienie - 刑務所
wigilia - イブ, イヴ, クリスマスイヴ, クリスマスイブ
Wigilia - クリスマス・イヴ
wihara - 精舎
Wikipedia - ウィキペディア
wikipedysta - ウィキペディアン
Wikisłownik - ウィクショナリー (Wikushonarī)
Wikiźródła - ウィキソース
wilgoć - 水分 (すいぶん)
wilia - イブ, イヴ, クリスマスイヴ, クリスマスイブ
wilija - イブ, イヴ, クリスマスイヴ, クリスマスイブ
wilk - オオカミ, 狼 (おおかみ, ōkami)
winien - 後ろめたい
winny - 後ろめたい
wino - スペード
winograd - スペード
wiolencja - 暴力
wioska - 村, 田舎
wiosna - 春 (はる, haru)
wirus - ウイルス, コンピュータウイルス
wirusowe zakażenie przewodu pokarmowego - 胃腸炎
Wisła - ヴィスワ川
wiśnia - 桜 (sakura)
Wisznu - ヴィシュヌ
witać - あいさつする
wiwenda - 食料
wiza - 査証 (さしょう)
wkrótce - やがて
włączać - 組み込む
Władywostok - ウラジオストク
władza - 権力
władze - 弁理
Włochy - イタリア (itaria)
Włocławek - ヴウォツワヴェク
włócznia - 槍
włókiennictwo - 機業 (kigyō), 繊維工業 (sen'ikōgyō)
włos - 毛, 髪
włoski - イタリア語
włosy - ヘア, 髪
wnętrze - 裡, 奥
woda - 水, みず (mizu)
wóda - おさけ, さけ, 酒, お酒, 御酒
woda królewska - 王水 (おうすい)
woda mineralna - ミネラルウォーター
wódka - おさけ, さけ, 酒, お酒, 御酒
wodór - 水素 (suiso)
wodospad - 滝 (たき)
wojewoda - 県知事
województwo - 県
wojna domowa - 内戦
wojownik - ファイター
wokabularz - 辞書 (じしょ, jisho), 辞典 (じてん, jiten)
wola - 意志
wolant - 操縦桿 (そうじゅうかん)
woniączka - おさけ, さけ, 酒, お酒, 御酒
worek - 袋
wóz - 車 (kuruma)
wpierdalać - 食
wpływać - 入
wrażenie - 印象
wręg - 肋骨
wróg - 敵
wrona - 烏 (からす, karasu)
wróżka - フェアリー
wrzątek - お湯 (おゆ, oyu)
wrzesień - ９月 (くがつ, kugatsu)
wrzód - 潰瘍 (kaiyō)
wrzutka - ウッテガエシ
wschód - 東 (higashi)
Wschód - 近東
wścieklizna - 狂犬病
współczuć - 「に」同情する
współczucie - 同情, 憐愍
współgrać - 映る
wspominać - 思い出す
wspomnienie - 思い出
wstawać - 立つ, 立ち上がる, 起きる
wszystkie drogi prowadzą do Rzymu - すべての道はローマに通ず
wszystko - すべて,　全て
wtorek - 火曜日 (かようび, kayōbi)
wulkan - 火山
wuszt - ソーセージ (sōsēji)
wy - あなた
wybrzeże - 浦, 磯
Wybrzeże kość Kości Słoniowej - コートジボワール (kōtojibowāru), コートジボアール (kōtojiboāru)
wyciąg krzesełkowy - チェアリフト
wycierać - 拭く
wydma - 砂丘 (Sakyū)
wygooglować - ググる • ググル • ぐぐる
wyjaśnienie - 説明 (せつめい)
wyjątek - 例外
wyjawiać - 明かす
wykałaczka - 爪楊枝, 楊枝, 楊子, 黒文字, 黒文字 (tylko do słodyczy podczas ceremonii picia herbaty)
wykluć się - 孵る (kaeru), かえる
wykluwać się - 孵る (kaeru), かえる
wykrzyknik - 感嘆符 (かんたんふ)
wyląc się - 孵る (kaeru), かえる
wylęgać się - 孵る (kaeru), かえる
wylęgnąć się - 孵る (kaeru), かえる
wylogowanie - ログオフ, ログアウト
wymiennik ciepła - 熱交換器 (ねつこうかんき, netsukoukanki)
wyobrażenie - 心像
wypowiadać - 謳う
wyraz - 言葉 (ことば, kotoba)
wyraźny - 明白
wyrostek robaczkowy - 虫垂
wyróżniać - 目立つ
wysoki - 高い
wyspa - 島 (しま, shima)
Wyspa Bożego Narodzenia - クリスマス島
Wyspa Świętego Wyspy Świętego Tomasza i Wyspa Książęca - サントメ・プリンシペ
Wyspa Świętej Heleny - セントヘレナ島
Wyspy Kanaryjskie - カナリア諸島
Wyspy Marshalla - マーシャル諸島
wyszukiwanie - 物色
wytrysk - 射精
wywoływać - 起こす
wyznanie - 告白
wzgląd - 思考
wzjawiać - 明かす
wznosić - 建立
wzrost - 増加
z - から
za - あまり, あんまり
żaba - カエル, 蛙 (かえる, kaeru)
zabawa - 遊び
zabawny - 面白い
Zabulon - ゼブルン m
Zachariasz - ゼカリヤ
zachód - 日没 (nichibotsu), 西 (nishi)
Zachód - 欧米
zaćmienie - 食 (shoku), 蝕 (shoku)
zadanie domowe - 宿題
żądło - 毒針 (どくばり, dokubari), 針 (はり, hari)
Żagań - ジャガニ
zagrożenie - 脅し
zaimek - 代名詞 (daimeishí)
zakażenie - 感染症 (kansen-shō)
zakład karny - 刑務所
zakładnik - 人質
zakochany - あいこい (aikoi)
żal - 悲しみ (kanashimi)
zalany - 酔っ払い (よっぱらい, yopparai), 酔っ払う (よっぱらう, yopparau), 酔い (よい, yoi), 酔う (よう, you)
zaleta - 長
zamach stanu - クーデター
zamieć - 吹雪
zamiłowanie - 楽しみ
zamknąć - 閉じる (とじる, tojiru), 閉める (しめる, shimeru)
Zamość - ザモシチ (zamoshichi)
zapad - 日没 (nichibotsu), 西 (nishi)
zapał - 熱意
zapalenie płuc - 肺炎
zapalenie wyrostek wyrostka robaczkowego - 虫垂炎
zapałka - マッチ
zapominać - 忘
zaprzeczenie - 否, 否定
żarliwy - 熱い
zasłona - カーテン
zastępca - 副
zastrużka - 鉛筆削り (えんぴつけずり)
Zatoka Sueska - スエズ湾
Zatoka Tajlandzka - タイランド湾
zatrzymać - 止める, 立ち止まる
zatrzymywać - 止める, 立ち止まる
zaufanie - 信用
zawierać - 含む
zawód - 職業
zawój - ターバン
zawsze - いつも (itsumo), 常に (tsuneni)
zawżdy - いつも (itsumo), 常に (tsuneni)
zazulka - テントウムシ
zazwyczaj - 普段
zbiór - ファイル
zboczeniec - 痴漢 (chikan)
zbrodnia - 犯罪
zbrodnia katyńska - カティンの森事件
zbyt - あまり, あんまり
zbytnio - あまり, あんまり
żdać - 待
zdarzać - 起こる
zderzak - バンパー
zdjęcie - 写真, フォト
zdrada stanu - 大逆罪 (たいぎゃくざい)
zdrowie - 健康
zdrzadło - 鏡 (かがみ, kagami)
ze - から
zebranie - 会合, 会議
żec - 焼く, 焼ける
zegar - 時計 (tokei)
zegarek - 時計 (tokei), 腕時計 (udedokei)
zegar słoneczny - 日時計 (hidokei)
żegleń - 炭素
żelazko - アイロン
żelazo - 鉄
zelter - ミネラルウォーター
zemrzeć - 死ぬ (しぬ)
zemsta - 復讐
zen - 禅
żenąć - 走る
żeńczyna - 女 (おんな, onna) / 女性 (じょせい, josei)
żeń-szeń - 朝鮮人参
zespół kanał kanału nadgarstka - 手根管症候群
zespół napięcia przedmiesiączkowego - 月経前症候群
zespół Sjögrena - シェーグレン症候群
zez - から
zicać - 座る
ziele angielskie - オールスパイス
zielona herbata - 緑茶
zielony - 緑 (midori), 緑色の (midoriirono), 緑の (midorino), 青い (aoi), 未熟 (mijuku), 未熟な (mijukuna)
Ziemia - 地球
ziemniak - ジャガイモ
zima - 冬 (ふゆ, fuyu)
Zimbabwe - ジンバブエ
zimorodek - 川蝉 (kawasemi)
ziołolecznictwo - 薬草
zista - お祖母さん, 御祖母さん, 祖母, お婆さん, 御婆さん
Zjednoczone Emiraty Arabskie - アラブ首長国連邦
złamać - 破る
złodziej - 泥棒 (どろぼう, dorobō)
złoto - 金 (きん)
złożony - 組み立てる
zmieniać - 変える
zmuszać - 強
zmysłowy - えん
znaczek - 切手
znaczek pocztowy - 切手
znajomy - 知り合い
znak - 印, 合図
znak wodny - 透かし
znienacka - 不意に
znużenie - あき, 飽
żołądek - 胃
żółć - 黄色い (きいろい, kiirói)
żołędny - クラブ
żółty - 黄色い (きいろい, kiirói)
żółw - 亀 (かめ)
żółw lamparci - ヒョウモンガメ
żona - 家内, 妻
zoofilia - 獣姦
zoologia - 動物学 (どうぶつがく dōbutsugaku)
żrący - 食
żreć - 食
źrenica - 瞳 (ひとみ, hitomi), 瞳 (ひとみ, hitomi, どう, dō), め (me), 目, アイ
zrywka - 袋
zuchwały - あつかましい, 厚かましい
żul - 破落戸 (ごろつき)
żulik - 破落戸 (ごろつき)
zupka chińska - インスタントラーメン
żurnal - 雑誌 (ざっし)
żurnalista - きしゃ
Zurych - チューリッヒ
zwalniać - 空ける
związek - 関係, 組合
zwierciadło - 鏡 (かがみ, kagami)
zwierzak - 動物 (どうぶつ, dōbutsu)
zwierzę - 動物 (どうぶつ, dōbutsu)
zwyczajny - 普段の
zwykły - 普段の
żyniaczka - 結婚式
żyrafa - キリン
zysk - 黒字
żywić - たべる, 食べる (taberu), 上がる
