AA - AA (Anonieme Alcoholisten)
aam - aam
abak - abacus
abakus - abacus
abecadło - abc n
Abel - Abel
Abelard - Abaelardus
abfal - anomalie f
Abidżan - Abidjan
abiecadło - abc n
ablutomania - wasdwang m
abo - of
ABS - ABS
abstynencja - abstinentie f
abstynent - geheelonthouder
Adam - Adam
adapter - platenspeler
Adelajda - Adelaide
Adonis - Adonis
adopcja - adoptie f
adwentnik - december m
aeracja - aëratie
aerodrom - luchthaven
afa - apenstaartje n, at w
afelzina - sinaasappel, appelsien
Afganistan - Afghanistan
afgański - Afghaans
Afrodyzja - Aphrodisias
Afryka - Afrika n
AGD - huishoudelijke apparatuur
agregat - aggregaat
akcja - aandeel
akolita - acoliet
akordeon - accordeon
akropol - akropolis
akson - axon n
aktyn - actinium
akupresura - acupressuur f
akupunktura - acupunctuur f
akwedukt - aquaduct
Albania - Albanië n
Albin - Alwin
albinos - albino m
albo - of
Aleksja - Alexia
alergia - allergie f
alergiczny - allergisch
alergologia - allergologie f
alfabet - abc n
alfabetu - abc n
algebraiczny - algebraïsch
Alghero - Alghero
Algieria - Algerije
algorytm - algoritme
Allach - Allah m
Allah - Allah m
allel - allel n
alleluja - hallelujah
almanach - kalender m
alokacja - allocatie, toewijzing
aluminium - aluminium
ambirz - gember
ambona - kansel
ambulatoryjny - ambulant
ameba - amoebe
ameryk - americium n
Amerykanin - Amerikaan m
amfa - amfetamine n
amfetamina - amfetamine n
Amman - Amman
ampułka - ampul m
amputacja - amputatie f
Amsterdam - Amsterdam
Amu-daria - Amu Darja
anarchista - anarchist
Anatolia - Anatolië
anatolian - Anatolische herder
anatomia - anatomie f
anatomiczny - anatomisch
ancug - kostuum n
Andaluzja - Andalusië
Andrea - Andrea
andrologia - andrologie
Andromeda - Andromeda
Andrzej - Andreas
Andy - Andes
anemia - bloedarmoede f
anestezjolog - narcotiseur m
anewryzm - aneurysma n
angiografia - vaatbeschrijving f
Anglia - Engeland n
Anglija - Engeland n
Anioł Stróż - beschermengel m
Anita - Anita
aniżeli - dan
Ankara - Ankara
anomalia - anomalie f
anonimowy - onbekend
anoreksja - anorexie f
Antananarywa - Antananarivo
Antares - Antares
Antarktyda - Antarctica
Antoni - Anton, Antonie
Antonia - Antonia
antrejka - gang, hal
antryj - gang, hal
Antwerpia - Antwerpen
antybiogram - antibiogram n
antybiotyk - antibioticum
antykoagulant - anticoagulantia f
antykomunizm - anticommunisme n
Antyle Holenderskie - Nederlandse Antillen
antyoksydant - antioxidant
antyseptyczny - antiseptisch
antyutleniacz - antioxidant
aparat rentgenowski - röntgenapparaat n
apatia - apathie f
Apeniny - Apennijnen
aplikator - applicator m
aplikować - toedienen
apluzyna - sinaasappel, appelsien
apryl - april
apsik - hatsjie!
a psik - hatsjie!
aptek - apotheek m
apteka - apotheek m
aptekarz - apotheker m
Arab - Arabier
Arabia Saudyjska - Saoedi-Arabië
arabski - Arabisch n, Arabisch
arabus - Arabier
Aragonia - Aragon
argon - argon n
armia - leger
armijo - leger
arogancja - aanmatiging
aromaterapia - aromatherapie f
arsen - arsenicum n, arseen n
artefakt - artefact
artykuły gospodarstwa domowego - huishoudelijke apparatuur
arytmia - aritmie
as - aas
asafetyda - duivelsdrek
aseksualizm - aseksualiteit
asfaltować - asfalteren
asta - tak m
astat - astatium n, astaat n
astma - astma n
asygnata - biljet n
Asyria - Assyrische Rijk, Assyrië
atak - aanval m
atak serca - hartaanval, myocardinfarct
ateizm - ateïsme n
atlantycki - Atlantisch
atom - atoom n
Augiasz - Augias m
August - Austen
Austria - Oostenrijk
Austro-Węgry - Oostenrijk-Hongarije
auto - auto
autobana - autosnelweg
autobus - bus m, autobus m
autoklaw - autoclaaf
autonomia - autonomie f
autopsja - autopsie f
autor - auteur
autostrada - autosnelweg
autyzm - autisme n
awokado - avocado
Azerbejdżan - Azerbeidzjan
Azja - Azië n
azot - stikstof n
Badenia-Wirtembergia - Baden-Württemberg
bądź - of
bagno - moeras n
baje - spijbelen schoolverzuim
bajerować - liegen
bakałarz - leraar
bakłażan - aubergine
bakteriobójczy - kiemdodend
bakteriolog - bacterioloog m
bakteryjny - bacterieel
bal - bal
balneologia - balneologie f
balsam - balsem m
Bałtyk - Oostzee
Bałtyka - Baltica
banan - banaan f, bacove f
banana - banaan f, bacove f
bandaż - verband n
bania - pompoen, hoofd (głowa człowieka lub konia), kop (głowa innego zwierzęcia)
baniak - hoofd (głowa człowieka lub konia), kop (głowa innego zwierzęcia)
bank - bank
bank krwi - bloedbank f
banknot - biljet n
bank spermy - spermabank f
baptyzm - baptisme n
bar - barium n
barabola - aardappel m
Baran - Ram
bardzo - heel, erg, meer, meest
bark - schouder m
barkentyna - barkentijn
barki - schouder m
barwa - kleur
barzej - heel, erg, meer, meest
barzoł - moeras n
basarunek - vergoeding f
basza - voer m
baszta - waltoren, muurtoren
batarejka - zaklamp f
batuta - dirigeerstok m
batymetria - bathymetrie
bawarka - melkthee
Bazylea - Bazel
bazylia - basilicum n
bebech - maag f
beczeć - huilen
bele kaj - overal
belfer - leraar
Belgia - België
Benin - Benin n
benzyna - benzine f
berga - steen m, tandsteen m, ketelsteen m, (nier-, gal)steen m
Bergamo - Bergamo
berkel - berkelium n
Berlin Zachodni - West Berlijn
bermudy - bermudashort m
beryl - beryllium n
bety - pyjama
bez - zonder, vlier m
bez- - -loos
bezbożnik - atheïst
bezdech - ademstilstand m
beze - zonder, vlier m
bezgorączkowy - koortsvrij
bezmocz - anurie f
bezokolicznik - infinitief m
bezosobowy - onpersoonlijk
bezrobotny - werkloos
białaczka - leukemie f
biała herbata - witte thee
Białoruś - Belarus, Wit-Rusland
biały - wit
biały fosfor - witte fosfor
Biblia - Bijbel
bicykl - hoge bi m
biedronka - lieveheersbeestje n
biegunka - diarree f
bierne palenie - passief roken
bikorn - steek
bindał - lendendoek m
bindka - verband n
binia - meisje, meid, dienstmeid
biograficzny - biografisch
bioróżnorodność - biodiversiteit f
biseksualizm - biseksualiteit f
bishalter - bustehouder m
biskup - bisschop m
biurko - schrijftafel f, schrijfberd n
biusthalter - bustehouder m
biustonosz - bustehouder m
bizmut - bismut n
błąd poznawczy - denkfout, cognitieve fout, redeneerfout
blałka - spijbelen schoolverzuim
blizna - litteken n
Bliźnięta - Tweelingen
bliźnięta syjamskie - siamese tweeling
błona dziewicza - maagdenvlies n
błona śluzowa - slijmvlies n
blumkol - bloemkool f
bluszcz - klimop
bluźnierstwo - godslastering, blasfemie
błyskawica - bliksem m
bo - omdat, aangezien, daar
bodziec - prikkeling f
bóg - god m
Bóg - God m
Bohemia - Tsjechië, Bohemen
bohr - bohrium n
ból - pijn m
Boliwia - Bolivia, Bolivië
bom - giek
bombarda - bombarde
bómbón - bonbon
bor - boor n
borowina - fango m
borówka bagienna - rijsbes
borsuk - das
Bośnia i Hercegowina - Bosnië en Herzegovina
boża krówka - lieveheersbeestje n
Brabancja Flamandzka - Vlaams-Brabant
brachol - broer m, broeder m
bracieniec - broer m, broeder m
brak miesiączki - amenorroe f
bransoleta - armband m
brat - broer m, broeder m
brązowy - bruin
Brazylia - Brazilië n
brazyliana - koffie m
briftreger - postbode
bród - voorde
brodawka sutkowa - tepel m
brokuł - broccoli m
broń - wapen n
broszura - brochure
browar - bier n
bruk - kinderkopje
Bruksela - Brussel
brukselka - spruitjes, spruitkool f
brusić - scherpen, wetten
bruzdownica - muurfrees
brydż - bridge
bryka - auto
brylant - briljant m
brzmienie - geluid
brzoskwinia - perzik
bubek - boer
buc - lul
Budapeszt - Boedapest
buddyjski - boeddhistisch
budowniczy - bouwer
Bug - Westelijke Boeg
buła - broodje, bolletje, kadetje
bulba - aardappel m
buldog - buldog
buldożer - laadschop
Bułgaria - Bulgarije
bulić - betalen, dokken, storten, uitbetalen, uitkeren, voldoen
bulimia - boulimie f
bułka - broodje, bolletje, kadetje
bulwa - aardappel m
burak - beetwortel
burdel - bordeel
burdynek - duel
bursztyn - amber
burza - onweer
burzowiny - bier n
buzi - zoen, kus
być - zijn, wezen
byk - bul m, stier m
Byk - Stier
Była Jugosłowiańska Republika Macedonii - Voormalige Joegoslavische Republiek Macedonië
całus - zoen, kus
cebula - ui m
cedr libański - libanonceder
cegła - baksteen
cellulitis - cellulitis
cel uświęca środki - het doel heiligt de middelen
cena - prijs m, kost m
cenotaf - cenotaaf
cer - cerium
cera - dochter f
cesarskie cięcie - keizersnede f
cewka moczowa - urinebuis f
cewnik - catheder m
cez - cesium
charczeć - snurken
chart afrykański - azawakh
chcieć - willen
chciwość - giergigheid
chemiczny - scheikundig
chemioterapia - chemotherapie f
chemoterapia - chemotherapie f
Cheronea - Chaeronea
Cheroneja - Chaeronea
chętny - gretig
chirurgia kosmetyczna - plastische chirurg m
chitozan - chitosan
chleb - brood n
chłopczyk - jongetje n
chlor - chloor m
chloroaceton - chlooraceton
chmiel - bier n
choćby - bijvoorbeeld
chocieć - willen
choinka - kerstboom
chójk - kerstboom
cholesterol - cholesterol m
chore - ziek
choroba - ziekte f, aandoening f
choroba morska - zeeziekte f
choroba Parkinsona - ziekte van Parkinson f
chorobotwórczość - pathogeniteit f
Chorwacja - Kroatië
chory - ziek
chów wsobny - inteelt
chrapać - snurken
chrom - chroom
chromosfera - chromosfeer
chromosom - chromosom n
chronić - beschermen
chruścik - kokerjuffer, schietmot, zijdebijter
Chrystus - Christus m
chrząstka - kraakbeen n
chuj - lul
chwila - moment
ciało obce - vreemd lichaam n
ciało szkliste - glasachtig lichaam
cicha woda brzegi rwie - stille wateren hebben diepe gronden
ciebie - jij, je
ciecz - vloeistof
ciecz łzowa - traanvocht n
cielę - kalf n
cień - schaduw
cierpienie - lijden n
cieść - schoonvader m
ciężki - zwaar, zware
ciocia - tante f
cipka - hanenkam m
ciśnienie - druk, bloeddruk
ćma - mot f, nachtvlinder
cmentarz - begraafplaats, kerkhof
córa - dochter f
córczysko - dochter f
córka - dochter f
cos - cos
coś - iets
co stać się stało, to odstać się nie odstać odstanie - gedane zaken nemen geen keer
co z oczu, to z serca - uit het oog, uit het hart
ctg - cot
cukier - suiker
cukierek - bonbon
cukrzyca - diabetes f
cupać - hurken
cwajnos - buldog
ćwiczenie czyni mistrza - oefening baart kunst
ćwierć - kwart, vierde, vierendeel
cyber- - cyber-
cyberprzestrzeń - cyberspace
cyborium - ciborie
cychalter - bustehouder m
cyferblat - gezicht n, aangezicht n, gelaat n
cyfra - cijfer, nummer
cyna - tin
cynk - zink n
Cypr - Cyprus
cypresz - cipres m
cyprofloksacyna - ciprofloxacine
cyprys - cipres m
cyrkiel - passer m
cyrkon - zirkonium
cytryna - citroen
cytrynat - citroen
cząber - bonenkruid n
czador - chador
czaj - thee m
czajnik - hoofd (głowa człowieka lub konia), kop (głowa innego zwierzęcia)
cząpać - hurken
czarna dziura - zwart gat
czarna porzeczka - zwarte bes
Czarnogóra - Montenegro
czarny - zwart
czasopismo - periodiek, revue, tijdschrift, magazine
czasownik - werkwoord n
czas to pieniądz - tijd is geld
Czechosłowacja - Tsjechoslowakije
Czecho-Słowacja - Tsjechoslowakije
Czechy - Tsjechië, Bohemen
czekać - wachten
czekolada - chocolade m
czernica - braam
czerwiec - juni
czerwona porzeczka - aalbes
czerwony - rood
czerwony olbrzym - rode reus m
cześć - hallo, hoi, dag
część - deel w
częstoskurcz - tachycardie
częsty - frequent, frequente
czkawka - hik
człowiek - mens m, man
czorny - zwart
czosnek - knoflook n
czwartek - donderdag m
czwartorzęd - Kwartair
czyhunka - thorium n, tor
czyrwiec - juni
czyrwień - juni
czyściec - vagevuur
Dagestan - Dagestan
daktyl - dadel m
dalece - heel, erg, meer, meest
dama - koningin, dame
Dania - Denemarken
dar - geschenk n, cadeau n
darmsztadt - darmstadtium
darowanemu koniowi w zęby się nie zagląda - een gegeven paard moet men niet in de bek kijken
dawno - lang geleden
defenestracja - defenestratie
dekiel - hoofd (głowa człowieka lub konia), kop (głowa innego zwierzęcia)
delfin - dolfijn m
demagogia - demagogie f
demiurg - demiurg
demografia - demografie
Demokratyczna Republika Wyspy Świętego Tomasza i Wysp Świętego Tomasza i Książęcej - Democratische Republiek Sao Tomé en Principe
deskorolka - skateboard
destylacja - Destillatie
dezinformacja - desinformatie f
dialekt - dialect n
difalia - diphallia
dioda - diode f
Diogenes - Diogenes, Diogenes (van Sinope)
DJ - DJ
dla - voor
dmuchać - blazen, neuken, naaien
Dniepr - Dnjepr
dobranoc - goedenacht
dobrobyt - rijkdom m, voorspoed m
dobry - goed
dobry wieczór - goedeavond
dogmat - dogma n
dojrzewanie - adolescentie
doktor - arts m, dokter m, geneesheer m
dokument - document
dolar - dollar m
dolina - vallei f, dal n
dolmen - hunebed
dolnołużycki - Nedersorbisch
dom dziecka - weeshuis n
domofon - intercom
domowej roboty - huisgemaakt
Donieck - Donetsk
doradca - adviseur m, raadgever m
doskonałość - voortreffelijkheid
doświadczenie - ervaring f, experiment n
do trzech razy sztuka - driemaal is scheepsrecht
dotykać - aanraken, aanroeren
do widzenia - tot ziens, doei, dag, houdoe
do zobaczenia - tot ziens, doei, dag, houdoe
droga ekspresowa - expressweg, autoweg
Droga Mleczna - Melkweg
drugie śniadanie - middageten n
drukarka - printer
drzewo - boom m
dubn - dubnium
duch - geest
Duch Święty - Heilige Geest m
dudlać - huilen
dudy - long f
dukat - dukaat m
dupa - kont
durnica - rijsbes
dusza - geest
duży - groot
dwukropek - dubbelepunt m
dychawica - astma n
dycki - altijd
dyftong - tweeklank, diftong
dyktator - dictator m
dym - rook m
dynia - pompoen
dyplom - diploma n
dysonans - dissonantie, dissonant
dysproz - dysprosium
dziabka - schoffel m
dziadek - grootvader, opa, notenkraker m
dziadek do orzechów - notenkraker m
dzięcioł - specht m
dziedzina - domein n
dziela - voor
dzień dobry - goedemorgen
dziennikarski - journalistiek
dziennikarstwo - journalistiek
dziesięciolecie - decennium n
dziewa - meisje, meid, dienstmeid
dziewczę - meisje, meid, dienstmeid
dziewczyna - meisje, meid, dienstmeid
dziób - snavel m
dziobak - vogelbekdier n
dziołcha - meisje, meid, dienstmeid
dziopa - meisje, meid, dienstmeid
dziunia - meisje, meid, dienstmeid
dziurkacz - perforator m, buro-perforator m
dziurkacz biurowy - perforator m, buro-perforator m
dżungla - jungle f, oerwoud
dźwig - lift, lift m
dzwon - bel f
dzwonek rowerowy - fietsbel f
ebor - ivoor n
echolalia - echolalie f
edytor tekstu - tekstverwerker
Efialtes - Ephialtes m
Egina - Egina
Egipt - Egypte
einstein - einsteinium
ejakulacja - ejaculatie
ekohydrologia - ecohydrologie
ekologia - ecologie
ekologio - ecologie
ekosystem - ecosysteem
eksperyment - experiment n
eksplikować - uitleggen, zich verontschuldigen, vertalen
ekstrapolacja - extrapolatie
EKUZ - EZVK
Ekwador - Ecuador
elefant - olifant
elekcja - verkiezing
Elza - Elisabeth, Elizabeth
Elżbieta - Elisabeth, Elizabeth
emigracja - uitwijking f
Emili - Emmy
Emilia - Emmy
emu - emoe m
Enschede - Enschede
entalpia - enthalpie
entalpia swobodna - vrije energie
entropia - entropie
erb - erbium
Erytrea - Eritrea
erytrozyna - erythrosine
ESBC - ESCB
eschatologia - eschatologie
eskalator - roltrap m
eskulap - arts m, dokter m, geneesheer m
Estonia - Estland
Etiopia - Ethiopië f
etniczny - etnisch
etruskologia - etruscologie
etymologia - etymologie f
eurocent - cent
europ - europium
Europa - Europa n
Ewa - Eva
Ezop - Aisopos m
facet - man m
facetka - vrouw f, Leraar m, Lerares f
facjata - gezicht n, aangezicht n, gelaat n
fagocista - fagottist m
fajny - mooi
fałat - biljet n
fałsz - onwaarheid f
familio - gezin n
famuła - gezin n
fana - vlag
fanatyzm - fanatisme
fandzolić - liegen
farmaceutyk - medicijn n
faryna - suiker
faryzeusz - farizeeër m
fasola - boon f
fasola szparagowa - sperzieboon
fasolka szparagowa - sperzieboon
fatwa - fatwa m
ferska - perzik
fest - heel, erg, meer, meest
feta - amfetamine n
fezeła - bij f
Fidżi - Fiji
filip - haas
Filip - Filip m
film - film m
filozof - filosoof
filozofia dziejów - geschiedfilosofie
filozofia historii - geschiedfilosofie
filozoficzny - filosofisch
finansowy - financieel, financiële
Finlandia - Finland
finwal - gewone vinvis
fioletowy - violet, paars
fiut - lul
fizjologia - fysiologie f
fiżon - boon f
flag - vlag
flaga - vlag
Flandria - Vlaanderen
flaszowiec miękkociernisty - zuurzak
flep - document
flet - lul
Florencja - Florence
fluor - fluor n
fojerman - brandweerman
fok - fok
formoterol - formoterol
fort - vesting
fosfor - fosfor n
frajda - pret
Francja - Frankrijk n
francuski pocałunek - tongzoen
frans - francium
frela - meisje, meid, dienstmeid
frutarianizm - fruitarisme n
fryc - Duitser m
Fryc - Duitser m
Fudżi - Fuji
fulać - liegen
funkcja stanu - toestandsfunctie
fura - auto
furosemid - furosemide
furt - weer, opnieuw
fusbal - voetbal
futbol - voetbal
gadolin - gadolinium
gajer - kostuum n
gal - gallium
gała - oog n, voetbal, kraai m
gałąź - tak m
Galia - Gallië
galicyzm - gallicisme
Galilea - Galilea
gangol - kostuum n
gapa - kraai m
garnitur - kostuum n
garota - Garrotte, Garotte
gasa - straat
gąść - spelen
gąsior - ganzerik
gatunkowizm - speciesisme
gaz musztardowy - mosterdgas
gdy kota nie ma, myszy harcują - als de kat van huis is, dansen de muizen op tafel
gdyż - omdat, aangezien, daar
gdzie - waar
gdziekolwiek - overal
gdzieś - ergens
gędzić - spelen
geografia - geografie
geologia - geologie
geriatria - geriatrie
german - germanium
germański - Duits, Duits n, de Duitse taal
giez - luis in de pels
glacok - kaal
glajza - thorium n, tor
glapa - kraai m
glin - aluminium
globus - hoofd (głowa człowieka lub konia), kop (głowa innego zwierzęcia)
głód - honger
głodny - hongerig
głośnik - luidspreker
głowa - hoofd (głowa człowieka lub konia), kop (głowa innego zwierzęcia)
głuchota - doofheid f
głuchy - doof
gnat - bot n, dobbelsteen, teerling
gnu - gnoe m
godka - tong, taal
godło - embleem n
Godzilla - Godzilla
godzina policyjna - spertijd
góra - berg m
górą - berg m
górnik - mijnwerker
Górny Śląsk - Opper-Silezië
gość - gast
gościna - bezoek n
gotować - koken, zich voorbereiden
gra - spel n
graba - hand f
grać - spelen
gracz - speler m
gramatyka - grammatica
gramofon - platenspeler
granatowy - donkerblauw
granica - grens f
groch - erwt f
gromadzić - accumuleren
gronostaj - hermelijn
groszek - erwt f
groźba - dreiging f
grudzień - december m
grupa - groep f
gruszka - peer f
Gruzja - Georgië
grycha - broodje, bolletje, kadetje
gryf - griffioen
gryfny - mooi
grzeczny - aardig
Grzegorz - Gregorius
gułag - goelag
guli - omdat, aangezien, daar
guma - condoom
gumka - condoom
gwiazda - ster f
Gwinea Równikowa - Equatoriaal-Guinea
haczka - schoffel m
hafn - hafnium
Haga - Den Haag
Haiti - Haïti
hajtok - mes n
halibut - heilbot
haptyczny - haptisch
has - hassium
haszysz - hasjiesj, hash, hasj
hau - waf, woef, blaf, kef
haubica - houwitser
haw - daar
hel - helium
helikopter - helikopter
hemoliza - hemolyse
heparyna - heparine
herbarz - herbarium
herbata - thee m
hetman - dame
hiacynt - hyacint f
hiena - hyena m
hierarchiczny - hiërarchisch
hipergrafia - hypergrafie
hipochondryk - hypochonder
hipopotam - nijlpaard n
hipoteka - hypotheek
hirsutyzm - hirsutisme n
historiozofia - geschiedfilosofie
historyk - historicus
Hiszpania - Spanje n
Holandia - Nederland, Holland
Holandyja - Nederland, Holland
holenderski - Nederlands n
holm - holmium
homeopatia - homeopathie
homo- - homo-
homoseksualny - homoseksueel
Hongkong - Hongkong
hormonozależny - hormoonafhankelijk
Horus - Horus
Hun - Hun m
hydrologia - hydrologie
hydrostatyka - hydrostatica
i - en
igrzyska olimpijskie - Olympische Spelen
ilość - hoeveelheid
imbir - gember
imię - naam m
imiesłów - deelwoord n
imperium - rijk
ind - indium
indoktrynacja - indoctrinatie
inkszy - ander
inny - ander
ino - alleen, slechts
instrument - instrument n, middel n
internet - internet n
interpretacja - interpretatie
intonacja - intonatie
inundacyja - overstroming f, vloed
iny - ander
inżynieria - techniek
Irlandia - Ierland
iryd - iridium
islamistyka - islamologie
islamizm - islamisme
Islandia - IJsland (uwaga: I i J pisane są z dużej litery)
islandzki - Ĳslands, Ĳslands n
Itaka - Ithaka
iterb - ytterbium
itr - yttrium
izba - vrede, rust, kamer
Izrael - Israël
izraelski - Israëlisch
ja - ik
jabłko - appel m
Jadwiga - Hadewig
jajko - ei n, kippenei, eendenei, slangenei
jajo - ei n, kippenei, eendenei, slangenei
jak - hoe
jak cię widzą, tak cię piszą - kleren maken de man
jaki - welk, welke, die
jakie drzewo, taki klin, jaki ojciec, taki syn - zo vader, zo zoon
jaki ojciec, taki syn - zo vader, zo zoon
jako - hoe
jakość - kwaliteit f
Jan - Johannes, Jan, Joannes, Johan
jantar - amber
jara - schoonmoeder f
jarecka - moeder f
jarosz - vegetariër
jarzyna - groente f
jaszczurka - hagedis m
jebać - neuken, naaien
jebadło - slaapkamer f, bed n
jeden za wszystkich, wszyscy za jednego - één voor allen, allen voor één
jednooki - eenogi
jednorożec - neushoorn m
Jędrzej - Andreas
jeleń - hert n
jemiołuszka - pestvogel m
jeniec - krijgsgevangene
jesień - herfst m
jeśli - als, indien
jest - zijn, wezen
jeż - egel m
jeżeli - als, indien
Jezus - Jezus m
Jezus Chrystus - Jezus Christus
język - tong, taal
język obcy - vreemde taal
język ojczysty - moedertaal
jeżyna - braam
jod - jodium
jol - jol
jordański - Jordaanse
Jugosławia - Joegoslavië
juny - jong, jeugdig
jutro - morgen
już - al, reeds, niet meer
kadencja - ambtstermijn, intonatie, cadens
kadm - cadmium
Kafarnaum - Kafarnaüm
kafej - café, koffieshop
kaffa - koffie m
kaj - waar
kakao - cacao m
kalafa - gezicht n, aangezicht n, gelaat n
kalafior - bloemkool f
kalapitra - hoofd (głowa człowieka lub konia), kop (głowa innego zwierzęcia)
kalendarz - kalender m
kaliforn - californium
Kalifornia - Californië n
kam - waar
kamerling - camerlengo
kamień - steen m, tandsteen m, ketelsteen m, (nier-, gal)steen m
Kanada - Canada
kanapa - bank
kaolin - kaolien
kapecytabina - capecitabine f
kąpiółka - badkamer f
kapować - begrijpen, snappen, verstaan
Kapsztad - Kaapstad
kapusta - kool
karaba - kat
karabin maszynowy - machinegeweer
karczoch - artisjok
kardiolog - cardioloog
karp - karper
kartofel - aardappel m
kasza - gort
kaszel - hoest m
Katarzyna - Catharina f, Katrijn f
katastrofa - ramp
kawa - koffie m
kawiarka - Moka, Moka Express
kawiarnia - café, koffieshop
kawka - kauw
Kazachstan - Kazachstan n
kazalnica - kansel
kazatelnica - kansel
każdy - elk, ieder
kaznodzieja - verkondiger m
kciuk - duim m
kędy - waar
kefija - keffiyeh
kejter - hond
Kenia - Kenya, Kenia
kenotaf - cenotaaf
kenotafium - cenotaaf
kiecka - jurk f
kieł - hoektand m
kiełbasa - worst m
kiepeła - hoofd (głowa człowieka lub konia), kop (głowa innego zwierzęcia)
kij - etage, verdieping
kilwater - kielzog n
kimać - slapen
kino - bioscoop
kintop - bioscoop
kirchóf - begraafplaats, kerkhof
kirgiski - Kirgizisch Kirgizisch n
Kirgistan - Kirgizië, Kirgizstan
Kirgizka - Kirgizische f
kiszka - melk f
kłącze - wortelstok m
klajdać - kleden, aankleden, omkleden, staan
kłamać - liegen
kłamca - leugenaar
kłamczuch - leugenaar
klamot - steen m, tandsteen m, ketelsteen m, (nier-, gal)steen m
klara - Zon
klasy - hinkelen n
klaustrofobia - claustrofobie, engtevrees
klej - lijm m
klękać - knielen
klistron - klystron
KLM - KLM
klucz - sleutel m, sluitsteen m
knipa - boek
koala - koala m
kobalt - kobalt n
kobieta - vrouw f
kobra - cobra f, brilslang f
kochać - houden van, verliefd zijn, vrijen
kociamber - kat
kod kreskowy - streepjescode f, barcode f
koja - bed n
kojec - box
kojo - bed n
kokotek - lift, lift m
kolano - knie f
kołchoz - kolchoz
koleś - man m
Kolonia - Keulen
kolonoskopia - colonoscopie
kolor - kleur
Kolumbia - Colombia, Colombië
Kolumbia Brytyjska - Brits-Columbia
komar - mug f
komp - computer m, rekenaar m
komponować - componeren
komputer - computer m, rekenaar m
komunizm - communisme n
koń - paard
kóń - paard
kondensacja - condensatiereactie
kondensator - condensator
kondom - condoom
kondygnacja - etage, verdieping
konfiskować - confisqueren
konkubinat - concubinaat
konspiracja - samenzwering
kontrabas - contrabas f
kontrreformacja - Contrareformatie f
koper - dille
kopruch - mug f
kopyto - hoef m
kora - schors f
korbol - pompoen
Korea Północna - Noord-Korea
korek - kurk, stop m, stopsel n, kurk n, kurklaag, kurken, file, smeltveiligheid f, elektrische zekering f, plomb m, stoppenkast f, gootsteenstop m, afvoerstop m
kormoran - aalscholver m
Korsyka - Corsica
korzeń - wortel m
Kos - Kos
kosa - mes n
kość - bot n, dobbelsteen, teerling
kościół - kerk f
kość słoniowa - ivoor n
kostka Rubika - Rubiks kubus
kot - kat
kozioł ofiarny - zondebok
Koziorożec - Steenbok
krab - hogel
kraj - land n, staat
krajacz do sera - kaasschaaf
Kraków - Krakau
kran - lift, lift m
krasula - koe f
kreda - krijt
krew - bloed n
królowa - dame
kropka - punt
kropla, która przepełnia czarę - de druppel die de emmer doet overlopen
krowa - koe f
krowa, która dużo ryczy, mało mleka daje - blaffende honden bijten niet
krtań - strottenhoofd
krucjata - kruistocht
krypton - krypton
Kryspin - Crispinus
krzem - silicium
krzywa - kromme
krzywoprzysięstwo - meineed m
krzyżyk - -kruis
ksenon - xenon
książka - boek
Księżyc - Maan
kto - wie, iemand
kto chce żyć z swojej pracy, dolegać nie trzeba - De ochtendstond heeft goud in de mond
kto mieczem wojuje, (ten) od miecza ginie - wie leeft bij het zwaard, zal sterven bij het zwaard
kto rano wstaje, temu Pan Bóg daje - De ochtendstond heeft goud in de mond
który - welk, welke, die
któż - wie, iemand
Kuba - Cuba
kubek - beker m, mok
Kubuś Puchatek - Winnie de Poeh
kucać - hurken
kuć żelazo, póki gorące - het ijzer smeden terwijl het nog heet is
Kujawy - Koejavië
kuloodporny - kogelvrij
kupidło - prijs m, kost m
kupować - kopen, klant
kurka - hanenkam m
kurki - hanenkam m
kuropatwa - patrijs f
kusik - zoen, kus
kuskus - couscous
Kusz - Kus
kutafon - lul
kutas - lul
kuter - kotter
kuzaj - neef
kuzyn - neef
kuzynka - nicht
kwantowy laser kaskadowy - kwantumcascadelaser
kwark - quark
kwas akrylowy - acrylzuur
kwas chlorogenowy - chlorogeenzuur
kwas foliowy - foliumzuur, folaat
kwas krotonowy - crotonzuur
kwiecień - april
kworum - quorum
Łaba - Elbe
lacz - hoofd (głowa człowieka lub konia), kop (głowa innego zwierzęcia)
ładny - mooi
laga - etage, verdieping
laicyzacja - laïcisme
lajbik - bustehouder m
lakier do paznokci - nagellak
lala - meisje, meid, dienstmeid
lantan - lanthanium
las - woud n
lat - jaar n
lata - jaar n
latarka - zaklamp f
lato - zomer
łazienka - badkamer f
Lazurowe Wybrzeże - Azurenkust
lebo - of
lek - medicijn n
lekarstwo - medicijn n
lekarz - arts m, dokter m, geneesheer m
lekkoatleta - atleet
leksykon - lexicon n
lepak - weer, opnieuw
łepetyna - hoofd (głowa człowieka lub konia), kop (głowa innego zwierzęcia)
lepszy wróbel w garści niż gołąb na dachu - beter één vogel in de hand dan tien in de lucht
lew - leeuw, lev
Lew - Leeuw
łgać - liegen
łgarz - leugenaar
libido - libido
liczba atomowa - atoomnummer
liczba mnoga - meervoud n
liczba podwójna - dualis
likier - likeur f
lilak - vlier m
linie lotnicze - luchtvaartmaatschappij f
link - link m
lipiec - juli
lipodystrofia - lipodystrofie
listonosz - postbode
listopad - november
list otwarty - open brief m
lit - lithium
litera - letter f
literat - schrijver
literaturoznawstwo - literatuurwetenschap f
liturgiczny - liturgisch
Litwa - Litouwen
lizać - likken
łochynia - rijsbes
lodowiec - gletsjer m
logika - redeneerkunde
logiko - redeneerkunde
łokieć - elleboog m
lola - meisje, meid, dienstmeid, etage, verdieping
Londyn - Londen
lorens - lawrencium
łosoś - zalm
lotnisko - luchthaven
lotniskowiec - vliegdekschip
Łotwa - Letland n
łoże - bed n
łóżko - bed n
łóżko piętrowe - stapelbed
lub - of
łucznictwo - boogschieten
ludność - bevolking f
łudzikwiat - april
łuk - boog m
Luksemburg - Luxemburg
lumbago - spit n
luńt - hond
lustro - spiegel
łut - lood
lutet - lutetium
luty - februari, sprokkelmaand, regenmaand
lwia część - leeuwendeel
Lwów - Lviv
łydka - kuit f
łysy - kaal
łzawić - wateren
mać - moeder f
Maciej - Matthias
macocha - stiefmoeder f
Madera - Madeira
magnez - magnesium
maj - mei m, bloeimaand f
makrela - makreel m
małpa - apenstaartje n, at w
Malta - Malta
mały - klein, kleintje
mam - hebben, moeten, aanhebben
mama - schoonmoeder f
mamut - mammoet
mangan - mangaan
maniurka - meisje, meid, dienstmeid
manometr - manometer
mapa - kaart f, landkaart f
mapa topograficzna - topografische kaart
marchew - wortel m
marchewka - wortel m
martwy - dood
marzec - maart
marznący deszcz - ijzel
maska - gezicht n, aangezicht n, gelaat n
masło - boter
maszyna do szycia - naaimachine f
Matiasz - Matthias
matka - moeder f
matriarchalny - matriarchaal
matriarchat - matriarchaat n
mazak - gezicht n, aangezicht n, gelaat n
Mazowsze - Mazovië
mdłość - zwakte
mecz - wedstrijd
męczennik - martelaar m
meczet - moskee f
mediana - mediaan
meduza - kwal
medyk - arts m, dokter m, geneesheer m
meitner - meitnerium
melki - bonbon
menda - schaamluis m
mendelew - mendelevium
mendoweszka - schaamluis m
mentalista - mentalist m
Merkury - Mercurius m, Mercurius f
metafizyka - metafysica f
meteor - meteoor
meteoryt - meteoriet
metr - meter m
mężczyzna - man m
Miami - Miami
miasto - stad f, binnenstad, stadskern
miasto stołeczne - hoofdstad
micela - micel
Michał - Michiel m, Michaël m, Michel m
mieć - hebben, moeten, aanhebben
miedź - koper
miedźwiedź - beer
międzynarodowy - internationaal
mielcuch - bier n
mieli - hebben, moeten, aanhebben
miesiąc - maand f
mięsopustnik - februari, sprokkelmaand, regenmaand
mieszkaniec - inwoner
mięta - munt
migotka - knipvlies
mikologia - mycologie f
Mila - Emmy
miliarder - miljardair m
miliwolt - millivolt m
miłość - liefde f
miły - aardig
m.in. - o.a.
minaret - minaret
miód - honing
miotła - bezem m
mizofonia - misofonie f
mleko - melk f
mleko sojowe - sojamelk, sojadrank
młody - jong, jeugdig
modlić się - bidden
modrakowy - blauw
modry - blauw
moher - mohair
mój - mijn
Mojżesz - Mozes
molibden - molybdeen
moneta - munt, muntstuk, geldstuk, specie
monocykl - eenwieler m
monopolowy - slijterij
monstrancja - monstrans, ostensorium
mops - mopshond
mora - geest
moralność - moraal
morkwa - wortel m
morze - zee f
Morze Bałtyckie - Oostzee
Morze Północne - Noordzee
Morze Śródziemne - Middellandse Zee
mosiądz - munt, muntstuk, geldstuk, specie
motyka - schoffel m
Mount Everest - Mount Everest
mowa - tong, taal
mowa jest srebrem, a milczenie złotem - spreken is zilver, zwijgen is goud
Moza - Maas
możliwy - mogelijk
mrównik - aardvarken
mściciel - wreker m
mućka - koe f
mufka - mof f
musieć - moeten
muszkiet - musket
mużyk - man m
my - we
mydło - zeep
mykologia - mycologie f
myszy tańcują, gdy kota nie czują - als de kat van huis is, dansen de muizen op tafel
nacja - natie
naczyniak - angioom
naczyniak krwionośny - hemangioom
Nahum - Nahum m
Nairobi - Nairobi
naleśnik - pannenkoek
napój - drank m
naprany - beschonken, dronken, zat
na przykład - bijvoorbeeld
narba - litteken n
naród - natie
native speakerka - moedertaalspreekster f
nauczyciel - leraar
nauczycielka - Leraar m, Lerares f
neodym - neodymium
neon - neon n
neonatologia - neonatologie
Nepal - Nepal
neptun - neptunium
neutralny - onzijdig
neutrino - neutrino
ni - nee, niet
nic - niets
Niderlandy - Nederland, Holland
nie - nee, niet
nieakceptowalny - onaanvaardbaar
niebieski - blauw
nieć - neef
niedaleko pada jabłko od jabłoni - de appel valt niet ver van de boom
niedokrwienie - ischemie
niedokrwistość - bloedarmoede f
niedokrwistość Addisona-Biermera - pernicieuze anemie
niedokrwistość tarczowatokrwinkowa - thalassemie
niedokrwistość złośliwa - pernicieuze anemie
nie dospać trzeba, kto chce dostać chleba - De ochtendstond heeft goud in de mond
nieduch - ziekte f, aandoening f
niedziela - zondag m
niedźwiedź - beer
nie ma dymu bez ognia - waar rook is, is vuur
Niemcy - Duitsland n
Niemen - Memel
Niemiec - Duitser m
nie mieć - nee, niet, hebben, moeten, aanhebben
Niemiecka Republika Demokratyczna - Duitse Democratische Republiek
niemiecki - Duits, Duits n, de Duitse taal
nienawidzić - haten
nie od razu Kraków zbudowano - Rome is niet op één dag gebouwd, Keulen en Aken zijn niet op één dag gebouwd
nieodwracalny - onomkeerbaar
nieokreślony - ongedefinieerd, willekeurig
niepewny - hachelijk
niepodległość - onafhankelijkheid f
nieposłuszny - ongehoorzaam
nieprzewidywalny - onvoorspelbaar
nieprzyjazny - onvriendelijk
nierówność - ongelijkheid f
nieść - dragen
nieściora - nicht
nieskuteczny - ineffectief
niewiasta - vrouw f
niewinny - onschuldig
niewolnictwo - slavernij f
niewolnik - slaaf m
nie wszystko złoto, co się świeci - het is niet alles goud wat er blinkt
nie wywołuj wilka z lasu - slapende honden wekt men niet
niezwyciężony - onoverwinnelijk
nigdy - nooit
nikiel - nikkel
niob - niobium
Nix - Nix
niż - dan
no - ja
nobel - nobelium
noc - nacht m
nominacja - nominatie f
Norbert - Norbert m
Norweg - Noor
Norwegia - Noorwegen
nosorożec - neushoorn m
Nowa Holandia - Nieuw-Nederland
Nowa Zelandia - Nieuw-Zeeland
nowotwór - tumor
nowy - nieuw
Nowy Orlean - New Orleans
Nowy Rok - Nieuwjaar
nóż - mes n
nożyce - schaar f
nożyczki - schaar f
nr - nr., nr
nudelzupa - soep f
nyga - mug f
obelisk - obelisk
oberżyna - aubergine
obiecadło - abc n
oblężenie - belegering f
obój - hobo m
obraz - film m
obserwować - observeren
ocean - oceaan
Ocean Spokojny - Grote Oceaan m
ociec - vader m
oczekiwać - verwachten, wachten op, afwachten
oczywiście - natuurlijk, uiteraard, vanzelfsprekend
odcisk palca - vingerafdruk
odlotowy - gaaf, tof, vet, cool, space
odmiana - type n, aard m, geslacht n, ras n, soort f, karakter n, genus n, sekse f
odmowa - weigering
odnośnie - ten opzichte van
odnośnie do - ten opzichte van
odpowiadać - antwoorden op, beantwoorden, overeenstemmen met, verantwoorden, verantwoordelijk zijn op, beantwoorden aan, vervullen
odpowiedź - antwoord n
odpowiedzialność - verantwoordelijkheid f
odpukać w malowane drewno - hout vasthouden
Odra - Oder
odsyłacz - link m
odszkodowanie - vergoeding f
odwet - vergelding f
odwracalny - omkeerbaar
oftalmologiczny - oogheelkundig
ogień - vuur n
ogórek - augurk, komkommer
ojciec - vader m
ojczyc - zoon
ojla - uil m
okłamywać - liegen
okno - raam
oko - oog n
okręt podwodny - onderzeeboot, onderzeeër m, duikboot m
okulistyczny - oogheelkundig
olcha - els m
olej - olie f
Olimpia - Olympia
omieszkać - nee, niet
ona - zij
oologia - oölogie
opactwo - abdij f
opal - opaal
opiąć - weer, opnieuw
opięć - weer, opnieuw
oprócz - behalve
oraz - en
organista - organist
orgazm - orgasme m, klaarkomen n
orzeczenie - gezegde n
orzeł - adelaar, arend
oś - as m
osa - wesp f
ośla łączka - babypiste
osm - osmium
osoba - persoon
Ostia - Ostia
ostrężyna - braam
ostrzyć - scherpen, wetten
otwierać - openen, opendoen
owalen - ovaleen
owoc - fruit, vrucht
ożarty - beschonken, dronken, zat
ożyna - braam
pacha - oksel m
paciuk - rat f, bruine rat f, rioolrat f, zwarte rat f
Pacyfik - Grote Oceaan m
pająk - spin m
pajęcznik - september, oktober, wijnmaand, november
pakli - als, indien
pała - hoofd (głowa człowieka lub konia), kop (głowa innego zwierzęcia)
palczatka cytrynowa - citroengras
pale - hoofd (głowa człowieka lub konia), kop (głowa innego zwierzęcia)
paleoproterozoik - Paleoproterozoïcum
Palestyńczyk - Palestijn
palindrom - palindroom
paliwo - brandstof m
pallad - palladium
palladianizm - palladianisme m
pan - U, meneer, heer, meester
Pan - Heer
Pan Bóg - Heer
panda - panda
Panna - Maagd
państwo - staat
papier milimetrowy - millimeterpapier
papież - paus m
papuga - papegaai
para - waterdamp
parapetówa - inwijdingsfeest
parapetówka - inwijdingsfeest
paraplegia - dwarslaesie
partia polityczna - politieke partij
Paryż - Parijs
pasożyt - parasiet m
pasza - voer m
pasztet strasburski - foie gras m, ganzenlever m, eendenlever m
pątnik - pelgrim m
paw - pauw m
pawęża - schild
październik - oktober, wijnmaand
paździerzeń - oktober, wijnmaand
pazura - hand f
peja - luis
pentagon - vijfhoek, pentagoon
pępek - navel m
perka - aardappel m
perła - parel
persona - persoon
peryskop - periscoop
petronelka - lieveheersbeestje n
piana - bier n
piaskownica - zandbak m
piątek - vrijdag m
pidżama - pyjama
piec - bakken
pięciokąt - vijfhoek, pentagoon
piekarz - bakker m
piękny - mooi
pielgrzym - pelgrim m
pień - stam m
pieprzyć - naaien, neuken
pierdolić - neuken, naaien
pierwiastek - element n, wortel m
pierwsza pomoc - Eerste Hulp Bij Ongelukken, EHBO
pies - hond
pies asystujący - assistentiehond
pięść - vuist f
pieścić - aaien
pies do towarzystwa - gezelschapshond
pies gończy - speurhond
pieśń - lied n
pies opiekun - assistentiehond
pies pasterski - herdershond
pies policyjny - politiehond
pies pomocnik - assistentiehond
pies przewodnik - geleidehond
pies towarzyszący - assistentiehond
pieszy - voetganger
piętro - etage, verdieping
pigularz - apotheker m
pigwa - kweepeer
pijanica - rijsbes
pijany - beschonken, dronken, zat
piksel - pixel
piłka nożna - voetbal
piłkarzyki - tafelvoetbal m
pinczer średni - Duitse pincher
piorun - bliksem m
piosenka - lied n
piosenkarz - zanger m
Piotr - Peter, Petrus, Piet, Pieter
Piotra - Petra f
pirat - piraat m
piromania - pyromanie f
pisarz - schrijver
pismo - abc n
pistacja - pistache f, pistachenoot f
pistolet maszynowy - machinepistool, pistoolmitrailleur
Pittsburgh - Pittsburgh
piwo - bier n
piżama - pyjama
pizza - pizza f
płacić - betalen, dokken, storten, uitbetalen, uitkeren, voldoen
plajster - pleister
płakać - huilen
planeta - planeet
planetarium - planetarium n
plaster - pleister
płaszczka - rog m
płeć - geslacht n, sekse f
plemię - stam m
plik - dossier n, ordener m, ordner m, bestand m, file m
płuco - long f
pluton - plutonium
płynąć - zwemmen, za pomocą łodzi: varen, stromen
płyn Lugola - lugol
płynny - vloeibaar, vloeistof
pobożny - vroom
pocałunek - zoen, kus
pocałunek z języczkiem - tongzoen
pocestny - reiziger
pochodnia - fakkel f
pochwa - vagina, schede
podatek kościelny - kerkbelasting
Podlasie - Podlachië
podobny - gelijkend
podróżnik - reiziger
poezja - poëzie f
pojedynek - duel
pojutrze - overmorgen
pokój - vrede, rust, kamer
pokrywać - bedekken
Polak - Pool
policja - politie
poliptyk - polyptiek
politura - politoer
polityka - politiek f
północnoamerykański - Noord-Amerikaans
polon - polonium n
połowa - helft m
półowa - helft m
położenie - plaats
położnica - kraamvrouw
Polska - Polen n
polski - Pools
półtora - anderhalf
półtorej - anderhalf
południk - meridiaan
półwysep - schiereiland
pomarańcza - sinaasappel, appelsien
pomarańczowy - oranje
pomidor - tomaat f
pomoc - hulp
Pomorze - Pommeren
poniedziałek - maandag m
ponieważ - omdat, aangezien, daar
ponownie - weer, opnieuw
por - prei m
pornograficzny - pornografisch
portier - portier m, conciërge m
Portugalia - Portugal
portugalski - Portugees, Portugees n
porucznik - eerste luitenant
potas - kalium n
potrzeba jest matką wynalazków - noodzaak is de moeder van uitvinding
potwór - monster n
powabnica - juweelwesp, zandgoudwesp
powabnica piaskowa - juweelwesp, zandgoudwesp
powiestka - naam m, Titel
powódź - overstroming f, vloed
powtarzać - herhalen
poza - behalve
pozawczoraj - eergisteren
pożyczka - lening f
PP - EHBO
praca - werk, baan, werking
praca domowa - huiswerk
Praga - Praag
prakseologia - praxeologie
prawa ręka - hand f
prawda - waarheid f
prawdopodobny - waarschijnlijk
prawdziwych przyjaciół poznaje się w biedzie - in nood leert men zijn vrienden kennen
prawo - wet, recht, rechts
prazeodym - praseodymium
prażyć - roosteren
prekariat - precariaat
prezent - geschenk n, cadeau n
prezentacja - voorstelling, voordracht
prezerwatywa - condoom
prócz - behalve
produkcja - fabrikation
promet - promethium
propaganda - propaganda f
propagando - propaganda f
prosię ziemne - aardvarken
proszę - alsjeblieft
protaktyn - protactinium
prowadzić - gaan (prowadzić jako droga), leiden, voeren, besturen, rijden, veroorzaken
Prusy - Pruisen
przać - houden van, verliefd zijn, vrijen
przebaczenie - vergiffenis, vergeving
przebiśnieg - sneeuwklokje n
przeciwutleniacz - antioxidant
przeciwwaga - contragewicht n
przedpokój - gang, hal
przedwczoraj - eergisteren
przekaźnik - relais
przepaska - lendendoek m
przepaska biodrowa - lendendoek m
przesądny - bijgelovig
prześcieradło - laken n
przestępstwo - misdaad
przestrzegać - waarschuwen, gehoorzamen, in acht nemen
przestrzeń kosmiczna - ruimte
przewlekły - chronisch, langdurig
przewrotka - omhaal
przoć - houden van, verliefd zijn, vrijen
przyjemny - aangenaam
przyrznia - verstekbak
przysięgać - zweren, een eed afleggen
przysłówek - bijwoord
psiarnia - politie
psisko - hond
pszczoła - bij f
Ptah - Ptah
ptak - vogel m
ptasia grypa - vogelpest, vogelgriep, aviaire influenza
ptaszę - vogel m
puchacz - oehoe
purpurowy - purper
pustka - leegte f
pustynia - woestijn f
puszka - bier n
pycha - hoogmoed m
Pyjter - Peter, Petrus, Piet, Pieter
pyra - aardappel m
pytanie retoryczne - retorische vraag
quorum - quorum
rabarbar - rabarber f
rachatłukum - turks fruit
raciądz - ridder m
rad - radium
radioaktywny - radioactief
radon - radon n
raj - paradijs n
raja - rog m
Rajch - Duitsland n
Rak - Kreeft
rana - wonde f
ranek - morgen
rano - morgen
rasizm - racisme n
razdziawa - kraai m
razem - aaneen
ręce do góry - handen omhoog!
ręcznik - handdoek
redyska - radijs f
redźka - radijs f
regent - regent m
rejs - reis
ręka - hand f
rekin - haai m
reklama - advertentie f
rekolekcje - retraite
relikwia - reliek
remiza - brandweerkazerne
ren - renium
renowacja - renovatie m
Republika Czeska - Tsjechische Republiek
Republika Federalna Niemiec - Bundesrepubliek Duitsland
Republika Słowacka - Slowaakse Republiek
Republika Środkowoafrykańska - Centraal-Afrikaanse Republiek
Republika Zielony Zielonego Przylądka - Kaapverdië n
rewolucjonista - revolutionair m
robić - maken, doen
robić z igły widły - van een mug een olifant maken, van een muis een olifant maken
rod - rhodium
rodzaj - type n, aard m, geslacht n, ras n, soort f, karakter n, genus n, sekse f
rodzic - ouder
rodzina - gezin n
rodzynek - rozijn f, krent f
rodzynka - rozijn f, krent f
rogal - croissant m
rok - jaar n
Roksana - Roxane
ropień - abces
ropowica - flegmone
ropucha - pad f
Rosja - Rusland
rosomak - veelvraat m
rotmistrz - ritmeester
równanie - vergelijking
również - ook, tevens, eveneens
równoważny - equivalent, gelijkwaardig
różdżka - toverstaf m
rożek - croissant m
rozgwiazda - zeester f
rozmaryn - rozemarijn m
rozmyślnie - bewust, expres, opzettelijk, met opzet
różowy - roze
rozumieć - begrijpen, snappen, verstaan
różyczka - rodehond m
rubid - rubidium n
ruchome schody - roltrap m
rudny - rood
rugby - rugby n
Rumunia - Roemenië n
rura - pijp, paal
ruten - ruthenium n
rutherford - rutherfordium
ryba - vis
Ryby - Vissen
rycerz - ridder m
rysować - tekenen, krassen
rysunek - tekening
rytuał - ritus f, kerkgebruik n
rywalizować - concurreren, meedingen, wedijveren
ryż - rijst
rzadko - zelden
rząd marionetkowy - vazalstaat, marionettenregering
rządzić - regeren, heersen, aanvoeren
rzeczownik - substantief n, zelfstandig naamwoord n
rzeczywistość - werkelijkheid f
rzeka - rivier f
rzeźnia - abattoir
rzeżucha - waterkers
rzić - kont
rzodkiewka - radijs f
rzut karny - strafschop m, penalty m
rzykać - bidden
sadzić - planten, poten
sagan - hoofd (głowa człowieka lub konia), kop (głowa innego zwierzęcia)
Saipan - Saipan
saksofonista - saxofoonspeler
sałata - taxi
salina - zoutpan
Salwador - El Salvador
sam - alleen
samar - samarium n
samiec - mannetje n
samo - alleen
samobójca - zelfmoordenaar m
samobójstwo - zelfmoord m, zelfdoding f
samochód - auto
sandacz - snoekbaars n
Sardynia - Sardinië
sarkofag - sarcofaag m
sarna - ree
sarnapa - giraf f
satelita - satelliet m, satellietstaat m
satysfakcja - duel
schody ruchome - roltrap m
ściągać - downloaden
ściemniać - liegen
seaborg - seaborgium n
segregacja rasowa - rassensegregatie, rassenscheiding
sejf - brandkast f, kluis, safe f
seksturystyka - sekstoerisme
seksualność - seksualiteit f
seksuologia - seksuologie
selen - seleen n, selenium n
seler - selder m, selderij m, selderie m
Serbia - Servië
Serbia i Czarnogóra - Servië en Montenegro
si - deze, de
siano - hooi n
siarka - zwavel
siarkowodór - Waterstofsulfide, zwavelwaterstof
siatkówka - volleybal, netvlies n
sieczeń - februari, sprokkelmaand, regenmaand
siedem grzechów głównych - zeven hoofdzonden
siemię lniane - lijnzaad
sierociniec - weeshuis n
sierpień - augustus
silno - heel, erg, meer, meest
sin - sin
Singapur - Singapore
siodło - zadel m
siostra - zus f, zuster f
sirpień - augustus
skand - scandium n
sklep monopolowy - slijterij
Skop - Ram
Skorpion - Schorpioen
skrytka pocztowa - postbus
skurwysyn - hoerenzoon m, hoerenjong n
słabość - zwakte
Śląsk - Silezië
śledziona - milt
śleptać - huilen
ślimak - slak f
slipy - slip
słoń - olifant
Słońce - Zon
słony - zout
słowa - woord n
Słowacja - Slowakije
Słowenia - Slovenië
Słowianin - Slaaf m
słownik - n woordenboek
słowo - woord n
słuchać - luisteren
sługa - bediende w
slup - sloep
smak - smaak
smażyć - bakken
smerf - Smurf, Smurfen
śmierć - dood
śmietana - room m
smrodyla - zwarte bes
smutniak - brood n
smutny - triest, verdrietig
smycz - hondenlijn
śnieg - sneeuw m
sobaka - hond
sobota - zaterdag m
sód - natrium n
sojusznik - bondgenoot m
sokół - valk
sopel - ijspegel
sos sojowy - sojasaus
sowa - uil m
sowa śnieżna - sneeuwuil
spać - slapen
spadać - vallen, verminderen, verlagen, oprotten, opdonderen
śpiący - slaperig
śpiewać - zingen
spirulina - spirulina f
śpiwór - slaapzak m
spotykać - ontmoeten
spowiedź - bekentenis, biecht
sprawdzać - checken, controleren, verifiëren
sprawiedliwość - gerechtigheid f
sprawiedlność - gerechtigheid f
sprzedawać - verkopen
sp. z o.o. - BV, BVBA
srebrna - zilver
srebrny - zilver
srebro - zilver n
Sri Lanka - Sri Lanka
środa - woensdag m
stała - constante
stanik - bustehouder m
Stany - Verenigde Staten
Stany Zjednoczone - Verenigde Staten
Stany Zjednoczone Ameryki - Verenigde Staten
starek - grootvader, opa, notenkraker m
stare miasto - oud, stad f, binnenstad, stadskern
starosek - grootvader, opa, notenkraker m
staroszek - grootvader, opa, notenkraker m
starszy - vader m
stary - oud
starzyk - grootvader, opa, notenkraker m
staw - vijver m, gewricht n
staw krzyżowo-biodrowy - sacro-iliacale gewrichten
staw łokciowy - elleboog
Stefan - Stefan
stereotyp - stereotype
stolica - hoofdstad
stonka - coloradokever
stopa - voet m
strach - angst m, vrees f, vogelverschrikker
strach na wróble - angst m, vrees f, vogelverschrikker
strąpacz - februari, sprokkelmaand, regenmaand
strażak - brandweerman
strefa Złotowłosej - Goudlokjesgebied n
stront - strontium
Strzelec - Boogschutter
studiować - studeren
stulecie - leeftijd, eeuw, eeuwen
styczeń - januari m, lauwmaand
subkontynent - subcontinent n
sugilit - sugiliet
sukienka - jurk f
sumienny - gewetensvol
Surinam - Suriname
suwerenność - soevereiniteit
świekier - schoonvader m
świekra - schoonmoeder f
świeść - schoonzus f, schoonzuster f, schoonmoeder f
świetlik lekarski - beklierde ogentroost
Święty Hufiec - Heilige Schare
Święty Zastęp - Heilige Schare
świostka - schoonzus f, schoonzuster f, schoonmoeder f
Sycylia - Sicilië
sylaba - lettergreep f
symbol - symbool n
syn - zoon
synapsa - synaps
syndrom grupowego myślenia - groepsdenken
syndrom miodowy miodowego miesiąca - wittebroodsweken syndroom n
synergia - synergie
synteza - synthese f
sypialnia - slaapkamer f
syrop klonowy - edoornsiroop, ahornsiroop
system operacyjny - besturingssysteem
szachy - schaakspel
szamanizm - sjamanisme
szampan - champagne
szary - grijs
szczaw - zuring f
szczeniak - welp
szczenię - welp
szczotka do włosów - haarborstel
szczur - rat f, bruine rat f, rioolrat f, zwarte rat f
szczyt - orgasme m, klaarkomen n
szechina - Sjechiena f
Szechina - Sjechiena f
szept - gefluister n, fluistering
szkira - meisje, meid, dienstmeid
szklistka - glasachtig lichaam
Szkocja - Schotland n
szkop - Duitser m
szlachtuz - abattoir
Szląsk - Silezië
szminka - lippenstift m
szneka - gezicht n, aangezicht n, gelaat n
szowinizm gatunkowy - speciesisme
szparag - asperge f
szpic fiński - Finse spits, Finse keeshond
szpic japoński - Japanse spits
sztuka - meisje, meid, dienstmeid
szwab - Duitser m
Szwabia - Schwaben, Zwaben
szwagierka - schoonzus f, schoonzuster f
Szwajcaria - Zwitserland
Szwecja - Zweden
Szwecyjo - Zweden
szwestera - zus f, zuster f
szyjka macicy - baarmoederhals m
szykowny - mooi
ta - deze, de
tablica rejestracyjna - kentekenplaat, nummerplaat
tablice logarytmiczne - logaritmetafel
tachykardia - tachycardie
tacik - vader m, grootvader, opa, notenkraker m
Tadżykistan - Tadzjikistan
tajemniczy - geheimzinnig
Tajlandia - Thailand
tak - ja
taksonomia - taxonomie f
taksówka - taxi
taksydermia - taxidermie
także - ook, tevens, eveneens
tak zwany - zogenaamd
tal - thallium n
talasemia - thalassemie
tam - daar
Tamara - Tamara
tamdotąd - daar
taniec na rurze - paaldansen
tantal - tantaal n, tantalium n
Tanzania - Tanzania
tarcza - schild, gezicht n, aangezicht n, gelaat n, tuimelschijf
tarcza krystaliczna - schild
tarcza sterująca - tuimelschijf
tarcza strzelecka - schild, gezicht n, aangezicht n, gelaat n, tuimelschijf
tarcza szkolna - schild
taśma perforowana - ponsband
taśtać - dragen
te - deze, de
technet - technetium n
technokracja - technocratie
technolog - technoloog
technologia - technologie f
tej - jij, je
tellur - telluur n
temat - onderwerp
temperatura pokojowa - kamertemperatuur
ten - deze, de
ten sam - hetzelfde n, dezelfde w, datzelfde
ten śmiać się śmieje, kto śmiać się śmieje ostatni - wie het laatst lacht, lacht het best
tenże - deze, de, dit, het, dat, dan
teofania - theofanie m
terapeuta - therapeut
terb - terbium n
teren - terrein
terier - terriër
termodynamika - thermodynamica
Termopile - Thermopylae
terroryzm - terrorisme n
teść - schoonvader m
teściowa - schoonmoeder f
tetraplegia - tetraplegie
tetrapylon - tetrapylon
tetum - Tetun
też - ook, tevens, eveneens
tg - tan
Timor Wschodni - Oost-Timor
tiul - tule
tkactwo - weven n
tlen - zuurstof n
tłumaczenie - vertaling
tłumaczyć - uitleggen, zich verontschuldigen, vertalen
to - dit, het, dat, dan
tobie - jij, je
toksyna - toxine
tolerować - aanzien
topografia - topografie
topola - populier m
toponim - toponiem n
tor - thorium n, tor
tory - thorium n, tor
totem - totem m
transgenderowy - transgender
transport - vervoer n, transport n
transsubstancjacja - transsubstantiatie
trawa cytrynowa - citroengras
trichotillomania - trichotillomanie
truchło - lijk n
tryk - ram m
trzeźwy - nuchter, sober, bedachtzaam
trznadel zwyczajny - geelgors
tsunami - vloedgolf
tu - hier
tudzież - en
tukej - hier
Tunezja - Tunesië
turban - tulband
turkusowy - turkoois
tutaj - hier
tuż - bijna, nagenoeg, vrijwel, zo goed als
twardość - hardheid f
twarz - gezicht n, aangezicht n, gelaat n
twierdza - vesting f
ty - jij, je
tyj - thee m
tylko - alleen, slechts
tymianek - tijm m
Tyrteusz - Tyrtaeus m
tytan - titanium
tytuł - Titel
ubierać - kleden, aankleden, omkleden, staan
ubóstwo - armoede
ucho - oor
uczeń - leerling, scholier, student
uczynek - daad f
udziec - been
ukaz - oekaze m
układ okresowy - periodiek systeem
Ukraina - Oekraïne
ukraiński - Oekraïens n
ulica - straat
umiak - huidboot, umiak
umyślnie - bewust, expres, opzettelijk, met opzet
umywalka - wastafel f
Unia Europejska - Europese Unie f
ununhexium - ununhexium n
ununoctium - ununoctium
ununpentium - ununpentium
ununquadium - ununquadium
Ural - Oeral
urępny - mooi
urna - urn m
urodziwy - mooi
urologia - urologie
uśmiechać się - glimlachen
uzasadniać - rechtvaardigen
Uzbek - Oezbeek
użytkownik - gebruiker
w - in
wacha - wahoo, benzine f, zee f, water n
Waga - Weegschaal
wagary - spijbelen schoolverzuim
wajco - ei n, kippenei, eendenei, slangenei
wąkrota zwyczajna - gewone waternavel
wałach - ruin m
Waldemar - Waldemar
walet - boer
Walia - Wales
wampirzyca - vampirella f
wanad - vanadium
wapń - calcium
wapniak - ouder
waran - varaan m
Warszawa - Warschau
warzyć - koken, zich voorbereiden
warzywo - groente f
wąski - nauw
wata cukrowa - suikerspin f
wątroba - lever m
Watykan - Vaticaan
ważka - libelle
wczoraj - gisteren
wdowa - weduwe f
wdowula - weduwe f
wdzięczność - dankbaarheid
we - in
weganin - veganist m
weganizm - veganisme
wegański - veganistisch
wegetarianin - vegetariër
wegetarianizm - vegetarisme
węgiel - koolstof n
Węgierka - Hongaarse f
węgorz - paling
Węgry - Hongarije n
welin - velijn, velijnpapier
wena - ingeving, ader
wentroba - lever m
wesoło - vrolijk
wesoły - vrolijk
Wesołych Świąt - prettig kerstfeest, prettige kerstdagen, gelukkig kerstfeest, vrolijk kerstfeest
wesz - luis
weterynaria - diergeneeskunde
węzeł - knoop m
wezwanie - naam m, Titel
wiatr - wind m
wieczna lampka - godslamp
wieczność - eeuwigheid f, eeuw f
wieczór - avond m
Wiedeń - Wenen
wiek - leeftijd, eeuw, eeuwen
wiela - welk, welke, die
wielbłąd - kameel m
Wielka Brytania - Groot Brittannië
Wielkanoc - Paasfeest n, Pasen n
Wielkie Antyle - Grote Antillen
Wielki Piątek - Goede Vrijdag
Wielkopolska - Groot-Polen
wielokulturowość - multiculturalisme, multiculturaliteit
wiewiórka - eekhoorn
wieża - toren
Wikipedia - Wikipedia
wikipedysta - Wikipediaan m
Wikisłownik - Wikiwoordenboek n
Wikiźródła - Wikisource
wilk - wolf m
wilkołak - weerwolf m
wilk w owczej skórze - wolf in schaapskleren m
willa - villa
winda - lift m
winnica - wijngaard
winograd - wijngaard
wiosło - riem
wiosna - lente
Wisła - Wisła
Włochy - Italië n
włos - haar
wnęk - kleinzoon m
wnęka - kleindochter f
wnuczka - kleindochter f
wnuk - kleinzoon m
woda - water n
woda mineralna - mineraalwater n
w odniesieniu do - ten opzichte van
Wodnik - Waterman
wodór - waterstof n
wojak - soldaat m
województwo - woiwodschap
wojna - oorlog
wojna religijna - heilige oorlog
wojskowy - soldaat m
wokabularz - n woordenboek
wolna miłość - vrije liefde
wolnomularz - vrijmetselaar m
wołowina - rundvlees n
wózek dziecięcy - kinderwagen m
wózek sklepowy - winkelwagen m, winkelwagentje n
wróg - vijand m
wrona - kraai m
wrzesień - september
współczucie - medelijden n
wspólnie - aaneen
współpracować - samenwerken
wszyscy - iedereen
wszystek - al
wszystkie - iedereen
wszystkie drogi prowadzą do Rzymu - alle wegen leiden naar Rome
wszystko - alles
wtorek - dinsdag m
w tym - in, dit, het, dat, dan
wuszt - worst m
wy - jullie, u
wybierać - kiezen, verkiezen
Wybrzeże kość Kości Słoniowej - Ivoorkust
wybuch - explosie
wyciąg krzesełkowy - stoeltjeslift, zetellift
wydma - duin
wyjątek - uitzondering
wyjątkowy - uniek, enig, speciaal
wyjebany - kankergoed, fuckinggoed, kankergeweldig, kankermoe
wyjście - uitgang
wykrywacz kłamstw - leugendetector
wykusz - erker
wymiennik ciepła - warmtewisselaar
wymowa - uitspraak
wynagrodzenie - loon
wyraz - woord n
wyścig w workach - zaklopen
wyspa - eiland n
Wyspa Księcia Edwarda - Prins Edwardeiland
Wyspa Świętego Wyspy Świętego Tomasza i Wyspa Książęca - Sao Tomé en Principe
Wyspy Kanaryjskie - Canarische Eilanden
Wyspy Marshalla - Marshalleilanden
Wyspy Owcze - Faeröer
wytrysk - ejaculatie
wzdręga grecka - griekse ruisvoorn
Zabulon - Zebulon m
zachód księżyca - ondergang van de maan m, maansondergang
zachód słońca - zonsondergang m
zaćmienie - eclips, verduistering f
zadanie domowe - huiswerk
żaden - geen
zadowolenie - genoegen
zagadka - raadsel n
żagiel - zeil n
zaimek - voornaamwoord n
zając - haas
zakażenie - infectie
żal - verdriet
zalany - beschonken, dronken, zat
założyciel - oprichter m
zamach stanu - staatsgreep m
zamknąć - sluiten
zapalenie płuc - longontsteking
zapiekanka - ovenschotel
zapominalski - vergeetachtig
zapraszać - uitnodigen
zarabiać - verdienen
zarękawek - mof f
zaś - weer, opnieuw
zaskroniec - ringslang f
zawój - tulband
zawór bezpieczeństwa - veiligheidsventiel
zawór motylkowy - vlinderklep
zawór skrzydełkowy - vlinderklep
zawroty głowy - duizeligheid, draaierigheid f
zawsze - altijd
zawżdy - altijd
zazulka - lieveheersbeestje n
zbiór - dossier n, ordener m, ordner m, bestand m, file m
żdać - wachten
zdecydować - besluiten
zdrowie - gezondheid
zdrzadło - spiegel
zegar słoneczny - zonnewijzer m
żegleń - koolstof n
Zelandia - Seeland, Zeeland
żelazo - ijzer
zelter - mineraalwater n
zemsta - wraak
żeńczyna - vrouw f
zespół Sjögrena - syndroom van Sjögren
zgrubienie - vergrootwoord
zięć - schoonzoon
zielnik - herbarium
Ziemia Święta - Heilige Land n
ziemniak - aardappel m
zima - winter m
zimorodek - ijsvogel
złodziej - dief m
złoto - goud n
złoty spadochron - gouden handdruk
złożenie - samenstelling
znać - kennen, kunnen
znajdować - zich bevinden
znak wodny - watermerk
znany - bekend
znęcać się - mishandelen
znów - weer, opnieuw
znowu - weer, opnieuw
żołądek - maag f
żółć - gal, geel
żołnierz - soldaat m
żółtaczka - geelzucht m
żółty - geel
żółw - schildpad
żołwica - schoonzus f, schoonzuster f
żółw lamparci - panterschildpad
zoo- - zoö-
zooplankton - zoöplankton m
zostawać - blijven, overblijven, worden
źrenica - pupil, oog n
z tyłu liceum, z przodu muzeum - van achteren lyceum, van voren museum
żuaw - zouaven, zouaaf
żulik - jongetje n
zupa - soep f
żurawina - veenbes (cranberry)
żurnal - periodiek, revue, tijdschrift, magazine
Zurych - Zürich
zwiastun - filmtrailer
Związek Socjalistycznych Republik Radzieckich - Unie van Socialistische Sovjet Republieken
zwierciadło - spiegel
zwierzak - dier n, beest n
zwierzę - dier n, beest n
zwłoki - lijk n
z wyjątkiem - behalve
zwykle - gewoonlijk
z wyłączeniem - behalve
żymła - broodje, bolletje, kadetje
żyrafa - giraf f
