abdykacja - abdikacija
Abidżan - Abidjan
aborcja - pobačaj, abortus
Abwehra - Abwehr
abwera - Abwehr
Adam - Adem m
Adonis - Adonis
aerodynamiczny - aerodinamički
Afganistan - Afganistan, Avganistan
agnostycyzm - agnosticizam m
agresja - agresija f
Alaska - Aljaska
Albania - Albanija
alchemia - alhemija
Algieria - Alžir m
Allach - Allah m
Allah - Allah m
Alzacja - Elzas
Amazonia - Amazonija
Amazonka - Amazon
amerykański - američki
Ameryka Południowa - Južna Amerika f
Amman - Aman
anatomia - anatomia f
android - android m
Andromeda - Andromeda
Andy - Andi
ankieta - anketa f
Antananarywa - Antananarivo
Antarktyda - Antarktik
antykoncepcja - kontracepcija f
Antyle Holenderskie - Holandski Antili
Arab - Arapin
Arabia Saudyjska - Saudijska Arabija
arabski - arapski
arabus - Arapin
archanioł - arhanđel m, arhanđeo m
Argentyna - Argentina f
Arktyka - Arktik
armia - vojska f, armija f
armijo - vojska f, armija f
artykuł - članak
Asyria - Asirija
Atlantyk - Atlantski okean m
Austria - Austrija f
austriacki - austrijski
autyzm - autizam m
Azerbejdżan - Azerbejdžan
Badenia-Wirtembergia - Baden-Württemberg
bajer - laž
bakłażan - patlidžan m
Bałtyk - Baltičko more
bana - tramvaj m
bank - banka f
banka - tramvaj m
barabola - krumpir m
bębenek - bubnjić, bubna opna
beczeć - plakati
Bejrut - Bejrut m
Benin - Benin m
Berlin Zachodni - Zapadni Berlin
beryl - berilij
bezosobowy - bezličan
Biblia - Biblija f
bimba - tramvaj m
biskup - biskup m
bizmut - bizmut
blaga - laž
Bliski Wschód - Bliski Istok m
błona bębenkowa - bubnjić, bubna opna
bóg - božanstvo n
ból - bol
Boliwia - Bolivija f
bośniacki - bosanski, bosanski jezik
bóstwo - božanstvo n
browar - pivo n
Brunei - Brunej
Budapeszt - Budimpešta
bulba - krumpir m
bulwa - krumpir m
burzowiny - pivo n
Była Jugosłowiańska Republika Macedonii - Bivša Jugoslovenska Republika Makedonija f
chemia organiczna - organska hemija
chipset - čipset m
chlorofil - hlorofil m
chmiel - pivo n
choroba von Willebranda - von Willebrandova bolest
Chorwacja - Hrvatska
chorwacki - hrvatski
chrystianizm - kršćanstvo n, hrišćanstvo n
chrześcijaństwo - kršćanstvo n, hrišćanstvo n
ciąg arytmetyczny - aritmetička progresija f, aritmetički niz m
ciało szkliste - staklasto tijelo
ciśnienie - pritisak
ciśnienie tętnicze - krvni pritisak
ciupa - zatvor
ciurma - zatvor
ćma - moljac
cud - čudo n
cukier - šećer
czarna dziura - crna rupa
czarna skrzynka - crna kutija f
Czarnogóra - Crna Gora f
czarnogórski - crnogorski, crnogorski m
Czeczenia - Čečenija
czereśnia - trešnja
cześć - zdravo, ćao
cześnia - trešnja
czyhunka - torij
Dagestan - Dagestan
dalmatyńczyk - dalmatinac, dalmatiner
demokracja - demokratija
Demokratyczna Republika Wyspy Świętego Tomasza i Wysp Świętego Tomasza i Książęcej - Demokratska Republika Sao Tome i Principe
dialekt - dijalekt m
DNA - DNK
Dniepr - Dnjepar
dno - dno
dobranoc - laku noć
dojrzewanie - adolescencija
doradca - savjetnik m
do widzenia - zbogom, pozdrav, doviđenja
do zobaczenia - zbogom, pozdrav, doviđenja
druga wojna światowa - drugi svjetski rat m
dudlać - plakati
dusza - duša f
dysfagia - disfagija f
Dżamila - Džemila f
dzień dobry - dobro jutro
dziennikarstwo - novinarstvo n
dziurkacz - bušač akata m
dziurkacz biurowy - bušač akata m
dżungla - džungla f
dźwięk - zvuk
ekonomia - ekonomija f
ekosystem - ekosistem
ekskomunika - ekskomunikacija
Ekwador - Ekvador
elektroliza - elektroliza f
epilepsja - epilepsija
Ereb - Ereb m
erytrocyt - eritrocit
erytrozyna - eritrozin
estetyka - estetika f
etymologia - etimologija f
Europa Zachodnia - Zapadna Evropa
ewangelia - evanđelje n
ewolucja - evolucija f
Ezdrasz - Ezra
fajera - volan m
faryna - šećer
fefer - biber
Fenicja - Fenicija f
filologia - filologija f
Finlandia - Finska
Florencja - Firenca
fonetyka - fonetika f
fotorealizm - fotorealizam m
francuski - francuski
furdygarnia - zatvor
Gabon - Gabon
gała - vrana f
gapa - vrana f
gdzie - gdje
geburstag - dan rođenja
gentamycyna - gentamicin m
geologia - geologija
gimnastyka - gimnastika
glajza - torij
glapa - vrana f
gnat - kost f
granica - granica f
gwiazda - zvijezda f
hebrajski - hebrejski
hedonizm - hedonizam m
heparyna - heparin
hiacynt - zumbul m
Hongkong - Hong Kong
hydrologia - hidrologija f
II wojna światowa - drugi svjetski rat m
imperator - car
infrastruktura - infrastruktura f
internetowy - internetski
iryd - iridijum
islamizacja - islamizacija f
itd. - itd.
jajo - jaje n
Jamajka - Jamajka
jaśmin - jasmin
jednorożec - nosorog m
Jerycho - Jerihon
jeż - jež m
Jezus Chrystus - Isus Krist
język ojczysty - maternji jezik m
Jugosławia - Jugoslavija f (Југославија)
juliański - julijanski
kaj - gdje
kalifat - kalifat m, halifat m
kam - gdje
Kamerun - Kamerun
Kanał Sueski - Suecki kanal m
kapitalizm - kapitalizam
Karaczi - Karači
kartofel - krumpir m
kaszubski - kašupski, kašupski m
Katalonia - Katalonija
kataloński - katalonski
Katmandu - Katmandu
kazaski - kazaški
kędy - gdje
kejter - pas m
Kenia - Kenija f
kiełbasa - kobasica f
kierownica - volan m
kij - sprat m
kinematyka - kinematika
Kirgistan - Kirgistan
kit - laž
kłamstwo - laž
klara - Sunce
kluza - zatvor
kolonoskopia - kolonoskopija f
Kolumb - Kolumbo m
Kolumbia - Kolumbija f
komar - komarac m, komarica f
kondygnacja - sprat m
kopruch - komarac m, komarica f
Koran - Kur'an
kość - kost f
kosmologia - kosmologija f
Kostaryka - Kostarika
kotwica - sidro
kradzież - krađa f
kraj - država f
krtań - grkljan
krucjata - rstaški ratovi
kryminał - zatvor
Księżyc - Mjesec m
kwas foliowy - folna kiselina
kynologia - kinologija
łaciński - latinski
łącznik - pomoćni glagoli
laga - sprat m
lamaizm - lamaizam m
laptop - laptop
lato - ljeto n
lawenda - lavanda
łechtaczka - klitoris
leksykon - leksikon n
Leningrad - Peterburg
lider - lider m
lingwistyka - lingvistika f
listopad - novembar
lola - sprat m
Londyn - London m
luńt - pas m
lupa - lupa f
luty - februar
łża - laž
Maghreb - Magreb
Matka Boska - Gospa f
meczet - džamija f
Merkury - Merkur m
męski - muški
meteor - meteor
miażdżyca - ateroskleroza
miecz - mač
międzyludzki - međuljudski
międzynarodowy - međunarodni
mielcuch - pivo n
mięsopustnik - februar
minuta - minuta f, minut m
mistrzostwa - prvenstvo n
mistycyzm - misticizam m
Monako - Monako n
monofizytyzm - monofizitstvo
morze - more n
Morze Bałtyckie - Baltičko more
Morze Śródziemne - Sredozemno More
Mount Everest - Mount Everest
mugol - bezjak
mural - mural
muzułmański - muslimanski
mydło - sapun m
myśleć - misliti
nacja - nacija f
nacjonalizm - nacionalizam m
Nairobi - Nairobi m
naród - nacija f
nauka - nauka, znanost
Neapol - Napulj
Nepal - Nepal m
Niagara - Nijagara f, Nijagarini vodopadi m
niepodległość - nezavisnost
Nigeria - Nigerija
nihilizm - nihilizam m
no - da
nosorożec - nosorog m
numeracja - numeracija f
Numidia - Numidija f
nyga - komarac m, komarica f
oaza - оаза f
oberżyna - patlidžan m
ocean - okean
Ocean Atlantycki - Atlantski okean m
ogórek - krastavac m
ojla - sova
okręt podwodny - podmornica f
oksymoron - oksimoron
opal - opal
orgazm - orgazam m
Osaka - Osaka
owoc - voće
padaczka - epilepsija
pająk - pauk m
pajęcznik - septembar, novembar
Pakistan - Pakistan
państwo - država f
Pasztun - Paštun
perka - krumpir m
perski - perzijski
Petersburg - Peterburg
piana - pivo n
pieprz - biber
pies - pas m
pies policyjny - policijski pas
piętro - sprat m
piksel - piksel
pingwin - pingvin
piorun - munja f
Piotr - Petar
piwo - pivo n
płakać - plakati
plemnik - spermatozoid
płynny - tekućina
płyta główna - matična ploča
podkoszulek - potkošulja f
podkoszulka - potkošulja f
podzielić - podijeliti
polityka - politika
połóg - porođaj
polon - polonij
Polska - Poljska / Пољска f
Półwysep Bałkański - Balkan
poniedziałek - ponedjeljak / понедјељак
porcja - porcija
poród - porođaj
portugalski - portugalski
posowa - plafon m
Poznań - Poznanj
prawa człowieka - ljudska prava
prawo międzynarodowe - međunarodno pravo n
prezydent - predsjednik
proporcja - proporcija f
prorok - prorok m
przebiśnieg - visibaba f
przeciw - protiv
przeciwko - protiv
przestępstwo - kriminal
przysadka mózgowa - hipofiza
przyspieszenie - ubrzanje
przyśpieszenie - ubrzanje
przywilej - povlastica
pseudonauka - pseudonauka
psisko - pas m
publicystyka - publicistika f
puszka - zatvor, pivo n
Pyjter - Petar
pyra - krumpir m
rachatłukum - rahat lokum
rakuski - austrijski
razdziawa - vrana f
recesja - recesija f
rekin - ajkula f
Republika Federalna Niemiec - Savezna Republika Njemačka
rewolucja - revolucija f
robotyka - robotika f
romantyzm - romantizam m
rozprawa - rasprava f
rozum - razum m
rubid - rubidij
ruten - rutenij
rywal - rival m
ryż - riža f
rzeź - masakr
samar - samarij
samobójstwo - samoubistvo n
samogłoska - samoglasnik
sarajewski - sarajevski
seaborg - seaborgij
seks - seks m
seks oralny - oralni seks
semicki - semitski
siarkowodór - vodonik sulfid
sieczeń - februar
sitko - rešeto
skand - skandij
skiba - krađa f
skład - plafon m
sklep - plafon m
slawistyka - slavistika f
śledziona - slezena
śleptać - plakati
Słońce - Sunce
Słowacja - Slovačka
Słowianin - Sloven m
smysł - razum m
sobaka - pas m
socjologia - sociologija f
sok - đus, sok
solniczka - slanik m, solanik m, tuzluk m
Somalia - Somalija f
sopel - ledenica f
sowa - sova
specjalność - specijalitet
sperma - sperma
spermatozoid - spermatozoid
standaryzacja - standardizacija f
stare miasto - star
staroangielski - staroengleski
stary - star
strąpacz - februar
stulecie - vijek
styczeń - januar
Suez - Suec
sufit - plafon m
sufizm - tesavuf, sufizam
superbohater - superjunak m
suwerenność - suverenitet
swastyka - svastika f
świerszcz - cvrčak m
syjonizm - cionizam
symbol - simbol
szahada - šehadet
szczyt - orgazam m
szept - šapat m
szklistka - staklasto tijelo
Szwajcaria - Švajcarska f
Szwecja - Švedska
Szwecyjo - Švedska
szwedzki - švedski, švedski m
Tajlandia - Tajland m
tak - da
tal - talij
tantal - tantal
Tanzania - Tanzanija
technet - tehnecij
telewizja - televizor
tellur - telur
teologia - teologija
terb - terbij
terytorium - teritorij
Tokio - Tokio
toksyczność - toksičnost f
tor - torij
Tora - Tora f
tory - torij
trąd - lepra f
trambimba - tramvaj m
tramwaj - tramvaj m
tramwajka - tramvaj m
trener - trener
tryk - ovan m
tsunami - cunami m
Turcja - Turska
turystyka - turizam m
typografia - tipografija f
Unia Europejska - Evropska unija f
urodziny - dan rođenja
uzależnienie - odanost, predanost, sklonost
wacha - more n, voda
wąski - uski
weterynaria - veterina, veterinarska medicina
weterynaryjny - veterinarski
wiara - vjera
wiek - vijek
Wielka Brytania - Ujedinjeno Kraljevstvo, Velika Britanija f
Wielkanoc - Uskrs m, Vaskrs m
Wielkie Antyle - Veliki Antili
wietnamski - vijetnamski
więzienie - zatvor
Wikisłownik - Vikirječnik
Wikiźródła - Wikizvor
wilk - vuk m
wiśnia - višnja
Włochy - Italija f
wnęk - unuk m
wnęka - unuka f
wnuczka - unuka f
wnuk - unuk m
woda - voda
wojna domowa - građanski rat m
wolność słowa - sloboda govora f
wrona - vrana f
wrzesień - septembar
wrzód - ulkus, čir
Wschód - Bliski Istok m
wuszt - kobasica f
Wyspa Świętego Wyspy Świętego Tomasza i Wyspa Książęca - Sao Tome i Principe
Wyspa Świętej Heleny - Sveta Helena
Wyspa Wniebowstąpienia - Ascension
Wyspy Kanaryjskie - Kanarska ostrva
Wyspy Owcze - Farska Ostrva
zakład karny - zatvor
Zatoka Tajlandzka - Tajlandski zaliv
zdjęcie - slika f
zegar słoneczny - sunčani sat m
ziemniak - krumpir m
zima - zima f
zimna wojna - hladni rat
Związek Socjalistycznych Republik Radzieckich - Савез Совјетских Социјалистичких Република
zwierzak - životinja f
zwierzę - životinja f
