1. - &rlm | 1־טער
abażur - אַבאַזשור m (abażur)
abbuś - גלח m (galech)
abdykować - אַבדיקירן (abdikirn)
abecadlny - אַלפֿאַבעטיש (alfabetisz)
abecadło - אַלפֿאַבעט m (alfabet) | אַלף־בית m (alef-bejs)
abecadłowy - אַלפֿאַבעטיש (alfabetisz)
Abel - הבֿל m (hewl)
abfal - טעות m (toes) | גרײַז m (grajz) | פֿעלער m (feler) | וואַגן (wagn)
abiecadło - אַלפֿאַבעט m (alfabet) | אַלף־בית m (alef-bejs)
abiturient - אַביטוריענט m (abiturjent) | גראַדואַנט m (graduant)
ablegierek - קינד n (kind)
ablegrować - קלײַבן (klajbn)
abonent - אַבאָנענט m (abonent)
aborcja - אַבאָרט m (abort)
Abraham - אבֿרהם m (awraham) | אַבֿרם m (awrum)
Abramczyk - אַבראַמטשיק
absolutny - אַבסאָלוט (absolut)
absolwent - אַבסאָלווענט m (absolwent)
absorpcja - אײַנזאַפּונג f (ajnzapung) | אַבסאָרבירונג f (absorbirung)
absurd - אַבסורד m (absurd)
aby - כּדי (kedej) | זאָלן (zoln)
abzac - אָבצאַס) אָפּצאַס) m | קנאַפֿל m
Adam - אָדם m (odem)
adept - חסיד m (chosid / chosed)
adiutant - אַדיוטאַנט
administracyjny - אַדמיניסטראַטיוו (administratiw)
administrator - אַדמיניסטראַטאָר m (administrator)
administrować - אַדמיניסטרירן (administrirn)
admirał - אַדמיראַל m (admiral)
adopcja - אַדאָפּטירונג f
adres - אַדרעס m (adres)
adresat - אַדרעסאַט m (adresat)
adwentnik - דעצעמבער m (december)
adwokacja - שמירה f (szmire)
adwokat - אַדוואָקאַט m (adwokat)
aerodrom - אַעראָפּאָרט m (aeroport)
aeroplan - אַעראָפּלאַן m (aeroplan)
afa - מאַלפּע f (malpe) | אויף ,שטרודל ,מאַלפּע
afelzina - מאַראַנץ m
Afganistan - אפגאניסטאן
afisz - אַפֿיש (plakat)
aforyzm - אַפֿאָריזם m (aforizm) | גלײַכווערטל n (glajchwertl)
Afrykańczyk - אַפֿריקאַנער m (afrikaner)
afrykanerski - אַפֿריקאַנס m (afrikans) | אַפֿריקאַנעריש (afrikanerisz)
Afrykanin - אַפֿריקאַנער m (afrikaner)
afrykański - אַפֿריקאַניש (afrykanisz)
agar - כוליגאַן m (chuligan)
agat - אַגאַט m (agat)
agent - אַגענט m (agent)
agonia - אַגאָניע f (agonje)
agrafka - אַגראַפֿקע f (agrafke)
agresja - אַגרעסיע f
agresor - אַגרעסאָר
agrest - אַגרעס m (agres)
ajmer - עמער (emer)
aj waj - אוי־וויי (oj-wej)
akacja - אַקאַציע
akademicki - אַקאַדעמיש (akademisz)
akademik - אַקאַדעמיקער m (akademiker)
akademski - אַקאַדעמיש (akademisz)
akademus - אַקאַדעמיקער m (akademiker)
akceptować - אָננעמען פֿאַר ליב (onnemen far lib)
akcja - אַקציע f (akcje) | קאַמף m (kamf)
akordeon - האַרמאָניע f (harmonje)
aksamit - סאַמעט (samet)
aksjomat - אַקסיאָם f (aksjom)
akt - אַקט m (akt)
aktor - אַקטיאָר m (aktjor)
aktorka - אַקטריסע f (aktrise)
aktualnie - איצט (ict) | לעת־עתּה (lesate) | הײַנט צו טאָג (hajnt cu tog) | הײַנט (hajnt)
akt urodzenia - געבוירן־אַקט m (gebojrn-akt)
aktyn - אַקטיניום (aktinjum)
akurat - טאַקע (take) | פּונקט (punkt)
akuratnie - פּונקט (punkt) | ערשט (erszt) | טאַקע (take)
akuratny - גענוי (genoj)
akuszeria - אַקושעריע f (akuszerie)
akuszerka - אַקושערקע f (akuszerke) | הייבאַם f (hejbam)
akwarium - אַקוואַריום m (akwarjum)
akwizytor - פּעדלער m (pedler)
Albania - אלבאניע
aleja - עוועניו f (ewenju) | שפּאַליר m (szpalir)
Aleksander - אַלעקסאַנדער m
alergia - אַלערגיע f
alfabet - אַלפֿאַבעט m (alfabet) | אַלף־בית m (alef-bejs)
alfabetu - אַלפֿאַבעט m (alfabet) | אַלף־בית m (alef-bejs)
alfabetyczny - אַלפֿאַבעטיש (alfabetisz)
alfons - שמײַסער m (szmajser) | פֿרויען־הענדלער m (frojen-hendler)
algida - פּראָסטיטוטקע f (prostitutke)
Algieria - אלזשיר
alimenty - אַלימענטן (alimentn)
alkohol - אַלקאָהאָל m (alkohol)
alkoholik - אַלקאָהאָליקער m (alkoholiker)
alkoholowy - אַלקאָהאָליש (alkoholisz)
alkowa - אַלקאָווע
alt - אַלט m (alt)
altówka - אַלט m (alt)
altruizm - אַלטרויִזם m (altruizm)
aluminium - אַלומיניום m
aluzja - רמז m (remez)
amajza - מוראַשקע f (muraszke)
amator - ליבהאָבער m (libhober)
ambasada - אַמבאַסאַדע f
ambicja - אַמביציע
ambirz - אינגבער m (ingber)
ambulans - אַמבולאַנס m (ambulans)
Ameryka - אַמעריקע f (amerike)
Ameryka Łacińska - לאַטײַן־אַמעריקע f (latajn-amerike)
Amerykanin - אַמעריקאַנער m (amerikaner)
amerykanizm - אַמעריקאַניזם m (amerikanizm)
amerykański - אַמעריקאַניש (amerikanisz)
amnestia - אַמנעסטיע f (amnestje)
amnestyja - אַמנעסטיע f (amnestje)
amputacja - אַמפּוטירונג f (amputirung)
amputować - אַמפּוטירן (amputirn)
amulet - שמירה f (szmire)
analfabeta - אַנאַלפֿאַבעט m (analfabet)
analogiczny - ענלעך (enlech)
ananas - אַנאַנאַס m (ananas)
anarchia - אַנאַרכיע
Anatolia - אנאטאליע
androny - שמאָנצעס (szmonces)
anegdota - אַנעקדאָט m (anekdot)
anegdotyczny - אַנעקדאָטיש
anekdota - אַנעקדאָט m (anekdot)
angielski - ענגליש (englisz)
anglosaski - אַנגלאָסאַקסיש (anglosaksisz)
angol - ענגליש (englisz)
angryst - אַגרעס m (agres)
animacja - אַנימאַציע (animacje)
anioł - מלאך m (malech)
anjoł - מלאך m (malech)
Antares - אַנטאַרעס (antares)
antonim - אַנטאָנים m (antonim)
antrejka - קאָרידאָר m (koridor)
antyczny - פֿאַרצײַטיק
antyk - אַנטיק
antykoncepcja - געבורט קאָנטראָל m (geburt kontrol)
antykwariat - אַנטיקוואַריאַט n (antikwariat)
antykwarnia - אַנטיקוואַריאַט n (antikwariat)
antysemicki - אַנטיסעמיטיש
antysemita - אַנטיסעמיט m (antisemit)
antysemityzm - שׂינאת־ישׂראל f
apetyt - אַפּעטיט
apetyt rośnie w miarę jedzenia - דער אַפּעטיט קומט מיטן עסן (der apetit kumt mitn esn)
apluzyna - מאַראַנץ m
apologia - אַנטשולדיקונג f (antszuldikung) | התנצלות n (hisnacles)
apostazja - פֿעלטשונג f (feltszung) | zobacz też: שמד f (szmad)
aprobata - הסכּמה f (haskome)
aprykoza - אַפּריקאָס m (aprikos)
apryl - אַפּריל m (april)
apryl-apryl - פּרימאַ־אַפּריליס m (prima-aprilis) | ערשטער אַפּריל (erszter april)
aptek - אַפּטייקקראָם f (aptejkkrom) | אַפּטייק f (aptejk)
apteka - אַפּטייקקראָם f (aptejkkrom) | אַפּטייק f (aptejk)
aptekarstwo - אַפּטייקערײַ n (aptejkeraj)
aptekarz - אַפּטייקער m (aptejker)
Arabia Saudyjska - סאַודי אַראַביע (Saudi Arabje)
arabski - אַראַביש (arabisz)
arbiter - אַרביטער m (arbiter) | שליש m (szolesz)
arbitralny - אַרביטראַריש (arbitrarisz)
arbuz - אַרבוז m (arbuz) | קאַווענע f (kawene)
archanioł - אַרכאַנגל m (archangl)
archeolog - אַרקיאַלאַדזשיסט m (arkijaladżist)
archeologia - אַרכעאָלאָגיע f (archeologje)
arcybiskup - אַרציביסקופּ m (arcibiskup)
arcydzieło - מײַסטערווערק n (majsterwerk)
arfa - האַרפֿע f
aria - אַריע f (arje)
Arizona - אַריזאָנאַ (arizona)
arka - תּבֿה f (tejwe) | אָרון m (orn)
arka Noego - נחס) תּבֿה) f ((nojechs) tejwe)
Arkansas - אַרקאַנסאָ (arkanso)
Arka Przymierza - תּבֿה f (tejwe)
armia - אַרמיי f (armaj)
armijo - אַרמיי f (armaj)
arogancja - גדלות | גאווה
arogant - שייגעץ m (szejgec)
arsen - אַרסען
arteria - אַרטעריע f (arterje) | מאַגיסטראַל m (magistral)
artykuł - אַרטיקל m (artikl) | סחורה f (schojre)
artysta - קינסטלער m (kinstler)
artystyczny - קינסטלעריש (kinstlerisz)
-arz - ער (er)
asfalt - אַספֿאַלט m (asfalt)
aspekt - פּרט m (prat) | אַספּעקט m (aspekt)
aspiryna - אַספּירין m (aspirin)
astma - אַסטמע f (astme)
astronom - אַסטראָנאָם
astronomia - אַסטראָנאָמיע f (astronomje)
astronomiczny - אַסטראָנאָמיש
astronomio - אַסטראָנאָמיע f (astronomje)
asygnata - באַנקנאָט m (banknot)
asza - אַש n (asz)
aszkenazyjski - אַשכּנזיש
aszynbecher - אַשטעצל n (asztecl)
atandzić - קלאַפּן (klapn) | שיסן
ateista - אַטעיִסט m (ateist) | כּופֿר־בעיקר m (kojfer-beiker)
ateizm - אַטעיִזם m (ateizm)
atencja - אַכט f (acht) | איי (ej)
ateusz - אַטעיִסט m (ateist) | כּופֿר־בעיקר m (kojfer-beiker)
Atlantyk - אַטלאַנטיק m (atlantik)
atłas - סאַטין f (satin)
atom - אַטאָם m (atom)
atomowy - אַטאָמיש (atomisz)
atrament - טינט f (tint)
audytorium - אוידיטאָריע f (ojditorje)
aureola - גלאַנץ m (glanc)
Australia - אויסטראַליע f (ojstralje)
Australijczyk - אויסטראַליער m (ojstraljer)
australijski - אויסטראַליש (ojstralisz)
Austria - עסטרײַך n (estrajch)
austriacki - עסטרײַכיש (estrajchisz)
auto - אויטאָ m (ojto)
autobiografia - אויטאָביאָגראַפֿיע f (ojtobjografje)
autobus - אויטאָבוס m (ojtobus)
automat - אויטאָמאַט m (ojtomat)
autonomia - אויטאָנאָמיע f (ojtonomje)
autor - אויטאָר m (ojtor)
autostop - היטש m (hicz)
awizo - אַוויז m (awiz)
Azerbejdżan - אַזערבײַדזשאַן
Azja - אַזיע f (Azje)
Azja Mniejsza - קליינאַזיע f (klejnazje)
baba - באַבע f (babe) | באַבקע f (babke)
babcia - באָבע f
babka - באָבע f
bach - באַך (bach)
bachraty - באַלײַבט (balajbt) | גראָב (grob) | דיק (dik)
baciar - שייגעץ m (szejgec)
bać się - מורא האָבן (mojre hobn)
bączek - דריידל n (drejdl)
baczyć - היטן זיך (hitn zich) | זען (zen) | האַלטן (haltn) | קלערן (klern) | באַטראַכטן (batrachtn) | וועגן (wegn)
bada - באַטראַכטן (batrachtn)
badać - באַטראַכטן (batrachtn)
badanie - באַטראַכטונג f (batrachtung)
bądź - בילע (bile)
bagaż - באַגאַזש m (bagaż)
bagażnik - באַגאַזשניק m
bagno - זומפּ m
bajbot - דריידל n (drejdl)
baje - אָפּציִערײַ n (opcieraj)
bajer - ליגן m (lign) | שקר m (szeker)
bajgiel - בייגל n (bejgl)
bajstruk - ממזר m (mamzer)
bajtel - קינד n (kind)
bajura - בלאָטע f (blote)
bajzel - באַלאַגאַן m (balagan) | שאַנדהויז n (szandhojz) | הײַזל n (hajzl)
bakałarz - לערער
bakburta - לינקער באָרט m (linker bort)
bakteria - באַקטעריע f (bakterie)
bal - באַלקן m (balkn)
bałabajka - באַלאַלײַקע f (balalajke)
bałagan - באַלאַגאַן m (balagan)
bałagula - שמײַסער m (szmajser)
bałaguła - בעל־עגלה m | שמײַסער m (szmajser) | נודניק m (nudnik)
bałałajka - באַלאַלײַקע f (balalajke)
bałamoncić - באַלעמוטשן
bałamucić - באַלעמוטשן
bałamut - פֿרויען־יעגער m (frojen-jeger)
baleja - באַליע
balia - באַליע
balkon - באַלקאָן m (balkon)
balon - באַלאָן m (balon) | לופֿטבאַלאָן m (luftbalon)
Bałtyk - באלטישער ים
bałwan - באַלוואַן m (balwan) | דאָס m (dos)
bambus - יאַמש m (jamsz)
bana - באַן f (ban) | צוג m (cug) | טראַמווײַ m (tramwaj)
banał - פֿראַזע f (fraze)
banan - באַנאַן m (banan)
banana - באַנאַן m (banan)
bandaż - באַנדאַזש m
bandażować - באַנדאַזשירן (bandażirn)
bandzioch - בויך m (bojch)
banerka - פּושקע f (puszke)
bania - דיניע f (dinje)
bank - באַנק (bank)
banka - טראַמווײַ m (tramwaj)
bańka - קאַנע f (kane)
banknot - באַנקנאָט m (banknot)
bar - באַר m (bar) | באַריום (barjum)
barabola - בולבע
baran - באַראַן m (baran) | ווידער m (wider) | דאָס m (dos)
Baran - באַראַן
barania głowa - בהמה f (behejme)
baranina - שעפּסנס n (szepsns)
Barcelona - באַרצעלאָנע (barcelone)
bardzo - זייער (zejer)
bark - אַקסל m (aksl)
barki - אַקסל m (aksl)
barwa - קאָליר m (kolir)
barwny - קאָלירט (kolirt)
barzej - זייער (zejer)
barzoł - זומפּ m
bas - בויך m (bojch)
basen - שווימבאַסיין m (szwimbasejn) | באַסיין m (basejn)
basior - נאַגײַקע f (nagajke)
basok - גראָב (grob)
bastard - ממזר m (mamzer)
batalion - באַטאַליאָן m (bataljon)
bateria - באַטעריע f (baterje)
bateryjka - באַטערייקע
batki - מײַטקעס (majtkes)
batłąch - פֿלאַש f (flasz)
batuta - טאַקטשטעקל n (taktsztekl)
bawarka - באַוואַרקע f
bawełna - באַוול m (bawl)
bawić - הוליען (huljen)
bębas - פּינדיוריק m (pindjurik)
bebech - בויך m (bojch) | מאָגן m (mogn)
bęben - פּויק f (pojk) | בויך m (bojch)
bębnić - פּויקן (pojkn) | באַראַבאַנעווען (barabanewen) | קלאַפּן אין פּויק (klapn in pojk)
beczeć - בעטשען
beczka - פֿאַס f (fas) | טון f (tun)
bedki - שוואָם (szwom) | שוווים m (szwojm)
Będzin - בענדין (bendin)
bejm - געלט n (gelt)
bękart - ממזר m (mamzer)
bele kaj - ערגעץ (ergec) | אין ערגעץ (in ergec) | ערגעץ וווּ (ergec wu)
belfer - לערער
Belgia - בעלגיע f (belgje)
belka - באַלקן m (balkn)
benzyna - גאַזאָלין
berać - דערציילן (dercejln)
beret - בערעט m (beret)
beretka - בערעט m (beret)
berga - שטיין m (sztejn)
Berlin - בערלין (berlin)
berlińczyk - בערלינער m (berliner)
betka - קלייניקייט f
bez - בעז m (bez) | מײַ m (maj)
bezbarwny - אָן קאָליר (on kolir)
bezcenny - אָן אַ שאַץ (on a szac)
bezchmurny - קלאָר (klor)
bezczelny - אומפֿאַרשעמט (umfarsztemt) | być bezczelnym: זײַן אַ שייגעץ (zajn a szejgec)
bezczynny - אָן אַ שטאָך אַרבעט (on a sztoch arbet)
bezdomny - אָנהיימיק ,היימלאָז
beze - בעז m (bez) | מײַ m (maj)
bezgraniczny - גרענעצלאָז (greneclos) | אָן אַ גרענעץ (on a grenec)
bezimienny - אָן אַ נאָמען (on a nomen)
bezmyślność - קלות־דעת n (kales-daas)
beżowy - בעזש (beż)
bezpłatnie - אומזיסט (umzist)
bezpośredni - דירעקט
bezsenność - שלאָפֿלאָזאיקייט f (szloflozikejt)
bezsens - הבֿל m (hewl)
bezstronność - גערעכטיקייט f | יושר m
bezstronny - גערעכט (gerecht) | יושרדיק (jojszerdik)
beztroska - קלות־דעת n (kales-daas)
bezuch - וויזיט m
bezużyteczny - צרה f (core)
bezzwłocznie - גלײַך
białko - ווײַסל n (wajsl) | ווײַסלשטאָף m (wajslsztof)
Białoruś - ווײַסרוסלאַנד n (wajsrusland)
białoruski - ווײַסרוסיש (wajsrusisz) | ווײַסרוסיש n (wajsrusisz)
biały - ווײַס (wajs)
Białystok - ביאַליסטאָק
Biblia - ביבל f (bibl)
bić - שמײַסן (szmajsn) | האַקן (hakn) | קלאַפּן (klapn) | ווערן זיך (wern zich)
bicz - נאַגײַקע f (nagajke)
bida - אָרעמקייט f (oremkejt) | בידע f (bide) | דלות m (dales) | צרה f (core)
bieda - אָרעמקייט f (oremkejt) | בידע f (bide) | דלות m (dales) | צרה f (core)
biedronka - משה־רבנוס קיִעלע n (mojsze-rabejnes kiele) | משיחל n (mesziechl)
bieg - לויף m (lojf)
biegłość - קענטעניש n (kentenisz)
biegły - קלאָר (klor)
biegunka - לאַקסירעכץ n | דורכפֿאַל m
bierzmowanie - קאָנפֿירמאַציע f (konfirmacje)
biglosko - פּרעסײַזן m (presajzn) | פּרעסל n (presl)
bigoteria - פֿאַרגלייבטקייט f (farglejbtkejt)
biksa - פּושקע f (puszke)
bilet - בילעט (bilet)
bima - בימה f (bime)
bimba - טראַמווײַ m (tramwaj)
bimbrownia - ברײַזל
bindasz - פּעניס m (penis) | מענלעכער אבֿר m (menlecher ejwer)
binder - שניפּס m (sznips) | קראַוואַט m (krawat) | אויסבינדער m (ojsbinder)
bindka - שניפּס m (sznips) | קראַוואַט m (krawat) | אויסבינדער m (ojsbinder) | באַנדאַזש m
binia - מויד f (mojd)
binks - סיניאָק m
binol - סיניאָק m
biografia - ביאָגראַפֿיע f (bjografje)
biologia - ביאָלאָגיע f (bjologje)
biskup - ביסקופּ m (biskup)
biurko - שרײַבטיש m (szrajbtisz)
biuro podróży - פֿאָר־אַגענטור f (for-agentur)
biurowy - ווײַס־קאָלנערדיק (wajs-kolnerdik)
biust - בוזעם (buzem)
biżuteria - צירונג
błąd - טעות m (toes) | גרײַז m (grajz) | פֿעלער m (feler)
blady - קלאָר (klor)
bladź - פּראָסטיטוטקע f (prostitutke)
blaga - ליגן m (lign) | שקר m (szeker)
błagać - בעטן רחמים ,באַשווערן
błaganie - האַרציקע בקשה f (harcike bakosze)
blagier - בליאַגער (bliager)
blałka - אָפּציִערײַ n (opcieraj)
blask - גלאַנץ m (glanc)
błazen - מאַרשעליק m (marszelik)
błecha - פֿלוי (floj) m
blef - בלאָף m
blizna - העפֿט m
Bliźnięta - צווילינג (cwiling)
błoto - בלאָטע f (blote)
blubry - שמאָנצעס (szmonces) | הבֿל m (hewl)
blumkol - קאַליפֿיאַר m (kalifiar)
bluźnierstwo - לעסטערונג
błyskawica - בליץ f
błyszczący - גלאַנציק (glancik)
błyszczeć - גלאַנצן (glancn)
bo - ווײַל (wajl) | וואָרן (worn) | מחמת (machmes)
bób - באָב m (bob)
boba - מאַריכואַנע f (marichuane)
bóbr - ביבער m (biber)
bochen - לאַבן m (labn)
bochenek - לעבל n (lebl)
bocian - באָטשען m (boczen) | בושל m (buszl)
bodaj - זאָלן (zoln)
bodziec - שטופּ m (sztup)
bóg - גאָט m (got)
Bóg - גאָט m (got)
bogactwo - רײַכקייט f (rajchkejt) | עשירות n (aszires) | אוצר m (ojcer) | מטמון m (matmen)
bogaty - רײַך (rajch)
bogini - געטין f (getin)
Bohemia - טשעכיע f (czechje) | בעהמען lub פיהם
bohr - באָריום
bojkot - בויקאָט (buikot)
bojownik - באַטאַליאָן m (bataljon)
bojtlik - טײַסטער m | בײַטל n | פּאָליאַרעס m | פּוליאַרעס m
boks - באָקס m (boks)
boleć - וויי טאָן (wej ton)
bolesny - ווייטיקדיק
bolszewik - באָלשעוויק m (bolszewik)
bomba atomowa - אַטאָמישע באָמבע f
bombardować - באָמבאַרדירן (bombardirn)
bombel - קינד n (kind)
bombka - טשאַטשקע f (czaczke) | קופֿל m (kufl)
bómbón - צוקערקע f (cukerke)
bont - גרענעץ (grenec)
bor - באָר (bor)
borówka - בעקל n (bekl) | באַק f (bak)
bosak - האַקן m (hakn)
bóstwo - גאָט m (got)
botanik - באָטאַניקער m (botaniker)
boża krówka - משה־רבנוס קיִעלע n (mojsze-rabejnes kiele) | משיחל n (mesziechl)
boźdór - יונג m (jung)
Boże Narodzenie - ניטל m (nitl)
bożonarodzeniowy - ניטלדיק (nitldik)
brać - קלײַבן זיך (klajbn zich)
brać nogi za pas - נעמען די פֿיס אויף די פּלייצעס (nemen di fis ojf di plejce)
brakować - פֿעלן
bramka - בראָם f (brom) | טויער m (tojer) | ראָגאַטקע f (rogatke)
bratek - חנהלעס אייגעלע n
brauza - דוש m (dusz)
brązowy - ברוין (brojn)
Brazylia - בראַזיליע f
brazyliana - קאַווע f (kawe)
brechnia - שמאָנצעס (szmonces)
brednia - שמאָנצעס (szmonces)
bredzić - האַקן אַ טשײַניק (hakn a czajnik)
brele - ברילן (briln)
brew - ברעם (brem) f
brifkastla - פּאָסטקעסטל n
briftasza - טײַסטער m | בײַטל n | פּאָליאַרעס m | פּוליאַרעס m
broda - גאָמבע f (gombe) | קין m (kin) | באָרד f (bord)
brodaty - בערדיק
broń - געווער n (gewer) | כּלי־זיין n (klezajen)
bronić - ווערן זיך (wern zich)
broszura - בראָשור f
browar - ביר n (bir)
bruk - ברוק m (bruk)
brukselka - בריסלער קרויט n (brisler krojt)
brunet - ברונעט m
brusić - שלײַפֿן (szlajfn)
bryczka - וועגעלע n (wegele)
bryła - קאָמע f (kome)
brylant - בריליאַנט m (briljant)
bryle - ברילן (briln)
brzeg - ברעג m (breg) | באָרטן m (bortn)
brzmienie - געזונט
brzoskwinia - פֿערשקע f (ferszke)
brzuch - בויך m (bojch)
brzydki - ברידקע (bridke)
brzydota - העסלעקייט f
bubek - פּויער m (pojer)
buc - שמאָק m (szmok) | פּוץ m (puc)
buda - בודע f (bude) | הונטבײַדל n (huntbajdl) | שולע f (szule) | שול f (szul) | בראָם f (brom) | טויער m (tojer) | ראָגאַטקע f (rogatke)
buddyjski - בודיסטיש
buddyzm - בודיזם m
budować - בויען (bojen)
budować zamki na lodzie - לייגן זיך פֿייגעלעך אין בוזעם (lejgn zich fejgelech in buzem)
budzić - אויפֿוועקן (ojfwekn)
budzik - וועקער m (weker)
bujny - רײַך (rajch)
buła - בולקע f (bulke) | זעמל f (zeml) | קאָמע f (kome) | מוסקל m (muskl)
bulba - בולבע
bułka - בולקע f (bulke) | זעמל f (zeml) | מוסקל m (muskl)
bulwa - בולבע
burak - בוריק m (burik) | צוויק m (cwik)
burdel - שאַנדהויז n (szandhojz) | הײַזל n (hajzl)
burderz - שטילעט m (sztilet) | שטעכמעסער (sztechmeser)
burdesz - שטילעט m (sztilet) | שטעכמעסער (sztechmeser)
burmistrz - בירגער־מײַסטער (birger-majster) m
burta - באָרט m (bort)
burzowiny - פּינע f (pine) | ביר n (bir)
but - שוך m (szuch)
butelka - פֿלאַש f (flasz)
buzi - קוש m (kusz)
buzia - פּנימל n (peneml)
-by - וואָלט (wolt) | זאָלן (zoln)
być - זײַן (zajn) | ווערן (wern) | וועל (wel)
być w siódmym niebie - זײַן אין זיבעטן הימל
bydlę - בהמה f (behejme) | אַ הונט מיט אויערן (a hunt mir ojern)
bydło - פֿיך n (fich) | גרויסע) בהמה) f ((grojse) behejme)
byk - ביק m (bik)
Byk - ביק (bik)
byle - בילע (bile)
byrna - לעמפּל n (lempl)
byt - זײַן n (zajn)
bywać - זײַן (zajn) | פֿלעג זײַן (fleg zajn) | אַרומדרייען זיך (arumdrejen zich) | טרעפֿן זיך (trefn zich)
bzdura - שמאָנצעס (szmonces) | הבֿל m (hewl)
bździągwa - וואַנץ
bzybzać - שנײַדן (sznajdn) | גנבֿענען (ganwenen)
cacko - צאַצקע f (cacke)
cajtung - צײַטונג f (cajtung)
cal - צאָל m (col)
całus - קוש m (kusz)
cap - צאַפּ m (cap)
capić - שטינקען (sztinken)
capu - כאַפּ־לאַפּ (chap-lap)
cebula - ציבעלע f (cibele)
celnik - צאָל־באַאַמטער m (col-baamter)
celować - אָנשטעלן (onszteln)
celtycki - קעלטיש
cena - פּרײַז m (prajz)
cenić - שאַצן (szacn) | אַכטן (achtn)
cent - סענט m (sent)
centrum - צענטער m (center)
cepaka - כאַם m (cham) | גראָבער פֿליגל m (grober fligl)
cera - קאָליר m (kolir)
certacja - קאַמף m (kamf) | געשלעג n (geszleg) | געראַנגל n (gerangl)
cesarskie cięcie - קייסערשניט m (kejsersznit)
cez - צעזיום (cezjum)
chabanina - פֿלייש n (flejsz)
chabas - פֿלייש n (flejsz)
chabić - גנבֿענען (ganwenen)
chachor - שייגעץ m (szejgec)
chałat - כאַלאַט m (chalat)
chałka - חלה f (chale) | פֿויגל m (fojgl)
chałupa - כאַלופּע f (chalupe)
cham - כאַם m (cham) | גראָבער פֿליגל m (grober fligl)
chaman - כאַם m (cham) | גראָבער פֿליגל m (grober fligl)
chamera - כמאַרע f (chmare)
chamidło - כאַם m (cham) | גראָבער פֿליגל m (grober fligl)
chamski - מוזשיצקע (mużicke)
chaotyczny - כאַאָטיש
charakter - טבֿע f (tewe) | כאַראַקטער m (charakter)
charakterystyka - כאַראַקטעריסטיק f
charkać - שפּײַען (szpajen) | פֿײַפֿן (fajfn)
charlać - הוסטן (hustn)
chasyd - חסיד m (chosid / chosed)
chasydyzm - חסידות n (chsides)
chata - כאַטע f (chate)
chazan - חזן m (chazn)
chcieć - וועלן (weln)
Chełm - כעלם (chelm)
chemia - כעמיע f (chemje)
chemiczny - כעמיש (chemisz)
chętnie - גערן (gern)
chętny - באַגעריק
Chińczyk - כינעזער m (chinezer)
chinina - כינין
Chinka - כינעזערין f (chinezerin)
chiński - כינעזיש (chinezisz)
Chiny - כינע f (chine)
chleb - ברויט n (brojt)
chlipać - כניקען (chniken)
chłód - קעלט f (kelt)
chłodny - קיל (kil)
chłodzić - קילן (kiln)
chłop - מוזשיק m (mużik) | יונג m (jung)
chłopak - יונג m (jung)
chłopiec - יונג m (jung)
chłop jak dąb - שטאַרק ווי אַ דעמב (sztark wi a demb)
chłopski - מוזשיצקע (mużicke)
chłopyszek - יונג m (jung)
chlor - כלאָר (chlor)
chłostać - שמײַסן (szmajsn) | שמיצן (szmicn)
chmiel - ביר n (bir)
chmura - כמאַרע f (chmare)
choć - הגם (hagam)
chocia - הגם (hagam)
chociaż - הגם (hagam)
chocieć - וועלן (weln)
chód - קאַצנשפּרונג m (kacnszprung)
chodnik - לאַווע f (lawe)
chodzenie - גאַנג
choinka - ניטלבוים m (nitlbojm)
chójk - ניטלבוים m (nitlbojm)
chojna - סאָסנע f (sosne)
cholera - כאָלערע f (cholere)
chore - קראַנק (krank)
choroba - קראַנקייט f (krankejt)
chory - קראַנק (krank)
chowaniec - קריקציִיִק
chowanka - קריקציִיִק
chowany - קריקציִיִק
chromosom - כראָמאָסאָם m
chronić - היטן (hitn) | היטן זיך (hitn zich)
chronologia - כראָנאָלאָגיע f (chronologie)
chrystianizm - קריסטנטום n (kristntum) | קריסטלעכקייט f (kristlechkejt)
Chrystus - קריסטוס m (kristus)
chrzan - כריין m (chrejn)
chrześcijański - קריסטלעך
chrześcijaństwo - קריסטנטום n (kristntum) | קריסטלעכקייט f (kristlechkejt)
chudoba - אָרעמקייט f (oremkejt) | בידע f (bide) | דלות m (dales) | צרה f (core) | בהמה f (behejme) | אַ הונט מיט אויערן (a hunt mir ojern)
chuj - שמאָק m (szmok) | פּוץ m (puc)
chuligan - כוליגאַן m (chuligan)
churchać - הוסטן (hustn)
chuśle - פֿידל m (fidl)
chusteczka - נאָזטיכל n (noztichl)
chustka - נאָזטיכל n (noztichl)
chwila - רגע f (rege)
chwost - עק m (ek)
chwyt - מאַניפֿאָרגע f (maniforge)
chyc - היץ f (hic)
chytrus - צלם־קאָפּ m (cejlem-kop) | ממזר m (mamzer) | חזיר m (chazer)
chytry - כיטרע
chyża - שײַער
ci - די (di)
ciągle - כּסדר (kesejder)
ciągnąć - נאָכשלעפּן (nochszlepn) | זופּן (zupn)
ciapryka - בלאָטע f (blote)
ciasnocha - העמד n (hemd)
ciasny - ענג (eng)
ciasto - טייג n (tejg) | קוכן m (kuchn)
ciąża - טראָגן n (trogn)
cicha woda brzegi rwie - שטיל וואַסער גראָבט טיף (sztil waser grobt tif)
cichy - שטיל (sztil)
ciebie - דו (du)
cięgiem - כּסדר (kesejder)
ciekawostka - טשיקאַוועס n (czikawes)
ciekawy - טשיקאַווע (czikawe) | אינטערעסאַנט (interesant)
cielesieństwo - ביאה f (bie)
ciemny - טונקל
cień - שאָטן
cienki - דין (din)
ciepać - וואַרפֿן (warfn) | שמיצן זיך (szmicn zich) | כאַפּן זיך (chapn zich) | לאָזן זיך (lozn zich)
ciepło - וואַרעם f | וואַרעמקייט f | וואַרעם
ciepły - וואַרעם (warem)
cierpienie - צרה f (core)
cieść - שווער m (szwer) | שנור f (sznur)
cieszyć - יובלען (jublen)
ciężarówa - משׂא־אויטאָ m (mase-ojto)
ciężarówka - משׂא־אויטאָ m (mase-ojto)
ciężki - שווער (szwer) | האַרט (hart) | שווער
ciga - ציג f (cig)
cios - קלאַפּ m (klap) | האַק m (hak)
ciosać - האַקן (hakn)
ciota - פּעדאַל m (pedal) | טרעטל m (tretl)
cipka - הון f (hun)
ciśnienie krwi - בלוטדרוק m (blutdruk)
ciuciek - הינטל n (hintl)
ciupać - האַקן (hakn)
ciurlocek - פּעניס m (penis) | מענלעכער אבֿר m (menlecher ejwer)
ciut - אַ ביסל (a bisl)
ciżma - שוך m (szuch)
ćma - פּראָסטיטוטקע f (prostitutke)
cmentarz - בית־עולם (bejs-ojlem)
ćmok - כאַם m (cham) | גראָבער פֿליגל m (grober fligl)
ćmy - טונקל
co - וואָס (wos)
cokolwiek - אַבי וואָס (abi wos) | אַ) בילע וואָס) ((a) bile wos)
coś - עפּעס (epes)
ćpać - עסן (esn) | וואַרפֿן (warfn) | שמיצן זיך (szmicn zich) | כאַפּן זיך (chapn zich) | לאָזן זיך (lozn zich)
cuchnący - פֿאַרשטונקען (farsztunken) | פֿאַרעיפּושט (faripeszt)
cud - נס m (nes)
cudownie - על־פּי נס (alpi nes)
cudowny - וווּנדערלעך (wunderlech) | נסימדיק (nisimdik) | אַ מחיה (a mechaje)
cudzołożyć - יענצן
cug - צוג m (cug) | באַן f (ban)
cukier - צוקער (cuker) m
cukierek - צוקערקע f (cukerke)
cukrzyca - צוקערקרענק f
cupać - הוסטן (hustn)
curig - צוריק (curik)
cwel - פּעדאַל m (pedal) | טרעטל m (tretl)
ćwierć - פֿערטל n (fertl)
cybernetyka - קיבערנעטיק f
cyckać - זויגן (zojgn) | סמאָקטשען (smokczen)
cyferblat - פּנים n (ponem)
cyfra - ציפֿער m (cifer)
cygan - וואַגאַבונד m (wagabund) | וואַנדערער m (wanderer) | שלעפּער m (szleper)
Cygan - ציגײַנער
cygański - ציגײַנעריש
cymes - צימעס m
cynamon - צימרינג m (cimring)
cyngiel - ברילן (briln)
cynizm - ציניזם
cyrkon - צירקאָניום (cirkonjum)
cytować - אָנרופֿן (onrufn)
cytryna - ציטרין m (citrin)
cytrynat - ציטרין m (citrin)
czaj - טיי f (tej)
czajniczek - טשײַניק m (czajnik)
czajnik - טשײַניק m (czajnik)
czarna dziura - שוואַרצע לאָך f (szwarce loch)
Czarnogóra - מאָנטענעגראָ n (montenegro)
czarny - שוואַרץ (szwarc)
czarodziej - מכשף m | כּישוף־מאַכער m
czary - כּישוף m (kiszef)
czas - צײַט f (cajt)
czasami - צו מאָל (cu mol)
czasem - צו מאָל (cu mol)
czasownik - ווערב m (werb)
czasownik posiłkowy - העלפֿווערב m (helfwerb)
czaszka - שאַרבן m (szarbn)
czcionka - שריפֿט m (szrift)
Czechosłowacja - טשעכאָסלאָוואַקײַ f (czechoslowakaj)
Czecho-Słowacja - טשעכאָסלאָוואַקײַ f (czechoslowakaj)
Czechy - טשעכיע f (czechje) | בעהמען lub פיהם
czędo - קינד n (kind)
czekać - וואַרטן (wartn)
czekolada - שאָקאָלאַד m (szokolad)
czekoladka - שאָקאָלאַדקע f (szokoladke)
czeladnik - לערנייִנגל n (lernjingl)
czemu - פֿאַר וואָס (far wos)
czereśnia - קאַרש f (karsz)
czernica - אָזשענע f (ożene)
Czerniowce - טשערנאָוויץ (czernowic)
czerwiec - יוני m (juni)
czerwienić - רויט ווערן (rojt wern)
czerwone jagody - פּילעניצע f (pilenice)
czerwony - רויט (rojt) | קאָמוניסט
część - טייל m (tejl)
częściowo - צום טייל (cum tejl)
część mowy - וואָרטקלאַס m (wortklas)
czeski - טשעכיש (czechisz)
cześnia - קאַרש f (karsz)
często - אָפֿט (oft)
częstoskurcz - טאַטשיקאַרדיאַ
czkawka - שלוקערץ (szlukerc)
członek - פּעניס m (penis) | מענלעכער אבֿר m (menlecher ejwer)
człowieczy - מענטשיש (menczisz) | מענטשלעך (menczlech)
człowiek - מענטש m (mencz)
czołg - טאַנק m (tank)
czoło - שטערן m
czorny - שוואַרץ (szwarc)
czosnek - קנאָבל m (knobl)
cztery litery - דאָס m (dos)
czuć - הערן (hern)
czulent - טשאָלנט
czuwać - זען (zen) | היטן (hitn)
czwartek - דאָנערשטיק m (donersztik)
czy - צי (ci)
czyhunka - באַן f (ban)
czyj - וועמענס (wemens)
czynić - מאַכן (machn) | טאָן (ton)
czyrwiec - יוני m (juni)
czyrwień - יוני m (juni)
czyście - שיין (szejn)
czysło - צאָל f (col)
czysto - קלאָר (klor)
czystość - ריינקייט (rejnkejt)
czysty - ריין (rejn) | קלאָר (klor) | לויטער (lojter) | כּשר (koszer)
czysty jak łza - שפּיגל ריין (szpigl rejn)
czytać - לייענען (lejenen)
czytanie - לייענען n (lejenen)
czytanka - לייענען n (lejenen)
czytelnia - לייענזאַל m (lejenzal)
czytelnik - לייענער m (lejener)
czytelny - קלאָר (klor)
czyżyk - יונג m (jung)
dąb - דעמב m (demb)
dać - געבן (gebn) | לאָזן (lozn) | לאָזן זיך (lozn zich)
dach - דאַך m (dach)
dądel - פּינדיוריק m (pindjurik)
daktyl - טייטל (tejtl)
dała - געבן (gebn) | לאָזן (lozn) | לאָזן זיך (lozn zich)
dalece - זייער (zejer)
dalej - לאָמיר (lomir)
dana - געבן (gebn) | לאָזן (lozn) | לאָזן זיך (lozn zich)
dany - געבן (gebn) | לאָזן (lozn) | לאָזן זיך (lozn zich)
dar - גאָב f (gob) | געשאַנק n (geszank) | מתּנה f (matone) | פּרעזענט m (prezent)
darem - אומזיסט (umzist)
darmo - אומזיסט (umzist)
dawać radę - אַן עצה געבן זיך (an ejce gebn zich) | באַגיין זיך (bagejn zich)
Dawid - דוד m (dowid)
dawno - לאַנג צוריק (lang curik)
dawny - אַלט (alt)
dbać - היטן (hitn) | אָפּהיטן (ophitn) | זען (zen)
definicja - דעפֿיניציע f (definicje)
Dekalog - די עשׂרת־הדיברות f (di aseres-hadibres) | די צען געבאָט (di cen gebot)
deklinacja - דעקלינאַציע f (deklinacje)
deknąć - טאָן / געבן אַ קלאַפּ (ton / gebn a klap) | אַ האַק טאָן (a hak ton) | געבן (gebn)
dekoracyjny - דעקאָראַטיוו (dekoratiw)
delektować się - לאָבן זיך (lobn zich) | זופּן (zupn)
delfin - דעלפֿין m (delfin)
demografia - דעמאָגראַפֿיע f (demografje)
demokrata - דעמאָקראַט (demokrat)
demokratyczny - דעמאָקראַטיש (demokratisz)
denerwować - דענערווירן (denerwirn) | צערייצן (cerejcn) | דענערווירן זיך (denerwirn zich)
dentysta - ציינדאָקטער m (cejndokter)
deprymować - דעפּרימירן (deprimirn)
deser - דעסערט m (desert) | פֿאַרבײַסן n (farbajsn)
despota - דעספּאָט m (despot)
deszcz - רעגן m (regn)
deszczowy - רעגנדיק
dętka - טשאַטשקע f (czaczke)
deżdż - רעגן m (regn)
diabeł - טײַוול m (tajwl)
dialekt - דיאַלעקט m (djalekt)
dialog - דיאַלאָג m (djalog)
dinozaur - דינאָזאַווער m (dinozawer)
dlaczego - פֿאַר וואָס (far wos)
dlatego - דעריבער (deriber) | דערפֿאַר (derfar)
długi - לאַנג (lang)
dłużnik - בעל־חובֿ m
dmuchać - טרענען (trenen)
dmuchnąć - גנבֿענען (ganwenen)
Dniepr - דניעפער
do - קיין (kejn) | ביז (biz)
dobranoc - אַ גוטע נאַכט (a gute nacht)
dobrowolny - פֿרײַוויליק
dobry - גוט (gut)
dobry wieczór - אַ גוטן אָוונט (a gutn ownt) | אַ גוטן שבת (a gutn szabes) | אַ גוטע וואָך (a gute woch)
dobrze - גוט (gut) | מסכּים (maskem)
dobytczę - בהמה f (behejme) | אַ הונט מיט אויערן (a hunt mir ojern)
doceniać - שאַצן (szacn)
dochód - הכנסה f
dochtór - דאָקטאָר m (doktor)
do dupy - טויגן צום תּחת (tojgn cum toches)
dogodny - גינציק
do greckich kalend - ביז משיח וועט קומען (biz mesziech wet kumen) | אָפּלייגן אין דער לאַנגער באַנק אַרײַן (oplejgn in der langer bank arajn)
doić - מעלקן (melkn)
dojrzały - צײַטיק (cajtik)
dojść - טרעפֿן אין פּינטל (trefn in pintl)
dokąd - וווּהין (wuhin)
dokądś - ערגעץ (ergec) | אין ערגעץ (in ergec) | ערגעץ וווּ (ergec wu)
dokładnie - פּונקט (punkt)
dokładny - גענוי (genoj)
dokonać - באַגיין (bagejn)
dokonały - אידעאַל (ideal)
doktor - דאָקטאָר m (doktor) | דאָקטער m (dokter)
dokuczać - דערקוטשען (derkuczen)
dokument - דאָקומענט m (dokument)
dola - לאָז m (loz)
dolar - דאָלאַר m (dolar)
dolnośląski - נידערשלעזיש
dołować - דעפּרימירן (deprimirn)
dom - הויז n (hojz) | היים f (hejm) | …בית־ n (bejs-…)
domena publiczna - רשות־הרבים
domokrążca - פּעדלער m (pedler)
dom publiczny - שאַנדהויז n (szandhojz) | הײַזל n (hajzl)
donica - דאָניצע
donikąd - אין ערגעץ (in ergec)
dopiero - ערשט (erszt)
doradca - ייצע-געבער (yyẕʻ-gʻbʻr) m
dorsz - דאָרש m (dorsz)
doś - וויפֿל (wifl)
doskonały - אידעאַל (ideal)
dosłownie - ממש (mamesz) | וואָרט פֿאַר וואָרט (wort far wort)
dostany - צײַטיק (cajtik)
dostarczać - איבערגעבן (ibergebn)
dostęp - צוטריט m (cutrit) | דריסת־הרגל n (drises-horegl)
dostrzegalny - קענטיק (kentik)
doświadczać - וויסן (wisn)
doświadczony - קלאָר (klor)
dotąd - לעת־עתּה (lesate) | ביז איצט (biz ict)
dotychczas - לעת־עתּה (lesate) | ביז איצט (biz ict)
dotychmiast - לעת־עתּה (lesate) | ביז איצט (biz ict)
dotyczyć - האָבן צו טאָן (hobn cu ton) | האָבן צו (hobn cu)
dotyk - פּאָרקע
dotykać - טרעפֿן (trefn)
do widzenia - אַ גוטן טאָג (a gutn tog) | אַ גוט־שבת (a gut-szabes)
dowolny - בילע (bile)
doznawać - וויסן (wisn)
do zobaczenia - אַ גוטן טאָג (a gutn tog) | אַ גוט־שבת (a gut-szabes)
dozorca - היטער m (hiter)
dr - ד״ר (d״r)
drabina - לייטער m (lejter)
drabka - לייטער m (lejter)
drach - פֿלישלאַנג f (fliszlang)
dracheta - פֿלישלאַנג f (fliszlang)
drąg - דרוק m (druk)
dramatyczny - דראַמאַטיש
drapacz chmur - וואָלקן־קראַצער m (wolkn-kracer)
dratewka - שוסטער m (szuster)
dręczyć - פּײַניקן (pajnikn) | מאָרען (moren) | מאַטערן (matern)
drętki - זויער (zojer)
drób - עוף n (of)
drobina - פּינדיוריק m (pindjurik)
drobiowy - עופֿן (ofn)
drobnostka - קלייניקייט f
droga - וועג m (weg) | אופֿן m (ojfn)
Droga Mleczna - מילכוועג m (milchweg)
drogi - טײַער (tajer) | ליב (lib)
Drohobycz - דראָהאָביטש (drohobicz)
drożdże - הייוון (hejwn)
dróżka - וועגל n (wegl) | וועגעלע n (wegele)
druch - כּסדר (kesejder)
druga wojna światowa - צווייטע וועלט־מלחמה f (cwejte welt-milchome)
drugdy - אַנדערש וווּ (andersz wu)
druh - חבֿר m (chawer)
druk - דרוק f (druk) | שריפֿט m (szrift)
drukarka - דרוקער m (druker)
drukarnia - דרוקערײַ f (drukeraj) | דרוק f (druk)
drukarz - דרוקער m (druker)
drukować - דרוקן (drukn)
drzazga - קין m (kin)
drzemać - דרימלען (drimlen) | דרעמלען (dremlen) | שלומערן (szlumern)
drzemka - דרימל (driml) | דרעמל (dreml) | שלומער (szlumer)
drzewo - בוים m (bojm)
drzwi - טיר f (tir)
duch - מוט m (mut)
dukat - רענדל (rendl) n
duma - שטאָלץ m (sztolc)
dumać - קלערן (klern)
dupa - תּחת m (toches)
dureń - בהמה f (behejme) | גראָבער קאָפּ m (grober kop) | דאָס m (dos) | חכם m (chochem)
durś - כּסדר (kesejder)
dusza - נשמה f (neszome) | נפֿש n (nefesz) | מוט m (mut)
dutek - געלט n (gelt)
duży - גרויס (grojs) | פֿאַרנעמיק (farnemik)
dwukropek - צווייפּינטל n (cwejpintl)
dybuk - דיבוק m (dibek)
dychawica - אַסטמע f (astme)
dymbcok - דעמב m (demb)
dynamit - דינאַמיט m
dynia - דיניע f (dinje)
dyplom - דיפּלאָם m
dyrygent - דיריגענט m (dirigent)
dysk - דיסק m (disk)
dysk twardy - האַרטדיסק m (hartdisk)
dysponować - האָבן (hobn)
dysproz - דיספּראָסיום
dyszel - דישעל m
dywergencja - דיווערגענץ f (diwergenc)
dzbanek - קריגל n
dżez - דזשעז m (dżez)
dziać - שטריקן (sztrikn) | טאָן זיך (ton zich)
dziadek - זיידע m (zejde) | קנאַקניסל n (knaknisl)
dziadek do orzechów - קנאַקניסל n (knaknisl)
dziadkowie - זיידע־באָבע (zejde-bobe)
działać - פֿונקציאָנירן (funkcjonirn)
działalność - אַקטיוויטעט (aktiwitet)
dziąsło - יאַסלע f (jasle) | ציינפֿלייש n (cejnflejsz)
dziatki - קינדערלעך (kinderlech)
dzieciak - פּינדיוריק m (pindjurik)
dziecięcy - קינדערש (kindersz) | קינדעריש (kinderisz)
dziecinny - קינדערש (kindersz) | קינדעריש (kinderisz)
dzieciszczko - קינד n (kind)
dziecko - קינד n (kind)
dziegieć - דזשעגעכץ n (dżegechc)
dziękówa - אַ דאַנק (a dank)
dziękówka - אַ דאַנק (a dank)
dziękuję - אַ דאַנק (a dank)
dzieło - ווערק n (werk)
dzień - טאָג m (tog)
dzień dobry - שלום־עליכם (szolem-alejchem) | אַ גוטן מאָרגן (a gutn morgn) | גוטהעלף (guthelf) | אַ גוטן שבת (a gutn szabes) | גוט־יום־טובֿ (gut-jontew / gut-jontef)
dziennikarka - זשורנאַליסטקע f
dziennikarstwo - זשורנאַליסטיק f
dziennikarz - זשורנאַליסט m (żurnalist)
dzierżyć - האַלטן (haltn) | האַלטן זיך (haltn zich)
dziesięciolecie - יאָרצענדלינג m (jorcendling)
dziewa - מויד f (mojd) | בתולה f | בתולה עלייסבת f | יונגפֿרוי f (jungfroj)
dziewczę - מויד f (mojd)
dziewczyna - מויד f (mojd)
dziewica - בתולה f | בתולה עלייסבת f | יונגפֿרוי f (jungfroj)
dzieżka - קריגל n
dzik - קאַבאַן m (kaban) | וואַלד־חזיר m (wald-chazer)
dziób - שנאָבל m (sznobl)
dziołcha - מויד f (mojd)
dziopa - מויד f (mojd)
dziś - הײַנט (hajnt) | הײַנט צו טאָג (hajnt cu tog) | איצט (ict)
dzisiaj - הײַנט (hajnt) | הײַנט צו טאָג (hajnt cu tog) | איצט (ict)
dzisiejszy - הײַנטיק (hajntik)
dziunia - מויד f (mojd)
dziura - לאָך (loch) | הייל f (hejl)
dżungla - דזשאַנגגאַל
dźwig - ליפֿט m (lift)
dźwigoń - טרעגער m
dzwonić - טעלעפֿאָנירן (telefonirn) | אָנרופֿן (onrufn)
ebenista - סטאָליער m (stoljer)
echo - ווידערקול
egipski - מיצריש (micrisz)
Egipt - מצרים n (micraim)
egoistyczny - עגאָיִסטיש
egoizm - עגאָיִזם (egoizm)
egzamin - עקזאַמען m (ekzamen)
egzystencja - זײַן n (zajn)
egzystować - עקסיסטירן
einstein - אײַנשטײַניום
ejber - יונג m (jung)
eka - עק m (ek)
ekler - בליצשלעסל n (blicszlesl)
ekspert - ידען m (jadn) | מבֿין m (mejwn) | מומחה m (mumche) | קענער m (kener)
eksplikować - קלאָר מאַכן (klor machn) | איבערזעצן (iberzecn)
eksploatować - עקספּלוּאַטירן (ekspluatirn)
eksplozja - אויפֿרײַס m (ojfrajs)
eksponat - עקספּאָנאַט m
ekspres - בליצשלעסל n (blicszlesl)
ekstremalny - עקסטרעם
elefant - העלפֿאַנד m (helfand)
elektroluks - שטויבמאַשין f (sztojbmaszin)
elektroniczny - עלעקטראָניש (elektronisz)
elektronika - עלעקטראָניק f
elektrownia - קראַפֿטסטאַנציע f (kraftstancje) | עלעקטרײַ f (elektraj)
elektryczność - עלעקטרע f
elektryk - עלעקטריקער m (elektriker)
elektryzować - עלעקטריזירן (elekrtizirn)
element - שטאָף m (sztof)
elf - שרעטל n (szretl)
Eliasz - אליהו m
elipsa - עליפּס m (elips) | אָוואַל m (owal)
emerytura - פּענסיע f (pensje)
encyklopedia - ענציקלאָפּעדיע f (enciklopedie)
entuzjasta - ליבהאָבער m (libhober)
erudycja - וויסן n (wisn)
erudyta - ידען m (jadn)
eskulap - דאָקטער m (dokter)
esperanto - עספּעראַנטאָ n (esperanto)
etap - שטאַפּל (sztapl)
Etiopia - עטיאָפיע
etniczny - עטניש
etymologia - עטימאָלאָגיע f (etimologje)
Eurazja - אייראַזיע f (ejrazje)
Europa - אייראָפּע f (ejrope)
europejski - אייראָפּעיִש (ejropeisz)
ewidentnie - קענטיק (kentik) | קלאָר (klor)
ewidentny - קענטיק (kentik) | קלאָר (klor)
eż - אַז (az) | דאָס (dos) | וואָס (wos)
facet - יונג m (jung)
facetka - פֿרוי f (froj)
facjata - פּנים n (ponem)
fajans - בהמה f (behejme) | דאָס m (dos) | חכם m (chochem)
fajek - שלוג f (szlug)
fajfus - פּעניס m (penis) | מענלעכער אבֿר m (menlecher ejwer)
fajka - פּיפּקע f (pipke) | שלוג f (szlug)
fajnie - פֿײַן (fajn)
fajny - פֿײַן (fajn) | שיין (szejn)
fajowo - פֿײַן (fajn)
fakt - פֿאַקט m (fakt)
fał - פֿאַל m (fal)
fala - כוואַליע f (chwalje) | וועל f (wel)
fałat - באַנקנאָט m (banknot)
fałszywy - פֿאַלש
familio - משפּחה f (miszpoche)
famuła - משפּחה f (miszpoche)
fana - פֿאָן f (fon)
fanatyk - חסיד m (chosid / chosed)
fantazja - חלום m (cholem)
fara - פּאַראַפֿיע f (parafje)
faraon - פּרעה m (pare)
farma - פֿאַרם f (farm)
faryna - צוקער (cuker) m
fasola - פֿאַסאָליע f (fasolje) | בעבל n (bebl)
faza - שטאַפּל (sztapl)
fedrować - בריקען (briken) | גראָבן (grobn)
fefer - פֿעפֿער m (fefer)
fefrać się - מורא האָבן (mojre hobn)
felczer - פֿעלדשער m (feldszer) | רופֿא m (rojfe)
fenek - פֿענעק m (fenek)
ferment - העצע f (hece)
ferska - פֿערשקע f (ferszke)
fest - זייער (zejer)
fezeła - בין f (bin)
figa - פֿײַג f (fajg)
filia - פֿיליע f (filje)
filip - האָז m (hoz)
film - פֿילם m (film)
filozof - פֿילאָסאָף m (filosof)
filozofia - פֿילאָסאָפֿיע f (filosofje)
finalizować - ענדיקן (endikn)
Finlandia - פינלאנד
fioł - פֿיאַלקע f (fialke)
fiołek - פֿיאַלקע f (fialke)
fioletowy - וויאָלעט (wiolet)
fiut - שמאָק m (szmok) | פּוץ m (puc)
fiżon - פֿאַסאָליע f (fasolje) | בעבל n (bebl)
flag - פֿאָן f (fon)
flaga - פֿאָן f (fon)
flaszka - פֿלאַש f (flasz)
flep - דאָקומענט m (dokument)
flet - פֿלייט f (flejt) | שמאָק m (szmok) | פּוץ m (puc)
fliger - אַעראָפּלאַן m (aeroplan)
fojercojg - אָנצינדער m (oncinder)
fojercok - אָנצינדער m (oncinder)
foka - ים־הונט m (jam-hunt)
folwark - פֿאָלוואַרק m
fonem - פֿאָנעם f (fonem)
fonetyka - פֿאָנעטיק
fontanna - פֿאָנטאַן m (fontan)
forma - פֿאָרעם f (forem)
fortel - מאַניפֿאָרגע f (maniforge)
fortuna - רײַכקייט f (rajchkejt)
fosa - גראָבן m (grobn)
fosfor - פֿאָספֿאָר (fosfor)
fotel - פֿאָטעל m (fotel)
fotografia - פֿאָטאָגראַפֿיע f (fotografje)
fotograficzny - פֿאָטאָגראַפֿיש (fotografisz)
fotografie - פֿאָטאָגראַפֿיע f (fotografje)
foton - פֿאָטאָן n (foton)
Francja - פֿראַנקרײַך (frankrajch)
francuski - פֿראַנצייזיש (francejzisz) | פֿראַנצייזיש n (francejzisz)
francuskojęzyczny - פֿראַנצייזיש־שפּראַכיק (francejzisz-szprachik)
frans - פֿראַנציום (francjum)
frasunek - טרויער m (trojer) | ערגערניש n (ergernisz) | צער m (car) | צרה f (core) | דאגה f (dajge)
fraza - פֿראַזע f (fraze)
frazeologia - פֿראַזעאָלאָגיע f (frazeologje)
frazeologiczny - פֿראַזעאָלאָגיש
frazeologizm - פֿראַזעאָלאָגיזם m (frazeologizm)
frazes - פֿראַזע f (fraze)
frechowny - אומפֿאַרשעמט (umfarsztemt) | być bezczelnym: זײַן אַ שייגעץ (zajn a szejgec)
fregata - פֿרעגאַט m (fregat)
frela - מויד f (mojd)
fryzjer - פֿריזירער m (frizirer)
fryzura - פֿריזור (frizur)
fura - וואָגן m (wogn)
furaż - אָבראָק m (obrok)
furman - שמײַסער m (szmajser)
furmanka - וואָגן m (wogn)
fusbal - פֿוטבאָל m (futbol) | פֿוסבאָל m (fusbol)
fusekla - סקאַרפּעט m (skarpet)
futbol - פֿוטבאָל m (futbol) | פֿוסבאָל m (fusbol)
fyrać - אַנטלויפֿן ,אַוועקלויפֿן
fyrtel - עק m (ek)
gad - רעפּטיליע f (reptilje) | שרץ m (szerec)
Gad - גד (gad)
gadać, co ślina na język przyniesie - האַקן אַ טשײַניק (hakn a czajnik)
gadać od rzeczy - האַקן אַ טשײַניק (hakn a czajnik)
gadałka - פֿעע f (fee)
gadanina - שלח־מנות (sz(a)lachmones)
gadolin - גאַדאָליניום
gag - שפּאַס m (szpas) | הלצה f (haloce)
gała - קנאָפּ m (knop) | אויג n (ojg) | פֿוטבאָל m (futbol) | פֿוסבאָל m (fusbol) | וואָראָן m (woron) | ראָב m (rob) | קראָ f (kro)
galancie - שיין (szejn)
galareta - גליווער m (gliwer) | גאַלאַרעט m (galaret)
galaretka - גאַלאַרעט m
galert - גאַלאַרעט m
gałka - קנאָפּ m (knop)
gałka muszkatołowa - מושקאַט m (muszkat)
gapa - וואָראָן m (woron) | ראָב m (rob) | קראָ f (kro)
gar - טאָפּ m (top)
gara - שלאָף m (szlof) | חלום m (cholem) | דרימל (driml) | דרעמל (dreml) | שלומער (szlumer)
garaż - גאַראַזש m
garb - האָרב m (horb)
gardło - גאָרגל m | האַלדז m
garnek - טאָפּ m (top)
gasa - גאַס f (gas)
gąść - שפּילן (szpiln)
gąsior - גאָנער m (goner)
gatki - גאַטקעס
gatunek - זגאַל m (zgal)
gaz - גאַז m (gaz)
gaża - פּיידע f (pejde)
gazeta - צײַטונג f (cajtung)
gbur - גראָבער פֿליגל m (grober fligl)
Gdańsk - דאַנץ (danc)
gdy - בעת (bejs)
gdyby - כּלומרשט (klumrszt)
gdyż - ווײַל (wajl) | וואָרן (worn) | מחמת (machmes)
gdzie - וווּ (wu)
gdzie indziej - אַנדערש וווּ (andersz wu)
gdziekolwiek - ערגעץ (ergec) | אין ערגעץ (in ergec) | ערגעץ וווּ (ergec wu)
gdzie kucharek sześć, tam nie ma co jeść - וווּ עס זײַנען דאָ אַ סך קעכינס, דאָרט איז דאָס עסן רױ
gdzieniegdzie - וווּ ניט וווּ (wu nit wu)
gdzie pieprz rośnie - וווּ דער שוואַרצער פֿעפֿער וואַקסט (wu der szwarcer fefer wakst)
gdzieś - ערגעץ (ergec) | אין ערגעץ (in ergec) | ערגעץ וווּ (ergec wu) | קעגן (kegn)
geburstag - געבוירן־טאָג m (gebojrn-tog) | געבוירן n (gebojrn)
gędźba - מוזיק f (muzik)
gędzić - שפּילן (szpiln)
gęgać - גאָנערן (gonern)
gejzer - גײַזער m
gemyla - באַלאַגאַן m (balagan)
generał - גענעראַל m (general)
geologiczny - געאָלאָגיש (geologisz)
gęś - גאַנדז f (gandz)
gest - זשעסט m (żest) | תּנועה f (tnue)
gestapo - געסטאַפּאָ (gestapo)
getto - געטאָ f (geto)
gibki - שנעל (sznel) | גיך (gich)
gibko - שנעל (sznel) | געשווינד (geszwind) | גיך (gich)
giezło - העמד n (hemd)
gira - פֿוס m (fus) | פֿוסבאָל m (fusbol)
giser - שריפֿטגיסער m (szriftgiser)
głąb - גלאָמב m (glomb) | בהמה f (behejme) | טיף f (tif) | טיפֿקייט
glacok - ליסע
glajda - בלאָטע f (blote)
glanc - גלאַנץ m (glanc)
glapa - קראָ f (kro)
glaska - גלעזל n (glezl)
głębia - טיף f (tif) | טיפֿקייט
głębokość - טיף f (tif) | טיפֿקייט f (tifkejt)
glin - אַלומיניום m
glina - ליים f (lejm)
głód - הונגער m (hunger)
głodny - הונגעריק (hungerik)
głos - שטים f (sztim) | וואָרט n (wort)
główka - צלם m (cejlem)
głównie - דער עיקר (der iker) | דערעיקרשט (derikerszt) | קודם־כּל (kojdem-kol) | צום (אַלעם) ערשטן (cum (alem) ersztn)
główny - הויפּט (hojpt)
głupi - חכם m (chochem)
głupiec - בהמה f (behejme) | דאָס m (dos) | חכם m (chochem)
głupota - טיפּשות n (tipszes)
głupstwo - הבֿל m (hewl)
gnać - כאַפּן (chapn)
gnat - פּיסטאָלעט m (pistolet)
gniazdo - נעסט f (nest) | קאָנטאַקט m (kontakt) | שפּעלטל n (szpeltl)
gniew - בייז n | גרימצאָרן m | צאָרן m | כּעס m
gnot - קינד n (kind)
godać - רעדן (redn) | זאָגן (zogn)
godka - רעדע f (rede) | צונג f (cung) | לשון n (loszn) | שפּראַך f (szprach)
godny - כּשר (koszer)
godoć - רעדן (redn) | זאָגן (zogn)
godzić - אָננעמען פֿאַר ליב (onnemen far lib)
godzinnik - זייגער m (zejger)
goj - גוי m (goj)
gołąb - טויב f (tojb)
golarka - גאָלער m
golarz - פֿריזירער m (frizirer)
golem - גולם (golem) m
golf - גאָלף m (golf)
golibroda - פֿריזירער m (frizirer)
gonić - נאָכיאָגן (nochjogn)
góra - באַרג m (barg)
górą - באַרג m (barg)
gorący - הייס (hejs)
gorączka - פֿיבער m (fiber) | היץ f (hic)
góra lodowa - אײַזבאַרג m (ajzbarg)
górnik - גרעבער m (greber)
goryl - גאָרילע f (gorile)
gorzała - אַלקאָהאָל m (alkohol)
gorzelnia - ברײַזל n
gorzki - ביטער (biter)
gość - אורח m (ojrech) | גאַסט m (gast) | יונג m (jung)
gościnność - גאַסטפֿרײַנדלעכקייט f
gotować - וועלן (weln)
gówno - דרעק m (drek)
gra - שפּיל f (szpil)
graba - האַנט f (hant)
grabież - גזלה f
grać - שפּילן (szpiln)
gracz - שפּילער m (szpiler)
grad - האָגל m
gramatyka - גראַמאַטיק f (gramatik)
granat - גראַנאַט m (granat) | מילגרוים m (milgrojm)
graniastosłup - פּריזמע f (prizme)
granica - גרענעץ (grenec)
graniczyć - גרענעצן זיך (grenecn zich)
gratulacja - מזל־טובֿ
grdyka - גאָרגל m (gorgl) | גאָרגלקנאָפּ m (gorglknop)
grejpfrut - גרייפּפֿרוט m (grejpfrut) | גרייפּפֿרוכט m (grejpfrucht)
grobowiec - קעלער m (keler)
groch - אַרבעס m (arbes)
grom - דונער m (duner)
gromadzić - קלײַבן (klajbn) | קלײַבן זיך (klajbn zich) | גרופּירן זיך (grupirn zich)
grosz - גראָש m (grosz)
groszek - אַרבעס m (arbes)
gruba - גרוב f (grub)
grubianin - גראָבער פֿליגל m (grober fligl)
grubiański - גראָב (grob)
gruby - באַלײַבט (balajbt) | גראָב (grob) | דיק (dik)
gruda - קאָמע f (kome)
grudzień - דעצעמבער m (december)
gruntować - גרונטעווען
gruntownie - גרינטלעך
grupa - גרופּע f (grupe)
grupować - גרופּירן (grupirn)
gruszka - באַר f (bar)
Gruzja - גרוזיע (gruzje)
gruźlica - טובערקולאָז m (tuberkuloz) | דער f (der)
grycha - בולקע f (bulke) | זעמל f (zeml)
gryfny - שיין (szejn)
gryka - רעטשקע f | גריקע f
grypsera - מאַניפֿאָרגע־לשון n (maniforge-loszn)
gryźć - בײַסן (bajsn) | גריזשן (griżn)
grzebać - גראָבן זיך (grobn zich) | אַרומדרייען זיך (arumdrejen zich)
grzebień - קאַם m (kam) | קעמל n (keml)
grzech - זינד m (zind) | חטא m (chet) | עבֿירה f (awejre)
grzeczny - ליב (lib)
grzęda - גרענדע f
grzeszyć - זינדיקן
grzyb - שוואָם (szwom) | שוווים m (szwojm)
guła - אינדיק m (indik)
gularz - אינדיק m (indik)
guli - ווײַל (wajl) | וואָרן (worn) | מחמת (machmes)
guma - גומע f (gume) | קײַגומע f (kajgume) | קאָנדאָם m (kondom)
gumka - מעקער | קאָנדאָם m (kondom)
gwałt - גוואַלד f (gwald) | בגוואַלד (bigwald)
gwer - ביקס f (biks)
gwiazda - שטערן m (sztern)
gwiazdarz - אַסטראָנאָם
gwiazdka - שטערנדל n (szterndl)
gwiaździarz - אַסטראָנאָם
gwizdać - פֿײַפֿן (fajfn)
gwizdnąć - טאָן / געבן אַ קלאַפּ (ton / gebn a klap) | אַ האַק טאָן (a hak ton) | געבן (gebn)
gwóźdź - נאָגל m (nogl)
gżegżółka - קוקאַווקע f (kukawke)
gzub - קינד n (kind) | בויך m (bojch)
gzubek - פּינדיוריק m (pindjurik)
hafn - האַפֿניום (hafnium)
haftować - העפֿטן ,האַפֿטן
Haga - האַג (hag)
hajtok - מעסער (mʻsʻr)
hak - האָק m (hok) | האַקן m (hakn)
haki - האָק m (hok) | האַקן m (hakn)
hałaśliwy - טומלדיק
hałastra - כאַליאַסטרע f (chaljastre)
hampelman - פּאַיאַץ m (pajac)
hańbić - פֿאַרשעמען (farszemen)
handszuły - הענטשקע f (henczke)
harać - האָרעווען (horeven)
harfa - האַרפֿע f
harmonia - האַרמאָניע f (harmonje)
harmonijny - סקלאַדנע
harować - האָרעווען (horeven)
harowanie - האָרעוואַניע
harówka - האָרעוואַניע f (horewanje)
haś - וואַגן (wagn)
haszysz - האַשיש m (haszisz)
haust - זופּ m (zup)
hazard - אַזאַרט m (azart)
hazardzista - אַזאַרטשפּילער m (azartszpiler)
hę - וואָס (wos)
hebrajski - העברעיִש (hebreisz) | העברעיִש n (hebreisz) | עבֿריתּ n (iwrit)
hej - היי (hej) | איי (ej) | הוי (hoj)
heklować - העקלען (heklen)
hel - העליום (heljum)
hełm - קאַסקע f
heparyna - כעפּערין
herbata - טיי f (tej)
Herod - הורדוס
hica - היץ f (hic)
Hindus - אינדיער m (indjer)
hipokryta - צבֿועק
hipotetyczny - היפּאָטעטיש
hipoteza - היפּאָטעז m (hipotez)
historia - געשיכטע f (geszichte) | מעשׂה f (mesh)
hit - שלאַגער m (szlager)
hojny - רײַך (rajch)
hoker - טאַבורעט m (taburet)
holenderski - האָלענדיש (holendisz)
holm - האָלמיום
hreczka - רעטשקע f | גריקע f
hryć - גראָבער פֿליגל m (grober fligl)
hucpa - חוצפּה f (chucpe)
humor - מוט m (mut)
huncwot - שייגעץ m (szejgec)
hunzytryjgi - שלייקעס (szlejkes) | שעלקעס (szelkes)
hyca - היץ f (hic)
hycel - היצעל m (hicel)
i - און (un)
idealista - אידעאַליסט m
idealny - אידעאַל (ideal)
identyczny - אידענטיש (identisz)
idiota - אידיאָט m (idjot) | דאָס m (dos) | חכם m (chochem)
igła - נאָדל f (nodl)
ignorancja - אומוויסן n (umwisn) | עם־הארצות n (ameraces) | אומקענטעניש n (umkentenisz)
ignorować - אַוועקקוקן (awekkukn)
II wojna światowa - צווייטע וועלט־מלחמה f (cwejte welt-milchome)
ile - וויפֿל (wifl)
iloraz - וויפֿלער m (wifler)
ilustracja - אילוסטראַציע f (ilustracje) | משל (moszl)
ilustrować - אילוסטרירן
imbecyl - בהמה f (behejme) | חכם m (chochem)
imbir - אינגבער m (ingber)
imię - נאָמען m (nomen)
imieniny - נאָמענסטאָג m (nomenstog)
imienniczka - נאָמען־שוועסטער f (nomen-szwester)
imiennik - חבֿר צום נאָמען m (chawer cum nomen) | נאָמען־ברודער m (nomen-bruder)
imiesłów - פּאַרטיציפּ m (particip)
imitować - נאָכמאַכן (nochmachn)
impertynent - שייגעץ m (szejgec)
impotencja - מענערשוואַכקייט f (menerszwachkejt) | אימפּאָטענץ f (impotenc)
impresor - דרוקער m (druker)
impuls - שטופּ m (sztup)
ind - אינדיום
Indie - אינדיע f (indje)
Indonezja - אינדאָנעזיע [indonezje]
indyk - אינדיק m (indik)
infekcja - אינפֿעקציע
inflacja - אינפֿלאַציע (inflacie)
informować - לאָזן וויסן (lozn wisn)
inkaust - טינט f (tint)
inkryminować - אינקרימינירן (inkriminirn) | שולדיקן (szuldikn)
innowierca - גוי m (goj)
ino - נאָר (nor)
insekt - אינסעקט m (insekt)
inspiracja - אינספּיראַציע f | באַגײַסטערונג f
instytut - אינסטיטוט m (institut)
insurekcja - אויפֿשטאַנד m
inteligencja - אינטעליגענץ
inteligentny - חכם m (chochem)
intencja - כּוונה (kawone) | מיין (mejn)
interes - אינטערעס m (interes) | דאָס m (dos)
interesować - אינטערעסירן (interesirn) | אינטערעסירן זיך (interesirn zich)
interesujący - אינטערעסאַנט (interesant) | טשיקאַווע (czikawe)
intryga - מאַניפֿאָרגע f (maniforge)
inżynier - אינזשעניר (inżenir)
ironiczny - איראָניש
iryd - אירידיום (iridjum)
irytacja - צעזעצעניש f (cezecenisz)
iść - מע קען (me ken) | מע מעג (me meg) | מע טאָר ניט (me tor nit)
iście - אויף געוויס (ojf gewis) | אויף זיכער (ojf zicher) | מוזן (muzn)
iść na skibę - גנבֿענען (ganwenen)
iskra - פֿונק m (funk)
islam - איסלאַם m (islam)
islamski - איסלאַמיש (islamisz)
istnieć - זײַן (zajn)
istnienie - זײַן n (zajn)
istotnie - טאַקע (take) | גערעכט (gerecht)
italski - איטאַליעניש (italjenisz) | הערל f (herl)
iterb - איטערביום
I wojna światowa - ערשטע וועלט־מלחמה f (erszte welt-milchome)
iż - אַז (az) | דאָס (dos) | וואָס (wos)
ize - אַז (az) | דאָס (dos) | וואָס (wos)
-izm - [[יזם|&rlm | -יזם]] m (-izm)
Izrael - ישׂראל n (jisroel) | ישׂראל m (jisroel)
Izraelita - ישׂראל m (jisroel)
izraelski - ישׂראליש
ja - איך (ich)
jabłko - עפּל m (epl)
jabłko Adama - גאָרגל m (gorgl) | גאָרגלקנאָפּ m (gorglknop)
jabłko niezgody - סלע־המחלוקת m (sele-hamachloykes)
jacht - יאַכט m (jacht)
jadać - עסן (esn)
jagnię - לאַם f (lam)
jagoda - בעקל n (bekl) | באַק f (bak)
jaguar - יאַגואַר m (jaguar)
jajecznica - פּרעזשעניצע f (preżenice)
jajko - איי n (ej)
jajnik - אייערשטאָק m (ejersztok)
jajo - איי n (ej)
jajówa - פּרעזשעניצע f (preżenice)
jaka - קאַפֿטאַן
jaki - וואָס פֿאַר אַ (wos far a) | וואָסער (woser) | וועלך (welch)
jakikolwiek - בילע (bile) | ערגעץ אַ (ergec a)
jakiś - ערגעץ אַ (ergec a)
jakkolwiek - אַבי ווי (abi wi)
jak u Pan Pana Boga za piecem - ווי גאָט אין פֿראַנקרײַך (wi got in frankrajch)
jak żółw - מע מעג (me meg) | מע טאָר ניט (me tor nit)
jama - לאָך (loch)
jangryst - אַגרעס m (agres)
japa - לאָך (loch) | הייל f (hejl)
jara - שוויגער f (szwiger)
jarmułka - יאַרמלקע f (jarmlke)
jarosz - וועגעטאַריער m (wegetarjer)
jarski - וועגעטאַריש (wegetarisz)
jarzmo - יאָך m (joch)
jarzyna - גרינס n (grins)
jaskinia - הייל f (hejl)
jaskółka - שוואַלב f (szwalb)
jasno - קלאָר (klor)
jasny - העל (hel) | קלאָר (klor) | קענטיק (kentik)
jasny jak słońce - קלאָר ווי דער טאָג (klor wi der tog)
jaszczurka - יאַשטשערקע f (jaszczerke)
jawny - קענטיק (kentik) | קלאָר (klor)
jazz - דזשעז m (dżez)
jebać - טרענען (trenen)
jeden za wszystkich, wszyscy za jednego - יחדיו איז אַ ייִדישע זאַך (jachdew iz a jidisze zach)
jedlina - יאָדלע f (jodle)
jednocześnie - בעת־מעשׂה (bejs-majse) | הײַנט (hajnt)
jednolity - איינהייטלעך (ejnhejtlech)
jednylki - זעלביק | זעלב
jedyny - איינציק (ejncik)
jedza - עסן n (esn)
jedzenie - עסן n (esn)
jego - זײַן (zajn)
jełop - בהמה f (behejme) | דאָס m (dos) | חכם m (chochem)
jeniec - געפֿאַנגענער m (gefangener)
Jerozolima - ירושלים n (jeruszelajem)
jeść - עסן (esn)
jesień - האַרבסט (horbst) | יעשען (jeszen) | אָסיען m (osjen)
jesion - אַשבוים m (aszbojm)
jeśli - לאָז (loz)
jest - זײַן (zajn) | ווערן (wern) | וועל (wel)
jeż - שטעכלער m (sztechler) | יאָזש m (joż)
jeżeli - לאָז (loz)
jezioro - אָזערע f (ozere)
Jezus - יעזוס m (jezus)
Jezus Chrystus - ישו הנוצרי (yišu hanoyʦri)
język - צונג f (cung) | לשון n (loszn) | שפּראַך f (szprach)
język ojczysty - מאַמע־לשון n (mame-loszn) | מוטערשפּראַך f (muterszprach)
językowy - שפּראַכ-&rlm | (szprach-) | שפּראַכיק (szprachik)
jeżyna - אָזשענע f (ożene)
jidysz - ייִדיש n (jidisz)
jidyszyzm - ייִדישיזם m (jidiszizm)
jod - יאָד (jod)
jodła - יאָדלע f (jodle)
jogurt - יאָגורט m (jogurt)
jubilat - יובילאַר m (jubilar)
jubileusz - יובֿל m (jojwl) | יוביליי m (jubilej)
judaizm - ייִדישקייט (jidiszkejt)
judasz - לעכל n (lechl)
judeochrześcijański - ייִדיש־קריסטלעך (jidisz-kristlech)
judofob - אַנטיסעמיט m (antisemit)
juny - יונג (jung)
jupa - אייבערבגד m (ejberbeged)
jutro - מאָרגן m (morgn) | מאָרגן (morgn)
jutrzejszy - מאָרגנדיק (morgndik)
kaban - חזיר m (chazer)
kabanina - חזיר m (chazer) | חזיר־פֿלייש n (chazer-flejsz)
kabat - אייבערבגד m (ejberbeged)
kabuki - קאַבוקי (kabuki)
kabza - קעשענע f (keszene)
kacap - בהמה f (behejme) | דאָס m (dos) | חכם m (chochem)
kaczan - גלאָמב m (glomb) | בהמה f (behejme) | טיף f (tif) | טיפֿקייט
kaczka - קאַטשקע f (kaczke)
kafej - קאַפֿע m (kafe) | קאַוויאַרניע f (kawjarnje)
kaffa - קאַווע f (kawe)
kaftan - קאַפֿטאַן
kaftan bezpieczeństwa - צוואַנגיאַק (cwangjak)
kaj - וווּ (wu)
kajet - העפֿט f (heft)
kajman - קראָקאָדיל m (krokodil)
kakao - קאַקאַאָ m (kakao)
kałabania - קאַליוזשע f (kaliuże) | לוזשע f (luże) | קאַלוזשע f (kaluże)
kalafa - נאָז f (noz) | אַלקאָהאָליקער m (alkoholiker) | פּנים n (ponem)
kalafior - קאַליפֿיאַר m (kalifiar)
kalectwo - מום m
kalejdoskop - קאַליידאָסקאָפּ m
kalfas - בויך m (bojch)
kalifat - כאַליפֿאַט m
kaliforn - קאַליפֿאָרניום
kaliski - קאַלישער (kaliszer)
kalkulator - רעכן־מאַשין f (rechn-maszin)
kalmar - טינטפֿיש m (tintfisz)
kalosz - קאַלאָש
kałuża - קאַליוזשע f (kaliuże) | לוזשע f (luże) | קאַלוזשע f (kaluże)
kam - וווּהין (wuhin) | וווּ (wu)
kamasz - שוך m (szuch)
kamień - שטיין m (sztejn)
kamień milowy - אָנדענקפּונקט m (ondenkpunkt)
kamień węgielny - ווינקלשטיין m (winklsztejn) | גרונטשטיין m (gruntsztejn)
kanał - קאַנאַל m (kanal) | גראָבן m (grobn)
kanapa - דיוואַן m | קאַנאַפּע f
kancelista - שרײַבער m (szrajber)
kangur - קענגורו m (kenguru)
kanka - קריגל n | קאַנע f (kane) | מאַריכואַנע f (marichuane)
kantor - חזן m (chazn)
kapeć - רייף ,גומערייף
kapitalista - קאַפּיטאַליסט (kapitalist)
kapitalistyczny - קאַפּיטאַליסטיש
kapitalizm - קאַפּיטאַליזם m (kapitalizm)
kapłan - גלח m (galech)
kapować - פֿאַרשטיין (farsztejn)
kapusta - קרויט (krojt) | געלט n (gelt)
karaba - קאַץ f (kac)
karabin - ביקס f (biks)
karabin maszynowy - פּולעמיאָט m (pulemiot)
karakan - טאַראַקאַן m (tarakan)
karaluch - טאַראַקאַן m (tarakan)
karczoch - אַרטישאָק m (artiszok)
karetka - אַמבולאַנס m (ambulans)
karibu - רעניפֿער m (renifer)
karlus - יונג m (jung)
karman - טײַסטער m | בײַטל n | פּאָליאַרעס m | פּוליאַרעס m
karnacja - קאָליר m (kolir)
karp - קאַרפּ m
karta - קאָרט f (kort)
karta do gry - קאָרט f (kort)
kartka - בלאַט (blat)
kartofel - בולבע
karygodny - שענדלעך (szendlech)
karzeł - דאָס פֿערטל עוף n (dos fertl of)
kasjer - קאַסיר m
kast - אָרון m | סקריניע
kasta - אָרון m | סקריניע
kasza - קאַשע f (kasze) | גריץ f (gric)
kaszleć - הוסטן (hustn)
kasztan - קעסט f (kest) | קאַשטאַן m (kasztan)
kasztanowiec - קאַשטאַן m (kasztan)
kasztanowy - קאַשטאַנעווע (kasztanewe)
kąt - עק m (ek)
katana - אייבערבגד m (ejberbeged)
kataryniarz - קאַטערינשטשיק (katerinszczik)
katedra - קאַטעדרע f (katedre)
katolicki - קאַטויליש
Katyń - קאַטינער הריגה f (katiner harige)
kawa - קאַווע f (kawe)
kawalerczak - פּינדיוריק m (pindjurik)
kawa wesoła - שאַנדהויז n (szandhojz) | הײַזל n (hajzl)
kawiarnia - קאַפֿע m (kafe) | קאַוויאַרניע f (kawjarnje)
kawka - מאָנאַשקע f
kawon - אַרבוז m (arbuz) | קאַווענע f (kawene)
kazać - לאָזן (lozn)
każdy - יעדער (jeder)
kaznodzieja - מגיד m
kciuk - גראָבער פֿינגער m (grober finger) | גוי m (goj)
keczup - פּאָמידאָרן־סאָס m (pomidorn-sos) | קעטשאָפּ m (keczop)
kędy - וווּ (wu)
kejter - הונט m (hunt)
keta - קייט f (kejt)
khaki - כאַקי
kibuc - קיבוץ m
kichać - ניסן (nisn) | פֿײַפֿן (fajfn)
kichnąć - געבן / טאָן אַ נאָס (gebn / ton a nos)
kici, kici - קיץ־קיץ־קיץ (kic-kic-kic)
kiecka - קליידל n (klejdl) | האַלב קליידל n (halb klejdl)
kiedy - בעת (bejs)
kiejda - קעשענע f (keszene)
Kielce - Kieltz
kieliszeczek - גלעזל n
kieliszek - גלעזל n (glezl)
kielonek - גלעזל n (glezl)
kieluńdek - גלעזל n (glezl)
kieszeń - קעשענע f (keszene)
kieszonkowiec - קעשענע־גנבֿ m (keszene-ganew)
kij - דרוק m (druk)
kilkujęzyczny - עטלעך־שפּראַכיק (etlech-szprachik)
kilkujęzykowy - עטלעך־שפּראַכיק (etlech-szprachik)
kimać - שלאָפֿן (szlofn)
kimono - שלאָף m (szlof) | חלום m (cholem)
kino - קינאָ m (kino)
kinol - נאָז f (noz) | אַלקאָהאָליקער m (alkoholiker)
kintop - קינאָ m (kino) | פֿאַרווײַלונג
kirchóf - בית־עולם (bejs-ojlem)
kireja - אייבערבגד m (ejberbeged)
kista - אָרון m | סקריניע
kiszka - מילך f (milch)
kit - קיט m (kit) | ליגן m (lign) | שקר m (szeker)
kitajski - כינעזיש (chinezisz)
kłąb - סקיין
klamka - קליאַמקע f (kliamke)
kłamny - פֿאַלש
klamot - שטיין m (sztejn)
kłamstwo - ליגן m (lign) | שקר m (szeker)
kłapaczka - מויל n (muil)
klawiatura - קלאַוויאַטור f (klawjatur)
klawisz - קלאַוויש m (klawisz) | היטער m (hiter)
klekotun - באָטשען m (boczen) | בושל m (buszl)
kleszcz - צוואַנגמילב f (cwangmilb)
kleszcze - צוואַנג f (cwang) | אָפּצווענגע f (opcwenge)
kletuśnica - יענטע f (jente) | קיפּלערין f (kiplerin)
kliber - נאָז f (noz) | אַלקאָהאָליקער m (alkoholiker)
klikać - קנאַקן (knakn)
klikanie - קנאַק m
klima - לופֿטקילונג f (luftkilung)
klimatyzacja - לופֿטקילונג f (luftkilung)
kłódka - הענגשלאָס m (hengszlos)
klon - נעזבוים m (nezbojm)
kłopot - צרה f (core)
klops - קלאָפּס m
kłos - זאַנג (zang)
kluber - נאָז f (noz) | אַלקאָהאָליקער m (alkoholiker)
kłuć - שטעכן (sztechn)
kłucie - שטאָך m (sztoch)
klucz - שליסל (šlisl)
kluka - נאָז f (noz)
klupać - גראָבן זיך (grobn zich) | קלאַפּן (klapn) | שמײַסן (szmajsn) | האַקן (hakn) | ווערן זיך (wern zich)
kminek - קימל m
knajpa - קנײַפּע
kniądz - פּרינץ m (princ) | גלח m (galech)
knipa - בוך n (buch)
knot - קנויט f (knuit)
koafiura - פֿריזור (frizur)
koalicja - קאָאַליציע f (koalicje)
kobalt - קאָבאַלט (kobalt)
kobieciarz - פֿרויען־יעגער m (frojen-jeger)
kobiecy - ווײַבלעך (wajblech)
kobieta - פֿרוי f (froj)
kobieta lekkich obyczajów - פּראָסטיטוטקע f (prostitutke)
kochać - ליבן (libn) | ליב האָבן (lib hobn) | קאָכען זיך (kochen zich)
kochan - קאָכאַנעק m (kochanek) | ליבהאָבער m (libhober) | ליובאָווניק m (ljubownik)
kochanek - קאָכאַנעק m (kochanek) | ליבהאָבער m (libhober) | ליובאָווניק m (ljubownik)
kochanie - ליובע f (ljube) | גאָלד n (gold) | ליובטשע (ljubcze) | ליובעליו (ljubelju) | ליובעניו (ljubenju) | מײַן גאָלד (majn gold)
kochanka - ליובאָווניצע f | מעטרעסע f | קאָכאַנקע f
kochany - ליב (lib) | ליבלעך (liblech)
koci - קעציש (kecisz)
kociamber - קאַץ f (kac)
kocia muzyka - קאַצן־מוזיק f (kacn-muzik)
kociątko - קעצעלע n (kecele) | קאָטינקע f (kotinke)
kocik - קעצעלע n (kecele) | קאָטינקע f (kotinke)
kocioł - קעסל
kocur - קאָטער m (koter)
kogel-mogel - גאָגל־מאָגל
kokosz - הון f (hun)
kokoszka - הון f (hun)
kokota - פּראָסטיטוטקע f (prostitutke)
kokotek - ליפֿט m (lift)
koks - קאָקס m (koks)
koktajl w:Wiaczesław Mołotowa - צינדפֿלעשל n
kołdra - קאָלדרע (koldre)
kolęda - קאָלענדע f (kolende)
kolej - באַן f (ban)
kolejny - צווייטער (cwejter)
koleś - יונג m (jung)
kołnierz - קאָלנער m (kolner)
koło - ראָד n (rod) | לעבן (lebn) | ראָווער m (rower) | קעגן (kegn)
kolonia - קאָלאָניע f (kolonje) | ייִשובֿ m (jiszew) | קעמפּ m (kemp) | מחנה f (machne)
Kolonia - קעלן n (keln)
kolonoskopia - קאלאנסקאפי
koloński - קעלניש
kolor - קאָליר m (kolir)
kolorowy - קאָלירט (kolirt)
koło zębate - ציינראָד n (cejnrod)
kolumna - קאָלאָנע f (kolone) | זײַל m (zajl) | קאָלומנע f (kolumne) | רובריק f (rubrik)
kołysanka - וויגליד n (wiglid)
kołyska - וויג f (wig)
koma - קאָמע f (kome)
komar - קאָמאַר m (komar)
komat - קאָמע f (kome)
komedia - קאָמעדיע f
kominek - קאַמין m (kamin)
kominiarz - קוימען־קערער m (kojmen-kerer)
komisja - קאָמיסיע
komoda - קאַמאָד m (kamod)
komora - קאַמער f
komórka - צעלקע f (celke) | מאָביל־טעלעפֿאָן m (mobil-telefon)
komp - רעכענער m (rechener) | קאָמפּיוטער m (kompjuter)
kompania - קאָמפּאַניע f
komplementarny - דערגאַנציק (dergancik)
kompot - קאָמפּאָט m (kompot)
komputer - רעכענער m (rechener) | קאָמפּיוטער m (kompjuter)
komuch - קאָמוניסט
komunista - קאָמוניסט
komunistyczny - קאָמוניסטיש (komunistisz)
komunizm - קאָמוניזם m (komunizm)
koń - פֿערד n (ferd) | פּעניס m (penis) | מענלעכער אבֿר m (menlecher ejwer)
kóń - פֿערד n (ferd)
koncert - קאָנצערט m (koncert)
kończyć - ענדיקן (endikn)
kondom - קאָנדאָם m (kondom)
konduktor - קאָנדוקטאָר m
koniak - קאָניאַק m (konjak)
koniec - סוף m (sof) | עק m (ek)
konik - פֿערדל n | ים־פֿערדל n (jam-ferdl)
konik morski - ים־פֿערדל n (jam-ferdl)
koniugacja - קאָניוגאַציע f (koniugacje)
konstytucja - קאָנסטיטוציע f (konstitucje) | גוף־געבוי m (guf-geboj)
kontakt - קאָנטאַקט m (kontakt)
konto - קאָנטע f (konte)
kontrabanda - שמוגל m (szmugl)
kontrast - קאָנטראַסט m (kontrast) | היפּוך m (hejpech)
kontynent - קאָנטינענט m (kontinent)
konwertyta - גוי m (goj)
kopa - שאָק (szok)
kopać - בריקען (briken) | גראָבן (grobn)
kopalnia - גרוב f (grub)
koperta - קאָנווערט m (konwert)
kopica - שאָק (szok)
kopiować - נאָכמאַכן (nochmachn)
kopniak - בריקע m (brike)
kopnięcie - בריקע m (brike)
kopruch - קאָמאַר m (komar)
kopyto - פּיסטאָלעט m (pistolet)
koralik - פּאַטשערקע
Koran - קאראן
korbol - דיניע f (dinje)
kordła - קאָלדרע (koldre)
Korea Północna - צפֿון־קאָרעע f (cofn-koree)
korek - קאָריק m (korik)
korona - קרוין f (krojn)
korpus - קערפּער m (kerper)
korytarz - קאָרידאָר m (koridor)
korzeń - וואָרצל m (worcl)
kos - קאָסע f (kose)
kosa - קאָסע f (kose) | מעסער (mʻsʻr)
kosiarka - גראָז־שנײַדער m (groz-sznajder)
kosić - קאָשען (koszen)
kosmetyk - קאָסמעטיק (kosmetik)
kosmos - קאָסמאָס m (kosmos)
Kosowo - קאָסאָווע (kosowe)
kosz - קוישבאָל m | לאַגער m (lager)
koszmar - בייזער חלום m (bejzer cholem)
kosztować - פֿאַרזוכן (farzuchn)
kosztowny - טײַער (tajer) | ליב (lib)
koszula - העמד n (hemd)
koszykówka - קוישבאָל m
kot - קאַץ f (kac)
kotek - קעצעלע n (kecele) | קאָטינקע f (kotinke)
kotku - קעצעלע n (kecele) | קאָטינקע f (kotinke)
kowal - שמיד m (szmid)
koza - ציג f (cig)
kozak - קאָזאַק m (kozak)
Kozak - קאָזאַק m (kozak)
kozi - ציגן (cign)
kozia bródka - ציגן־בערדל n (cign-berdl)
kozioł ofiarny - שׂעיר־לעזאָזל m (soer-lazozl) | כּפּרה־הינדל n (kapore-hindl)
kpić - שפּאָטן
kra - קריע f
krab - ראַק m (rak)
kradzież - גנבֿה m (ganejwe)
kragel - קאָלנער m (kolner)
kraj - לאַנד n (land)
krajać - שנײַדן (sznajdn) | גנבֿענען (ganwenen)
Kraków - קראָקע f (kroke)
kran - ליפֿט m (lift)
kraniec - עק m (ek)
kraść - גנבֿענען (ganwenen)
krasula - קו f (ku)
krawat - שניפּס m (sznips) | קראַוואַט m (krawat) | אויסבינדער m (ojsbinder)
krawatka - שניפּס m (sznips) | קראַוואַט m (krawat) | אויסבינדער m (ojsbinder)
krawiec - שנײַדער m (sznajder)
krążyć - אַרומדרייען זיך (arumdrejen zich)
kręcić - אַרומדרייען (arumdrejen) | ראָלן (roln) | אַרומדרייען זיך (arumdrejen zich) | ראָלן זיך (roln zich)
kremacja - פֿאַרברענונג f (farbrenung) | קרעמאַציע f (kremacje)
krematorium - קרעמאַטאָריע f (krematorje)
krem do opalania - זונשמירעכץ
krępować - פֿאַרשעמען (farszemen) | שעמען זיך (szemen zich) | פֿאַרשעמען זיך (farszemen zich)
kres - אונטערגאַנג m (untergang)
kret - מולטוואָרעס m (multwores) | קראָט m (krot)
kretyn - בהמה f (behejme) | מאָראָן m (moron)
kretyński - מאָראָניש (moronisz)
krew - בלוט n (blut)
krewetka - ראַקל n (rakl)
krewni i znajomi królika - קינד־און־קייט (kind-un-kejt)
krewny - משפּחה f (miszpoche)
krew z mlekiem - בלוט און מילך (blut un milch)
kroić - שנײַדן (sznajdn) | גנבֿענען (ganwenen)
krok - קאַצנשפּרונג m (kacnszprung)
krokodyl - קראָקאָדיל m (krokodil)
król - מלך m (mlch) | קיניג m (kinig)
królestwo - קיניגרײַך n (kinigrajch)
królowa - קיניגין f
kropeczka - פּינטעלע n (pintele)
kropka - פּונקט m (punkt) | פּינטל n (pintl) | פּינטעלע n (pintele)
kropla - טראָפּן m (tropn)
krople - טראָפּן m (tropn)
krótki - קורץ (kurc)
krotofila - פֿאַרווײַלונג
krowa - קו f (ku)
krowi - קיִיִש (kiisz)
krówka - קיִעלע f (kiele)
krtań - שטימע קעסטל
krucyfiks - צלם m (cejlem)
kruk - וואָראָן m (woron) | ראָב m (rob)
krupnik - קרופּניק m
kruty - שטאַרק (sztark)
krwawy - בלוטיק (blutik)
krybuny - צלם m (cejlem)
krytyk - קריטיקער m (kritiker) | רעצענזענט m (recenzent)
krytyka - קריטיק f (kritik)
krytykantka - קיפּלערין f (kiplerin)
kryzys - קריזיס
krzem - סיליציום (silicjum)
krzesło - שטול m (sztul)
krzyk - גוואַלד m | געשריי n
krzykliwy - שרײַיִק
krzywoprzysięstwo - פֿאַלשע שבֿועה f
krzyż - צלם m (cejlem)
ksiądz - גלח m (galech)
książę - פּרינץ m (princ)
książka - בוך n (buch)
Księga Rodzaju - &rlm | בראשית m (birejszis) (ספֿר)
księżniczka - פּרינצעסין f
księżyc - לבֿנה f (lewone)
Księżyc - לבֿנה f (lewone)
kto - ווער (wer)
ktokolwiek - אַ) בילע ווער) ((a) bile wer)
który - וועלך (welch)
ktoś - עמעץ (emec) | עמעצער (emecer)
któż - ווער (wer)
ku - קיין (kejn)
kubek - טעפּל n (tepl)
kubek w kubek - אידענטיש (identisz)
Kubuś Puchatek - וויני־דער־פּו m (wini-der-pu)
kuć - בעל־עגלה m | שמײַסער m (szmajser)
kucać - הוסטן (hustn)
kucza - כאַטע f (chate)
kufel - קופֿל m (kufl)
kukułka - קוקאַווקע f (kukawke)
kukurydza - פּאַפּשוי m (papszoj) | קוקורוזע f (kukuruze)
kula - קויל f (kojl) | קוליע f (kulje) | פֿוס m (fus) | פֿוסבאָל m (fusbol)
kulka - קויל f (kojl) | קוליע f (kulje)
kulos - פֿוס m (fus) | פֿוסבאָל m (fusbol)
kultura - קולטור f (kultur) | תּרבות n (tarbes)
kulturalny - קולטורעל (kulturel)
kulturowy - קולטורעל
kuna - קונע f (kune)
kuper - תּחת m (toches) | דאָס m (dos)
kupidło - פּרײַז m (prajz)
kupować - קויפֿן (kojfn)
kupować kota w worku - קויפֿן אַ קאַץ אין אַ זאַק (kojfn a kac in a zak)
kura - הון f (hun)
kuraż - מוט m (mut)
kurka - הון f (hun)
kurki - הון f (hun)
kurtka - אייבערבגד m (ejberbeged)
kurtyzana - פּראָסטיטוטקע f (prostitutke)
kurwa - זונה f (zojne) | הור f (hur) | קורוואַ f (kurwa)
kurwacik - שניפּס m (sznips) | קראַוואַט m (krawat) | אויסבינדער m (ojsbinder)
kurz - שטויב (sztojb)
kusić - סטראַשען | זען (zen) | היטן (hitn)
kusik - קוש m (kusz)
kuśka - פּעניס m (penis) | מענלעכער אבֿר m (menlecher ejwer)
kusy - טײַוול m (tajwl)
kutafon - שמאָק m (szmok) | פּוץ m (puc)
kutas - שמאָק m (szmok) | פּוץ m (puc)
kutwa - חזיר m (chazer)
kwadrans - פֿערטל n (fertl)
kwasić - זײַערן (zajern)
kwaśne mleko - זויערמילך f (zojermilch)
kwaśny - זויער (zojer)
kwiaciarnia - בלומענקראָם f (blumenkrom)
kwiat - בלום f (blum) | קווייט m (kwejt)
kwiatek - בלום f (blum) | קווייט m (kwejt)
kwiecień - אַפּריל m (april)
kwitnąć - בליִען (blien) | צוויטען (cwiten) | בליִען זיך (blien zich)
łabęć - שוואַן m (szwan)
łabędź - שוואַן m (szwan)
łacina - לאַטײַן n (latajn)
łaciński - לאַטײַניש (latajnisz)
łacny - גרינג (gring)
lacz - פּעניס m (penis) | מענלעכער אבֿר m (menlecher ejwer)
ładnie - שיין (szejn)
ładny - שיין (szejn)
laga - דרוק m (druk)
łagodzić - מילדערן
łajać - געבן (gebn)
lajerman - קאַטערינשטשיק (katerinszczik)
lak - לאַק m
łąka - לאָנקע f (lonke)
lala - טאָק (tok) | מויד f (mojd)
lalka - טאָק (tok)
łamać - ברעכן (brechn)
lampa - לאָמפּ
lamparcica - לעמפּערטיכע f (lempertiche)
lampart - לעמפּערט m (lempert)
łańcuch - קייט f (kejt)
land - דאָרף n (dorf)
langusta - ראַק m (rak)
łapać - כאַפּן (chapn) | כאַפּן זיך (chapn zich)
łapu - כאַפּ־לאַפּ (chap-lap)
łapu-capu - כאַפּ־לאַפּ (chap-lap)
larwa - לאַרווע f (larwe)
las - וואַלד m (wald)
łasica - וויזעלע n (wizele)
lat - יאָר n (jor)
lata - יאָר n (jor) | האַלב קליידל n (halb klejdl)
łata - לאַטע f (late)
latawiec - פֿלישלאַנג f (fliszlang)
lato - זומער (zumer)
łatwo - גרינג (gring)
łatwy - גרינג (gring)
lawa - לאַווע f (lawe)
ława - באַנק f (bank)
lawina - לאַווינע f
ławka - באַנק f (bank)
łazior - וואַגאַבונד m (wagabund) | וואַנדערער m (wanderer) | שלעפּער m (szleper)
łaźnia - מיקווה f (mikwe)
lecieć - פֿליִען (flien)
ledwo - קוים מיט צרות (kojm mit cores)
legalny - לעגאַל (legal) | כּשר (koszer)
lejce - לייצע f
lekarz - דאָקטער m (dokter)
lekceważyć - שעצן גרינג (szecn gring) | אַוועקקוקן (awekkukn) | ניט לייגן גענוג אַכט אויף (nit lejgn genug acht ojf)
lekki - גרינג (gring)
lekko - גרינג (gring)
lekkomyślność - קלות־דעת n (kales-daas)
leopard - לעמפּערט m (lempert)
leść - מאַניפֿאָרגע f (maniforge)
letni - זומערדיק (zumerdik)
lew - לייב m (lejb)
lewy - לינק (link)
lichy - הינטיש (hintisz)
liczba - צאָל f (col)
liczba mnoga - מערצאָל f (mercol)
liczba pojedyncza - איינצאָל f (ejncol)
liczebnik - צאָלוואָרט n (colwort) | צאָלנאָמען m (colnomen)
liczyć - ציילן (cejln) | קוקן (kukn)
liczykrupa - חזיר m (chazer)
likwidować - ליקווידירן
lilak - בעז m (bez) | מײַ m (maj)
lilia - ליליע f (lilje)
liliput - דאָס פֿערטל עוף n (dos fertl of)
lina - שטריק (sztrik)
lingwistyka - שפּראַך־וויסנשאַפֿט f (szprach-wisnszaft)
linia - ליניע f (linie) | מאַרשרוט m (marszrut) | שורה f (szure)
linka - שטריקל n (sztrikl)
linoleum - לינאָליי
lipa - לינדנבוים m (lindnboim)
lipiec - יולי m (juli)
lis - פֿוקס m (fuks)
liść - בלאַט (blat)
liść bobkowy - לאָרבער בלאַט m
liść laurowy - לאָרבער בלאַט m
lista - רשימה f (rszimh)
listopad - נאָוועמבער m (nowember)
lit - ליטיום (litjum)
litera - אות (os)
literat - שרײַבער m (szrajber) | שריפֿטשטעלער m (szriftszteler)
litewski - ליטוויש (litwisz)
Litwa - ליטע (lite)
lizać - לעקן (lekn)
lm - מצ
łobocyć - זען (zen)
łobuz - שייגעץ m (szejgec)
locha - ליאָכע f (ljoche) | חזירטע f (chazerte)
lód - אײַז n (ajz) | אײַזקרעם m (ajzkrem)
lodowiec - גלעטשער m (gleczer)
lodówka - קעלטערער m (kelterer)
Łódź - לאָדזש (lodż)
łódzki - לאָדזשער (lodżer)
logarytm - לאָגאַריטם (logaritm) m
logika - לאָגיק f | לאָגיקע f
logiko - לאָגיק f | לאָגיקע f
lokalizacja - אָרט m
lokator - לאָקאַטאָר m
łokieć - עלנבויגן m (elnbojgn)
lokomotywa - לאָקאָמאָטיוו m (lokomotiw)
lola - מויד f (mojd) | דרוק m (druk)
lombard - לאָמבאַרד m
Londyn - לאָנדאָן
łopata - לאָפּעטע f (lopete)
łor - גראָבער פֿליגל m (grober fligl)
lorens - לאָרענציום
los - לאָז m (loz)
łosoś - לאַקס m (laks)
łosprawiać - דערציילן (dercejln)
lot - פֿליג f (flig)
lotnisko - אַעראָפּאָרט m (aeroport)
lowelas - פֿרויען־יעגער m (frojen-jeger)
łowić - כאַפּן (chapn)
łowicki - לאָוויטשער (lowiczer)
lp - אצ
lśniący - גלאַנציק (glancik)
lśnić - גלאַנצן (glancn)
lub - אָדער
lubić - ליב האָבן (lib hobn)
lubieżny - תּאווהדיק (tajwedik)
Lublin - לובלין
łucznik - פֿײַלן־בויגער m (fajln-bojger)
ludność - באַפֿעלקערונג f
ludowy - פֿאָלקסטימלעך
łudzikwiat - אַפּריל m (april)
ludzki - מענטשיש (menczisz) | מענטשלעך (menczlech)
ludzkość - מענטשהייט
lukrecja - לאָקריץ
luksus - לוקסוס
lulka - פּיפּקע f (pipke) | שלוג f (szlug)
luna - לבֿנה f (lewone)
luńt - הונט m (hunt)
lutet - לוטעציום
lutować - שמײַסן (szmajsn) | האַקן (hakn) | קלאַפּן (klapn) | ווערן זיך (wern zich)
luty - פֿעברואַר m (februar) | קאַלט (kalt)
Lwów - לעמבערג (lemberg)
łyk - זופּ m (zup)
łysy - ליסע
łyżeczka - טיילעפֿל
łyżka do butów - שוכלעפֿל m (szuchlefl)
łza - טרער f (trer)
łża - ליגן m (lign) | שקר m (szeker)
maca - מצה f
macha - העוויה f (hawaje) | פּנים n (ponem)
macica - מוטערלײַב
maciek - בויך m (bojch)
macierz - מאַטריקס f (matriks)
maciora - ליאָכע f (ljoche) | חזירטע f (chazerte)
macoszka - חנהלעס אייגעלע n
mączka - פּודרע f | פּודער m
madla - אַקושערקע f (akuszerke) | הייבאַם f (hejbam)
mądry - חכם m (chochem)
magnetofon - רעקאָרדירקע f | מאַגנעטאָפֿאָן m | באַנד־רעקאָרדירער m
magnez - מאַגנעזיום (magnezjum)
maj - מײַ m (maj)
majątek - רײַכקייט f (rajchkejt)
majętny - רײַך (rajch)
majonez - מאַיאָנעז m (majonez)
majtki - מײַטקעס (majtkes)
mak - מאָן m
makaron - לאָקש m (loksz)
malaria - מאַלאַריע f (malarje)
malarstwo - מאָלערײַ (moleraj)
malarz - מאַליער m (malier) | מאָלער m (moler)
malec - פּינדיוריק m (pindjurik)
maleć - פֿאַרמינערן
malin - מאַלענע f (malene)
malina - מאַלענע f (malene)
małpa - מאַלפּע f (malpe) | אויף ,שטרודל ,מאַלפּע
mały - קליין (klejn) | דאָס m (dos)
małżonka - פֿרוי f (froj) | ווײַב n (wajb)
mam - האָבן (hobn) | מאַמע f (mame)
mama - מאַמע f (mame) | שוויגער f (szwiger)
mamusia - מאַמעלע f (mamele) | מאַמעניו f (mameniu)
mandolina - מאַנדאָלין f (mandolin)
manekin - טאָק (tok)
maniurka - מויד f (mojd)
mantel - אייבערבגד m (ejberbeged)
mapa - קאַרטע f (karte) | מאַפּע f (mape)
maras - בלאָטע f (blote)
marcowy - מאַרצאָווע (marcowe)
margaryna - מאַרגאַרין m (margarin)
marihuana - מאַריכואַנע f (marichuane)
marionetka - מאַריאָנעט f (marjonet)
marka - מאַרקע
marmolada - מאַרמעלאַד m
marmur - מאַרמער מאַרמל
marność - הבֿל m (hewl)
marny - הינטיש (hintisz)
marokański - מאַראָקאַניש (marokanisz)
Maroko - מאַראָקאָ n (Maroko)
marszałek - מאַרשאַל m
marynarka - פּידזשאַק m (pidżak)
marzec - מאַרץ m (marc)
marzenie - חלום m (cholem)
marzenie senne - שלאָף m (szlof) | חלום m (cholem)
marzyć - חלומען (cholemen)
masarnia - יאַטקע f (jatke) | פֿליישיק (flejszik)
masaż - מאַסאַזש m
masażysta - שמײַסער m (szmajser)
maść - זאַלב f (zalb)
maska - פּנים n (ponem)
maślanka - מאַסלינקע f (maslinke) | פּוטערמילך f (putermilch)
masło - פּוטער f (puter)
mason - פֿרײַמײַער m (frajmajer)
masywny - פֿאַרנעמיק | מעכטיק
maszyna - מאַשין f (maszin)
maszyna do pisania - שרײַבמאַשין f (szrajbmaszin)
maszyna do szycia - ניימאַשין f
matematyczny - מאַטעמאַטיש (matematisz)
matematyk - מאַטעמאַטיקער m (matematiker)
matematyka - מאַטעמאַטיק f (matematik)
materiał - סחורה f (schojre)
materiał wybuchowy - אויפֿרײַסוואַרג n (ojfrajswarg) | אויפֿרײַס־מאַטעריאַל m (ojfrajs-materjal) | אויפֿרײַס־שטאָף m (ojfrajs-sztof)
maturzysta - אַביטוריענט m (abiturjent)
mauretański - מוריניש (murinisz)
mazak - פּנים n (ponem)
mazojen - מאַיאָנעז m (majonez)
mdłość - שוואַכקייט f | שלאַפֿקייט f | מיחוש m
mebel - מעבל (mebl)
mecenas - אַדוואָקאַט m (adwokat)
mechanizm - מעכאַניזם ,מאַשינעריע ,מאַשינערײַ
męczennik - מאַרטירער m
meczet - מעטשעט m (meczet)
męczyć - מיד ווערן (mid wern)
mędrzec - חכם m (chochem)
medyk - דאָקטער m (dokter)
meitner - מײַטנעריום
męka - יסורים (jisurim / jesurim) | פּײַן f (pajn) | צרה f (core)
Meksyk - מעקסיקע (meksike)
melać - שפּײַען (szpajen) | פֿײַפֿן (fajfn)
melancholia - מעלאַנכאָליע f (melancholje)
melki - צוקערקע f (cukerke)
melodia - מעלאָדיע f (melodje)
melodio - מעלאָדיע f (melodje)
melon - מעלאָן m (melon)
memorandum - מעמאָראַנדום m (memorandum)
menażeria - מענאַזשעריע f (menażerje)
mendelew - מענדעלעוויום
menora - מנורה f (menojre)
Merkury - מערקור m (merkur)
męski - מענלעך (menlech)&lrm | מאַסקולין&lrm | מענלעך (menlech)
męstwo - מוט m (mut)
metafora - מעטאַפֿאָר m (metafor)
metal - מעטאַל m (metal)
metalowy - מעטאַלן (metaln)
meteor - מעטעאָר m (meteor)
meteorologia - מעטעאָראָלאָגיע f (meteorologje)
meteorologiczny - מעטעאָראָלאָגיש (meteorologisz)
metoda - שיטה f (szith)
metro - אונטערבאַן f (unterban)
mewa - מעווע f (mewe)
miałki - אויבנאויפֿיק (ojbnojfik) | איבערפֿלעכלעך | אויבנאויפֿיק
Miami - מיאמי
mianownik - נאָמינאַטיוו m (nominatiw)
miara - מאָס f (mos)
miasto stołeczne - הויפּטשטאָט f (hojptsztot)
miau - מיאַו (mjau)
mieć - האָבן (hobn)
mieć dwie lewe ręce - ניט קענען אַ קאַץ דעם עק פֿאַרבינדן (nit kenen a kac dem ek farbindn)
mieć gdzieś - שעצן גרינג (szecn gring) | אַוועקקוקן (awekkukn) | ניט לייגן גענוג אַכט אויף (nit lejgn genug acht ojf)
mieć głowę na karku - האָבן אַ קאָפּ אויפֿן קאַרק
mieć gzik w kolanach - מורא האָבן (mojre hobn)
mieć miejsce - זײַן (zajn) | טרעפֿן זיך (trefn zich)
mieć muchy w nosie - האָבן פֿליגן אין דער נאָז (hobn flign in der noz)
mieć się na baczności - היטן זיך (hitn zich)
mieć w nosie - פֿײַפֿן
miecz - שווערד f (szwerd)
miedźwiedź - בער m (ber)
między - צווישן (cwiszn)
międzynarodowy - אינטערנאַציאָנאַל (internacjonal)
Międzyrzec Podlaski - מעזעריטש (Mezeritch)
miejski - שטאָטיש (sztotisz)
miękki - ווייך (wejch)
mielcuch - ביר n (bir)
mieli - האָבן (hobn)
mierzyć - אָנשטעלן (onszteln)
mieścić - זײַן (zajn)
miesiąc - מאָנאַט m (monat) | חודש m (chojdesz) | לבֿנה f (lewone)
miesiąc miodowy - האָניק־חודש m (honik-chojdesz)
miesiączek - לבֿנה f (lewone)
miesięcznik - חודשניק m (chojdesznik)
mięsień - מוסקל m (muskl)
mięsny - פֿליישיק (flejszik) | יאַטקע f (jatke)
mięso - פֿלייש n (flejsz)
mięsopustnik - פֿעברואַר m (februar) | קאַלט (kalt)
mieszkać - וווינען (wojnen)
mieszkanie - וווינונג f (wojnung) | דירה f (dire) | היים f (hejm)
mięta - מינץ f (minc)
miętki - ווייך (wejch)
mikrofon - מיקראָפֿאָן m (mikrofon)
mikrus - דאָס פֿערטל עוף n (dos fertl of)
militaryzm - מיליטאַריזם m
miło - ליב (lib)
miłość - ליבע f (libe) | ליבשאַפֿט
miłośnica - ליובאָווניצע f | מעטרעסע f | קאָכאַנקע f
miłośnik - ליבהאָבער m (libhober)
miły - ליב (lib)
mimo - ניט קוקנדיק / געקוקט אויף (nit kukndik / gekukt ojf) | לעבן (lebn) | ראָד n (rod)
mimochodem - פֿון דער גרינג (fun der gring)
mina - העוויה f (hawaje) | פּנים n (ponem)
minuta - מינוט f (minut)
miód - האָניק m (honik)
miód pitny - מעד m
miotać - שמיצן זיך (szmicn zich)
miotła - בעזעם m
miska - שיסל f (szisl)
mistrz - מײַסטער m (majster) | מומחה m (mumche)
mistycyzm - קבלה f (kabole)
miteser - פּיפּקעלע n
mleko - מילך f (milch)
młode - יונגוואַרג n (jungwarg)
młodość - יונגע יאָרן (junge jorn)
młody - יונג (jung)
młodzie - הייוון (hejwn)
młodzieniec - יונג m (jung)
młodzież - יונגוואַרג n (jungwarg)
młodziutki - בלוט יונג (blut jung)
mniej więcej - מער־ווייניקער (mer-wejniker) | קעגן (kegn)
mniemać - קלערן (klern)
mniemanie - שמועה f (szmue)
mnogdy - אָפֿט (oft)
moc - כּוח m (kojech)
móc - קענען (kenen) | מעגן (megn) | ניט טאָרן (nit torn)
mocny - שטאַרק (sztark)
modlić się - דאַוונען (dawnen) | תּפֿילה טאָן (tfile ton)
modlitwa - תּפֿילה f (tfile) | לייענען n (lejenen)
modrakowy - בלוי (bloj)
modry - בלוי (bloj)
modyfikować - איבערמאַכן (ibermachn)
modystka - פּוצערקע f | פּוצמאַכערין f
moher - מאָרע (more)
mój - מײַן (majn)
Mojżesz - משה
mokry - נאַס (nas)
mól - מאָל m (mol)
molo - מאָל m (mol)
Monachium - מינכן n (minchn)
monoteizm - מאָנאָטעיִזם m (monoteizm)
mora - מוט m (mut)
moralność - מאָראַל (moral)
mordownia - קנײַפּע
morela - אַפּריקאָס m (aprikos)
mors - ים־פֿערד n (jam-ferd)
morze - ים m (jam)
Morze Bałtyckie - באלטישער ים
Morze Śródziemne - מיטלענדישער ים m (mitlendiszer jam)
mosiądz - מעש n (mesz)
Moskwa - מאָסקווע (moskwe)
most - בריק f (brik)
mostek - בריקל n (brikl)
moszna - כּיס m
motyl - פֿלאַטערל n (flaterl) | באַבעטשקע f (babeczke) | באַבעלע n (babele)
motyw - מאָטיוו m (motiw)
Mount Everest - עווערעסט
mowa - רעדע f (rede) | צונג f (cung) | לשון n (loszn) | שפּראַך f (szprach)
mowa jest srebrem, a milczenie złotem - רעדן איז זילבער - שווײַגן איז גאָלד (redn iz zilber – szwajgn iz gold) | שיין שווײַגן איז שענער ווי שיין רעדן (szejn szwajgn iz szener wi szejn redn)
mówić - רעדן (redn) | זאָגן (zogn)
mówić, co ślina na język przyniesie - האַקן אַ טשײַניק (hakn a czajnik)
mówić na ty - דוצן (ducn)
mówić od rzeczy - האַקן אַ טשײַניק (hakn a czajnik)
może - קענען (kenen) | מעגן (megn) | ניט טאָרן (nit torn)
mózg - מוח m (mojech) | זשוזשען (żużen)
możliwość - מעגלעכקייט f (meglechkejt) | מיגלעכקייט f (miglechkejt) | פֿעיִקייט f (feikejt)
możliwy - מעגלעך (meglech) | מיגלעך (miglech)
można - מע קען (me ken) | מע מעג (me meg) | מע טאָר ניט (me tor nit)
mrówka - מוראַשקע f (muraszke)
mróz - פֿראָסט m (frost)
mruczeć - מרוקען | מורמלען
mrugać - פּינטלען (pintlen)
mrugnąć - געבן אַ פּינטל (gebn a pintl)
mućka - קו f (ku)
muczeć - מוקען (muken)
muł - עקשן (ekszn)
muraszka - מוראַשקע f (muraszke)
mus - קאָמפּאָט m (kompot)
musieć - מוזן (muzn) | דאַרפֿן (darfn)
muskuł - מוסקל m (muskl)
musztarda - מושטאַרדע f (musztarde) | זענעפֿט m (zeneft)
muzeum - מוזיי m (muzej) | מוזעום m (muzeum)
muzyka - מוזיק f (muzik)
my - מיר (mir)
myć - וואַשן (waszn)
mycka - יאַרמלקע f (jarmlke)
mydło - זייף f (zejf)
mykita - פֿוקס m (fuks)
mykwa - מיקווה f (mikwe)
myśl - געדאַנק m (gedank)
myśleć - טראַכטן (trachtn) | קלערן (klern)
mysz - מויז f (mojz)
myszka - מײַזל n (majzl)
mżawka - רעגנדל
nacisk - דרוק m (druk)
nacja - נאַציאָנאַליטעט f (nacionalitet)
nadawać - לאָזן זיך (lozn zich)
nadziany - רײַך (rajch)
nadzwyczajny - נסימדיק (nisimdik)
naelektryzować - עלעקטריזירן (elekrtizirn)
nagle - פּלוצעם (plucem)
nagroda - פּריז m (priz)
naiwność - נאַיִווקייט f
naiwny - נאַיוו
najpierw - ערשט (erszt) | צו(ם) ערשט (cu(m) erszt) | צום ערשטן (cum ersztn)
naleśnik - בלינצע f (blince)
należy - מען / מע דאַרף (men / me darf)
należycie - כּשר (koszer)
należyty - כּשר (koszer)
namawiać - איבעררעדן (iberredn)
namiętnie - תּאווהדיק (tajwedik)
namiętność - תּאווה f (tajwe)
namiętny - תּאווהדיק (tajwedik)
namiot - געצעלט n (gecelt)
naonczas - דעמלט (demlt) | דעמאָלט (demolt) | דאַן (dan) | בעת־מעשׂה (bejs-majse)
na pewno - אויף געוויס (ojf gewis) | אויף זיכער (ojf zicher) | מוזן (muzn)
napięcie - וואָלטאַזש m (woltaż)
na pierwszy rzut oka - אויפֿן ערשטן קוק (ojfn ersztn kuk)
naprawdę - טאַקע (take) | באמת (beemes) | אויף אַן אמת (ojf an emes) | אין דער אמתן (in der emesn)
naprzeciw - קעגן (kegn)
naradzać - איבעררעדן (iberredn) | האַלטן זיך אַן עצה (haltn zich an ejce)
na razie - לעת־עתּה (lesate)
narba - העפֿט m
narciarka - נאַרטלערין f (nartlerin)
narciarstwo - נאַרטלערײַ n (nartleraj)
narciarz - נאַרטלער m (nartler)
narodowość - נאַציאָנאַליטעט f (nacionalitet)
narodziny - געבורט (geburt) | געבוירן n (gebojrn)
narta - נאַרטע f (narte)
narząd - אָרגאַן m (organ)
narzędzie - מכשיר m (machszer)
narzekać - קלאָגן (klogn)
naśladować - נאָכמאַכן (nochmachn)
nastawić - אָנשטעלן (onszteln)
następny - צווייטער (cwejter)
na sto procent - אויף געוויס (ojf gewis) | אויף זיכער (ojf zicher) | מוזן (muzn)
nastrój - מוט m (mut)
na święty nigdy - ביז משיח וועט קומען (biz mesziech wet kumen) | אָפּלייגן אין דער לאַנגער באַנק אַרײַן (oplejgn in der langer bank arajn)
na szczęście - אַ נס וואָס…&rlm | (a nes wos…)
naszyjnik - האַלדזבאַנד f
natenczas - דעמלט (demlt) | דעמאָלט (demolt) | דאַן (dan) | בעת־מעשׂה (bejs-majse)
natręt - נודניק (nudnik) | כאָלערע (cholere)
natychmiastowy - אויגנבליקלעך
nauczać - לערנען זיך (lernen zich)
nauczyciel - לערער
nauka - וויסנשאַפֿט f (wisnszaft)
naukowiec - וויסנשאַפֿטלער m (wisnszaftler)
naukowy - וויסנשאַפֿטלעך (wisnszaftlech)
na wagę złota - מיט גאָלד גלײַך (mit gold glajch)
nawias - האַלבע לבֿנות (halbe lewones)
na wszelki wypadek - אויף יעדן פֿאַל (ojf jedn fal)
nawyk - געוווינהייט (gewonhejt) f
nawzajem - איינס דאָס צווייטע (ejns dos cwejte) | גם־אַתּם (gam-atem)
nazad - צוריק (curik)
nazajutrz - אויפֿן צווייטן טאָג (ojfn cwejtn tog) | אויף מאָרגן (ojf morgn) | אויף מאָרגנס (ojf morgns)
nazod - צוריק (curik)
nazwa - נאָמען m (nomen)
nazwa własna - פּרט־נאָמען m (prat-nomen)
nazwisko - נאָמען m (nomen) | פֿאַמיליע־נאָמען m (familje-nomen) | דײַטשער נאָמען m (dajczer nomen)
nazywać - אָנרופֿן (onrufn) | אַ נאָמען געבן / טאָן (a nomen gebn / ton) | הייסן (hejsn) | אָנרופֿן זיך (onrufn zich)
nazywać rzeczy po imieniu - אָנרופֿן דאָס קינד בײַם נאָמען (onrufn dos kind bajm nomen) | אָנרופֿן דאָס קינד מיטן נאָמען (onrufn dos kind mitn nomen)
n.e. - נ״ק
nędzny - הינטיש (hintisz)
negatywny - נעגאַטיוו (negatiw)
nekrolog - נעקראָלאָג
neodym - נעאָדימיום (neodimjum)
neologizm - נעאָלאָגיזם m (neologizm)
neptun - נעפּטוניום
nerka - ניר f (nir)
nerwowy - נערוועז
neutralność - נייטראַליטעט f
neutralny - נייטראַל
ni - ניין (nejn) | נישט (niszt)
nic - קיין זאַך (kejn zach) | גאָרנישט (gorniszt) | גאָרניט (gornit) | ממזר m (mamzer)
nić - פֿאָדעם m (fodem)
nicpoń - שייגעץ m (szejgec)
nicpota - שייגעץ m (szejgec)
nie - ניין (nejn) | נישט (niszt)
nie- - ניט (nit)
niebawem - באַלד
niebezpieczeństwo - סכּנה f (sakone)
niebieski - בלוי (bloj)
niebiosa - הימל m (himl) | די בלויע יאַרמלקע f (di bloje jarmlke)
niebo - הימל m (himl) | די בלויע יאַרמלקע f (di bloje jarmlke)
niech - זאָלן (zoln) | לאָז (loz)
niecierpliwie - אומגעדולדיק (umgeduldik)
niecierpliwość - אומגעדולד f (umgeduld)
niecierpliwy - אומגעדולדיק (umgeduldik)
niedbale - פֿון דער גרינג (fun der gring)
niedola - צרה f (core)
nieduch - קראַנקייט f (krankejt)
niedziela - זונטיק m (zuntik)
niedźwiedź - בער m (ber)
niegodziwiec - רשע m (rosze)
nieistotny - ממזר m (mamzer)
niełatwy - שווער
nie mieć - ניין (nejn) | נישט (niszt) | האָבן (hobn)
nie mieć bladego pojęcia - ניט האָבן קיין שום באַגריף (nit hobn kejn szum bagrif)
nie mieć zielonego pojęcia - ניט האָבן קיין שום באַגריף (nit hobn kejn szum bagrif)
niemoc - מענערשוואַכקייט f (menerszwachkejt) | אימפּאָטענץ f (impotenc)
nienagannie - כּשר (koszer)
nienawidzić - פֿײַנט האָבן
nie od razu Kraków zbudowano - די וועלט איז אויך ניט באַשאַפֿן געוואָרן אין איין טאָג (di welt iz ojch nit baszafn geworn in ejn tog) | משיח ווערט ניט אין איין נאַכט געבוירן געוואָרן (meszjech wert nit in ejn nacht gebojrn geworn) | ניט אין איין טאָג איז דער בית־המיקדש געבויט געוואָרן (nit in ejn tog iz der bejs-amigdesz gebojt geworn) | קראָקע איז ניט אין איין טאָג געבויט געוואָרן (kroke iz nit in ejn tog gebojt geworn)
nieokrzesany - גראָב (grob)
niepodległość - אומאָפּהענגיקייט f (umophengikejt) | זעלבסטשטענדיקייַט
niepodległy - אומאָפּהענגיק
niepokoić - באַאומרויִקן
nieprzydatny - צרה f (core)
nieprzytomny - פֿאַרחלשט (farchlszt)
nie puszczać pary z ust - שווײַגן ווי יורקעס הונט (szwajgn wi jurkes hunt)
nieść - טראָגן
niesłychanie - בלוטיק (blutik)
niesłychany - בלוטיק (blutik)
nieśmiało - שעמעוודיק (szemewdik)
nieśmiały - שעמעוודיק (szemewdik)
nieśmiertelny - אומשטאַרביק
niesprawiedliwie - אומגערעכט
niesprawiedliwość - אומיושר m (umjojszer)
nieszczęścia chodzą parami - אַ צרה קומט ניט אַליין (a core kumt nit alejn)
nieszczęście - צרה f (core) | צער m (car) | אומגליק n (umglik) | שלימזל n (szlimazl)
nieszczęśnik - שלימזל m
niewątpliwie - אָן שום ספֿק (on szum sofek) | קלאָר (klor)
niewiarygodny - נסימדיק (nisimdik)
niewiasta - פֿרוי f (froj)
niewiastka - שנור f (sznur)
niewidoczny - ניט צו זען (nit cu zen)
niewidzialny - ניט צו זען (nit cu zen)
niewolnik - שקלאַף m (szklaf)
nie wszystko złoto, co się świeci - ניט אַלץ וואָס גלאַנצט איז גאָלד (nit alc wos glanct iz gold)
niewypłacalny - באַנקראָט
niezależność - אומאָפּהענגיקייט
niezapominajka - פֿאַרגעסניטל (fargesnitl) n
niezdrowy - ניט־געזונט
niezgrabny - אומגעלומפּערט
nieźle - שיין (szejn)
nieznany - אומבאַקאָנט
niezwykle - בלוטיק (blutik)
nie-Żyd - גוי m (goj)
nigdy - קיין מאָל (kejn mol)
nigdzie - אין ערגעץ (in ergec)
nikaj - אין ערגעץ (in ergec)
nikczemny - הינטיש (hintisz)
nikiel - ניקל (nikl)
nikt - גאָרנישט m (gornisz) | גאָרניט m (gornit)
nim - ער (er) | עס (es)
nitka - פֿאָדעם m (fodem)
ni w pięć, ni w dziewięć - קלעפּן זיך ווי אַן אַרבעס אין וואַנט (klepn zich wi an arbes in want)
no - נו (nu) | אַזוי (azoj) | יאָ (jo)
nobel - נאָבעליום
noc - נאַכט f (nacht)
nocny - נאַכטיק (nachtik)
noga - פֿוס m (fus) | פֿוסבאָל m (fusbol)
nominować - נאָמינירן
nora - לאָך (loch) | נאָרע f (nore)
nos - נאָז f (noz) | אַלקאָהאָליקער m (alkoholiker)
nosiwoda - וואַסער־טרעגער m (waser-treger)
nostalgia - היימוויי m (hejmwej)
notes - סאָבילטאַזש
notować - פֿאַרצייכענען (farcejchenen)
nowina - שמועה f (szmue)
nowojorski - ניו־יאָרקער (nju-jorker)
nowy - נײַ (naj)
Nowy Jork - ניו־יאָרק (nju-jork)
Nowy Rok - נײַיאָר (najjor)
nóż - מעסער (mʻsʻr)
nuci - אונטערזינגען (unterzingen)
nucić - אונטערזינגען (unterzingen)
nudelkula - וואַלגערהאָלץ n (walgerholc)
nudelzupa - יויך f (jojch) | זופּ f (zup)
nudle - לאָקש m (loksz)
nudny - נודנע (nudne)
nudziarz - נודניק m (nudnik)
nuta - טאָן m (ton)
nyga - קאָמאַר m (komar)
nyra - חזיר m (chazer)
nyrol - חזיר m (chazer)
o - וועגן (wegn)
obcas - אָבצאַס) אָפּצאַס) m | קנאַפֿל m
obchodzić - יובֿלען (jojwlen) | באַגיין זיך (bagejn zich)
obecnie - איצט (ict) | לעת־עתּה (lesate) | הײַנט צו טאָג (hajnt cu tog) | הײַנט (hajnt)
obecność - אָנוועזנהייט (onweznhejt)
obejmować - אַרומנעמען (arumnemen) | האַלדזן (haldzn) | פֿאַרנעמען (farnemen)
obficie - רײַך (rajch)
obfitość - רײַכקייט f (rajchkejt)
obfity - רײַך (rajch)
obiad - אָנבײַסן n (onbajsn) | מיטאָג m (mitog) | וואַרמעס n (warmes)
obiecadło - אַלפֿאַבעט m (alfabet) | אַלף־בית m (alef-bejs)
obiecywać - פֿאַרזאָגן אַ צענטן (farzogn a centn)
obiekt - אָביעקט m (objekt)
obierać - שמײַסן (szmajsn) | האַקן (hakn) | קלאַפּן (klapn) | ווערן זיך (wern zich)
obietnica - צוזאָג
objaśniać - קלאָר מאַכן (klor machn)
oblicze - געזיכט n (gezicht) | פּנים n (ponem)
obłuda - צבֿיעות n
obmierzły - מיאוס (mies)
obnażać - אַנטבלויזן
obojętnie - בילע (bile)
obok - לעבן (lebn)
obóz - לאַגער m (lager)
obracać - אַרומדרייען (arumdrejen) | ראָלן (roln) | אַרומדרייען זיך (arumdrejen zich) | ראָלן זיך (roln zich)
obraz - בילד n (bild) | שירמע f (szirme) | פֿאָרשטעלונג f (forsztelung) | אימאַזש m (imaż) | פֿילם m (film)
obraza - באַליידיקונג
obrażać - טרעפֿן (trefn)
obręcz - אָבאָד m (obod)
obrobienie - באַאַרבעטונג f
obróbka - באַאַרבעטונג f (baarbetung)
obrok - אָבראָק m (obrok)
obrona - פֿאַרטיידיקונג f (fartejdikung) | שמירה f (szmire) | אָבאָראָנע f (oborone)
obrót - אָבאָראָט m (oborot)
obserwacja - באַטראַכטונג f (batrachtung)
obserwować - באַטראַכטן (batrachtn)
obsesja - שליטה f
obszerny - פֿאַרנעמיק (farnemik)
obwiniać - באַשולדיקן (baszuldikn)
oby - זאָלן (zoln)
obyczaj - קבלה f (kabole)
ocean - אָקעאַן m (okean)
Ocean Atlantycki - אַטלאַנטיק m (atlantik)
Ocean Spokojny - פּאַציפֿיק m (pacifik) | פּאַציפֿישער אָקעאַן m (pacifiszer okean) | שטילער אָקעאַן m (sztiler okean)
ocena - שאַץ m (szac)
ocet - עסיק m (esik)
och - װײ
ochota - גערנקייט ,באַגער ,חשק
ochrona - באַשיצונג f (baszicung) | שוץ f (szuc) | שמירה f (szmire) | לײַבוואַך f (lajbwach)
ochroniarz - לײַבוועכטער m
ociec - פֿאָטער m (foter) | טאַטע m (tate)
ociupina - פּינדיוריק m (pindjurik)
oczodół - אויגנלאָך m
oczyszczać - קלערן (klern)
oczywiście - אַוודאי (awade)
oczywisty - קענטיק (kentik) | קלאָר (klor)
od - זינט (zint) | פֿון זינט (fun zint)
odbijać - דרוקן (drukn)
odbywać - זײַן (zajn)
odchody - דאָס m (dos)
odchodzić - אַוועקשפּאַנען
odcień - ניואַנס m (njuans)
odcinać - אָפּהאַקן (ophakn)
odcisk palca - פֿינגערדרוק m (fingerdruk)
odczytywać - זאָגן (zogn)
oddawać - איבערגעבן (ibergebn) | איבערגעבן זיך (ibergebn zich)
ode - זינט (zint) | פֿון זינט (fun zint)
Odessa - אַדעס f
odkąd - זינט (zint)
odkładać - קלײַבן (klajbn)
odkurzacz - שטויבמאַשין f (sztojbmaszin)
odmawiać - דאַוונען (dawnen) | זאָגן (zogn)
odmiana - בייגונג f (bejgung) | פֿלעקסיע f (fleksje) | זגאַל m (zgal)
od niechcenia - פֿון דער גרינג (fun der gring)
odnosić - האָבן צו (hobn cu)
odnośnie - וועגן (wegn)
odnośnie do - וועגן (wegn)
odpadek - וואַגן (wagn)
odpieprzyć - קושן אין תּחת (kuszn in toches)
odporność - אויסהאַלט־כּוח m (ojshalt-kojech)
odpowiadać - ענטפֿערן (entfern)
odpowiedź - ענטפֿער (entfer) m
odpowiedzialność - פֿאַראַנטוואָרטלעכקייט (farantwortlechkejt) | אַחריות (achrius) | אחריות (chrius)
odrębny - באַזונדער
odszczepieniec - גוי m (goj)
odtąd - פֿון איצט אָן (fun ict on) | להבא (lehabe)
odwaga - מוט m (mut)
odzyskiwać - צוריקקריגן (curikkrign)
ogień - פֿײַער m (fajer)
ogier - אָגער m (oger)
oglądać - באַטראַכטן (batrachtn)
oglądanie - באַטראַכטונג f (batrachtung)
ogon - עק m (ek)
ogórek - אוגערקע f (ugerke)
ograniczony - גראָב (grob)
ogród - גאָרטן m (gortn)
ogrodzenie - צאַם (cam) | צאָם (com) | צוים (cojm)
ogromny - מעכטיק (mechtik)
ohydny - הינטיש (hintisz)
ojciec - פֿאָטער m (foter) | טאַטע m (tate)
Ojcze nasz - אונדזער פֿאָטער m (undzer foter)
ojczyc - זון m (zun)
ojczym - שטיפֿפֿאָטער m (sztiffoter)
ojczyzna - היימלאַנד n (hejmland) | היים f (hejm)
ojla - סאָווע f
okazale - רײַך (rajch) | גרויסאַרטיק (grojsartik)
okazały - מעכטיק (mechtik) | רײַך (rajch) | גרויסאַרטיק (grojsartik)
okno - פֿענצטער m (fencter)
oko - אויג n (ojg)
około - קעגן (kegn)
okop - אַקאָפּע f (akope) | גראָבן m (grobn)
okres - פּעריאָד m (perjod) | צײַט f (cajt)
okresowy - פּעריאָדיש (perjodisz)
okręt podwodny - סובמארין
okropny - שרעקלעך (szreklech)
okrucieństwo - אַכזריות (achzrjus)
okrutny - אַכזריותדיק (achzorjesdik)
okrycie - אייבערבגד m (ejberbeged)
oksza - האַק f (hak)
okulary - ברילן (briln)
okulary przeciwsłoneczne - זונברילן (zunbriln)
okulista - אויגן־דאָקטער m
olbrzymi - מעכטיק (mechtik)
olcha - אָלכע f (olche)
olej - אייל m
oliwa - בוימל m (bojml)
ołówek - בלײַער m (blajer)
ołtarz - אַלטאַר m (altar) | מזבח m (mizbejech)
oma - באָבע f
omawiać - איבעררעדן (iberredn)
omieszkać - ניין (nejn) | נישט (niszt)
on - ער (er)
ona - זי (zi)
oni - זיי (zej)
ono - עס (es)
ONZ - פֿ״פֿ f (fej fej)
opanowanie - שליטה f
oparcie - ספּינע f (spine)
opieka - שמירה f (szmire)
opiekować się - היטן (hitn)
opiekun - היטער m (hiter)
opierać - ווערן זיך (wern zich)
opinia - שמועה f (szmue) | נאָמען m (nomen)
opium - אָפּיום m (opjum)
opłakać - באַטרויערן (batruiern)
opłakiwać - באַטרויערן (batruiern)
opona - רייף ,גומערייף
opowiadać - דערציילן (dercejln)
oprócz tego - הײַנט (hajnt)
optymizm - אָפּטימיזם m
opuszczać - לאָזן (lozn)
orać - אַקערן | האָרעווען (horeven)
oraz - און (un)
ordynarny - גראָב (grob)
organ - אָרגאַן m (organ)
organizacja - אָרגאַניזאַציע f (organizacje) | אָרגאַניזירן n (organizirn)
Organizacja Narodów Zjednoczonych - די פֿאַראייניקטע פֿעלקער (farejnikte felker)
organy - אָרגל m (orgl)
orgazm - אָרגאַזם m (orgazm)
orientalny - אָריענטאַליש
Ormianin - אַרמענער (armener)
ormiański - אַרמעניש (armenisz)
oryginalność - אָריגינעלקייט f
orzeł - אָדלער m (odler)
osa - וועספּ f (wesp)
osioł - אייזל m (ejzl) | גראָבער קאָפּ m (grober kop)
osłupiały - פֿאַרשטיינעטר (farsztejnetr)
osoba - פּערזאָן f (perzon)
Osobłoga - האָצ׳פּלאָץ (hoc'ploc)
ośrodek - צענטער m (center)
ostrężyna - אָזשענע f (ożene)
ostry - שאַרף (szarf)
ostrzyć - שלײַפֿן (szlajfn)
ostrzyć sobie zęby - שאַרפֿן זיך די ציינער ( שאַרפֿן די ציינער) (szarfn (zich) di cejner)
Oświęcim - אוישוויץ (ojszwic)
oszczerstwo - באַריידערײַ f | רכילות n | בילבול m
otchłań - תּהום m (thom) | אָפּגרונט m (opgrunt)
otucha - מוט m (mut)
otwarty - אָפֿן (ofn)
otyły - גראָב (grob)
owad - אינסעקט m (insekt)
owal - אָוואַל m
owca - שאָף f (szof) | שעפּס m (szeps)
o wilku mowa - מע זאָל דערמאָנען משיח (me zol dermonen mesziech)
o wilku mowa, a wilk tu - מע זאָל דערמאָנען משיח (me zol dermonen mesziech)
o wilku mowa, a wilk tuż - מע זאָל דערמאָנען משיח (me zol dermonen mesziech)
owoc - אויבס n (ojbs) | אויבסט n (ojbst) | אויפּס n (ojps) | אויפּסט n (ojpst) | אויפּסן (ojpsn)
owocowy - פֿרוכטיק (fruchtik)
ożyna - אָזשענע f (ożene)
pacan - בהמה f (behejme) | דאָס m (dos) | חכם m (chochem)
pachniarz - נאָז f (noz)
pacholę - יונג m (jung)
paciuk - שטשור m (szczur) | ראַץ m (rac)
Pacyfik - פּאַציפֿיק m (pacifik) | פּאַציפֿישער אָקעאַן m (pacifiszer okean) | שטילער אָקעאַן m (sztiler okean)
padać - רעדן (redn) | זאָגן (zogn)
pajac - פּאַיאַץ m (pajac)
pająk - שפּין (szpin)
pajęcznik - סעפּטעמבער m (september) | אָקטאָבער m (oktober) | נאָוועמבער m (nowember)
Pakistan - פּאַקיסטאַן (pakistan)
pakli - לאָז (loz)
pakować - פּאַקן (pakn)
pała - פּעניס m (penis) | מענלעכער אבֿר m (menlecher ejwer)
palcem nie kiwnąć - ניט קענען אַ קאַץ דעם עק פֿאַרבינדן (nit kenen a kac dem ek farbindn)
pale - פּעניס m (penis) | מענלעכער אבֿר m (menlecher ejwer)
palec - פֿינגער m (finger)
paliwo - ברענוואַרג
pallad - פּאַלאַדיום (paladjum)
palma - פּאַלמע f (palme)
palto - אייבערבגד m (ejberbeged)
paluch - גראָבער פֿינגער m (grober finger)
pamiątka - אָנדענק m (ondenk)
pamięć - זכּרון m (zikorn) | אָנדענק m (ondenk)
pan - רב m (reb)
Pan - אדוני m (adonaj)
pana - רייף ,גומערייף
Pan Bóg - אדוני m (adonaj)
pancerz - פּאַנצער m (pancer)
pani - פֿרוי (froj)
panienka - פּאַניענקע f
pan młody - חתן m
panna - יונגפֿרוי f (jungfroj) | מויד f (mojd)
Panna - בתולה f (bsule)
panować - זײַן (zajn)
pantera - לעמפּערט m (lempert)
papierośnica - פּאָרטציגאַר m (portcigar)
papier toaletowy - אַשר־יצר־פּאַפּיר | קלאָזעט־פּאַפּיר
papież - פּויפּס m (pojps)
paplanina - שלח־מנות (sz(a)lachmones)
paproć - פֿעדערגראָז n (federgroz)
papuć - שוך m (szuch)
papuga - פּאָפּוגײַ m (popugaj)
para - פּאָרל n (porl) | פּאָר (por)
paradygmat - פּאַראַדיגמע f (paradigme)
parafia - פּאַראַפֿיע f (parafje)
paralelny - פּאַראַלעל (paralel)
park - פּאַרק m (park)
parkan - צאַם (cam) | צאָם (com) | צוים (cojm)
parlament - פּאַרלאַמענט m (parlament) | כּנסתּ f (kneset)
Parlament Europejski - אייראָפּעיִשער פּאַרלאַמענט m (ejropeiszer parlament)
parochija - פּאַראַפֿיע f (parafje)
partia - פּאַרטיי f (partej) | פּאַרטיע f (partje)
partykuła - פּאַרטיקל m (partikl)
parytet - פּאַריטעט f (paritet)
Paryż - פּאַריז (pariz)
parzyć - פֿאַרבריִען (farbrien)
pasażer - פּאַסאַזשיר m (pasażir)
paser - פּאַסער m (paser)
pasja - לײַדנשאַפֿט f (lajdnszaft)
paskudny - פּאַסקודנע (paskudne) | הינטיש (hintisz)
pasować - פּאַסן (pasn) | פֿאַרבײַפֿאַרן (farbajfarn)
pasożyt - פּאַראַזיט m (parazit)
pas startowy - סטאַרטפּאַס m (startpas)
pasta do zębów - צאָנפּאַסטע
pasterka - פּאַסטעכין f (pastechin)
pastuszka - פּאַסטושקע f (pastuszke)
pątnik - פּילגרים m (pilgrim) | עולה m (ojle)
patria - היימלאַנד n (hejmland) | היים f (hejm)
patrzałki - ברילן (briln)
patrzeć - קוקן (kukn)
patrzyć - קוקן (kukn)
październik - אָקטאָבער m (oktober)
paździerzeń - אָקטאָבער m (oktober)
paznokieć - נאָגל m (nogl)
pazur - נאָגל m (nogl)
pazura - האַנט f (hant)
pchać - שטופּן (sztupn) | שטעכן (sztechn) | שטופּן זיך (sztupn zich)
pchła - פֿלוי (floj) m
pchnąć - אַ שטופּ טאָן (a sztup ton)
pchnięcie - שטופּ m (sztup) | שטאָך m (sztoch)
pechowiec - שלימזלניק m | שלימזל n
pechowy - שלימזלדיק
pedał - פּעדאַל m (pedal) | טרעטל m (tretl)
pedryl - פּעדאַל m (pedal) | טרעטל m (tretl)
pędzić - כאַפּן (chapn)
pejs - פּאה f (ph)
pekator - פּעניס m (penis) | מענלעכער אבֿר m (menlecher ejwer)
pełny - פֿול (ful)
peniak - פּחדן m (pachdn) | טכויר m (tchojr)
penis - פּעניס m (penis) | מענלעכער אבֿר m (menlecher ejwer)
pentagon - פֿינפֿעק m (finfek)
pępek - פּופּיק m (pupik) | נאָפּל m (nopl)
perfumy - פּאַרפֿום m | פּאַרפֿומע f
perka - בולבע
perła - פּערל m (perl)
Persja - פּערסיע (persie)
perski - פּערסיש (persisz)
persona - פּערזאָן f (perzon)
petent - אינטערעסאַנט m (interesant)
petronelka - משה־רבנוס קיִעלע n (mojsze-rabejnes kiele) | משיחל n (mesziechl)
petycja - בקשה f (bakosze)
pewnie - אַ פּנים (a ponem)
piana - פּינע f (pine) | ביר n (bir)
pianino - פּיאַנע f (piane)
pianista - פּיאַניסט m (pianist)
piano - פּינע f (pine)
piasek - זאַמד n (zamd)
piąta kolumna - פֿינפֿטע קאָלאָנע f (finfte kolone)
piątek - פֿרײַטיק m (frajtik)
piec - אויוון m (ojwn) | באַקן (bakn)
pięćdziesięciolecie - יובֿל m (jojwl)
pięciokąt - פֿינפֿעק m (finfek)
Pięcioksiąg - חומש m
pieczara - הייל f (hejl)
pieczarka - אַגאַריק (agarik)
pieczeń - געבראָטנס | אינטערעס m (interes) | דאָס m (dos)
pieg - זומער־שפּרענקל n (zumer-szprenkl) | קלײַען (klajen)
piekarz - בעקער m (beker) | פּיעקער m (pieker)
piekło - גיהנום n (gehenem)
pięknie - שיין (szejn)
piękność - יפֿת־תּואר f
piękny - שיין (szejn)
pielgrzym - פּילגרים m (pilgrim) | עולה m (ojle)
pieniądz - געלט n (gelt)
pieprz - פֿעפֿער m (fefer)
pieprzyć - טרענען (trenen)
pierdolić - טרענען (trenen)
pierdy - שמועה f (szmue) | שלח־מנות (sz(a)lachmones)
piernik - פֿעפֿער־קוכן m (fefer-kuchn) | האָניק־לעקעך m (honik-lekech)
pieróg - קרעפּל n
pierogi - קרעפּל n
pierwsza pomoc - גיכע הילף f (giche hilf)
pierwsza wojna światowa - ערשטע וועלט־מלחמה f (erszte welt-milchome)
Pierwszy Maja - דער ערשטער מײַ m (der erszter maj)
pierwyj - ערשט (erszt) | צו(ם) ערשט (cu(m) erszt) | צום ערשטן (cum ersztn)
pies - הונט m (hunt)
pięść - פֿויסט f
pięściarstwo - באָקס m (boks)
pieścić - לאַשטשען | פּיעסטען | פּיעשטשען
piesek - הינטל n (hintl)
pieski - הינטיש (hintisz)
pieśń - ליד n (lid) | זינגליד n (zinglid) | פּיעסניע f (pjesnje)
pies ogrodnika - אַ הונט אויף היי (a hunt ojf hej)
pietruszka - כּרפּס m (krps) | פּעטרישקע f (petriszke)
pietruziel - כּרפּס m (krps) | פּעטרישקע f (petriszke)
pigularz - אַפּטייקער m (aptejker)
pijawa - רעגן־בויגן m (regn-bojgn)
pijawka - פּיאַווקע
pikawa - האַרץ n (harc)
piła - זעג (zeg) f
piłka nożna - פֿוטבאָל m (futbol) | פֿוסבאָל m (fusbol)
pilnować - היטן (hitn) | זען (zen) | היטן זיך (hitn zich)
piorun - בליץ (blits)
piosenka - ליד n (lid) | זינגליד n (zinglid)
pisać - שרײַבן (szrajbn) | דרוקן (drukn) | דרוקן זיך (drukn zich)
pisarz - שרײַבער m (szrajber) | שריפֿטשטעלער m (szriftszteler)
pisemnie - בכּתבֿ
pisklę - פֿייגעלע n (fejgele)
pismo - שריפֿט f (szrift) | די שוואַרצע פּינטעלעך (di szwarce pintelech) | אַלפֿאַבעט m (alfabet) | אַלף־בית m (alef-bejs)
pistacja - פֿיסטאַשקע f (fistaszke)
pistolet - פּיסטאָלעט m (pistolet)
Pitagoras - פּיטאַגאָראַס m (pitagoras)
piterka - טײַסטער m | בײַטל n | פּאָליאַרעס m | פּוליאַרעס m
Pittsburgh - פּיטסבורג (pitsburg)
piwnica - קעלער m (keler)
piwo - ביר n (bir)
pizgać - וואַרפֿן (warfn) | שמיצן זיך (szmicn zich) | כאַפּן זיך (chapn zich) | לאָזן זיך (lozn zich) | שמײַסן (szmajsn) | האַקן (hakn) | קלאַפּן (klapn) | ווערן זיך (wern zich)
piznąć - טאָן / געבן אַ קלאַפּ (ton / gebn a klap) | אַ האַק טאָן (a hak ton) | געבן (gebn)
pizza - פּיצע f (pice)
plac - פּלאַץ m (plac) | סקווער m (skwer)
płaca - פּיידע (pejde) | לוין (luin)
plajster - האָניקשויבן (honikszojbn)
plakat - פּלאַקאַט m (plakat)
plamka - שפּרענקל n (szprenkl) | פּינטל n (pintl)
planeta - פּלאַנעט m (planet)
planować - קלערן (klern)
planta - געוויקס n (gewiks)
plaster - האָניקשויבן (honikszojbn)
płaszcz - אייבערבגד m (ejberbeged)
płaszczyć - קריכן אונטער די נעגל (krichn unter di negl)
Platforma Obywatelska - בירגערלעכע פּלאַטפֿאָרם f (birgerleche platform)
płatność - אײַנצאָלונג f (ajncolung) | צאָלונג f (colung) | אײַנצאָל m (ajncol)
platynki - צירונג
plecak - רוקזאַק m (rukzak)
plecy - פּלייצע f (plejce)
plemię - שבֿט m (szejwet)
pleść, co ślina na język przyniesie - האַקן אַ טשײַניק (hakn a czajnik)
płot - צאַם (cam) | צאָם (com) | צוים (cojm)
plotka - שמועה f (szmue) | שלח־מנות (sz(a)lachmones)
plotkarka - יענטע f (jente) | קיפּלערין f (kiplerin)
plotkarz - קיפּלער m (kipler)
pluć - שפּײַען (szpajen) | פֿײַפֿן (fajfn)
plucha - פּליוכע f
pluskwa - וואַנץ
pluton - פּלוטאָניום
płyn - פֿליסיקייט f (flisikejt)
płyta - דיסק m (disk)
płytki - אויבנאויפֿיק (ojbnojfik)
p.n.e. - פֿ״ק
pobożny - פֿרום (frum)
pobudzać - סטימולירן (stimulirn)
pocałować w dupę - קושן אין תּחת (kuszn in toches)
pocałunek - קוש m (kusz)
pochodzenie - ייִחוס m (jiches)
pochodzić - קומען (kumen)
pochwa - וואַגינע f (wagine) | מוטערשייד f (muterszejd)
pociąg - באַן f (ban) | צוג m (cug)
pocić się - שוויצן (szwicn)
pociecha - נחמה f (nechome)
pocieszenie - נחמה f (nechome)
początek - אָנהייב m (onhejb)
początkowo - צו(ם) ערשט (cu(m) erszt) | צום ערשטן (cum ersztn)
początkowy - ערשטער (erszter)
poczta - פּאָסט f (post)
poczynać - געבוירן (gebojrn)
pod - אונטער (unter) | קעגן (kegn)
podać - איבערגעבן (ibergebn)
podanie - בקשה f (bakosze)
podatkowy - שטײַערדיק
podążać - לאָזן זיך (lozn zich)
podbródek - קין m (kin)
podchodzić - אונטערגיין (untergejn)
podciąć skrzydła - אָפּהאַקן די פֿליגל (ophakn di fligl)
podczas - בעת (bejs)
podczas gdy - בעת (bejs)
poddać - איבערגעבן (ibergebn) | אונטערוואַרפֿן (unterwarfn) | איבערגעבן זיך (ibergebn zich) | אונטערוואַרפֿן זיך (unterwarfn zich)
pode - אונטער (unter) | קעגן (kegn)
podejrzenie - חשד m
podeszwa - זויל f (zojl) | פּאַדעשווע f (padeszwe) | פּיאַטע f (piate)
podkoszulek - לײַבל n (lajbl)
podkoszulka - לײַבל n (lajbl)
podkowa - פּאָדקעווע f (podkewe)
podległy - אונטערגעוואָרפֿן (untergeworfn)
podłoga - פּאָדלאָגע f (podloge)
podły - הינטיש (hintisz)
podniebienie - גומען m (gumen)
podnieta - שטופּ m (sztup)
podobać się - ליב זײַן (lib zajn)
podobieństwo - ענלעכקייט f (enlechkejt)
podobnie - ענלעך (enlech)
podobno - זאָלן (zoln)
podobny - ענלעך (enlech) | געגליכן (geglichn)
podomka - באָדכאַלאַט m (borchalat)
podówczas - דעמלט (demlt) | דעמאָלט (demolt) | דאַן (dan) | בעת־מעשׂה (bejs-majse)
podpałka - קין m (kin)
podpis - חתימה f (chsime) | אונטערשריפֿט f (unterszrift) | קעפּל n (kepl)
podpisywać - אונטערשרײַבן (unterszrajbn) | אונטערשרײַבן זיך (unterszrajbn zich)
podpity - אונטערן גלעזל (untern glezl)
podręcznik - האַנטבוך n (hantbuch) | לערנבוך n (lernbuch) | הילפֿבוך n (hilfbuch)
podróż - נסיעה f (nesije) | וועג m (weg)
podrzucać - אונטערוואַרפֿן (unterwarfn)
podrzutek - אונטערגעוואָרפֿן קינד n (untergeworfn kind)
podstawek - טעצל n (tecl)
podstawka - טעצל n (tecl)
podstawówka - פֿאָלקשול f (folkszul)
podstawowy - קנופּיק (knupik)
podstęp - מאַניפֿאָרגע f (maniforge)
podświadomie - אונטערבאַוווּסטזיניק (unterbawustzinik)
podszewka - אונטערשלאַק m (unterszlak)
poduszka - קישן m (kiszn)
podwładny - אונטערגעוואָרפֿן (untergeworfn)
podwójny - טאָפּל (topl) | צוויייִק (cwejik) | צווייענדיק (cwejendik)
pod wpływem - אונטער אײַנפֿלוס
podzielić - צעשנײַדן (cesznajdn)
poeta - פּאָעט m (poet) | דיכטער m (dichter)
poezja - פּאָעזיע f | דיכטונג f
poganin - פּאַגאַנער m (paganer)
pogański - פּאַגאַניש (paganisz)
pogląd - קוק m (kuk)
pogłoska - שמועה f (szmue)
pogoda - וועטער m (weter)
pogodny - קלאָר (klor)
pogranicze - גרענעצלאַנד n (grenecland)
poić - פּויען
pojedynczy - איינציק (ejncik)
pojmować - כאַפּן (chapn)
pojutrze - איבער מאָרגן (iber morgn)
pokaźny - פֿאַרנעמיק (farnemik) | שיין (szejn)
poker - פּאָקער m (poker)
pokojowo - אין גוטן מוט (in gutn mut)
pokwitowanie - קבלה f (kabole)
pół - האַלבן (halbn)
połączenie - שײַכות n (szajches) | פֿאַרבינדונג f (farbindung) | פֿאַרבונד m (farbund)
Polak - פּאָליאַק m (poljak)
polecać - לאָזן (lozn)
poleku - פּאַמעלעך (pamelech)
polepszać - בעסער ווערן (beser wern)
polewka - זופּ f (zup)
policja - פּאָליציי f (policej)
policzek - בעקל n (bekl) | באַק f (bak)
poliglota - שפּראַכן־קענער m (szprachn-kener)
poligrafia - דרוקערײַ f (drukeraj)
polityczny - פּאָליטיש (politisz)
polityk - פּאָליטיקאַנט m (politikant)
polityka - פּאָליטיק f (politik)
Polka - פּאָלקע f (polke)
półksiężyc - האַלבע לבֿנה f (halbe lewone)
północ - האַלבע נאַכט f (halbe nacht) | צפֿון m (cofn)
Północ - צפֿון m (cofn)
połóg - האָבן n (hobn)
polon - פּאָלאָניום (polonjum)
Polska - פּוילן n (pojln)
polski - פּויליש (pojlisz)
półtora - אָנדערטהאַלבן (onderthalbn)
półtorej - אָנדערטהאַלבן (onderthalbn)
półtrzecia - דריט האַלבן (drit halbn)
półudenyk - אָנבײַסן n (onbajsn) | מיטאָג m (mitog) | וואַרמעס n (warmes)
południe - מיטאָג m (mitog) | האַלבער טאָג m (halber tog) | דרום m (dorem)
Południe - דרום m (dorem)
półwysep - האַלבאינדזל m (halbindzl)
połykać - שלינגען (szlingen) | זופּן (zupn)
połysk - גלאַנץ m (glanc)
pomagać - העלפֿן (helfn) | זײַן צו הילף (zajn cu hilf)
pomarańcza - מאַראַנץ m
pomarańczowy - אָראַנזש (oranż)
pomidor - פּאָמידאָר m (pomidor) | טאָמאַט m (tomat)
pomiędzy - צווישן (cwiszn)
pomijać - אויסלאָזן (ojslozn)
pomimo - ניט קוקנדיק / געקוקט אויף (nit kukndik / gekukt ojf)
pomoc - הילף f (hilf)
pomocnik - יונג m (jung) | לערנייִנגל n (lernjingl)
pomysłowy - קינצלעך
ponadto - הײַנט (hajnt)
poniedziałek - מאָנטיק m (montik)
ponieważ - ווײַל (wajl) | וואָרן (worn) | מחמת (machmes)
pono - זאָלן (zoln)
ponoć - זאָלן (zoln)
pop - פּאָפּ m (pop)
popielaty - פּאָפּעליאַטע (popeljate)
popielniczka - אַשטעצל n (asztecl)
popiół - אַש n (asz)
popioły - אַש n (asz)
popołudnie - נאָכמיטאָג m (nochmitog)
poprawny - אמת (ms)
popularny - פּאָפּולער (populer)
por - פּאָרע f (pore)
porada - עצה f (ejce)
pora roku - צײַט פֿון יאָר f (cajt fun jor)
porcelana - פּאָרצעלײַ n (porcelaj)
porcelano - פּאָרצעלײַ n (porcelaj)
porcja - פּאָרציע
poród - האָבן n (hobn)
porównanie - פֿאַרגלײַך m
portfel - טײַסטער m | בײַטל n | פּאָליאַרעס m | פּוליאַרעס m
portugalski - פּאָרטוגייזיש
porucznik - לייטענאַנט (lejtenant)
poruta - חרפּה f | בושה f | שאַנד f | בזיון m
porządnie - כּשר (koszer) | שיין (szejn)
porządny - כּשר (koszer) | שיין (szejn)
porzeczka - ווײַמפּערל n (wajmperl)
pościć - פֿאַסטן
posesor - בעל־הבית m (balebos)
posiadać - האָבן (hobn)
posiadłość - פּאָסעסיע f
posługiwać - באַגיין זיך (bagejn zich)
posłuszeństwo - הכנעה f (hachnoe)
posowa - באַלקן m (balkn)
pośpiech - יאָגעניש n | אײַלעניש n
pospolity - סקאַרבאָווע (skarbowe)
poświęcać - איבערגעבן זיך (ibergebn zich)
pot - שווייס (szwejs)
potępiać - פֿאַרדאַמען (fardamen)
potężny - מעכטיק (mechtik) | פֿאַרנעמיק (farnemik)
potmanyj - טײַסטער m | בײַטל n | פּאָליאַרעס m | פּוליאַרעס m
potrafić - קענען (kenen)
potrzeba - נויט f (nojt)
potrzebizna - נויט f (nojt)
potrzebować - דאַרפֿן (darfn) | נייטיק האָבן ,באַנייטיקן זיך אין
potwierdzenie - קבלה f (kabole)
potwierdzić - באַשטעטיקן (basztetikn) | אוטווערדזשען (utwerdżen)
potwór - פֿאַרזעעניש n (farzeenisz)
pouczać - באַלערן (balern)
poufny - אויגאויפֿאויגיק (ojgojfojgik)
poważać - אַכטן (achtn)
powiadać - דערציילן (dercejln)
powiedzenie - ווערטל n
powiedziałeś A, powiedz B - ווער עס זאָגט אַלף, מוז זאָגן בית (wer es zogt alef, muz zogn bejs)
powiedzieć - זאָגן (zogn)
powieka - ברעם (brem) f
powierzchnia - אייבערפֿלאַך f (ejberflach) | אויבנאויף m (ojbnojf) | שפּיגל m (szpigl)
powierzchowny - איבערפֿלעכלעך | אויבנאויפֿיק
powieść - ראָמאַן m (roman)
powieściopisarz - ראָמאַנטיסט m
powiestka - צאָמיס m | נאָמען m (nomen)
powieszenie - הענגאַקט m (hengakt) | הענגונג f (hengung)
powietrze - לופֿט f (luft)
powinien - דאַרפֿן (darfn) | זאָלן (zoln)
powodować - לאָזן (lozn)
powoli - פּאַמעלעך (pamelech) | מע מעג (me meg) | מע טאָר ניט (me tor nit)
powstanie - פּאָווסטאַניע (powstanie) | אויפֿשטאַנד (ojfsztand)
powstanie warszawskie - וואַרשעווער אויפֿשטאַנד m (warszewer ojfsztand)
powtarzać - איבערחזרן (iberchzrn)
pożądać - באַגערן (bagern)
pożądanie - תּאווה f (tajwe)
poza tym - הײַנט (hajnt)
pozawczoraj - אייערנעכטן (ejernechtn)
poziom - שטאַפּל (sztapl)
poziomka - פּילעניצע f (pilenice)
Poznań - פּױזן (Poyzn)
późno - שפּעט (szpet)
pozór - אַכט f (acht) | איי (ej)
pozostały - פֿאַרבליבן
pozostawiać - לאָזן (lozn)
pozować - אָנשטעלן זיך (onszteln zich)
pozwalać - לאָזן (lozn)
pożyczać - באָרגן (borgn) | אַוועקלײַען (aweklajen)
pożyczka - באָרג | הלוואה
pożywienie - עסן n (esn)
praca - אַרבעט f (arbet) | ווערק n (werk)
praca domowa - היימאַרבעט f (hejmarbet)
prącie - פּעניס m (penis) | מענלעכער אבֿר m (menlecher ejwer)
pracodawca - באַשעפֿטיקער m (baszeftiker)
Praga - פּראָג (prog)
pragnąć - באַגערן (bagern) | וועלן (weln)
pragnienie - דאָרשט m (dorszt) | באַגער m (bager)
prawa człowieka - מענטשנרעכט n (mencznrecht)
prawa ręka - רעכט (recht) | גערעכט (gerecht) | יושרדיק (jojszerdik) | כּשר (koszer) | האַנט f (hant)
prawda - אמת m (emes) | גערעכט (gerecht)
prawda w oczy kole - דער אמת שטעכט די אויגן (der emes sztecht di ojgn)
prawdopodobnie - אַ פּנים (a ponem) | דאַרפֿן (darfn)
prawdziwie - אמת
prawie - כּמעט (kimat)
prawnik - יוריסט m (jurist)
Prawo i Sprawiedliwość - געזעץ און גערעכטיקייט f (gezec un gerechtikejt)
prawość - גערעכטיקייט f (gerechtikejt) | יושר m (jojszer)
prawowicie - כּשר (koszer)
prawowity - כּשר (koszer)
prawy - רעכט (recht) | גערעכט (gerecht) | יושרדיק (jojszerdik) | כּשר (koszer)
prazeodym - פּראַזעאָדימיום (prazeodimjum)
prędko - שנעל (sznel) | געשווינד (geszwind) | גיך (gich)
premier - פּרעמיער m (premier)
premiera - פּרעמיערע f (premjere)
presja - דרוק m (druk)
prezent - געשאַנק n (geszank) | מתּנה f (matone) | פּרעזענט m (prezent)
prezerwatywa - קאָנדאָם m (kondom)
prezydent - פּרעזידענט m (prezident)
prezydentura - פּרעזידענטשאַפֿט f (prezidentszaft)
prima aprilis - פּרימאַ־אַפּריליס m (prima-aprilis) | ערשטער אַפּריל (erszter april)
próba - רעפּעטיציע f (repeticje) | פּראָבע f (probe) | פּרוּוו m (pruw)
problem - פּראָבלעם f (problem) | צרה f (core) | אַ האַרב / שווער לייענען (a harb / szwer lejenen)
problematyczny - פּראָבלעמאַטיש (problematisz)
próbować - פּרוּוון (pruwn) | פּרובירן (prubirn) | פֿאַרזוכן (farzuchn)
procent - פּראָצענט m (procent)
procesja - פּראָצעסיע f
proch - פּראָשיק m (proszik) | פּולווער m (pulwer) | שטויב (sztojb)
proch strzelniczy - פּולווער m (pulwer)
prochy - אַש n (asz)
produkcja - פּראָדוקציע
profit - פּראָפֿיט m (profit) | רווח m (rewech)
próg - גרענעץ (grenec)
projekt - פּראָיעקט m (projekt)
prom - פּראָם f (prom)
promet - פּראָמעטיום (prometjum)
promień - שטראַל m (sztral) | ראַדיוס m (radius)
proroctwo - נבֿואה f (newue)
proroczy - נבֿיאיש (newiisz)
prorok - נבֿיא m (nowi)
prorokini - נבֿיאה f (newie)
prośba - בקשה f (bakosze)
prosić - בעטן (betn)
prostacki - גראָב (grob)
prostak - גראָבער פֿליגל m (grober fligl)
prosto - גראָב (grob)
prostota - עניוות n (aniwes)
prosty - גראָב (grob)
prostytucja - זנות m (znus) | פּראָסטיטוציע f (prostitucje)
prostytutka - פּראָסטיטוטקע f (prostitutke)
proszę - ביטע
proszek - פּראָשיק m (proszek)
protaktyn - פּראָטאַקטיניום
protein - ווײַסל n (wajsl) | ווײַסלשטאָף m (wajslsztof)
proteina - ווײַסל n (wajsl) | ווײַסלשטאָף m (wajslsztof)
prowokacja - פּראָוואָקאַציע f (prowokacje)
prowokować - פּראָוואָצירן (prowocirn) | צערייצן (cerejcn)
próżnia - וואַקוּום m (wakuum)
pruć - טרענען (trenen)
prymitywny - גראָב (grob)
prynuka - שטופּ m (sztup)
pryszcz - פּיפּקעלע n
prysznic - דוש m (dusz)
przać - ליבן (libn) | ליב האָבן (lib hobn) | קאָכען זיך (kochen zich)
przebaczać - פֿאַרגעבן (fargebn)
przebytek - וווינונג f (wojnung) | דירה f (dire) | היים f (hejm)
przebywać - זײַן (zajn) | אַרומדרייען זיך (arumdrejen zich)
przeciąć - צעשנײַדן (cesznajdn)
przeciąg - צוג m (cug)
przeciągać strunę - איבערציִען דאָס שטריקל (ibercien dos sztrikl)
przecinek - קאָמע f (kome)
przeciw - קעגן (kegn)
przeciwciało - אַנטיקערפּער m (antikerper)
przeciwko - קעגן (kegn)
przed - פֿאַר (far) | ערבֿ (erew)
przeddzień - ערבֿ (erew)
przede - פֿאַר (far) | ערבֿ (erew)
przede wszystkim - דער עיקר (der iker) | דערעיקרשט (derikerszt) | קודם־כּל (kojdem-kol) | צום (אַלעם) ערשטן (cum (alem) ersztn)
przedimek - אַרטיקל m (artikl)
przedkładać - בעסער וועלן (beser weln)
przedpołudnie - פֿאַרמיטאָג m (farmitog)
przedwczesny - צופֿריִיִק
przedwczoraj - אייערנעכטן (ejernechtn)
przeglądać - קוקן זיך (kukn zich)
przejechać - איבערפֿאָרן
przejrzysty - קלאָר (klor)
przekątna - דיאַגאָנאַל m (djagonal) | אַלכסון m (alachsn)
przekazywać - איבערגעבן (ibergebn)
przekładać - איבערזעצן (iberzecn)
przekonanie - שמועה f (szmue)
przekonywać - איבעררעדן (iberredn)
przekształcać - איבערמאַכן (ibermachn)
przeliczać - איבערציילן (ibercejln)
przemoc - גוואַלד f (gwald) | בגוואַלד (bigwald)
przemożność - כּוח m (kojech)
przemysł - אינדוסטריע f
przemyt - שמוגל m
przenośnia - מעטאַפֿאָר m (metafor)
przepraszam - מוחל זײַן (mojchl zajn)
przerywać - אָפּהאַקן (ophakn)
przesądny - אָבערגלייביש
przesadzać - איבערזעצן (iberzecn) | מגזם זײַן (megazem zajn) | מאַכן פֿון אַ פֿליג אַ העלפֿאַנד (machn fun a flig a helfand)
przesiadać się - איבערזעצן זיך (iberzecn zich)
przeskakiwać - איבערשפּאַען
przestarzały - אַלטמאָדיש (altmodisz)
przestawać - אַרומדרייען זיך (arumdrejen zich)
przestrzegać - היטן (hitn)
przeszłość - פֿאַרגאַנגענהייט f (fargangenhejt) | אַמאָל m (amol)
przeważność - מוט m (mut)
przewinienie - חטא m (chet)
przewodnik - פֿירער m (firer) | וועגווײַזער m (wegwajzer) | מדריך m (madrech) | דורכפֿירער m (durchfirer)
przez - פֿון וועגן (fun wegn)
przeze - פֿון וועגן (fun wegn)
przeznaczenie - לאָז m (loz)
przezroczysty - קלאָר (klor)
przeźroczysty - קלאָר (klor)
przoć - ליבן (libn) | ליב האָבן (lib hobn) | קאָכען זיך (kochen zich)
przybijać - צוקלאַפּן (cuklapn)
przychodzić - קומען (kumen)
przyglądać się - באַטראַכטן (batrachtn)
przyjaciel - חבֿר m (chawer)
przyjaciółka - ליובאָווניצע f | מעטרעסע f | קאָכאַנקע f
przyjebać - טאָן / געבן אַ קלאַפּ (ton / gebn a klap) | אַ האַק טאָן (a hak ton) | געבן (gebn)
przyjemnie - ליב (lib)
przyjemny - ליב (lib)
przykazanie - געבאָט n
przykład - משל (moszl)
przykrość - צרה f (core)
przymiotnik - אַדיעקטיוו m (adjektiw)
przymrozek - געפֿריר n (gefrir)
przymus - צוואַנג m (cwang) | דרוק m (druk)
przynosić - אײַנטראָגן (ajntrogn)
przypadek - בייגפֿאַל m (bejgfal) | פֿאַל m (fal)
przypatrywać się - באַטראַכטן (batrachtn)
przypominać - דערמאָנען (dermonen) | זײַן ענלעך / געגליכן (zajn enlech / geglichn) | האָבן אַ פּנים פֿון (hobn a ponem fun)
przysłówek - אַדווערב m (adwerb)
przysłowie - שפּריכוואָרט n (szprichwort)
przysługa - טובֿה (tuwh) f
przystanek - אָפּשטעל m (opsztel)
przyszłość - וועט־זײַן m (wet-zajn) | צוקונפֿט f (cukunft) | מאָרגן m (morgn)
przyszły - מאָרגנדיק (morgndik) | צווייטער (cwejter)
przytcza - משל (moszl) | בייגפֿאַל m (bejgfal) | פֿאַל m (fal)
przytomność - אָנוועזנהייט (onweznhejt)
przywoływać - דערמאָנען (dermonen)
przyzwoity - לײַטיש
psalm - מיזמור m (mizmer) | תּהילים n (tilim) | קאַפּיטל n (kapitl)
pseudonim - פּסעוודאָנים m (psewdonim)
psi - הינטיש (hintisz)
psiaczek - הינטעלע n (hintele)
psiak - הינטל n (hintl)
psiarnia - פּאָליציי f (policej)
psisko - הונט m (hunt)
psiuk - הינטל n (hintl)
pstrąg - פֿאָרעל f (forel)
psychiatra - פסיכיאטר m (psichiater) | פּסיכיאַטער m (psichjater)
psychiatria - פסיכיאטריה f (psichiatria) | פּסיכיאַטריע f (psichjatrje)
psychiczny - פּסיכיש (psichisz) | גײַסטיק (gajstik)
psycholog - פּסיכאָלאָג m (psicholog)
psychologia - פּסיכאָלאָגיע f (psichologie)
pszczoła - בין f (bin)
pszenica - ווייץ m (wejc)
ptak - פֿויגל m (fojgl) | פּעניס m (penis) | מענלעכער אבֿר m (menlecher ejwer)
ptaszę - פֿויגל m (fojgl) | פּעניס m (penis) | מענלעכער אבֿר m (menlecher ejwer)
ptaszek - פֿייגעלע n (fejgele) | דאָס m (dos) | פֿויגל m (fojgl)
ptyś - בליצשלעסל n (blicszlesl)
publikacja - דרוק f (druk)
publikować - דרוקן (drukn) | דרוקן זיך (drukn zich)
puchowy - פּוכאָווע | פּוכען
pudel - פּודל m (pudl)
pudełko - פּודעלע n (pudele)
puder - פּודרע f | פּודער m
pugilares - טײַסטער m | בײַטל n | פּאָליאַרעס m | פּוליאַרעס m
puginał - שטעכמעסער (sztechmeser)
pukać - קלאַפּן (klapn) | שיסן
pukieltasia - רוקזאַק m (rukzak)
pułap - באַלקן m (balkn)
pulares - טײַסטער m | בײַטל n | פּאָליאַרעס m | פּוליאַרעס m
pularysek - טײַסטער m | בײַטל n | פּאָליאַרעס m | פּוליאַרעס m
Puławy - פּולאַוו (pulaw)
pultok - אינדיק m (indik)
pumeks - פּימס m (pims)
punkt - פּונקט m (punkt) | פּינטל n (pintl) | פּינטעלע n (pintele) | פּונקט (punkt)
punktualnie - פּונקט (punkt)
punkt widzenia - קוק m (kuk) | זעפּונקט m (zepunkt)
pupa - דאָס m (dos)
Purim - פּורים m (purim)
purpurowy - פּורפּעלן (purpeln)
Purym - פּורים m (purim)
pustka - פּוסטעניש n | פּוסטקייט f | חלל m
pusty - חכם m (chochem)
pustynia - מידבר m (midber)
puszczać - לאָזן (lozn) | לאָזן זיך (lozn zich)
puszka - פּושקע f (puszke) | ביר n (bir)
puter - אינדיק m (indik)
putnia - עמער (emer)
pynzyjo - פּענסיע f (pensje)
pyra - בולבע
pysk - פּיסק m (pisk)
pyta - פּעניס m (penis) | מענלעכער אבֿר m (menlecher ejwer)
pytanie - פֿרעג m (freg)
rąbać - האַקן (hakn)
rąbek - זוים | נאָזטיכל n (noztichl)
rabin - רבֿ m (row) | רבי m (rebe)
rachować - ציילן (cejln) | קוקן (kukn)
raciądz - ריטער m (riter)
racja - גערעכט (gerecht)
raczek - ראַקל n (rakl)
rad - ראַדיום (radjum)
rada - עצה f (ejce)
radio - ראַדיאָ m (radio)
radocha - פֿרייד f (frejd) | פֿאַרגעניגן n (fargenign) | שׂימחה f (simche) | יובל m (jubl)
radość - פֿרייד f (frejd) | פֿאַרגעניגן n (fargenign) | שׂימחה f (simche) | יובל m (jubl)
radować się - יובלען (jublen)
radzić - איבעררעדן (iberredn) | אַן עצה געבן זיך (an ejce gebn zich)
raj - גן־עדן m (gan-ejdn)
rajza - נסיעה f (nesije) | וועג m (weg) | אויספֿלוג ,עקסקורסיע
rajzer - וואַגאַבונד m (wagabund) | וואַנדערער m (wanderer) | שלעפּער m (szleper)
rak - ראַק m (rak)
Rak - ראַק m (rak)
rakarz - היצעל m (hicel)
rakuski - עסטרײַכיש (estrajchisz)
ramię - אָרעם m (orem)
rana - וווּנד f (wund)
ranek - אין דער פֿרי (in der fri) | אינדערפֿרי m (inderfri)
rano - אין דער פֿרי (in der fri) | אינדערפֿרי m (inderfri)
raptem - ראַפּטום
rasowy - ראַסנדיק (rasndik)
raz - איין מאָל (ejn mol) | פֿאַל m (fal)
razdziawa - וואָראָן m (woron) | ראָב m (rob) | קראָ f (kro)
razem - יחדיו (jachdew)
raz na sto lat - איין מאָל אין אַ יובֿל (ejn mol in a jojwl)
realizm - רעאַליזם m
Rebeka - רבקה f (riwka)
ręcznik - האַנטעך (hantech)
ręczyć - ערבֿ זײַן (orew zajn)
redakcja - רעדאַקציע f
redaktor - רעדאַקטאָר m
regularny - רעגולער (reguler)
regulować - אָנשטעלן (onszteln)
ręka - האַנט f (hant)
rękawica - הענטשקע f (henczke)
rękawiczka - הענטשקע f (henczke)
rekin - הײַפֿיש (hayfysh) m
rekrut - רעקרוט m (rekrut)
religia - רעליגיע f (religje)
ren - רעניום (renium) | רעניפֿער m (renifer)
renifer - רעניפֿער m (renifer)
renoma - נאָמען m (nomen)
Republika Czeska - טשעכישע רעפּובליק f (czechisze republik) – טשעכיע
reputacja - נאָמען m (nomen)
restauracja - רעסטאָראַן m (restoran)
restaurator - רעסטאָראַטאָר m (restorator)
rewolucja - רעוואָלוציע f (rewolucje)
rezolucja - רעזאָלוציע (rezolucie)
robić - מאַכן (machn) | טאָן (ton)
robić na drutach - שטריקן (sztrikn)
robić z igły widły - מאַכן פֿון אַ פֿליג אַ העלפֿאַנד (machn fun a flig a helfand)
robić z muchy słonia - מאַכן פֿון אַ פֿליג אַ העלפֿאַנד (machn fun a flig a helfand)
robieniec - אַרבעטער m (arbeter)
robot - ראָבאָט m (robot) | גולמאַט m (gojlemat)
robótka - געשטריקעכץ m
robotnik - אַרבעטער m (arbeter)
rocznica - יובֿל m (jojwl)
rod - ראָדיום (rodjum)
ród - משפּחה f (miszpoche)
rodzaj nijaki - דריטער מין m (driter min)
rodzajnik - אַרטיקל m (artikl)
rodzic - טאַטע־מאַמע (tate-mame) | עלטערן (eltern)
rodzić - געבוירן (gebojrn) | האָבן (hobn) | געבוירן ווערן (gebojrn wern)
rodzina - משפּחה f (miszpoche)
rodzynek - ראָזשינקע f (rożinke)
rodzynka - ראָזשינקע f (rożinke)
róg - עק m (ek)
rogacizna - גרויסע) בהמה) f ((grojse) behejme)
rój - רוי m (roj)
rok - יאָר n (jor) | האַלב קליידל n (halb klejdl)
rolnictwo - לאַנדווירטשאַפֿט f | ערדאַרבעט
rolnik - פּויער m (pojer)
romantyczny - ראָמאַנטיש
romantyzm - ראָמאַנטיק
rosa - טוי m (toj)
Rosja - רוסלאַנד (rusland)
roślina - געוויקס n (gewiks)
roso - טוי m (toj)
rosół - יויך f (jojch)
rouza - רויז f (rojz)
rów - גראָבן m (grobn)
rower - ראָווער m (rower)
równanie - גלײַכונג f (glajchung)
również - אויך (oych)
równik - עקוואַטאָר m (ekwator)
równocześnie - בעת־מעשׂה (bejs-majse)
równoległy - פּאַראַלעל (paralel)
róża - רויז f (rojz)
rozbieżność - דיווערגענץ f (diwergenc)
rozciąć - צעשנײַדן (cesznajdn)
rozczarowanie - אַנטוישונג f (antojszung)
rozdrażnienie - צעזעצעניש f (cezecenisz)
rozdział - קאַפּיטל
rozdzielać - אָפּטיילן | פֿאַרטיילן | פֿונאַנדערשיידן | טיילן
rozdzielić - צעשנײַדן (cesznajdn)
rozgwieżdżony - אויסגעשטערנט (ojsgeszternt)
rozkład jazdy - פֿאָרפּלאַן m
rozkoszować się - מחיה זײַן (mechaje zajn) | לאָבן זיך (lobn zich)
rozmowny - באַריידעוודיק
rozmyślać - טראַכטן (trachtn) | באַטראַכטן (batrachtn) | באַטראַכטן זיך (batrachtn zich) | קלערן (klern)
rozmyślanie - באַטראַכטונג f (batrachtung)
różnojęzyczny - עטלעך־שפּראַכיק (etlech-szprachik)
różnojęzykowy - עטלעך־שפּראַכיק (etlech-szprachik)
różnorodny - פֿאַרשיידנדיק (farszejdndik)
różny - פֿאַרשיידן (farszejdn)
różowy - ראָז (roz)
rozpatrywać - באַטראַכטן (batrachtn) | קלערן (klern) | וועגן (wegn)
rozpatrywanie - באַטראַכטונג f (batrachtung)
rozrywka - פֿאַרווײַלונג
rozsądny - רעסאָנדנע (resondne) | חכם m (chochem)
rozsierdzie - בייז n | גרימצאָרן m | צאָרן m | כּעס m
rozstrzygnięcie - אויסלאָז m
roztomaity - פֿאַרשיידן (farszejdn)
rozum - פֿאַרשטאַנד
rozumieć - פֿאַרשטיין (farsztejn)
rozumny - חכם m (chochem)
rozważać - באַטראַכטן (batrachtn) | קלערן (klern) | וועגן (wegn)
rozważanie - באַטראַכטונג f (batrachtung)
rozważny - חכם m (chochem)
rozwiązanie - עצה f (ejce) | האָבן n (hobn)
rubel - פֿויגל m (fojgl)
rubid - רובידיום (rubidjum)
rubież - גרענעצלאַנד n (grenecland)
ruchliwy - באַוועגלעך
rucho - קלייד n (klejd)
rudny - רויט (rojt) | קאָמוניסט
rum - ראָם m (rom)
rumianek - רומיאַנעק m
ruski miesiąc - אַ שאָק מיט יאָרן (a szok mit jorn)
ruten - רוטעניום (rutenjum)
rutherford - רוטערפֿאָרדיום
rutyna - רוטין f (rutin)
ryba - פֿיש m (fisz)
Ryby - פֿיש m (fisz)
ryć - גראָבן (grobn) | שטעכן (sztechn)
rycerz - ריטער m (riter)
rychtig - טאַקע (take) | גערעכט (gerecht)
rychtyk - טאַקע (take) | גערעכט (gerecht) | פּונקט (punkt)
ryczka - טאַבורעט m (taburet)
rymarz - שאָרניק m (szornik)
rynka - טאָפּ m (top)
rywal - קאָנקורענט
ryż - רײַז (rajz)
rząd - רעגירונג f (regirung) | ראָנד m (rond)
rzadny - ברידקע (bridke)
rzeciądz - קייט f (kejt)
rzeczownik - סובסטאַנטיוו m (substantiw)
rzeczownik własny - פּרט־נאָמען m (prat-nomen)
rzeczownik zbiorowy - קאָלעקטיוו m
rzeczywiście - טאַקע (take) | גערעכט (gerecht)
rzemieślnik - בעל־מלאָכה m (balmeloche) | האַנטווערקער m (hantwerker)
rzemiosło - מלאָכה f (meloche)
rzęsa - ברעמען
Rzeszów - רײַשע (rajsze)
rzeź - שחיטה
rzeźnia - סאַלהאָן (salhon) | שלאַכטהויז n (szlachthuiz) | סקאָטאָבויניע f (skotobuinie)
rzić - תּחת m (toches)
rzucać - וואַרפֿן (warfn) | שמיצן זיך (szmicn zich) | כאַפּן זיך (chapn zich) | לאָזן זיך (lozn zich)
rzucać się w oczy - וואַרפֿן זיך אין די אויגן (warfn zich in di ojgn)
rzut oka - קוק m (kuk)
rzykać - דאַוונען (dawnen) | תּפֿילה טאָן (tfile ton)
Rzym - רוים n (rojm)
rzymski - רוימיש (rojmisz)
sabotaż - סאַבאָטאַזש m (sabotaż)
sabotować - סאַבאָטירן (sabotirn)
Sąd Ostateczny - יום־הדין m (jom-hadin)
sądzić - קלערן (klern)
sadzielnik - קוימען־קערער m (kojmen-kerer)
sagan - סאַגאַן m (sagan) | טשײַניק m (czajnik)
saksofon - סאַקסאָפֿאָן m (saksofon)
salamandra - סאַלאַמאַנדרע f (salamandre)
salami - סאַלאַמי m (salami)
sałata - טאַקסי (taksi)
sam - אַליין (alejn) | גופֿא (gufe)
samar - סאַמאַריום
samo - אַליין (alejn) | גופֿא (gufe)
samobójca - זעלבסטמערדער m (zelbstmerder)
samobójstwo - אַליינמאָרד m (alejnmord) | זעלבסטמאָרד m (zelbstmord)
samogłoska - וואָקאַל m (wokal) | נקודה f (nekude)
samolot - אַעראָפּלאַן m (aeroplan)
samotny - איינזאַם ,עלנט
samowar - סאַמאָוואַר m
Samuel - שמואל m
sandał - סאַנדאַל m (sandal) | צינדלהאָלץ n (cindlholc) | צינדל n (cindl)
sarkazm - סאַרקאַזם m (sarkazm)
sarnapa - זשיראַף m (żiraf)
sąsiad - שכן m (szochn)
sąsiadować - גרענעצן זיך (grenecn zich)
satelita - סאַטעליט m (satelit) | לבֿנהלע n (lewonele)
Saturn - סאַטורן (saturn)
satyra - סאַטירע f
śćdza - סטעשקע f (steszke) | וועגל n (wegl) | וועגעלע n (wegele) | שטעג m (szteg)
scena - סצענע f (scene) | בינע f (bine) | סצענע f
sceptycyzm - סקעפּטיציזם m
schyłek - אונטערגאַנג m (untergang)
ściana - וואַנט
ścieg - שטאָך m (sztoch)
ścięgno - שפּאַנאָדער f
ścierka - סציערקע f (scierke)
ścierwo - שטשערווע f (szczerwe)
ścieżka - סטעשקע f (steszke) | וועגל n (wegl) | וועגעלע n (wegele) | שטעג m (szteg)
ścinać - אָפּהאַקן (ophakn)
ściśle - ענג (eng)
scyzoryk - מעסערל n (meserl)
śdza - סטעשקע f (steszke) | וועגל n (wegl) | וועגעלע n (wegele) | שטעג m (szteg)
se - זיך (zich)
seaborg - סיבאָרגיום
sedno - טרעפֿן אין פּינטל (trefn in pintl)
sejf - סייף m (sejf)
Sejm - סיים m (sejm)
sękaty - סוקעוואַטע (sukewate)
sekretarz - שרײַבער m (szrajber)
seksualny - געשלעכטיק (geszlechtik) | סעקסועל (seksuel)
selen - סעלעניום (selenjum)
seler - סעלעריע f (selerje)
semicki - סעמיטיש
sen - שלאָף m (szlof) | חלום m (cholem)
serce - האַרץ n (harc)
serdce - האַרץ n (harc)
serwatka - סיראָוואָטקע f | סראָוועטקע f
sezon - סעזאָן m (sezon)
sfinks - ספֿינקס (sfinks)
sfrustrowany - פֿרוסטרירט
si - דער (der)
siano - היי n (hej)
siarka - שוועבל (szwebl)
siatkówka - נעצבאָל m (necbol) | נעצהײַטל n (nechajtl)
się - זיך (zich) | עס (es) | מען/מע (me)/(men)
siebie - זיך (zich)
siec - שמײַסן (szmajsn)
sieć - נעץ f (nec)
sieczeń - פֿעברואַר m (februar)
Siedlce - שעדליץ (Shedlits)
siedzenie - דאָס m (dos)
siedzieć - זיצן (zicn)
siedzieć na jajach - אַוועקזיצן (awekzicn)
siekać - האַקן (hakn)
siekiera - האַק f (hak)
sierp - סערפּ m | f | שערפּ m
sierpień - אויגוסט m (ojgust)
sikać - פּישן
siła - כּוח m (kojech)
siłą - בגוואַלד (bigwald)
silno - זייער (zejer)
silny - שטאַרק (sztark)
Singapur - סינגאַפּור (singapur)
siniak - סיניאָק m
sinus - סינוס m (sinus)
siodłak - פּויער m (pojer)
sioło - דאָרף n (dorf)
siostra - שוועסטער f (szwester)
siostrzenica - פּלימעניצע f (plimenice)
sipa - לאָפּעטע f (lopete)
sirpień - אויגוסט m (ojgust)
sitko - מיקראָפֿאָן m (mikrofon)
siurać - פּישן
skała - פֿעלדז m (feldz) | שטיין m (sztejn)
skamieniałość - פֿאָסיל
skandalista - סקאַנדאַליסט
skąpiec - חזיר m (chazer)
skarb - שאַץ m (szac) | גאָלד n (gold)
skarpeta - סקאַרפּעט m (skarpet)
skiba - גנבֿה m (ganejwe)
skibać - גנבֿענען (ganwenen)
skład - קראָם f (krom) | קעלער m (keler) | באַלקן m (balkn)
sklep - קראָם f (krom) | קעלער m (keler) | באַלקן m (balkn)
sklepikarz - קרעמער m (kremer)
skomplikowany - קאָמפּליצירט (komplicirt)
skończony - ענדיקן (endikn)
Skop - באַראַן
skopowina - שעפּסנס n (szepsns)
Skorpion - סקאָרפּיאָן (skorpion)
skot - פֿיך n (fich) | גרויסע) בהמה) f ((grojse) behejme)
skra - פֿונק m (funk)
skraj - גרענעץ (grenec)
skrajnie - בלוטיק (blutik)
skrajny - בלוטיק (blutik)
skromność - באַשיידנקייט f (baszejdnkejt) | הכנעה f (hachnoe) | עניוות n (aniwes)
skroń - שלייף f (szlejf)
skryba - שרײַבער m (szrajber) | סופֿר m (sojfer)
skrzydło - פֿליגל m (fligl)
skrzynia - אָרון m | סקריניע
skrzynka pocztowa - פּאָסטקעסטל n
skrzypce - פֿידל m (fidl)
skrzypek - פֿידלער m (fidler)
skuteczny - עפֿעקטיוו
słabość - שוואַכקייט f | שלאַפֿקייט f | מיחוש m
ślad - שפּור f (szpur) | פֿוסדרוק m (fusdruk) | סליד m (slid) | זכר m (zejcher)
sładnie - גרינג (gring) | שיין (szejn)
ślamazara - בלײַענער פֿויגל m (blajener fojgl)
slang - סלענג m (sleng)
śląski - שלעזיש (szlezisz)
sława - נאָמען m (nomen)
śledź - הערינג m (hering) | שניפּס m (sznips) | קראַוואַט m (krawat) | אויסבינדער m (ojsbinder)
śledzić - אויסקוקן (ojskukn) | באַטראַכטן (batrachtn)
śledziona - מילץ
ślepiec - בלינד (blind)
ślepucha - הון f (hun)
ślepy - בלינד (blind)
ślicznie - שיין (szejn)
śliczny - שיין (szejn)
ślimak - פּוילע־רוילע f (pojle-rojle) | שנעק m (sznek)
ślips - שניפּס m (sznips) | קראַוואַט m (krawat) | אויסבינדער m (ojsbinder)
śliwa - פֿלוימענבוים m (flojmenbojm)
śliwka - פֿלוים f (flojm)
słodki - זיס (zis)
słoń - העלפֿאַנד m (helfand)
słońce - זון f (zun)
słonecznik - זונרויז f (zunrojz)
słowa - וואָרט n (wort)
słowik - סאָלאָוויי m (solowej)
słownik - ווערטערבוך (werterbuch)
słowo - וואָרט n (wort)
ślubny - כּשר (koszer)
słuchać - הערן (hern)
słuchalnia - אוידיטאָריע f (ojditorje)
sługa - דינער m
słup - סלופּ m (slup)
ślusarz - שלאָסער m
słusznie - גערעכט (gerecht)
słuszny - גערעכט (gerecht)
służąca - מויד f (mojd)
słyszeć - הערן (hern)
smaczny - געשמאַק (geszmak)
smak - געשמאַק m (geszmak) | טעם m (tam)
smakować - פֿאַרזוכן (farzuchn)
smarkacz - פּינדיוריק m (pindjurik)
smażonka - פּרעזשעניצע f (preżenice)
smętny - אומעטיק (umetik)
śmiałość - מוט m (mut)
śmieć - וואַגן (wagn)
śmierć - טויט m (tojt)
śmierdolić - שטינקען (sztinken)
śmierdzieć - שטינקען (sztinken)
śmierdziuch - פּינדיוריק m (pindjurik)
śmietana - סמעטענע f (smetene)
smok - שמאָק m (szmok) | פּיפּערנאָטער m (pipernoter)
smutniak - ברויט n (brojt)
smycz - הונטרימען m (huntrimen) | שטריקל n (sztrikl)
smysł - פֿאַרשטאַנד | חוש m (chosz)
snecha - שנור f (sznur)
śniadanie - פֿרישטיק m (frisztik) | איבערבײַסן n (iberbajsn)
śnić - חלומען (cholemen)
śnieg - שניי (sznej)
snoci - זאָלן (zoln)
sobą - זיך (zich)
sobaczy - הינטיש (hintisz)
sobaka - הונט m (hunt)
sobie - זיך (zich)
soból - סויבל m
sobota - שבת m (szabes)
socjalista - סאָציאַליסט
socjalistyczny - סאָציאַליסטיש (socjalistisz)
socjalizm - סאָציאַליזם m (socializm)
soczewka - גלעזל n (glezl)
soczysty - זאַפֿטיק (zaftik)
sód - נאַטריום (natrjum)
sojusznik - אַליִיִרטער m
sok - זאַפֿט m (zaft) | סאָק m (sok)
sól - זאַלץ f (zalc)
sola - ים־צונג f (jam-cung)
solidarność - סאָלידאַריטעט f (solidaritet) | שאָלידאַרישקייט f (solidariszkejt)
somsiad - שכן m (szochn)
Sopot - סאָפּאָט
sopran - סאָפּראַן m (sopran)
sos - סאָוס m (sous) | סאָס m (sos) | בראָטיויך f (brotjojch)
sosna - סאָסנע f (sosne)
sowa - סאָווע f
sowiecki - סאָוועטיש
spać - שלאָפֿן (szlofn)
spacer - שפּאַציר m (szpacir)
spadać - פֿאַלן (faln) | טרעפֿן (trefn)
spadanie - פֿאַל m (fal)
specjalista - מומחה m (mumche) | קענער m (kener)
spekulant - פּערעקופּשטשיק m (perekupszczik)
spichlerz - שפּײַכלער m
spichrz - שפּײַכלער m
śpieszyć - כאַפּן (chapn)
śpiew - געזאַנג n (gezang)
śpiewać - זינגען (zingen)
śpiewnik - לידערבוך n (liderbuch)
spinka - שפּאָנקע f (szponke) | ספּינקע f (spinke)
spis rzeczy - אינהאַלט m
spis treści - אינהאַלט m
spodek - טעצל n (tecl)
spódnica - האַלב קליידל n (halb klejdl)
spoglądać - קוקן (kukn)
spojrzeć - טאָן / געבן אַ קוק (ton / gebn a kuk)
spojrzenie - קוק m (kuk) | אַרויסקוק m (arojskuk)
spółgłoska - קאָנסאָנאַנט m
sporo - שיין (szejn)
spory - שיין (szejn)
sposób - אופֿן m (ojfn) | עצה f (ejce)
spostrzec - זען (zen)
spotykać - טרעפֿן (trefn) | טרעפֿן זיך (trefn zich) | זען זיך (zen zich)
spóźniać się - פֿאַרשפּעטיקן (farszpetikn) | פֿאַרשפּעטיקן זיך (farszpetikn zich)
spragniony - דאָרשטיק
sprawa - אינטערעס m (interes)
sprawiać - לאָזן (lozn)
sprawiedliwie - גערעכט (gerecht) | יושרדיק (jojszerdik)
sprawiedliwość - גערעכטיקייט f (gerechtikejt) | יושר m (jojszer)
sprawiedliwy - גערעכט (gerecht) | יושרדיק (jojszerdik)
Sprawiedliwy wśród Narodów Świata - חסידי־אומות־העולם (chside-umes-hoojlem)
sprawiedlność - גערעכטיקייט f (gerechtikejt) | יושר m (jojszer)
spróbować - פֿאַרזוכן (farzuchn)
sprzedawać - פֿאַרקויפֿן (farkojfn)
sprzedawca - פֿאַרקויפֿער m (farkojfer)
sprzedawczyni - פֿאַרקויפֿערין f (farkojferin)
sprzyjać - באַגינסטיקן
spylać - אַנטלויפֿן ,אַוועקלויפֿן
srać - קאַקן (kakn)
sraczka - דורכפֿאַל m (durchfal)
sraka - דורכפֿאַל m (durchfal) | תּחת m (toches) | דאָס m (dos)
srebrna - זילבער (zilber)
srebrny - זילבער (zilber)
srebro - זילבער (zilber)
średnik - פּינטל־קאָמע f (pintl-kome)
średnio - דורך ס׳באַנק (durch s’bank)
średniowiecze - מיטל־עלטער m (mitl-elter)
środa - מיטװאָך m (mitwoch)
środek - צענטער m (center) | אינעווייניק m (inewejnik) | עצה f (ejce)
środkowy - מיטל (mitl)
środowisko - סבֿיבֿה f (swiwe)
śródziemnomorski - מיטלענדיש (mitlendisz)
śródziemny - מיטלענדיש
śrubokręt - שרויפֿן־ציִער m (szrojfn-cier)
śrupać - בײַסן (bajsn) | גריזשן (griżn)
ssać - זויגן (zojgn) | סמאָקטשען (smokczen)
stać - שטיין (sztejn)
stadion - סטאַדיאָן m (stadjon)
stadium - שטאַפּל (sztapl)
stal - שטאָל
stała - קאָנסטאַנט m (konstant)
stalować się - אָנשטעלן זיך (onszteln zich) | לאָזן זיך (lozn zich)
stanowisko - קוק m (kuk)
Stany - פֿאַראייניקטע שטאַטן פֿון אַמעריקע (farejnikte sztatn fun amerike)
Stany Zjednoczone - פֿאַראייניקטע שטאַטן פֿון אַמעריקע (farejnikte sztatn fun amerike)
Stany Zjednoczone Ameryki - פֿאַראייניקטע שטאַטן פֿון אַמעריקע (farejnikte sztatn fun amerike)
stara panna - אַלטע מויד f (alte mojd) | פֿאַרזעסענע מויד f (farzesene mojd)
starek - זיידע m (zejde) | קנאַקניסל n (knaknisl)
stare miasto - אַלט (alt)
starka - באָבע f
starosek - זיידע m (zejde) | קנאַקניסל n (knaknisl)
staroświecki - אַלטמאָדיש (altmodisz) | אַלטפֿרענקיש (altfrenkisz)
staroszek - זיידע m (zejde) | קנאַקניסל n (knaknisl)
starszy - פֿאָטער m (foter) | טאַטע m (tate)
stary - אַלט (alt)
starzeć się - עלטערן זיך (eltern zich) | אַלט ווערן (alt wern)
starzyk - זיידע m (zejde) | קנאַקניסל n (knaknisl)
staw - אָזערע f (ozere)
stawać - ווערן (wern)
stawiać - שטעלן (szteln) | אויפֿשטעלן (ojfszteln)
stegnisko - שפּור f (szpur) | פֿוסדרוק m (fusdruk) | סליד m (slid) | זכר m (zejcher)
sterczeć - שטיין (sztejn)
stodoła - שײַער
stojeć - שטיין (sztejn)
stolarz - סטאָליער m (stoljer)
stolica - הויפּטשטאָט f (hojptsztot)
stomatolog - ציינדאָקטער m (cejndokter)
stopa - פֿוס m (fus)
stopień - שטאַפּל (sztapl)
stosować - באַגיין זיך (bagejn zich)
stosunek - באַציִונג f (baciung) | ביאה f (bie)
stosunek płciowy - ביאה f (bie)
stowarzyszenie - אַסאָציאַציע f (asocjacje) | בינדונג f (bindung) | פֿאַרבאַנד m (farband) | פֿאַראייניקונג f (farejnikung)
stożek - קאָנוס m (konus)
strach - מורא f (mojre)
strachliwy - מוראוודיק (mojrewdik)
strach na wróble - מורא f (mojre)
strąpacz - פֿעברואַר m (februar) | קאַלט (kalt)
strasznie - בלוטיק (blutik)
straszny - מוראדיק (mojredik) | בלוטיק (blutik)
straszyć - סטראַשען
straż - שמירה f (szmire)
strażnik - היטער m (hiter)
Strefa Gazy - עזה־שטרײַף m (aze-sztrajf) | עזה־פּאַס m (aze-pas)
strona - זײַט f (zajt)
stront - סטראָנטייִום (strontjium)
strop - באַלקן m (balkn)
stróż - סטראָזש m (stroż) | סטרוזש m (struż) | היטער m (hiter)
śtrykować - שטריקן (sztrikn)
strzała - פֿײַל f (fajl)
strzec - היטן (hitn) | היטן זיך (hitn zich)
strzelać - שיסן
strzeżenie - שמירה f (szmire)
student - סטודענט m (student) | לערנער m (lerner) – studiujący święte księgi
studia - לימודים (limudim)
studiować - שטודירן (sztudirn)
studnia - ברונעם m (brunem)
stuk - קלאַפּ m (klap)
stukanie - קלאַפּ m (klap)
stuknąć - טאָן / געבן אַ קלאַפּ (ton / gebn a klap)
stulecie - יאָרהונדערט m (jorhundert)
stwórca - בעשעפֿער m
styczeń - יאַנואַר m (januar)
styl - סטיל m (stil)
stymulować - סטימולירן (stimulirn)
suchy - טרוקן (trukn)
Sudety - סודעטן
sufit - באַלקן m (balkn)
sukces - הצלחה f (hacloche) | באַגליק m (baglik) | סוקצעס m (sukces)
sukienka - קליידל n (klejdl)
sukmana - ראָק m
suknia - קלייד n (klejd)
sumienie - געוויסן n (gewisn) | יושר m (jojszer)
suszyć - טריקענען (trikenen) | טריקענען זיך (trikenen zich)
sutanna - סוטאַנע f (sutane)
sutener - שמײַסער m (szmajser) | פֿרויען־הענדלער m (frojen-hendler)
suwerenność - אייבערהאַרשאַפֿט f
swastyka - האַקנקרייץ m (haknkrejc)
świat - וועלט f (welt)
światło - ליכט (licht)
świątynia - טעמפּל m (templ)
świeca - ליכט (licht)
świecę - ליכט (licht) | גלאַנצן (glancn)
świecić - גלאַנצן (glancn)
świecznik - לײַכטער m (lajchter)
świekier - שווער m (szwer)
świekra - שוויגער f (szwiger)
świerk - טענענבוים m (tenenbojm)
świerszcz - גריל f (gril)
świeść - שוויגער f (szwiger)
świetność - גלאַנץ m (glanc)
świętować - יובֿלען (jojwlen)
święty - הייליקער m (hejliker)
świgać - וואַרפֿן (warfn) | שמיצן זיך (szmicn zich) | כאַפּן זיך (chapn zich) | לאָזן זיך (lozn zich)
świnia - חזיר m (chazer)
świnka - חזירל n (chazerl) | מומס m (mums)
świnka morska - ים־חזירל n (jam-chazerl)
świństwo - חזירײַ
świostka - שוויגער f (szwiger)
świt - באַגינען m (baginen)
świtanie - באַגינען m (baginen)
swój - זײַן (zajn)
swoje - זײַן (zajn)
Syberia - סיביר
sygnał - סיגנאַל m (signal)
syjonizm - ציוניזם m (cijenizm)
syk - סיקעניש n (sikenisz)
sylwek - סילוועסטער m (silwester) | סילוועסטער־אָוונט m (silwester-ownt) | ערבֿ נײַיאָר (erew najjor)
sylwester - סילוועסטער m (silwester) | סילוועסטער־אָוונט m (silwester-ownt) | ערבֿ נײַיאָר (erew najjor)
symbol - סימבאָל m (simbol)
symetria - סימעטריע f (simetrje)
symfonia - סימפֿאָניע f
symptom - סימפּטאָם m (simptom)
syn - זון m (zun)
synagoga - שול f (szul) | דאַוונשול f (dawnszul)
synek - יונג m (jung)
synonim - סינאָנים m (sinonim)
synonimiczny - סינאָנים
synowa - שנור f (sznur)
syra - פֿוס m (fus) | פֿוסבאָל m (fusbol)
syryjski - סיריש (sirisz)
sytuacja - סיטואַציע f (situacje)
szabas - שבת m
szabat - שבת m
szachownica - שאָכברעט f (szochbret)
szachy - שאָך m (szoch)
szacować - שאַצן (szacn)
szacunek - דרך־ארץ m (dercherec) | רעספּעקט m (respekt) | אוּוואַזשעניע f (uważenje) | שאַץ m (szac)
szafka - שאַפֿקע f
szajs - דרעק m (drek)
szaleć - הוליען (huljen)
szaleństwo - טיפּשות (tipszus)
szalik - שאַליק m (szalik)
szalki - שלייקעס (szlejkes) | שעלקעס (szelkes)
szambo - אָפּגאַנגגרוב m (opganggrub)
szamot - פּיסק m (pisk)
szampan - שאַמפּאַניער m (szampanjer)
szampon - שאַמפּו (szampu)
szanować - אַכטן (achtn)
szarańcza - היישעריק m
szary - גרוי (groj)
szaszok - פּחדן m (pachdn) | טכויר m (tchojr)
szatan - שׂטן m
szatkować - האַקן (hakn)
szczaw - לאָבידע f | שטשאַוו m
szczebel - שטאַפּל (sztapl)
Szczebrzeszyn - שעברעשין m (szebreszin)
szczególnie - באַזונדערש (bazundersz)
szczególny - באַזונדער (bazunder)
szczekać - האַווקען
szczeniak - הינטל n (hintl) | הינטעלע n (hintele)
szczenię - הינטל n (hintl) | הינטעלע n (hintele)
szczerość - אויפֿריכטיקייט f
szczerze - פֿראַנק ,אָפֿנהאַרציק
szczerzyć - לאַכן מיט ציינער (lachn mit cejner)
szczęście - נס m (nes)
szczęśliwego Nowy Nowego Roku - גליקלעכן נייעם יאָר
szczewik - שוך m (szuch)
szczodry - פּזרניש (pazronisz) | רײַך (rajch)
szczoteczka do zębów - ציינבערשטל n (cejnbersztl)
szczotka - באַרשט f
szczupak - העכט m (hecht)
szczur - שטשור m (szczur) | ראַץ m (rac)
szczycić - ווערן זיך (wern zich)
szczyt - אָרגאַזם m (orgazm)
szef - שעף m (szef) | ראָש m (rosz)
szelka - שלייקעס (szlejkes) | שעלקעס (szelkes)
szeroki - ברייט
szerszeń - פֿערדבין f (ferdbin)
szewc - שוסטער m (szuster)
szezlong - שעזלאָנג (szezlong) m
szkielet - געביין n (gebejn) | סקעלעט m (skelet)
szkira - מויד f (mojd)
szkita - פֿוס m (fus) | פֿוסבאָל m (fusbol)
szklanka - גלעזל n (glezl)
szkło - גלאָז n (gloz)
Szkocja - שאָטלאַנד n (szotland)
szkoła - שולע f (szule) | שול f (szul)
szkoła podstawowa - פֿאָלקשול f (folkszul)
szkoła powszechna - פֿאָלקשול f (folkszul)
szkopuł - צרה f (core)
szlachtuz - סאַלהאָן (salhon) | שלאַכטהויז n (szlachthuiz) | סקאָטאָבויניע f (skotobuinie)
szlafrok - באָדכאַלאַט m (borchalat)
szlag - קלאַפּ m (klap) | האַק m (hak)
szlak - וועג m (weg)
szlauch - שלאַנג f (szlang)
szlips - שניפּס m (sznips) | קראַוואַט m (krawat) | אויסבינדער m (ojsbinder)
szlug - שלוג f (szlug)
szluk - זופּ m (zup)
szmugiel - שמוגל m (szmugl)
szmuglerka - שמוגל m
szneka - פּנים n (ponem)
sznupa - פּנימל n (peneml)
sznur - שטריק (sztrik) | שנור (sznur) | שרוך
sznurek - שטריקל n (sztrikl)
sznurowadło - שוכבענדל n (szuchbendl)
sznurówka - שוכבענדל n (szuchbendl)
szofar - שופֿר m (szojfer)
szok - שאָק m (szok) | קלאַפּ m (klap)
szpagat - שטריקל n (sztrikl)
szparag - שפּאַרזשע f | שפּאַרגל m
szperać - גראָבן זיך (grobn zich)
szpilka - שפּילקע f (szpilke)
szpinak - שפּינאַט m
szpital - שפּיטאָל (szpitol)
szpon - נאָגל m (nogl)
szpuk - טויב f (tojb)
szpunt - שפּונט (szpunt)
sztetl - שטעטל m
sztof - סחורה f (schojre)
sztrykować - שטריקן (sztrikn)
sztuka - קונסט f (kunst) | שטיק (sztik) | שפּיל f (szpil) | מויד f (mojd)
sztylet - שטילעט m (sztilet) | שטעכמעסער (sztechmeser)
szucman - היטער m (hiter) | לײַבוועכטער m
szuflada - שופֿלאָד m
szum - גערויש (gerojsz)
szwaja - פֿוס m (fus) | פֿוסבאָל m (fusbol)
Szwecja - שוועדן n (szwedn)
Szwecyjo - שוועדן n (szwedn)
szwestera - שוועסטער f (szwester)
szwindel - שווינדל (szwindl)
szybki - שנעל (sznel) | גיך (gich)
szybko - שנעל (sznel) | געשווינד (geszwind) | גיך (gich)
szydełko - העקל n (hekl)
szydełkować - העקלען (heklen)
Szydłowiec - שידלאָווצע (szidlowce)
szykowny - שיין (szejn)
szynal - נאָגל m (nogl)
szynd - גוואַלד f (gwald) | בגוואַלד (bigwald)
szyszka - שישקע f (sziszke)
ta - די (di)
tabaka - טאַביקע f | טאַבאַק m | טאַביקע f (tabike)
taborek - טאַבורעט m (taburet)
taboret - טאַבורעט m (taburet)
taca - טאַץ m (tac)
tachykardia - טאַטשיקאַרדיאַ
tacik - פֿאָטער m (foter) | טאַטע m (tate) | זיידע m (zejde) | קנאַקניסל n (knaknisl)
tacka - טעצל n (tecl)
tajga - טײַגע f (tajge)
tak - אַזוי (azoj) | יאָ (jo)
taki - דער (der)
taki sam - זעלביק | זעלב
tak sobie - אַזוי זיך | (azoy zikh) | נימער־ערגער (nimer־erger)
taksówka - טאַקסי (taksi)
także - אויך (oych)
talerz - טעלער m (teler)
talia - פּאַש m
tandetny - טאַנדעט (tandet)
tango - טאַנגאָ m (tango)
tani - וואָלוול (wolwl) | ביליק (bilik) | טאַנדעט (tandet)
tank - טאַנק m (tank)
tapeta - טאַפּעטן (tapetn) | שפּאַליר m (szpalir)
tarcza - פּנים n (ponem)
tarcza strzelecka - פּנים n (ponem)
Tarnów - טאָרנע (torne)
taśtać - טראָגן
tata - טאַטע m (tate)
tato - טאַטע m (tate)
tatuś - טאַטעשי m (tateszi)
tchórz - פּחדן m (pachdn) | טכויר m (tchojr)
te - דער (der)
teatr - טעאַטער m (teater)tyaoter
techniczny - טעכניש (technisz)
technokracja - טעכנאָקראַטיע f (technokratje)
technokratyczny - טעכנאָקראַטיש (technokratisz)
tęcza - רעגן־בויגן m (regn-bojgn)
tegdy - בעת־מעשׂה (bejs-majse)
tęgi - גראָב (grob)
tej - דו (du)
Teksas - טעקסאַס
tekst - טעקסט m
Tel Awiw - תּל־אָבֿיבֿ n (tel-awiw)
telefon - טעלעפֿאָן m (telefon)
telefoniczny - טעלעפֿאָניש (telefonisz)
telefon komórkowy - מאָביל־טעלעפֿאָן m (mobil-telefon)
telefonować - טעלעפֿאָנירן (telefonirn) | אָנרופֿן (onrufn)
teleskop - שפּאַקטיוו m (szpaktiw)
telewizja - טעלעוויזיע f (telewizje)
telewizor - טעלעוויזאָר m (telewizor)
temat - טעמע f (teme) | מאָטיוו m (motiw) | וועגן (wegn)
tempo - טעמפּ m (temp)
temu - מיט … צוריק (mit … curik)
ten - דער (der)
ten sam - זעלביק (zelbik) | זעלב (zelb)
tenże - דער (der) | די (di) | דאָס (dos)
teologia - טעאָלאָגיע f (teologje)
tępak - גראָבער קאָפּ m (grober kop) | חכם m (chochem)
tępy - גראָב (grob)
teraz - איצט (ict) | אַצינד (acind) | הײַנט צו טאָג (hajnt cu tog) | הײַנט (hajnt)
terminator - לערנייִנגל n (lernjingl) | יונג m (jung)
termometr - טערמאָמעטער m (termometer)
terrorysta - טעראָריסט (terorist)
terrorystyczny - טעראָריסטיש (teroristisz)
terroryzm - טעראָריזם m
teść - שווער m (szwer)
teściowa - שוויגער f (szwiger)
tęsknić - בענקען
tęsknota - בענקשאַפֿט f (benkszaft) | בענקעניש n (benkenisz)
testament - צוואה f (cawoe)
teszarz - סטאָליער m (stoljer)
tętnica - אַרטעריע f (arterje) | מאַגיסטראַל m (magistral)
też - אויך (oych)
tkanina - סחורה f (schojre)
tkanka - געוועב n (geweb)
tlen - אָקסיגען (oksigen)
tłuk - מויד f (mojd)
tłumacz - איבערזעצער m (iberzecer)
tłumaczyć - קלאָר מאַכן (klor machn) | איבערזעצן (iberzecn)
tłusty - גראָב (grob)
to - דאָס (dos)
Tobiasz - טבֿיה (tewje)
tobie - דו (du)
toczyć - ראָלן (roln) | ראָלן זיך (roln zich)
tokarka - טאָק f (tok)
tolerancja - טאָלעראַנציע f (tolerancie)
ton - טאָן m (ton)
tona - טאָן f (ton)
tonąć - אונטערגיין (untergejn)
topnieć - צעגיין
topór - האַק f (hak)
Tora - תּורה f
tornister - רענצל n
tort - טאָרט m (tort)
tost - טאָסט m (tost)
towar - סחורה f (schojre)
towarzyszyć - באַגלייטן (baglejtn)
trąba - שנוק m (sznuk)
trącać - שטופּן (sztupn) | שטופּן זיך (sztupn zich) | קלאַפּן זיך (klapn zich) | צוקלאַפּן (cuklapn)
tracić - אָנווערן (onwern) | פֿאַרלירן (farlirn) | דערלייגן (derlejgn) | צולייגן (culejgn)
trącić - אַ שטופּ טאָן (a sztup ton)
tradycja - טראַדיציע f (tradicje) | קבלה f (kabole)
traf - בייגפֿאַל m (bejgfal) | פֿאַל m (fal)
tragarz - טרעגער m
tragedia - טראַגעדיע f (tragedje)
tragiczny - טראַגיש
tragikomedia - טראַגיקאָמעדיע f (tragikomedje)
traktować - באַגיין זיך (bagejn zich)
trambimba - טראַמווײַ m (tramwaj)
tramwaj - טראַמווײַ m (tramwaj)
tramwajka - טראַמווײַ m (tramwaj)
transformator - טראַנספֿאָרמאַטאָר m (transformator)
translator - איבערזעצער m (iberzecer)
transparentny - קלאָר (klor)
tranzystor - ראַדיאָ m (radio)
trasa - וועג m (weg)
tratować - טרעטן (tretn)
trawa - גראָז n (groz)
trawnik - גראָזגאָרטן m (grozgortn)
trefl - צלם m (cejlem)
trefny - טרייפֿן (trejfn) | טרייף (trejf)
troć - פֿאָרעל f (forel)
trochę - אַ ביסל (a bisl)
tróhła - טרונע f (trune)
Troja - טרויע f (troje)
trójkąt - דרײַעק m (drajek)
troska - קלאַפּאָט m (klapot)
troszeczkę - אַ ביסעלע (a bisele)
truchło - טויטער m | ברמינן m | מת m
trucizna - סם m (sam)
trudność - צרה f (core) | אַ האַרב / שווער לייענען (a harb / szwer lejenen)
trudny - שווער
truizm - טרויִזם m (truizm) | פֿאַרשטייט־זיך m (farsztejt-zich) | פֿראַזע f (fraze)
trujący - סמיק (samik)
trumna - טרונע f (trune)
trupa - טרופּע f (trupe)
truskawka - טרוסקאַפֿקע f (truskafke)
trza - מען / מע דאַרף (men / me darf) | מען / מע מוז (men / me muz)
trzaska - קין m (kin)
trzeba - מען / מע דאַרף (men / me darf) | מען / מע מוז (men / me muz)
trzeć - רײַבן
trzęsienie ziemi - ערד־ציטערניש n (erd־citernisz)
trzeźwy - ניכטער (nichter) | קלאָר (klor)
trzoda - בהמות (behejmes)
trzymać - האַלטן (haltn) | האַלטן זיך (haltn zich)
tu - דאָ (do)
tuberkuloza - טובערקולאָז m (tuberkuloz) | דער f (der)
tudzież - און (un)
tukej - דאָ (do)
tu leży pies pogrzebany - דאָ ליגט דער הונט באַגראָבן (do ligt der hunt bagrobn)
tulipan - טולפּאַן m
tulp - טולפּאַן m
tumult - טומל m (tuml)
tuńczyk - טונפֿיש m (tunfisz)
tunfisz - טונפֿיש m (tunfisz)
Turcja - טערקײַ (terkaj)
turystyka - טוריסטיק f (turistik)
tutaj - דאָ (do)
tuzin - טוץ m (tuc)
twardy - האַרט (hart) | שווער (szwer)
twardziel - האַרטדיסק m (hartdisk)
twarz - פּנים n (ponem)
twarzą w twarz - פּנים־אל־פּנים (ponem-el-ponem)
twój - דײַן (dajn)
ty - דו (du)
tybetański - טיבעטיש (tibetisz)
tygr - טיגער m (tiger)
tygrys - טיגער m (tiger)
tyj - טיי f (tej)
tył - הינטן m (hintn)
tyłek - תּחת m (toches) | דאָס m (dos)
tylko - נאָר (nor)
tymczasem - בעת־מעשׂה (bejs-majse) | לעת־עתּה (lesate)
tyn - צאַם (cam) | צאָם (com) | צוים (cojm)
typ - טיפּ m (tip) | יונג m (jung)
typografia - טיפּאָגראַפֿיע f (tipografje)
tytoń - טאַביקע f (tabike)
tytuł - נאָמען m (nomen)
ubezpieczenie - פֿאַרזיכערונג f (farzicherung) | סטראַכירונג f (strachirung) | אַסעקוראַציע f (asekuracje)
uchodźca - פּליט (plit)
uchodźczyni - פּליטה (plejte) f
uciecha - יובל m (jubl)
uciekać - אַנטלויפֿן ,אַוועקלויפֿן
uciskać - דריקן
uczciwie - בנאמנות (benemones) | גערעכט (gerecht) | יושרדיק (jojszerdik) | כּשר (koszer)
uczciwość - גערעכטיקייט f (gerechtikejt) | יושר m (jojszer) | ערלעכקייט f (erlechkejt)
uczciwy - גערעכט (gerecht) | יושרדיק (jojszerdik) | כּשר (koszer)
uczeń - תּלמיד m (talmed)
uczony - וויסנשאַפֿטלער m (wisnszaftler) | חכם m (chochem)
uczyć - לערנען זיך (lernen zich)
udawać - אָנשטעלן זיך (onszteln zich) | לאָזן זיך (lozn zich)
uderzenie - קלאַפּ m (klap) | האַק m (hak)
uderzyć - טאָן / געבן אַ קלאַפּ (ton / gebn a klap) | אַ האַק טאָן (a hak ton) | געבן (gebn)
udo - דיך m (dich)
udręka - צרה f (core)
ufnal - נאָגל m (nogl)
ugryzienie - שטאָך m (sztoch)
ujrzeć - זען (zen)
ukąszenie - שטאָך m (sztoch)
układ okresowy - פּעריאָדישע טאַבעלע f (perjodisze tabele) | פּעריאָדישע סיסטעם f (perjodisze sistem)
układ okresowy pierwiastków - פּעריאָדישע סיסטעם פֿון כעמישע עלעמענטן f (perjodisze sistem fun chemisze elementn)
ukochany - ליב (lib)
ukrzyżowanie - קרײַציקונג f
ułamek - בראָכצאָל f (brochcol) | תּשבורת m (tiszbojres) | בראָכטייל m (brochtejl)
ułaskawienie - באַגנאַדיקונג f
ulegać - אונטערוואַרפֿן זיך (unterwarfn zich)
ulica - גאַס f (gas)
uliczka - געסקע f (geske)
ułomność - מום m
ulubiony - באַליבט (balibt) | ליב (lib)
umieć - קענען (kenen)
umiejętność - קענען n (kenen) | קענטעניש n (kentenisz)
umówić - צונויפֿרעדן זיך (cunojfredn zich)
umysł - מוח m (mojech)
umywalka - וואָשטיש m
Unia Europejska - אייראָפּעיִשער פֿאַרבאַנד m (ejropeiszer farband)
uniwerek - אוניווערסיטעט m (uniwersitet)
uniwersytet - אוניווערסיטעט m (uniwersitet)
unosić - אַוועקבלאָזן (awekblozn)
uón - ער (er)
upadać - אונטערגיין (untergejn)
upadek - פֿאַל m (fal) | אונטערגאַנג m (untergang)
upał - היץ f (hic)
uparciuch - עקשן (ekszn)
uparty - פֿאַרעקשנט (faraksznt)
upiec - אָפּשנײַדן טרוקן (opsznajdn trukn)
upokarzać - פֿאַרשעמען (farszemen) | פֿאַרשעמען זיך (farszemen zich)
uprawiać - באַאַרבעטן (baarbetn)
uprzątać - אַוועקראַמען (awekramen)
uprzejmie - ליב (lib) | אין גוטן מוט (in gutn mut)
uprzejmy - ליב (lib)
urępny - שיין (szejn)
urna - אורנע f (urne) | קלפֿי f (kalfe)
urodzenie - געבוירן n (gebojrn)
urodziny - געבוירן־טאָג m (gebojrn-tog) | געבוירן n (gebojrn)
urodziwy - שיין (szejn)
urodzony - געבוירן (gebojrn)
uruchamiać - אָנשטעלן (onszteln)
urząd - אַמט m (amt)
usłyszeć - פֿאַרנעמען (farnemen)
usprawiedliwiać - באַרעכטיקן
usta - מויל n (muil)
ustawa - געזעץ n (gezec)
ustawiać - אָנשטעלן (onszteln)
usuwać - אַוועקראַמען (awekramen)
utęsknienie - בענקשאַפֿט f (benkszaft) | בענקעניש n (benkenisz)
utopia - אוטאָפּיע f (utopje)
utopijny - אוטאָפּיש
utrzymywać - האַלטן (haltn) | אויסהאַלטן (ojshaltn) | טענהן (tajnen) | אויסהאַלטן זיך (ojshaltn zich)
utwór - ווערק n (werk)
uwaga - אַכט f (acht) | איי (ej)
uważać - היטן זיך (hitn zich) | זען (zen) | האַלטן (haltn) | קלערן (klern)
uwertura - אוּווערטור
uwodziciel - פֿרויען־יעגער m (frojen-jeger)
uzasadnienie - גערעכטיקייט f (gerechtikejt)
Uzbekistan - אוזבעקיסטאַן (uzbekistan)
użytkownik - באַניצער m (banicer)
używać - באַגיין זיך (bagejn zich)
w - בעת (bejs)
wacha - גאַזאָלין | רעגן m (regn) | שמירה f (szmire) | ים m (jam) | וואַסער n (waser)
waga - וואָג f (wog)
Waga - וואָג f (wog)
wagary - אָפּציִערײַ n (opcieraj)
wahować - היטן (hitn) | זען (zen) | היטן זיך (hitn zich)
wajco - איי n (ej)
walczerz - באַטאַליאָן m (bataljon)
wałek do ciasta - וואַלגערהאָלץ n (walgerholc)
walet - פּויער m (pojer)
Walia - וויילז n (wejlz)
walić - האַקן (hakn) | געבן (gebn)
waliza - וואַליזקע f (walizka) | וואַליזע f (walize) | טשעמאָדאַן m (czemodan)
walizka - וואַליזקע f (walizka) | וואַליזע f (walize) | טשעמאָדאַן m (czemodan)
walka - קאַמף m (kamf) | געשלעג n (geszleg) | געראַנגל n (gerangl)
walnąć - אַ האַק טאָן (a hak ton)
waluta - וואַלוטע f (walute)
wampir - וואַמפּיר m (wampir)
wanilia - וואַניל m (wanil)
wapń - קאַלציום m (kalcjum)
wapniak - טאַטע־מאַמע (tate-mame) | עלטערן (eltern)
warkocz - צאָפּ m
Warszawa - וואַרשע f (warsze)
warszawiak - וואַרשעווער m (warszewer)
warszawianin - וואַרשעווער m (warszewer)
warszawski - וואַרשעווער (warszewer)
warta - שמירה f (szmire)
wartość - ווערט (wert) | שאַץ m (szac)
warzyć - וועלן (weln)
warzywo - גרינס n (grins)
wąs - וואָנצעס (wonces) | וואָנצע f (wonce)
wąski - שמאָל (szmol) | ענג (eng)
wąsko - ענג (eng)
Waszyngton - וואַשינגטאָן
wątpliwość - ספֿק m
wątpliwy - ספֿקדיק
wątroba - לעבער f (leber)
Watykan - וואַטיקאַן (vatikan)
wąż - שלאַנג f (szlang)
ważny - וויכטיק (wichtik) | וואָגיק (wogik) | חשובֿ (choszew) | גילטיק (giltik)
ważyć - וועגן (wegn) | וואַגן (wagn)
wbrew - קעגן (kegn) | אויף צעזעצעניש (ojf cezecenisz)
w czasie - בעת (bejs)
wczesny - פֿריִיִק (friik)
wczoraj - נעכטן (nechtn)
wczorajszy - נעכטיק (nechtik)
wdowa - אַלמנה f (almone)
wdowula - אַלמנה f (almone)
wdychać - אָטעמען (otemen)
we - בעת (bejs)
węborek - עמער (emer)
wegetarianin - וועגעטאַריער m (wegetarjer)
wegetariański - וועגעטאַריש (wegetarisz)
węgiel - קוילנשטאָף m (kojlnsztof) | קויל (kojl)
węgorz - אייל f (ejl)
wełna - וואָל f (wol)
welon - דעקטוך
wena - ווענע
wentroba - לעבער f (leber)
werdykt - פּסק m
wesołość - יובל m (jubl)
Wesołych Świąt - פֿרײלעכע ניטל (freylekhe nitl)
węszyć - שנאַפּן
wewnątrz - אינעווייניק (inewejnik)
węzeł - קנופּ m (knup)
wezwanie - צאָמיס m | נאָמען m (nomen)
wiadomości - וויסנשאַפֿט n (wisnszaft)
wiadro - עמער (emer)
wiatr - ווינט m (wint)
widać - זען זיך (zen zich) | מע זעט (me zet) | קענטיק (kentik) | אַ פּנים (a ponem)
widelec - גאָפּל m (gopl)
widły - ווידלע f (widle)
widnieć - זען זיך (zen zich)
widocznie - קענטיק (kentik) | אַ פּנים (a ponem)
widoczny - קענטיק (kentik)
widołka - גאָפּל m (gopl)
widz - צוקוקער
widzialny - קענטיק (kentik)
widzieć - זען (zen)
wieczność - אייביקייט f (eybikeyt) | אַ שאָק מיט יאָרן (a szok mit jorn)
Wiedeń - ווין (win)
wiedza - וויסן n (wisn) | וויסנשאַפֿט n (wisnszaft) | קענען n (kenen) | קענטעניש n (kentenisz)
wiedzieć - וויסן (wisn)
wiedźma - באַבע f (babe)
wiejski - דאָרפֿיש (dorfisz) | מוזשיצקע (mużicke)
wiek - יאָרהונדערט m (jorhundert)
wiekowy - אַלט (alt)
wiela - וויפֿל (wifl) | וועלך (welch)
wielbiciel - ליבהאָבער m (libhober) | חסיד m (chosid / chosed)
wielbłąd - קעמל m (keml)
Wielka Brytania - גרױסבריטאַניע
Wielkanoc - קייסעך m (kejsech) | פּאַסכע f (pasche)
wielki - גרויס (grojs)
wielkoduszny - ברייטהאַרציק (brejtharcik)
wielojęzyczny - עטלעך־שפּראַכיק (etlech-szprachik)
wielojęzykowy - עטלעך־שפּראַכיק (etlech-szprachik)
wieloryb - וואַלפֿיש m (walfisz)
Wieluń - וויעלון (wielun)
wielunianin - וויעלונער m (wjeluner)
wieluński - וויעלונער m (wjeluner)
wieprz - חזיר m (chazer)
wieprzowina - חזיר m (chazer) | חזיר־פֿלייש n (chazer-flejsz)
wiersz - ליד n (lid)
wierzba - ווערבע
wieś - דאָרף n (dorf)
wieść - שמועה f (szmue)
wieśniak - פּויער m (pojer) | כלאָפּ m (chlop) | מוזשיק m (mużik)
wietrzny - ווינטיק
wiewiórka - וועווערקע f (wewerke)
wieża - טורעם m (turem)
wieża Babel - בבֿל n (bowl)
wigilia - ערבֿ (erew)
wikiholik - וויקיהאָליקער m (wikiholiker)
Wikipedia - וויקיפּעדיע f (wikipedje)
Wikisłownik - וויקיווערטערבוך (wikiwerterbuch)
Wikiźródła - װיקיביבליאָטעק
wiklina - פֿלעכטוואַרג n (flechtwarg)
wilgoć - נעץ
wilia - ערבֿ (erew)
wilija - ערבֿ (erew)
wilk - וואָלף m (wolf)
wilkołak - ווילקאָלאַק m
Wilno - ווילנע (wilne)
w imię - פֿון וועגן (fun wegn)
winda - ליפֿט m (lift)
winien - שולדיק (szuldik) | דאַרפֿן (darfn) | זאָלן (zoln)
winnica - ווײַנגאָרטן (wajngortn) m
winny - שולדיק (szuldik)
wino - ווײַן m (wajn)
winograd - ווײַנגאָרטן (wajngortn) m | ווײַן m (wajn)
wiolencja - גוואַלד f (gwald) | בגוואַלד (bigwald)
wioska - דאָרף n (dorf)
wiosna - פֿרילינג m (friling)
wisieć - הענגען (hengen)
wisieć na telefonie - הענגען אויפֿן טעלעפֿאָן (hengen ojfn telefon)
Wisła - ווײַסל f (wajsl)
witać - געבן / אָפּשטעקן שלום־עליכם (gebn / opsztekn szolem-alejchem) | געבן אַ גוט־מאָרגן (gebn a gut-morgn)
wiwenda - עסנוואַג n
wizerunek - צלם m (cejlem)
wizjer - לעכל n (lechl)
wizyta - וויזיט m
w każdym razie - אויף יעדן פֿאַל (ojf jedn fal)
wkrótce - באַלד
włączać - אָנשטעלן (onszteln)
władca - הערשער m (herszer) | מושל m (mojszl)
właściciel - בעל־הבית m (balebos)
właśnie - ערשט (erszt) | טאַקע (take) | פּונקט (punkt)
własny - אייגן
właz - ליקל n
wlec - נאָכשלעפּן (nochszlepn) | נאָכשלעפּן זיך (nochszlepn zich)
Włocławek - וולאָצלאַוועק (wloclawek)
włóczęga - וואַגאַבונד m (wagabund) | וואַנדערער m (wanderer) | שלעפּער m (szleper)
włócznia - שפּיז f
włóczyć - אַרומדרייען זיך (arumdrejen zich)
włos - האָר f (hor)
włoski - איטאַליעניש (italjenisz) | הערל f (herl)
wnętrze - אינעווייניק (inewejnik)
wobec - קעגן (kegn)
woda - וואַסער n (waser)
w odniesieniu do - וועגן (wegn)
wojaż - נסיעה f (nesije) | וועג m (weg)
wojna - מלחמה f (milchome)
wojna domowa - בירגער־מלחמה f (birger-milchome) | בירגערקריג (birgerkrig)
wojskowy - מיליטעריש (militerisz)
wokabularz - ווערטערבוך (werterbuch)
wokół - אַרום (arum)
wół - אָקס (oks)
wola - ווילן m (wiln)
wołać - אָנרופֿן (onrufn)
woleć - בעסער וועלן (beser weln)
wolno - מע מעג (me meg) | מע טאָר ניט (me tor nit)
wolnomularz - פֿרײַמײַער m (frajmajer)
wolt - וואָלט m (wolt)
wosk - וואַקס m (waks)
wówczas - בעת־מעשׂה (bejs-majse)
wóz - וואָגן m (wogn)
wozatarz - בעל־עגלה m | שמײַסער m (szmajser)
wózek - וואָגן m (wogn) | וועגל n (wegl) | וועגעלע n (wegele)
wózek dziecięcy - קינדער־וועגעלע n (kinder-wegele)
wózek inwalidzki - רעדערשטול f (redersztul)
woźnica - בעל־עגלה m | שמײַסער m (szmajser)
wpływowy - מעכטיק (mechtik)
wprost - פּונקט (punkt)
wręczać - איבערגעבן (ibergebn)
wróbel - שפּערל m (szperl)
wrodzony - געבוירן (gebojrn)
wrogi - פֿײַנדלעך (fajndlech)
wrona - קראָ f (kro)
wróżka - פֿעע f (fee)
wrzesień - סעפּטעמבער m (september)
wschód - זון)אויפֿגאַנג) m ((zun)ojfgang) | מיזרח m (mizrech)
wschodzić - אויפֿגיין
wściekły - אויפֿגעקאָכט (ojfgekocht)
wsiok - פּויער m (pojer) | כלאָפּ m (chlop) | מוזשיק m (mużik)
wskazówka - עצה f (ejce)
wskutek - פֿון וועגן (fun wegn)
wspaniale - גרויסאַרטיק (grojsartik)
wspaniało - גרויסאַרטיק (grojsartik)
wspaniałomyślny - ברייטהאַרציק (brejtharcik)
wspaniałość - גלאַנץ m (glanc)
wspaniały - גרויסאַרטיק (grojsartik) | נסימדיק (nisimdik)
współczesny - הײַנטצײַטיק (hajntcajtik)
wspólnie - יחדיו (jachdew)
wspominać - דערמאָנען זיך (dermonen zich) | דערמאָנען (dermonen)
wspomnienie - דערמאָנונג f (dermonung) | אָנדענק m (ondenk)
w stosunku do - קעגן (kegn)
wstrętny - הינטיש (hintisz)
wstrząs - קלאַפּ m (klap) | שאָק m (szok)
wstyd - חרפּה f | בושה f | שאַנד f | בזיון m
wstydzić się - שעמען זיך (szemen zich)
wszystko - אַלץ (alc) | אַלצדינג (alcding)
wszystko jedno - בילע (bile)
wtedy - דעמלט (demlt) | דעמאָלט (demolt) | דאַן (dan) | בעת־מעשׂה (bejs-majse)
wtenczas - דעמלט (demlt) | דעמאָלט (demolt) | דאַן (dan) | בעת־מעשׂה (bejs-majse)
wtorek - דינסטיק m (dinstik)
wtrącać - אַרײַנמישן (arajnmiszn)
w trakcie - בעת (bejs)
wtykać - שטופּן (sztupn)
w tym - בעת (bejs) | דאָס (dos)
wulkan - וווּלקאַן m (wulkan)
wulkaniczny - וווּלקאַניש (wulkanisz)
wy - איר (ir)
wybaczać - פֿאַרגעבן (fargebn)
wybieg - מאַניפֿאָרגע f (maniforge)
wybierać - קלײַבן (klajbn)
wybór - אָפּקלײַב
wybory - וואַלן (waln)
wybrzeże - באָרטן m (bortn)
Wybrzeże kość Kości Słoniowej - העלפֿאַנדביין־באָרטן m (helfandbejn-bortn)
wybuch - אויפֿרײַס m (ojfrajs)
wychodzić - קוקן (kukn)
wycieczka - אויספֿלוג ,עקסקורסיע
wyciekać - אויסרינען | רינען
wydatkować - דרוקן (drukn) | אויסזען (ojszen)
wydawać - דרוקן (drukn) | אויסזען (ojszen)
wydobywać - גראָבן (grobn)
wyga - ממזר m
wygląd - אויסזען n (ojszen) | פּנים n (ponem)
wyglądać - אויסזען (ojszen) | אויסקוקן (ojskukn) | האָבן אַ פּנים פֿון (hobn a ponem fun)
wygłaszać - זאָגן (zogn) | לייענען (lejenen)
wygwizdywać - פֿײַפֿן (fajfn)
wyjaśniać - קלאָר מאַכן (klor machn)
wyjaśnienie - דערקלערונג
wyjątek - ויסנעם
wyjeżdżać - אַוועקפֿאָרן ,אַרויספֿאָרן
wykałaczka - צאָנשטעכער m (consztecher)
wykapany - פּונקט (punkt)
wykładać - לייענען אַ קורס (lejenen a kurs)
wykopywać - גראָבן (grobn)
wykręcić się sianem - אָפּשנײַדן טרוקן (opsznajdn trukn)
wykroczenie - חטא m (chet)
wykrzyknik - אויסרוף־צייכן m (ojsruf-cejchn) | אינטעריעקציע f (interjekcje)
wykształcenie - וויסן n (wisn) | וויסנשאַפֿט n (wisnszaft)
wykształcony - קולטורעל (kulturel)
wyłącznie - דווקא (dwk)
wymagać - דאַרפֿן (darfn)
wymieniać - אָנרופֿן (onrufn)
wynagrodzenie - פּיידע
wynalazek - אויסגעפֿינס n
wynosić - כאַפּן (chapn) | אַוועקפּאַקן זיך (awekpakn zich)
wyobrażalny - באַגרײַפֿלעך (bagrajflech)
wyobrażenie - צלם m (cejlem)
wypatrywać - אויסזען (ojszen) | אויסקוקן (ojskukn)
wypowiadać - זאָגן (zogn)
wyprysk - פּיפּקעלע n
wypuszczać - אַרויסלאָזן (arojslozn) | לאָזן (lozn) | לאָזן זיך (lozn zich)
wyraz - וואָרט n (wort)
wyrażać - איבערגעבן (ibergebn)
wyraźnie - קענטיק (kentik) | קלאָר (klor)
wyraźny - קענטיק (kentik) | קלאָר (klor)
wyruszać - לאָזן זיך (lozn zich)
wysiadywać - אַוועקזיצן (awekzicn)
wyśmienicie - גרויסאַרטיק (grojsartik)
wysokie napięcie - הויכוואָלטאַזש m (hojchwoltaż)
wysoko - …הויכ (hojch…)
wyspa - אינדזל m (indzl)
wystawa - וויטרינע f (witrine) | ווײַזפֿענצטער m (wajzfencter) | אויסשטעלונג f (ojssztelung)
wystawnie - רײַך (rajch)
wystawny - רײַך (rajch)
występek - חטא m (chet)
występować - אָפּשפּאַלטן זיך (opszpaltn zich)
wytrwałość - אויסדויער (ojsduier)
wytrzymałość - אויסהאַלט־כּוח m (ojshalt-kojech)
wywiad - אינטערוויו m (interwju) | אויסשפּיר
wyznanie - אמונה f (emune) | נאמנה (denominacje) | מודה m (mojde)
wyzwolenie - באַפֿרײַונג f
wzajemnie - איינס דאָס צווייטע (ejns dos cwejte)
wzdłuż - בײַ (baj)
wzgląd - באַטראַכט m (batracht) | אַכט f (acht)
względem - קעגן (kegn)
wzmianka - דערמאָנונג f (dermonung)
-yzm - [[יזם|&rlm | -יזם]] m (-izm)
z - פֿון וועגן (fun wegn) | קעגן (kegn)
-ż - זשע (że)
ząb - צאָן m (con)
żaba - זשאַבע f (żabe) | זשאַבקעלע n (żabkele)
zabawka - צאַצקע f (cacke) | שפּילכל n (szpilchl)
żabie oczko - פֿאַרגעסניטל (fargesnitl) n
zabierać - פֿאַרנעמען (farnemen) | פֿאַרנעמען זיך (farnemen zich)
żabi skok - קאַצנשפּרונג m (kacnszprung)
żabka - זשאַבקעלע n (żabkele)
Zabulon - זבולן m
zabyły - חכם m (chochem)
zachęta - שטופּ m (sztup)
zachód - אונטערגאַנג m (untergang) | זון־אונטערגאַנג m (zun-untergang) | מערבֿ m (majrew)
Zachód - מערבֿ־וועלט f (majrew-welt)
zachód księżyca - לבֿנה־אונטערגאַנג m (levone-untergang)
zachód słońca - זון־אונטערגאַנג m
zachodzić - אונטערגיין (untergejn) | זײַן (zajn)
zachowywać - האַלטן (haltn) | לאָזן בײַ זיך (lozn baj zich) | האַלטן זיך (haltn zich) | באַגיין זיך (bagejn zich)
zaciekle - בלוטיק (blutik)
zacny - גערעכט (gerecht)
żądać - פֿאָדערן (fodern)
zadanie domowe - היימאַרבעט f (hejmarbet)
zadawać - אַרומדרייען זיך (arumdrejen zich)
zadek - תּחת m (toches) | דאָס m (dos)
żaden - קיין (kejn) | קיין שום (kejn szum)
żądło - שטעכלקע f (sztechlke) | שטאַכל m (sztachl)
zadowalać - טאָן צו ליב (ton cu lib) | באַגיין זיך (bagejn zich)
zadowolenie - צופֿרידנקייט f
żądza - תּאווה f (tajwe)
żagiel - זעגל m (zegl)
zagłada - אומקום m (umkum) | פּאָהיבל m (pohibl) | אונטערגאַנג m (untergang)
zagrożenie - סכּנה f (sakone)
zaimek - פּראָנאָם (pronom)
zainteresowanie - אינטערעס m (interes)
zając - האָז m (hoz)
zajebać - טאָן / געבן אַ קלאַפּ (ton / gebn a klap) | אַ האַק טאָן (a hak ton) | געבן (gebn)
zajefajny - פֿײַן (fajn)
zajmować - פֿאַרנעמען (farnemen) | פֿאַרנעמען זיך (farnemen zich)
zajrzeć - כאַפּן אַ קוק אַרײַן (chapn a kuk arajn)
zakładka - לייען־צייכן m (lejen-cejchn)
zakonnica - מאָנאַשקע f
zakrawać - גרענעצן זיך (grenecn zich)
zakuty łeb - גראָבער קאָפּ m (grober kop)
żal - טרויער
załącznik - צוטשעפּעניש n (cuczepenisz)
zaledwie - ערשט (erszt)
zaleta - זכות ,מעלה
zależny - אונטערגעוואָרפֿן (untergeworfn)
założyciel - גרינדער m
zamach - אַטנטאַט m (atntat) | אַטענטאַט m (atentat)
zamek - שלאָס m (szlos) | שלעסל n (szlesl) | בליצשלעסל n (blicszlesl)
zamek błyskawiczny - בליצשלעסל n (blicszlesl)
zamieć - זאַווערוכע
zamierzać - טראַכטן (trachtn) | קלערן (klern)
zamiłowanie - לײַדנשאַפֿט f
zamówienie - באַשטעלונג
zamożność - רײַכקייט f (rajchkejt) | עשירות n (aszires) | אוצר m (ojcer) | מטמון m (matmen)
zamożny - רײַך (rajch)
zanik - אונטערגאַנג m (untergang)
zapad - אונטערגאַנג m (untergang) | זון־אונטערגאַנג m (zun-untergang) | מערבֿ m (majrew)
zapaleniec - פֿאַרברענטער m
zapałka - שוועבעלע n (szwebele)
zapalniczka - אָנצינדער m (oncinder)
zapamiętywać - אײַנחזרן (ajnchzrn)
zapewne - קענטיק (kentik) | אַ פּנים (a ponem) | דאַרפֿן (darfn)
zapierdolić - טאָן / געבן אַ קלאַפּ (ton / gebn a klap) | אַ האַק טאָן (a hak ton) | געבן (gebn)
zapominać - פֿאַרגעסן
zaprawdę - אין דער אמתן (in der emesn)
zaproszenie - אײַנלאַדונג | פֿאַרבעטונג
zaprzaństwo - בגידה f (bgide)
zarabiać - פֿאַרדינען (fardinen)
żargon - זשאַרגאָן m (żargon)
żarłok - פֿרעסער m (freser)
żarówka - לעמפּל n (lempl)
żartować - וויצלען זיך ,חכמהן ,שפּאַסן
żartowniś - מאַרשעליק m (marszelik)
zasadniczy - קנופּיק (knupik)
zasłużenie - גערעכט (gerecht)
zasłużony - גערעכט (gerecht) | כּשר פֿאַרדינט (koszer fardint)
zasobny - רײַך
zasrany - פֿאַרקאַקט
zastanawiać - טראַכטן (trachtn) | באַטראַכטן (batrachtn) | באַטראַכטן זיך (batrachtn zich) | קלערן (klern)
zastanowienie - אַכט f (acht)
zasuwka - ריגל m (rigl)
zatrudniać - אָנשטעלן (onszteln)
zatrzymać - לאָזן בײַ זיך (lozn baj zich)
zatrzymywać - לאָזן בײַ זיך (lozn baj zich)
zawiadamiać - איבערגעבן (ibergebn) | לאָזן וויסן (lozn wisn)
zawierne - אמת
zawieszać - הענגען (hengen)
zawód - פּראָפֿעסיע f (profesje) | אַנטוישונג f (antojszung)
zawodzić - יאָמערן (jomern)
zawracać głowę - האַקן אַ טשײַניק (hakn a czajnik)
zawstydzać - פֿאַרשעמען (farszemen) | פֿאַרשעמען זיך (farszemen zich)
zazdrość - קינאה f (kine)
zazula - קוקאַווקע f (kukawke)
zazulka - משה־רבנוס קיִעלע n (mojsze-rabejnes kiele) | משיחל n (mesziechl)
zazwyczaj - בדרך־כּלל
zbędny - אומנייטיק (umniitik)
zbierać - קלײַבן (klajbn)
zbijać bąki - ער קלערט, צי אַ פֿלוי האָט אַ פּופּיק (er klert, ci a floj hot a pupik)
żbik - וואַלדקאַץ f (waldkac)
zbliżać - אונטערגיין (untergejn)
zbliżenie - ביאה f (bie)
zboże - תּבֿואה f (twue)
zbrodnia katyńska - קאַטינער הריגה f (katiner harige)
żdać - וואַרטן (wartn)
zdalasiały - מיד (mid) | פֿאַרמאַטערט (farmatert)
zdarzać - טרעפֿן זיך (trefn zich) | זײַן (zajn)
zdawać sobie sprawę - כאַפּן זיך (chapn zich)
zdenerwowanie - צעזעצעניש f (cezecenisz)
zdjęcie - פֿאָטאָגראַפֿיע f (fotografje)
zdrada - בגידה f (bgide)
zdrowie - געזונט n (gezunt)
zdrowy - געזונט (gezunt)
ździebluchno - אַ ביסל (a bisl)
zdzierać - אַוועקרײַסן (awekrajsn)
ze - פֿון וועגן (fun wegn) | קעגן (kegn)
że - אַז (az) | דאָס (dos) | וואָס (wos)
-że - זשע (że)
żeby - כּדי (kedej) | זאָלן (zoln)
zecer - שריפֿטזעצער m (szriftzecer)
zegar - זייגער m (zejger)
zegarek - זייגערל n (zejgerl)
zegarmistrz - זייגער-מאַכער m (ziiger-macher) | זייגער־מאַכער m (zejger־macher)
zegar słoneczny - זונזייגער m (zunzejger)
żegleń - קוילנשטאָף m (kojlnsztof) | קויל (kojl)
żel - טעלער m (teler)
żelazko - פּרעסײַזן m (presajzn) | פּרעסל n (presl)
żelazo - אײַזן (ajzn)
zemsta - נקמה
żenąć - כאַפּן (chapn)
żeńczyna - פֿרוי f (froj)
żeński - ווײַבלעך (wajblech) | פֿעמינין (feminin)
żerdź - דרוק m (druk)
zeszyt - העפֿט f (heft)
ze względu na - פֿון וועגן (fun wegn) | וועגן (wegn)
zez - שיקלען (sziklen) | פֿון וועגן (fun wegn) | קעגן (kegn)
żgać - דערקוטשען (derkuczen)
zgadzać - מסכּים זײַן (maskem zajn) | געבן גערעכט (gebn gerecht) | צונויפֿרעדן זיך (cunojfredn zich)
żgak - קין m (kin)
Zgierz - זגערזש (zgerż)
zgoda - מסכּים (maskem)
żgok - קין m (kin)
z grubsza - גראָב (grob)
zgryźliwiec - קיפּלער m (kipler)
zgryzota - צער m (car) | צרה f (core)
zguba - אונטערגאַנג m (untergang)
ziąb - קעלט f (kelt)
zic - דאָס m (dos)
zicherka - אַגראַפֿקע f (agrafke)
zielony - גרין (grin)
Ziemia - ערד f (erd)
ziemniak - בולבע
zieziulka - קוקאַווקע f (kukawke)
zima - ווינטער m (winter)
zimnica - פֿיבער m (fiber) | היץ f (hic)
zimno - קעלט f (kelt) | קאַלט (kalt)
zimny - קאַלט (kalt)
zista - באָבע f
zjeść zęby - אויפֿעסן די ציין (ojfesn di cejn)
złamać - צעברעכן
złodziej - גנבֿ m (gnw) | לאַטכער m (latcher)
złość - כּעס m (kaas) | געבייזער n (gebejzer)
złotko - גאָלד n (gold)
złotnik - גאָלדשמיד m (goldszmid)
złoto - גאָלד n (gold)
złotówka - גילדן m (gildn) | גאָלד (gold)
złoty - גאָלד (gold) | גילדן m (gildn)
zły - אויפֿגעקאָכט (ojfgekocht)
zmagać się - ווערן זיך (wern zich)
zmarszczka - מאַרשטשקע f | קנייטש m
z marszu - קוקן און (kukn un)
zmartwienie - טרויער m (trojer) | ערגערניש n (ergernisz) | צער m (car) | צרה f (core) | דאגה f (dajge)
zmęczony - מיד (mid) | פֿאַרמאַטערט (farmatert)
zmiana - ענדערונג f (enderung) | בייטונג f (bejtung) | אַרבעטערגרופּע f (arbetergrupe)
zmieniać - איבערבײַטן (iberbajtn) | איבערמאַכן (ibermachn) | וואַריִיִרן (wariirn) | ווערן (wern)
zmierzać - לאָזן זיך (lozn zich)
zmysł - חוש m (chosz)
zmysłowo - תּאווהדיק (tajwedik)
zmysłowy - תּאווהדיק (tajwedik)
znać - קענען (kenen) | קענען זיך (kenen zich) | זײַן אין דער היים (zajn in der hejm)
znachor - רופֿא m (rojfe)
znaczek - מאַרקע
znaczek pocztowy - מאַרקע
znaczenie - באַדײַטונג f (badajtung)
znacznie - שיין (szejn)
znaczny - שיין (szejn)
znajda - אונטערגעוואָרפֿן קינד
znajdować - זײַן (zajn)
znajomość - קענען n (kenen) | קענטעניש n (kentenisz) | וויסן n (wisn) | וויסנשאַפֿט n (wisnszaft)
znajomy - באַקאַנטער m (bakanter) | קענטלעך (kentlech)
znakomicie - גרויסאַרטיק (grojsartik)
znakomity - גרויסאַרטיק (grojsartik)
znany - באַוווּסט (bawust)
znawca - ידען m (jadn) | מבֿין m (mejwn) | קענער m (kener)
zniechęcać - אָפּהאַקן די פֿליגל (ophakn di fligl)
znienacka - פּלוצעם (plucem)
znosić - אָננעמען פֿאַר ליב (onnemen far lib)
zob. - זען (zen)
zobaczyć - זען (zen)
zol - פּאָדלאָגע f (podloge)
zola - פּאָדלאָגע f (podloge)
żołądek - מאָגן m (mogn)
żołądź - צלם m (cejlem)
żółć - געל (gel)
żołędny - צלם m (cejlem)
żółty - געל (gel)
żółw - טשערעפּאַכע f (czerepache)
zołza - יענטע f (jente)
żona - פֿרוי f (froj) | ווײַב n (wajb)
zostawać - ווערן (wern)
zostawiać - לאָזן (lozn)
zozula - קוקאַווקע f (kukawke)
z powodu - פֿון וועגן (fun wegn) | וועגן (wegn)
z powrotem - צוריק (curik)
zrażać - אָפּהאַקן די פֿליגל (ophakn di fligl)
z reguły - בדרך־כּלל (baderech-klal)
źrenica - אויג n (ojg)
zresztą - הײַנט (hajnt)
źródło - קוואַל m (kwal)
zrozumiały - פֿאַרשטענדלעך (farsztendlech) | קלאָר (klor) | באַגרײַפֿלעך (bagrajflech)
zrozumiały sam przez się - קלאָר ווי דער טאָג (klor wi der tog)
zrozumienie - פֿאַרשטענדעניש | פֿאַרשטאַנד
zrywać - קלײַבן (klajbn) | אַוועקרײַסן (awekrajsn)
źrzały - צײַטיק (cajtik)
zsiadłe mleko - זויערמילך f (zojermilch)
ZSRR - פֿסס״ר (fssr)
żuć - קײַען (kajen)
zuchwały - פֿרעך
zupa - זופּ f (zup)
żurnalista - זשורנאַליסט m (żurnalist)
żurnalistka - זשורנאַליסטקע f
zwać - אָנרופֿן (onrufn) | אַ נאָמען געבן / טאָן (a nomen gebn / ton) | הייסן (hejsn) | אָנרופֿן זיך (onrufn zich)
związać - צובינדן (cubindn) | פֿאַרבינדן (farbindn) | בינדן (bindn)
związek - בונד m (bund)
związek frazeologiczny - פֿראַזעאָלאָגיזם m (frazeologizm)
Związek Socjalistycznych Republik Radzieckich - פֿאַרבאַנד סאָוועטישע סאָציאַליסטישע רעפּובליקן
związywać - צובינדן (cubindn) | פֿאַרבינדן (farbindn) | בינדן (bindn)
zwierzak - חיה f (chaje) | בעל־חי m (bal-chaj) | בהמה f (behejme)
zwierzę - חיה f (chaje) | בעל־חי m (bal-chaj) | בהמה f (behejme)
zwierzę domowe - גלעטלינג (gletling)
zwijać manatki - אַוועקפּאַקן זיך (awekpakn zich)
zwinąć - ראָלן (roln)
zwlekać - אַרומדרייען זיך (arumdrejen zich) | אָפּלייגן אין דער לאַנגער באַנק אַרײַן (oplejgn in der langer bank arajn)
zwłoki - טויטער m | ברמינן m | מת m
zwolennik - אָנהענגער m (onhenger) | ליבהאָבער m (libhober) | חסיד m (chosid / chosed)
zwyciężać - געווינען (gewinen)
zwyknąć - פֿלעג (fleg)
zwyrodnialec - דעגענעראַט m (degenerat)
żyć - לעבן (lebn)
życie - לעבן n (lebn)
żyć jak pies z kotem - לעבן צווישן זיך ווי צוויי קעץ אין איין זאַק (lebn cwiszn zich wi cwej kec in ejn zak)
życzliwie - אין גוטן מוט (in gutn mut)
żyd - ייִד m (jid) | ישׂראל m (jisroel) | חזיר m (chazer)
Żyd - ייִד m (jid) | ישׂראל m (jisroel)
żydowski - ייִדיש (jidisz) | ייִדיש n (jidisz)
żydowskość - ייִדישקייט (jidiszkejt) | דאָס פּינטעלע ייִד n (dos pintele jid)
żydożerstwo - שׂינאת־ישׂראל f
żyła - אָדער m (oder)
żylak - געדראָלענע אָדערן (gedrolene odern)
żyletka - גאָלמעסערל n (golmeserl)
zymft - מושטאַרדע f (musztarde) | זענעפֿט m (zeneft)
żymła - בולקע f (bulke) | זעמל f (zeml)
żynich - חתן m
żyrafa - זשיראַף m (żiraf)
żyrandol - הענגלײַכטער m (henglajchter) | זשיראַנדאָל m (żirandol)
zysk - רווח m (rewech) | פּראָפֿיט m (profit) | נוץ m (nuc) | נוצן m (nucn)
żywić - אויסהאַלטן (ojshaltn) | אויסהאַלטן זיך (ojshaltn zich) | עסן (esn)
żywina - בהמות (behejmes)
żywność - עסנוואַג n
żywny - לעבעדיק (lebedik) | שלאָגיק (szlogik) | זשוואַווע (żwawe)
żywotnie - בלוטיק (blutik)
żywy - לעבעדיק (lebedik) | שלאָגיק (szlogik) | זשוואַווע (żwawe)
