a - og, men
a. - el.
AA - AA (Anonyme Alkoholikere)
abak - abacus
abakus - abacus
abat - abbed w
abażur - lampeskærm n
abbuś - præst w
ABC - ABC / abc w
abdykacja - abdikation
abecadlny - alfabetisk
abecadło - alfabet n
abecadłowy - alfabetisk
Abelard - Abelardo
abfal - fejl w
Abidżan - Abidjan
abiecadło - alfabet n
abituria - studentereksamensbevis n
abiturient - student w
ablegierek - barn n
abo - eller
abonament - abonnement n
abonent - abonnent w
aborcja - abort w
ABS - ABS
absencja - fravær n
absolucja - absolution w
absolutny - absolut
absolutyzm - absolutisme w
absolwent - dimittend w
abstrahować - abstrahere (fra ngt)
abstynencja - abstinens w
abstynent - afholdsmand w
absurd - absurditet w
absurdalny - absurd
aby - for at
aceton - acetone w
acetylen - acetylen n
Achilles - Achilleus m, Akilles m
acz - dog
aczkolwiek - dog
adadżio - adagio
Adam - Adam
adapter - grammofon w, pladespiller w
adaptować - adaptere
addendum - addendum n
adekwatność - adækvathed w
Adelajda - Adelaide
administrator - administrator w
administrowanie - administrering w
adonis - adonis w
Adonis - Adonis
adopcja - adoption w
adoptować - adoptere
adres - adress w
adresat - adressat w
adwent - advent w
adwentnik - december w
adwentysta - adventist w
adwersarz - opponent w
adwokat - advokat w
adwokat diabła - djævelens advokat
aerodrom - lufthavn w
aerodynamika - aerodynamik w
aerometr - aerometer n
aeroplan - fly n, flyvemaskine w
afa - abe w, snabel-a n
afekcja - affektion w
afekt - affekt w
afektacja - affektation w
afektować - affektere
afektowany - affekteret
afektowny - affektiv
afektywny - affektiv
afelzina - appelsin w
afera - affære w
Afganistan - Afghanistan
afrodyzjak - afrodisiakum n, elskovmiddel n
Afryka - Afrika n
AGD - hvidevarer
agenda - agenda w
agent - agent w
agnostycyzm - agnosticisme w
agrafia - dysgrafi
agrafka - sikkerhedsnål w
agrawacja - aggravering w
agresja - aggression w
agrest - stikkelsbærbusk, stikkelsbær
agresywny - aggressiv
agronomia - agronomi
ajmer - spand w, spand
ajnfachowy - dårlig, ringe, elendig
akademia - akademi n
akademie - akademi n
akalkulia - acalculia w
akcent - accent w
akcentować - accentuere
akceptować - acceptere
akceptowalny - acceptabel
akcesja - accession w
akcja - aktion w, aktie w
akcjonariusz - aktiehaver w, aktieejer w
akomodacja - akkomodation w
akord - akkord w
akordeon - akkordeon n
akordeonista - akkordeonist w
akrobata - akrobat w
akronim - akronym n
akt - handling w, akt w, nøgenstudie
aktor - skuespiller w
aktorka - skuespillerinde w
aktualny - aktuel
aktyn - actinium
aktywny - aktiv
akuratnie - lige
akuratny - præcis, eksakt, nøjagtig
akuszeria - obstetrik w
akuszerka - jordemoder w
akuzatyw - akkusativ w, genstandsfald n
akwamaryn - akvamarin w
akwamaryna - akvamarin w
akwarium - akvarium n
akwedukt - akvædukt
a kysz - væk
Aladyn - Aladdin
alarm - alarm w
Albańczyk - albaner w
Albania - Albanien n
albański - albansk
albinizm - albinisme w
albinos - albino w
albo - eller
album - album n
albumina - albumin n
ale - men
alegoria - allegori w
alfa - alfa n
alfabet - alfabet n
alfabetu - alfabet n
alfabetyczny - alfabetisk
alfons - alfons w
algida - prostitueret w
Algieria - Algeriet n
algorytm - algoritme w
alians - alliance w
alibi - alibi n
aligator - alligator w
alimenty - alimentation w, alimentationsbidrag n
alkohol - alkohol w
alkoholik - alkoholiker m, alkoholist w
alkoholizm - alkoholisme w
alkoholowy - alkoholisk
Allach - Allah
Allah - Allah
alleluja - halleluja
almanach - kalender
almaryjo - skab n
alokacja - allokering
alpinizm - bjergbestigning
Alpy - Alperne
ałsztojer - medgift w
alt - alt w
alternator - vekselstrømsgenerator w
altówka - bratsch w, viola w
altruista - altruist w
altruizm - altruisme w, næstekærlighed w
aluminium - aluminium
aluzja - allusion w, hentydning w, antydning w
amajza - myre w
Amanda - Amanda
amator - amatør w
ambasada - ambassade w
ambasador - ambassadør w
ambirz - ingefær w
ambiwalencja - ambivalens w
ambiwalentny - ambivalent
ambona - prædikestol w, hochstand
ambrazura - skydeskår n
ambus - ambolt w
ameba - amøbe w
ameryk - americium
Amerykanin - amerikaner w
amerykanizacja - amerikanisering w
amerykanizm - amerikanisme w
Amerykanka - amerikanerinde w
amerykański - amerikansk
Ameryka Środkowa - Mellemamerika n, Centralamerika n
amfa - amfetamin
amfetamina - amfetamin
amfibia - amfibium n
Amman - Amman
amnestia - amnesti
amnestyja - amnesti
amnezja - amnesi w
amoniak - ammoniak
amper - ampere w
amperogodzina - amperetime w
ampułka - ampul w
amputacja - amputation w
amputować - amputere
amsterdamski - amsterdamsk
Amu-daria - Amu Darja
amunicja - ammunition w
anachronizm - anakronisme
anafilaksja - anafylaksi
anaglif - anaglyf
analfabeta - analfabet w
analizator - analysator w
analizować - analysere
anamneza - anamnese w
ananas - ananas w
anarchia - anarki w
anarchista - anarkist w
Anastazja - Anastasia
Anastazy - Anastasios
Anatolia - Anatolien
anatomia - anatomi w
anatomiczny - anatomisk
Andora - Andorra n
andorski - andorransk
andrologia - andrologi
Andromeda - Andromeda
androny - vrøvl n
Andrzej - Anders
Andy - Andesbjergene
anegdota - anekdote w
anekdota - anekdote w
anektować - annektere
anemia - blodmangel w, anæmi w
anemometr - anemometer n
anestezjolog - anæstesiolog w, anæstesilæge w, narkoselæge w
Aneta - Annette
Angelika - Angelica
angielski - engelsk
angielskojęzyczny - engelsksprogede
Anglia - England n
anglicyzm - anglicisme w
Anglija - England n
Anglik - englænder w
anglojęzyczny - engelsksprogede
anglomania - anglomani w
angol - englænder w, engelsk
Angol - englænder w
angryst - stikkelsbærbusk, stikkelsbær
ani - eller, heller ikke, ejheller, ikke (endnu) en/et
anilina - anilin
anioł - engel w
Anioł Stróż - skytsengel w
anion - anion w
Anita - Anita
aniżeli - lavtryk n, end
anjoł - engel w
Ankara - Ankara
Anna - Anna, Anne
anoda - anode w
antagonizm - antagonisme w
Antananarywa - Antananarivo
Antares - Antares
Antarktyda - Antarktis
antena - antenne w
antidotum - modgift w
antonim - antonym n
antrejka - veranda w, gang w
antropo- - antropo-
antropologia - antropologi w
antropomorfizm - antropomorfisme w
antycypacja - anticipation w, foregribelse w
antydatować - antedatere
antyfaszystowski - antifascistisk
antyk - antik w, antikvitet w
antyklerykalizm - antiklerikalisme w
antykomunista - antikommunist w
antykomunistyczny - antikommunistisk
antykomunizm - antikommunisme w
antykwariusz - antikvar w, antikvarboghandler w
antykwarz - antikvar w, antikvarboghandler w
Antyle Holenderskie - Nederlandske Antiller
antylopa - antilope w
antymon - antimon
antyoksydant - antioxidant / antioxydant w
antypapież - modpave w
antypatia - antipati w
antysemita - antisemit w
antyutleniacz - antioxidant / antioxydant w
anulować - ophæve, annullere
anyż - anis w
anyżek - anis w
Anzelm - Ansam
aorta - aorta w
apałonik - grydeske w, øseske w
aparat - apparat n
aparat fotograficzny - kamera n
apasz - forbryder m, lovovertræder w
apatryda - statsløs
Apeniny - Appenninerne
apertura - blænde / blænder w
aplikacja - applikation w
apluzyna - appelsin w
Apollo - Apollon
apostazja - apostasi n
apostrof - apostrof w
apoteoza - apoteose w
aprykoza - abrikos w
apryl - april w
apsik - atju!
a psik - atju!
apsyda - apsis w
aptek - apotek n
apteka - apotek n
ar - ar w
Arab - araber
Arabia Saudyjska - Saudi-Arabien n
arabski - arabisk
arabus - araber
arachnofobia - araknofobi w
Aragonia - Aragonien
arak - arrak w
arbitralny - arbitrær
arboretum - aboret n
arbuz - vandmelon w
archeolog - arkæolog w
archeologia - arkæologi w
architekt - arkitekt w
architektonika - arkitektur w
architektura - arkitektur w
archiwum - arkiv n
arcybiskup - ærkebiskop w
arcydzieło - mesterværk n, mesterstykke n
arena - arena w, skueplads w
argentan - nysølv
Argentyna - Argentina
argon - argon
argument - argument n
aria - arie
arka - ark w
-arka - -er, -inde
Arktyka - Arktis n
Armenia - Armenien n
armia - hær w
armijo - hær w
arsen - arsen
artefakt - artefakt n
arteria - arterie w, pulsåre w, færdselsåre w
artykuł - artikel w, vare w, stykke n, kendeord n
artykuły gospodarstwa domowego - hvidevarer
artystyczny - artistisk
arystokrata - aristokrat w
arytmetyk - aritmetiker w
arytmetyka - aritmetik w
arytmetyzacja - aritmetisering w
-arz - -er
as - es n
asfalt - asfalt w
aspekt - aspekt w
aspiryna - aspirin w
asta - gren w, rand, branche w
astat - astat
asteroida - asteroide w
asterysk - asterisk w
astma - astma w
astmatyk - astmatiker w
astrologiczny - astrologisk
astronautyka - astronautik w
astronom - astronom w
astronomia - astronomi w
astronomio - astronomi w
asygnata - assignation, pengeseddel w, seddel w
asymetryczny - asymmetrisk
Asyria - Assyrien
asza - aske
aszynbecher - askebæger n
atak serca - hjerteinfarkt, hjerteanfald n, hjertetilfælde n
atandzić - banke
ateista - ateist w, gudsfornægter w
atencja - opmærksomhed w, agt w, bemærkning w, bebrejdelse w, reprimande w, pas på!
Ateny - Athen
ateusz - ateist w, gudsfornægter w
atlas - atlas n
atmosfera - atmosfære
atmosferyczny - atmosfærisk
atol - atol w
atom - atom w
atomowy - atom-, atombar
atrium - atrium w
atu - trumf w
atut - trumf w
audycja - udsendelse w
audytorium - foredragssal w, auditorium n
aukcja - auktion w
aura - aura w
Austria - Østrig
Austro-Węgry - Østrig-Ungarn
aut - out, ude
auto - auto, bil w
auto- - auto-, selv-, bil-
autobana - motorvej w
autobiografia - autobiografi w, selvbiografi w
autobus - bus w
autobusowy - bus-
autocenzura - selvcensur w
autohipnotyczny - selvhypnotisk
autohipnoza - autohypnose, selvhypnose
autokar - bus w
autoklaw - autoklave
automat - automat w
autonomia - autonomi w
autonomiczny - autonom
autopsja - autopsi w, obduktion w, erfaring w
autor - autor m, forfatter w
autorytet - autoritet w
autostrada - motorvej w
awangardowy - avantgardist
awantura - ballade w
awersja - aversion w
aż - så
Azerbejdżan - Aserbajdsjan n
Azerbejdżanin - aserbajdsjaner w
azerbejdżański - aserbajdsjansk
Azja - Asien n
Azja Mniejsza - Lilleasien
azot - nitrogen n, kvælstof n
azotan - nitrat
B - akkusativ w, genstandsfald n
baba - kone w, kælling w, kvindemenneske n
babcia - bedste m, bedstemor m, bedstemoder m, mormor m, farmor w
babie lato - flyvende sommer
babka - bedste m, bedstemor m, bedstemoder m, mormor m, farmor w
babsko - kælling w, gimpe w
bachraty - tyk, fed, overvægtig
bać się - være bange
baczyć - passe på, synes, finde, anse, overveje
badanie - undersøgelse w, forskning w
badejki - badebukser w
Badenia-Wirtembergia - Baden-Württemberg
badki - badebukser w
badyl - ukrudt n
bądź - eller
bagaż - bagage w
bagnet - bajonet w
bajer - løgn w
bajerować - lyve
bajgiel - bagel w
bajka - eventyr n
bajstruk - bastard w
bajt - byte w
bajtel - barn n
bajtoła - dovenlars w
bajura - mudder n, dynd n
bajzel - rod n, bordel n, horehus n
bakałarz - lærer w
bakteria - bakterie w
bakteryjny - bakteriel
bal - bal n
bala - bold w, boldkast w, sav w
bałagan - rod n
bałak - samtale w, konversation w
balon - ballon w
bałtycki - baltisk
Bałtyk - Østersøen w
bałwan - snemand m, afgud w, afgudsbillede n, fæhoved, dumrian, høj bølge, sø
bambosz - futsko w
bambus - bambus w
bana - tog n, sporvogn w
banan - banan w
banana - banan w
bandyta - bandit w
bandzioch - mave w
bandzior - bandit w
banerka - dåse w
bania - hoved n, leder w, overhoved n
baniaczek - hat w
baniak - hoved n, leder w, overhoved n
bank - bank m
banka - sporvogn w
bańka - blære w, boble w
banknot - pengeseddel w, seddel w
bankomat - pengeautomat w, hæveautomat w, kontantautomat w, bankomat w
bar - bar w, barium
barabola - kartoffel w
barak - barak w
baran - vædder w
Baran - Vædderen w
barani - vædder-
Barbados - Barbados n
bard - barde w, skjald w
bardyzana - hellebard
bardzo - meget, megen, mere, mest +
bark - skulder m, bark w
barki - skulder m, bark w
barman - bartender w, (barmand w)
barokowy - barok
barometr - barometer n
baron - baron
barszcz - borstj, rødbedesuppe w, hvid borstj
barwa - farve w
barzej - meget, megen, mere, mest +, mange
bas - bas w, mave w
basarunek - erstatning w
basen - svømmebassin n, svømmepøl w, stikbækken w, sengebækken w
basior - pisk w
basset - bassethund w
basta - nok
bastard - bastard w
basza - urskov w
batarejka - lygte w
batki - trusser, badebukser w
batłąch - flaske w
batuta - dirigentstav w, taktstok w
batymetria - bathymetri
bawełna - bomuld
bawić - underholde
baza - base w, basis w
bażant - fasan w
bazar - basar w
bazylia - basilikum w
be - mæh
bebech - mave w
bęben - tromme w, mave w
beczeć - græde
beczka - tønde w
bedki - svamp w
bednarski - bødkers-
bednarz - bødker w
befsztyk tatarski - tatar w
bejm - penge
bękart - bastard w
belfer - lærer w
Belgia - Belgien
Belize - Belize n
belona - hornfisk w
bengalski - bengalsk, bengali n
Beniamin - Benjamin
Benin - Benin n
benzyna - benzin w
berga - sten
Bergamo - Bergamo
berkel - berkelium
berlińczyk - berliner w
berliński - berlinsk
Berlin Zachodni - Vestberlin
beryl - beryllium
beta - beta
beton - beton w
betoniarka - betonblander w
bety - pyjamas w
bez - uden
bezalkoholowy - alkoholfri
bezboleśnie - smertefrit
bezcenny - ubetalelig, uvurdelig
bezczelny - uforskammet, fræk
bezdomny - hjemløs
beze - uden
bezlitosny - hensynsløs, nådeløs
beznadziejnie - håbløst
bezokolicznik - navnemåde w, navneform w, infinitiv w
bezosobowy - upersonlig
beżowo - beige
beżowy - beige
bezpieczeństwo - sikkerhed w
bezpiecznik - sikring w
bezpłatnie - gratis, forgæves
bez pracy nie ma kołaczy - man skal yde før man kan nyde
bez pracy nie ma płacy - man skal yde før man kan nyde
bezprzewodowy - trådløs
bezrobocie - arbejdsløshed w
bezuch - besøg n
bezwartościowy - værdiløs
bezzębny - tandløs
białko - æggehvide w, hvide w
Białoruś - Hviderusland, Belarus
Białorusin - hviderusser w
białoruski - hviderussisk
biały - hvid
biber - hat w
Biblia - Bibelen
bibliografia - bibliografi
biblioteka - bibliotek n
bibliotekarz - bibliotekar w
bić - banke, slå, præge
bicykl - væltepeter
bicz - pisk w
bida - fattigdom w, armod, smalhals
bidet - bidet n
bidon - cykelflaske w
biec - løbe
bieda - fattigdom w, armod, smalhals
biedak - fattig person, stakkel
biedny - fattig, arm, stakkels
biedny jak mysz kościelna - fattig som en kirkerotte
biedronka - mariehøne w
bieg - løb n, gear n
biegacz - løber w
biegnąć - løbe
biegun - pol w
biegunka - diaré w, diare w, diarré w, diarre w
bierne palenie - passiv rygning w
biernik - akkusativ w, genstandsfald n
bierny palacz - passiv ryger w
bierzmowanie - konfirmation
bieżący - løbende
bieżeć - løbe
biglosko - strygejern n
bigoteria - bigotteri n
bikini - bikini w
biksa - dåse w
bilateralny - bilateral, tosidet
bilet - billet w
biliard - billiard w
bilion - billion w
bimba - sporvogn w
bindasz - penis w
binder - slips n
bindka - slips n, strik/strikke w
binia - pige m, kærste w
bio- - bio-
biochemia - biokemi w
biograf - biograf w
biografia - biografi w
biolog - biolog w
biologia - biologi w
biologiczny - biologisk
bioróżnorodność - biodiversitet w
biotechnologia - bioteknik w
biseksualny - biseksuel
bishalter - brystholder w, bh w
biskup - biskop w
bistro - bistro w
bitwa - slag n
biurko - skrivebord n
biuro podróży - rejsebureau )
biurowiec - kontorbygning w
biusthalter - brystholder w, bh w
biustonosz - brystholder w, bh w
bizmut - bismut n, vismut
blacha - metalplade w
błąd - fejl w
błąd ortograficzny - stavefejl w
bladź - prostitueret w
blaga - løgn w
błagać - bede, bønfalde
blat - plade w
blaza - slange w
błecha - loppe w
błędne koło - ond cirkel w
błękitna krew - blåt blod
błękitny - himmelblå
bliski - nær
blisko - tæt, nær
blizna - ar n
bliźniaczka - tvillingesøster / tvillingsøster w
bliźniak - tvilling w, tvillingebror / tvillingbror / tvillingebroder w
Bliźniak - tvilling w
Bliźnięta - Tvillingerne, tvilling w
blok - blok w, bolig blok w, husblok w
blok mieszkalny - blok w, bolig blok w, husblok w
blondynka - blondine w
błotnik - skærm w
błoto - mudder n, dynd n
blubry - vrøvl n, sludder n
blumkol - blomkål w
bluszcz - vedbend w, efeu w
błyskawica - lyn n
błyskawicznie - lynhurtigt
błyskawiczny - lynhurtig
bm. - d.m.
bo - fordi
boa - boaslange w, boa w
bób - hestebønne w, (bønnevikke w)
boba - hue w, marihuana w
bóbr - bæver m, bæverpels w
bobslej - bobslæde w
bocian - stork w
bóg - gud
Bóg - Gud w
bogacz - rigmand w
bogatka - musvit w
bogaty - rig
bogini - gudinde w
bohater - helt w
bohaterka - heltinde w
Bohemia - Tjekkiet, Bøhmen
bohr - bohrium
boja - bøje w
bójka - slagsmål n
bojtlik - tegnebog w
boks - boks w, boksekamp w
bokserki - boksershorts
ból - pine w, smerte w
boleć - gøre ondt, smerte, værke
Boliwia - Bolivia
bom - bom w
bomba - bombe w
bomba atomowa - atombombe w
bombel - barn n
bombka - glaskugle w, pokal w
bombowiec - bomber w
bon mot - bonmot n
bonus - bonus w
bor - bor
bordo - bordeaux
bordowy - bordeaux
Bornholm - Bornholm
borówka - tyttebær n, bær n, kind w
borówka brusznica - tyttebær n
borsuk - grævling w
borsztajn - kantsten w, fortovskant w
borykać się - slås, kæmpe
bosak - bådshage, barfodet
Bośnia i Hercegowina - Bosnien-Hercegovina n
boso - barfodet
botanik - botaniker w
botanika - botanik w
boża krówka - mariehøne w
boźdór - dreng w, knægt w, kærste w
Boże Narodzenie - jul w
br. - d.å.
brać - tage
brachol - bror w
bracieniec - bror w
brać udział - deltage
brak - mangel w
bramkarz - målmand w, dørvagt w
brat - bror w
bratanek - nevø w, brorsøn w, brodersøn m
bratobójstwo - brodermord n
bratowa - svigerinde w
brąz - bronze, bronzefarve, brun, bronzealder w
brązowy - brun
Brazylia - Brasilien n
brazyliana - kaffeplante w, kaffe w, kaffeerstatning w, kornkaffe w
brechnia - vrøvl n
brednia - vrøvl n
brele - briller
brew - øjenbryn n
brifkastla - postkasse w
briftasza - tegnebog w
briftreger - postbud n
broda - hage w, skæg n
brodzić - vade
brom - brom
broń - våben n
brosza - broche w
broszka - broche w
broszura - brochure w
browar - bryggeri n, bajer w, øl w
brud - snavs n, skidt n
brudny - beskidt, snavset, uren
bruk - brolægning w
brukiew - knudekål w
Bruksela - Bryssel n, Bruxelles n
brukselka - rosenkål w
brusić - skærpe
brusznica - tyttebær n
brutto - brutto, bto.
brydż - bridge w
bryka - bil w
brylant - brillant w
bryle - briller
brzeg - kyst w, kant w
brzemienny - gravid
brzmienie - lyd
brzoskwinia - fersken w
brzuch - mave w
brzuszek piwny - ølmave w
brzydki - grim
brzydkie kaczątko - grim ælling
brzytwa - ragekniv w, barberkniv w
bubek - knægt w
buc - pik w
buchalter - bogholder w
buda - skole w
buddyzm - buddhisme w
budowa - byggeri n, bygning w, byggeplads, opbygning w, struktur w
budować - bygge
budowa ciała - bygning w
budowanie - bygning w
budowla - byggeri n, bygning w, byggeplads, opbygning w, struktur w
budujący - opbyggelig, opløftende
budyń - budding w
budynek - bygning w
budzić - vække, vågne
budzik - vækkeur n
bug - bug w
bujać - skride, svinge
bujać w obłokach - svæve i skyerne
buk - bøg w, bøgetræ n
bukiet - buket
buła - rundstykke n, muskel w
bulba - kartoffel w
Bułgaria - Bulgarien n
bulić - betale
bułka - rundstykke n, muskel w
bułka z masłem - den rene barnemad
bulwa - kartoffel w
bunkier - bunker w
bunt - revolte w, oprør n
burak - roe w, bede w
burdel - bordel n, horehus n, svineri n
Burkina Faso - Burkina Faso n
burkini - burkini w
burmistrz - borgmester w
burnus - burnus w
bursztyn - rav n
burza - storm w, uvejr n
burza w szklance wody - en storm i et glas vand
burzowiny - skum n, bajer w, øl w
burżuj - burgøjser w
but - sko w
butelka - flaske w
butik - (lille tøj)butik w
but w podłodze - giv motoren/den gas!, fart!
buzi - kys n
by - at, for at
być - være
być solą w oku - være en torn i øjet på én
być w stanie - være i stand til
być w swoim żywiole - være i sit es
bydło - kvæg n
byk - tyr w
Byk - Tyren
Była Jugosłowiańska Republika Macedonii - Tidligere Jugoslaviske Republik Makedonien
bynajmniej - slet ikke, på ingen måde, langt fra
byrna - pære w (elektrisk)
bzdura - vrøvl n, sludder n
bździągwa - væggelus w, bug w
bzik - mani w
bzybzać - skære, stjæle
bzykanie - summen
C - sigte w, viser w, søger, dativ w
cackać - gøre (stort) væsen af
cajtung - avis w
całka - integral n
całki - hel
całkiem - helt, nok
całkowicie - komplet, helt, fuldstændigt
całować - kysse
całus - kys n
cały - hel
capić - lugte, stinke
capstrzyk - tappenstreg w
car - tsar/zar w
carski - zar-
cd. - forts.
cdn. - forts.
cebula - løg n
cecha - træk, egenskab, kendetegn, karaktertræk
cegła - mursten w
cel - mål n, formål n
celibat - cølibat n
celnik - tolder w
celny - træfsikker, told-
celofan - cellofan n
celownik - sigte w, viser w, søger, dativ w
cel uświęca środki - hensigten helliger midlet
cement - cement w
cena - pris w
centrum - center n
centyl - percentil
centymetr - centimeter w, centimetermål n, målebånd n
centymetr krawiecki - centimetermål n, målebånd n
cepaka - bonderøv w, grobrian w, bonde w
cepeen - tank w, tankstation w, benzinstation w
cer - cerium
cera - datter w
cerber - kerberos w, cerberus w
certacja - kamp
cesarski - kejserlig, kejser-
cesarskie cięcie - kejsersnit n
cesarz - kejser w
cesarzowa - kejserinde w
cetologia - cetologi w
cewnik - kateter n
cez - cæsium n
chabanina - kød n
chabas - kød n
chabić - stjæle
chachoł - nakke w
chałka - flettet sød hvedebrød n
cham - bonderøv w, grobrian w, bonde w
chaman - bonderøv w, grobrian w, bonde w
chamera - sky w
chamidło - bonderøv w, grobrian w, bonde w
charakter - karakter w, personlighed w
charakterystyczny - karakteristisk
charakteryzować - karakterisere
charczeć - snorke
charkać - spytte
charytatywny - velgørende
charyzma - karisma w
chata - hytte w
chatować - chatte
chcieć - ville
chciwie - grådigt
chciwość - grådighed w, havesyge w, begærlighed w
chciwy - grådig, gerrig, havesyg, begærlig, grisk
chęć - lyst w
chemia - kemi w
chemia biologiczna - biokemi w
chemiczny - kemisk
chemik - kemiker w
Cheronea - Chaeronea
Cheroneja - Chaeronea
chi - chi n, khi n
Chińska Republika Ludowa - Den Kinesiske Folkerepublik
Chiny - Kina n
chironomia - (kironomi w)
chirurgiczny - kirurgisk
chitozan - chitosan
chlać - drikke
chleb - brød n
chlew - sti w, svinesti w
chłodnik - kold suppe w
chłodny - kold
chłopak - dreng w, knægt w, kærste w
chłopiec - dreng w
chłopyszek - dreng w
chlor - klor, bums w
chlorek - klorid n
chlusnąć - sjaske
chmiel - humle w, bajer w, øl w
chmura - sky w
choć - selvom
chocia - selvom
chociaż - selvom
chocieć - ville
chód - skridt n
chodnik - fortov n
chodzić - gå
chodzi o - det handler om/drejer sig om
choinka - juletræ n
chójk - juletræ n
chojna - fyr w, fyrretræ n
cholera - kolera w
cholesterol - kolesterol n
chomik - hamster w
chór - kor n
chore - syg
choroba - sygdom w
choroba morska - søsyge w
choroba Parkinsona - Parkinsons sygdom w
Chorwacja - Kroatien n
chory - syg
chować - gemme, skjule, begrave
chów wsobny - indavl w
chrapać - snorke
chrobot - puslen w
chrom - krom n
chromosfera - kromosfære
chronić - beskytte
chroniczny - kronisk
chronologia - kronologi w
chruścik - vårflue w
chrust - klejner
chrystadelfiański - kristadelfiansk
chrystianizm - kristendom w
Chrystus - Kristus
chryzantema - krysantemum w
chrząstka - brusk w
chrześcijanin - kristen w
chrześcijański - kristen
chrześcijaństwo - kristendom w
chrzest - dåb w
chrzestna - gudmor / gudmoder w
chrzestny - gudfar / gudfader w
chuć - lyst
chudoba - fattigdom w, armod, smalhals
chuj - pik w
chujowy - dårlig, ringe, elendig
chuj z tym - op i røven (med …)
chuśle - violin w
chusteczka - lommetørklæde n
chwast - ukrudt n
chwila - øjeblik n, moment w
chwost - ukrudt n, hale w, kø w
chyba - medmindre
ciąg dalszy nastąpi - forts.
ciągle - konstant, uafbrudt, uophørlight
ciało - krop w
ciamajda - slapsvans w
ciap - futsko w
ciapa - slapsvans w
ciapryka - mudder n, dynd n
ciasnocha - skjorte w
ciasny - snæver, trang
ciasto - dej w, kage w
ciąża - graviditet n, svangerskab n
cicha woda brzegi rwie - det stille vand har den dybe grund
cicho - stille
cichy - stille
ciebie - du, De
ciecz - væske w
cięgiem - konstant, uafbrudt, uophørlight
cielę - kalv
cielesieństwo - samleje w
ciemno - mørkt, mørke n
ciemność - mørke n
ciemny - mørk
cienki - tynd
ciepać - kaste
ciepły - varm
cierpiarz - taxachauffør
cierpieć - lide
cierpienie - lidelse w
cierpliwość - tålmodighed w
cieśnina - sund n
ciężarny - gravid
ciężarówa - lastbil w
ciężarówka - lastbil w
ciężki - tung, hård, bitter, svær
ciga - ged w
ciocia - moster
ciota - pedal w, bøsserøv w
cipa - fisse w, dåse w
cipka - grønbenet rørhøne w, høne w
cis - lærk w, lærketræ n
ciśnienie - tryk n
ciupa - fængsel n
ciurlocek - penis w
ciurma - fængsel n
ciut - lidt
ciżma - sko w
cło - told w
ćma - møl, mørke n, prostitueret w
cmentarniany - kirkegårds-
cmentarny - kirkegårds-
cmentarz - kirkegård w
cmentarzysko - større kirkegård, gravsted n, nekropol
ćmić - brænde, ryge
ćmik - cigaret w
ćmok - bonderøv w, grobrian w, bonde w
ćmy - mørk
co - hvad, der, som, hver (dag, uge, ), -lig
codziennie - hver dag
cofać - tage/trække tibage
cokolwiek - nogen
cołki - hel
co nagle, to po diable - hastværk er lastværk
co najmniej - mindst
cop - knold w
córa - datter w
córczysko - datter w
córka - datter w
coroczny - årlig
coś - noget
cotangens - cotangens w
ćpać - spise, kaste
cud - mirakel w
cudzokrain - udlænding w
cudzoziemiec - udlænding w
cudzy - fremmed, andens
cudzysłów - anførselstegn n, anførelsestegn n, citationstegn n
cug - tog n
cukier - sukker n
cukierdoza - sukkerskål w
cukiernia - konditori n
cukiernica - sukkerskål w
cukierniczka - sukkerskål w
cukier puder - melis w, flormelis w, florsukker n
cukrownia - sukkerfabrik w
cukrzyca - sukkersyge w, diabetes w
cupać - sidde / sætte sig på hug
curig - tilbage, igen
cwek - tegnestift w
cwel - pedal w, bøsserøv w
cwibak - (sandkage med tørret frugt)
ćwiczenia - øvelse w
ćwiczenie - øvelse w
ćwiczenie czyni mistrza - øvelse gør mester
ćwierć - kvart w, fjerdedel w
ćwierćnuta - fjerdedelsnode w
cyc - patte w, melon w
cycero - cicero w
cychalter - brystholder w, bh w
cyckać - suge
cyferblat - urskive w, ansigt n
cyfra - ciffer n, taltegn n
cygan - snyder m, bedrager m, svindler w
cygareta - cigaret w
cygaretka - cigaret w
cyklista - cyklist w
cyklotron - cyklotron w
cylinder - cylinder w, cylinderhat w
cylindryczny - cylindrisk
cyna - tin
cynamon - kanel
cyngiel - briller
cynizm - kynisme w
cynk - zink
Cypr - Cypern
cyranka - atlingand w
cyrkiel - passer w
cyrkon - zirkon
cysorz - kejser w
cytadela - citadel n
cytryna - citron w
cytrynat - citron w
czad - sej!, kulilte
czador - chador
czaj - te
czajka - vibe w
czajnik - kedel w, hoved n, leder w, overhoved n
czapa - slapsvans w
cząpać - sidde / sætte sig på hug
czapka - hue w
czarna dziura - sort hul
czarna godzina - vanskelige tider
czarna magia - sort magi
czarna owca - familiens sorte får
czarna porzeczka - solbær n
czarna wdowa - sorte enke w
czarna wołga - sort Volga
Czarnogóra - Montenegro n
czarny - sort
czarny humor - galgenhumor w
czarny rynek - det sorte marked, sorte børs
czarownica - heks w
czary - magi w, trolddom w, hekseri n
czas - tid w, tempus n
czasami - sommetider, af og til, en gang imellem, nu og da, undertiden
czasem - sommetider, af og til, en gang imellem, nu og da, undertiden
czas niniejszy - nutid w
czasochłonny - tidskrævende
czasopismo - tidsskrift n
czasownik - udsagnsord n, verbum n
czasownik dokonany - perfektivt verbum
czasownik modalny - modalverbum n, mådesudsangsord n
czasownik niedokonany - imperfektivt verbum
czasownik nieprzechodni - intransitivt verbum
czasownik posiłkowy - hjælpeverbum n, hjælpeudsagnsord n
czasownik przechodni - transitivt verbum
czasownik zwrotny - reflexivt verbum
czas przeszły - datid w
czas teraźniejszy - nutid w
cząstka - partikel w
czas to pieniądz - tid er penge
czasza - hvælving w, drikkeskål w, skærm n
czaszka - kranie n, kranium n
czatować - chatte
Czech - tjekker w
Czechosłowacja - Tjekkoslovakiet
Czecho-Słowacja - Tjekkoslovakiet
Czechy - Tjekkiet, Bøhmen
Czeczenia - Tjetjenien n
czędo - barn n
czekać - at vente (på)
czekolada - chokolade w
czemu - hvorfor
czepiec - netmave w
czernica - brombærbusk w, brombær n
czerwiec - juni w
czerwona porzeczka - ribs n
czerwonawy - rødlig
czerwony - rød, kommunist w
Czerwony Krzyż - Røde Kors n
czerwony olbrzym - rød kæmpe w
czesać - kæmme, rede
cześć - ære w, hæder w, hej
część - del w
czeski - tjekkisk
często - tit
częstoskurcz - takykardi
częstotliwość - frekvens w, hyppighed w
częsty - hyppig, frekvent
czkawka - hikke w
członek - medlem m, lem n, penis w
człowieczy - human, menneskelig
człowiek - menneske n
czołg - tank w
czoło - pande w
czopek - stikpille w
czorny - sort, beskidt, snavset, uren
czosnek - hvidløg n
czuć - føle, føle sig, høre
czuć się jak ryba w wodzie - som en fisk i vandet
czwartek - torsdag w
czwartorzęd - Kvartær
czworokąt - firkant w
czy - om, eller
czyhunka - bane w, thorium
czyj - hvis, hvems
czyjś - nogens
czyli - eller, dvs., det vil sige
czyn - akt w, aktion w, handling w
czynić - gøre, lave, udføre
czynność - action w, handling w
czyrwiec - juni w
czyrwień - juni w
czyściec - skærsild w
czysło - tal n, nummer n
czysty - ren
czytać - læse
czytać od deski do deski - læse fra enden til anden
czytelnik - læser w
czyżyk - dreng w
D - genitiv, ejefald
dąb - eg w, egtræ n
dać - give, tillade, lade
dach - tag n
dać kosza - give en kurv
dadaistyczny - dadaistisk
Dagestan - Dagestan
daktyl - daddel w
dała - give, tillade, lade
dalece - meget, megen, mere, mest +
dalej - fjernt, borte (lang), væk
daleko - fjernt, borte (lang), væk
dalekosiężny - vidtstrakt
dalekowzroczność - langsynethed
dama - dame w, dronning w
damski - dame-
dana - givet, give, tillade, lade
dandys - dandy w, laps w
Dania - Danmark n
danie - ret w
dany - givet, give, tillade, lade
dar - gave w, talent n, talent w
darem - gratis, forgæves
daremny - frugtløs, resultatløs, forgæves
darmo - gratis, forgæves
darmsztadt - darmstadtium
darowanemu koniowi w zęby się nie zagląda - sku ikke en given hest i munden
darwinista - darwinist w
dawca - giver w, donor w
dawno - engang tidligere, længere siden
dawny - gammel
debata - diskussion w
debil - debil w
debiut - debut w
decydować - bestemme
de facto - faktisk
defekt - defekt w
defetyzm - defaitisme w
defibrylator - defibrillator w
deficyt - underskud n
definicja - definition w
definitywnie - definitivt
degradować - degradere
dek - dæk n
dekada - dekade w
Dekalog - dekalog w, De Ti Bud
dekiel - hoved n, leder w, overhoved n
dekoracja - dekoration
dekret - dekret n
delfin - delfin w, butterfly, dauphin
delta - delta n
demagog - demagog w
demagogia - demagogi w
deminutyw - diminutiv n
demobilizacja - demobilisering w
demografia - demografi
demokracja - demokrati n
demokrata - demokrat w
demolować - demolere
demonstrant - demonstrant w
dentysta - tandlæge w
denuncjować - stikke
depok - knap w
deportacja - deportation w
deportować - deportere
deprymować - deprimere
deputacja - deputation w
derby - derby n
dermatolog - hudlæge w, dermatolog w
dermatologa - hudlæge w, dermatolog w
deskorolka - rullebræt n, skateboard n
destrukcyjny - destruktiv, ødelæggende
destylacja - destillation w
deszcz - regn w
detal - detalje w, detail
dętka - slange w, glaskugle w
dewon - devon
deżdż - regn w
dezelować - ødelægge
diabeł - djævel w
diabelski młyn - pariserhjul n
diagram - diagram n
dialekt - dialekt w
dialog - dialog w
diament - diamant w
dieta - kost w
dinozaur - dinosaur w, dinosaurus w
dioda - diode w
Diogenes - Diogenes, Diogenes (fra Sinope)
dla - til
dlaczego - hvorfor
dłoń - hånd w
długi - lang, langvarig
długo - længe
długość - længde w
dłużnik - debitor w
dmuchać - blæse, bolle
dmuchanie - blæsning w
dmuchnąć - stjæle
Dniepr - Dnepr
dno - bund w
do - til
doba - døgn n
doberman - dobermann w
dobranoc - god nat
dobroć - godhed w
dobry - god
dobry wieczór - god aften
dobrze - godt
dochód - indkomst w
dodatni - positiv
do góry nogami - på hovedet, bunden i vejret (med)
doić - malke
dokąd - hvorhen, hvortil
dokładny - præcis, eksakt, nøjagtig
doktor - læge w
dokument - dokument n
do kurwy nędzy - for fanden, for satan, for poker, fuck
dół - hule w
dolar - dollar w
dolina - dal w
dolmen - dysse
dolnołużycki - lavsorbisk
dołować - deprimere, gemme, skjule, begrave
dom - hus n, hjem n
dom dziecka - børnehjem n
dominikański - dominikansk
domino - domino, dominospil n, dominobrik w
domokrążca - bissekræmmer w
domowy - huisgemaakt
dom publiczny - bordel n, horehus n
do niczego - ubrugelig
donikąd - ingen steder
dopełniacz - genitiv, ejefald
dopiero - kun, først
doprowadzać - lede, føre
doradca - rådgiver
dorosły - voksen, voksen w
Dorota - Ditte
dorsz - torsk w
doś - hvor mange, hvor meget, mange, meget
dość - nok
dosłownie - bogstaveligt
dosłowny - bogstavelig
dostarczać - levere
dostawać - få, modtage
dostęp - adgang w
dostępny - tilgængelig
dostojnik - dignitar
doświadczać - opleve
doświadczenie - erfaring w, eksperiment n
dosyć - nok
dot. - vedr., ang.
dotacja - dotation w, donation w
do trzech razy sztuka - alle gode gange tre
dotyczyć - angå, vedrøre, vedkomme
dotyk - følesans w, føleevne w
dotykać - røre
do widzenia - farvel, vi ses
dowód - bevis n
do zobaczenia - farvel, vi ses
dr - ph.d., dr.
drabina - stige w
drabka - stige w
drach - drage w
dracheta - drage w
drakońskie prawa - drakoniske bestemmelser
drapacz chmur - skyskraber w
drapanie - krating w, kradseri n
drapieżny - rov… (w złożeniach)
dratewka - skomager w
drażliwy - arrig, hidsig
drętki - sur
drewniak - træsko w
drewno - træ n
drink - drik w
drobiazg - småting n
drobne - småpenge, skillemønt w
drobnoustrój - mikroorganisme w
droga - vej w
droga ekspresowa - motortrafikvej w
Droga Mleczna - Mælkevejen w
drogi - dyr, kær
drogowskaz - vejskilt n
drop - stortrappe w
druch - konstant, uafbrudt, uophørlight
druga wojna światowa - anden verdenskrig
druh - ven w
druk - tryk n
drukarka - printer
drużynowy - fører hos spejdere
drwal - skovhugger w
drwina - ironi w, hån w
dryndziorz - taxachauffør
drżenie - dirren w, rysten w
drzewce - skaft n, stang w
drzewo - træ n
drzewo iglaste - nåletræ n
drzwi - dør w
ds. - vedr.
dubn - dubnium
duch - spøgelse n, ånd w
dudlać - græde, drikke
dudy - lunge w
duet - duet w, duo w
Duńczyk - dansker w
duński - dansk
duńskojęzyczny - dansksproget
dupa - røv w, fisse w
dupczyć - kneppe, bolle, knalde
dupek - røvhul n
dureń - nar w, tomhovedet
durś - konstant, uafbrudt, uophørlight
dusić - kvæle, strangulere
dusza - sjæl w, spøgelse n, ånd w
dutek - penge
dużo - mange, meget
duży - stor
dwoić się i troić - pukle røven ud af bukserne
dwujęzyczny - tosproget, bilingval
dwujęzykowy - tosproget, bilingval
dwukropek - kolon n
dwunastnica - tolvfingertarm w
dwupłat - biplan n, todækker w, dobbeltdækker w
dwupłatowiec - biplan n, todækker w, dobbeltdækker w
dycha - tier w
dychawica - astma w
dychotomia - dikotomi w
dycht - helt, nok, komplet, fuldstændigt
dycki - altid, konstant, stadigvæk, alligevel
dygać - løbe
dylać - danse
dyletant - dilletant w
dym - røg w
dymać - kneppe, bolle, knalde, snyde, svindle, bedrage
dymbcok - eg w, egtræ n
dymić - ryge
dymisja - demission w
dynks - noget
dysgrafia - dysgrafi
dysk - diskos w, disk w
dyskoteka - diskotek n
dysk twardy - harddisk w, (fastpladelager w)
dyskusja - diskussion w
dysleksja - dysleksi w, ordblindhed w
dysmorfofobia - dysmorfofobi w
dysonans - dissonans w
dyspensa - uddeling
dysproz - dysprosium
dysza - dyse w
dyszel - trækstang w
dywan - tæppe n
dżdżownica - regnorm w
dżem - syltetøj n
dziać - ske
dziadek - farfar w, morfar w, olding w
działać - handle, du, virke
działanie - virkning w, aktivitet w, operation w
dziąsło - tandkød n
dzidziuś - trold w
dziecięcy - barnlig, barnagtig, børne-
dziecinny - barnlig, barnagtig, børne-
dzięcioł - spætte w
dzieciszczko - barn n
dziecko - barn n
dziedziczyć - arve
dziegieć - trætjære
dzięki - takker
dziękówa - tak, takke
dziękować - takke
dziękówka - tak, takke
dziękuję - tak, takke
dziękuję bardzo - mange tak
dziela - til
dzielić - dele
dzieło - værk n
dzień - dag w
dzień dobry - god morgen, god dag
dziennikarski - journalistisk
dziennikarstwo - journalistik w
dzień wypłaty - lønningsdag
dzierżyć - holde
dziesięciokrotnie - tifold
dziewa - pige m, kærste w, jomfru w
dziewczę - pige m, kærste w
dziewczyna - pige m, kærste w
dziewiątka - nier w
dziewica - jomfru w
dżihad - jihad
dzik - vildsvin w
dziób - næb n
dziobak - næbdyr n
dzioborożec - næsehornsfugl w
dziołcha - pige m, kærste w
dziopa - pige m, kærste w
dziś - i dag
dzisiaj - i dag
dżistać - prutte
dziunia - pige m, kærste w
dziura - hul n, tandhul n
dziurkacz - hulmaskine w
dziurkacz biurowy - hulmaskine w
dziwka - ludder w
dziwny - mærkelig
dżoker - joker w
dżuma - pest w
dżungla - jungle w
dźwięk - lyd w
dźwig - elevator w
dzwon - klokke w
dzwonek rowerowy - cykelklokke w
dzwonić - ringe, telefonere
dzwony rurowe - rørklokker
ebor - elfenben n
edyficjum - bygning w
edytować - redigere
efemeryczny - kortvarig, (efemer, efemerisk)
Efialtes - Ephialtes m
Egina - Égina
Egipt - Egypten / Ægypten n
ego - ego n, jeg n
egocentryk - egocentriker w
egoista - egoist w
egzaltacja - eksaltation w, opstemthed w
egzamin - eksamen w, prøve w
egzekwować - udføre, gennemføre, eksekvere, inddrive, opkræve
egzotyczny - eksotisk
einstein - einsteinium
ejakulacja - ejakulation w, sædafgang w
ejber - dreng w, knægt w, kærste w
ekologia - økologi
ekologiczny - økologisk
ekologio - økologi
ekonomiczny - økonomisk
ekran - skærm n, filmlærred n
ekshibicjonista - ekshibitionist w, blotter w
ekshibicjonistka - ekshibitionist w, blotter w
ekshibicjonizm - ekshibitionisme w
ekskomunika - ekskommunikation w
ekskomunikować - ekskommunikere
ekspedycja - ekspedition w
eksperyment - eksperiment n
eksplikować - forklare, oversætte, fortolke
ekspresja - udtryksfuldhed w
ekstatyczny - ekstatisk
ekstaza - ekstase w
ekstensywny - ekstensiv
Ekwador - Ecuador n
ekwilibrystyka - balancekunst w
elefant - elefant w
elektro- - elektro-
elektrofiltr - elektrofilter n
elektroluks - støvsuger w
elektronika - elektronik w
elektrownia - elværk n, elektricitetsværk n, kraftværk n
elektrownia wodna - vandkraftanlæg n
elektryczność - elektricitet w, el w
elektryczny - elektrisk
elektryk - elektriker m, elinstallatør w
elektryzować - elektrisere
element - element
elementarny - elementær
elewacja - facade w
elf - elver w
elipsa - ellipse w
Elza - Elisabeth
Elżbieta - Elisabeth
embargo - embargo w
emerytura - pension w
Emili - Emilie, Emily
Emilia - Emilie, Emily
empiryczny - empirisk
encyklopedia - encyklopædi w
energia - energi w
entalpia - enthalpi
entalpia swobodna - Gibb’s fri energi, fri enthalpi
ententa - entente w
entomologia - entomologi w
entropia - entropi w
entuzjasta - entusiast w
enzym - enzym n
epidemia - epidemi n
epidemio - epidemi n
epilepsja - epilepsi w
epilog - epilog w
epoka - epoke w
epsilon - epsilon n
era - æra w
erb - erbium
erudycja - lærdom w
Eryk - Erik
erystyka - eristik w
Erytrea - Eritrea
eschatologia - eskatologi w
esemes - sms w
eskalator - rulletrappe
eskulap - læge w
esperanto - esperanto
esteta - æstet w
estetyk - æstetiker w
estetyka - æstetik w
Estonia - Estland n
estoński - estisk
eta - eta n
Etiopia - Etiopien n
etniczny - etnisk
etola - stola w
etymologia - etymologi w
etymologia ludowa - folkeetymologi w
eufemizm - eufemisme w
eugenika - eugenik w, arvehygiejne w
euro - euro w
eurocent - cent
euroentuzjasta - (euroentusiast w)
euroizacja - euroisering w
euroizować - euroisere
euroizowanie - euroisering w
europ - europium
Europa - Europa n
Europa Wschodnia - Østeuropa n
Europa Zachodnia - Vesteuropa
Europejczyk - europæer w
europejski - europæisk
eurosceptycyzm - euroskepsis w, euroskepticisme w
eurosceptyk - euroskeptiker w
ewokacja - fremkaldelse w
ewokować - fremkalde
ewolucjonizm - evolutionisme w
eż - at
Ezdrasz - Ezra
Ezop - Æsop w
ezoteryczny - esoterisk
fabryka - fabrik w
facet - fyr w, mand w
facetka - kvinde w, lærerinde w
facjata - ansigt n
fagocista - fagottist w
fagot - fagot w
fajans - fajance w, nar w, tomhovedet
fajek - smøg w, cigaret w
fajera - rat n
fajerwer - cigaret w
fajfus - penis w, kumpan w
fajka - pibe w, cigaret w, smøg w
fajka pokoju - fredspibe w
fajny - fin, køn, pæn, net, nydelig, sød
faks - fax w
fakt - faktum n
fala - bølge w
fałat - pengeseddel w, seddel w
fallus - fallos w
falochron - bølgebryder w
fałszywy - falsk
familio - familie f
familok - blok w, bolig blok w, husblok w
famuła - familie f
fana - flag n
fandzolić - lyve
fantastycznie - fantastisk
fantastyczny - fantastisk
faraon - farao w
farba - maling w
farbowany lis - rævepels w
farerski - færøsk
farmaceuta - farmaceut w
farmaceutyk - medicin w
farmakologia - farmakologi w
faryna - sukker n
fasola - bønne w
fason - facon w
faszysta - fascist w
fazan - fasan w
fedrować - arbejde, sparke, grave
fefer - peber w, peber n
fefrać się - være bange
felga - fælg
feministyczny - feministisk
feminizm - feminisme w
fenig - pfennig w
ferm - fermium
ferment - enzym n
feromon - feromon n
ferska - fersken w
fest - meget, megen, mere, mest +
festyn - fest w
feta - amfetamin
fetor - stank w
Fez - Fez
fezeła - bi w
fi - phi n
fiasko - fiasko w
Fidżi - Fiji
figa - gummitræ n
figlarz - spøgefugl w
figowiec - gummitræ n
figur - figur w
figura - figur w
fiksmatentum - småting n
fikus - gummitræ n
filia - filial w, afdeling w
-filia - -fili
filip - hare w
Filipiny - Filippinerne
film - film w
filozof - filosof w
filozofia - filosofi w
filozofia dziejów - historiefilosofi
filozofia historii - historiefilosofi
filtr - filter n
finalizować - komplettere, fulstandiggøre, ende, slutte, afslutte
finansowy - financiel
Finlandia - Finland n
fioł - mani w
fioletowy - violet, violblå
firma - firma n
firmament - firmament n
fiut - pik w
fiza - fysik w
fiżon - bønne w
fizyka - fysik w
flag - flag n
flaga - flag n
flakon - vase w
flamaster - skrivestift, griffel, fiberpen
flaming - flamingo w
flaszka - flaske w
flep - dokument n
flet - fløjte w, pik w
fliger - fly n, flyvemaskine w
flirt - flirt w, eventyr n
flora - flora w
Florencja - Firenze
flota - grunker
fluor - fluor
fobia - fobi w
-fobia - -fobi
fojerman - brandmand w
foka - sæl w
fokstrot - foxtrot w
fontanna - fontæne w, springvand n
forma - form w
formatować - formatere
formatowanie - formatering w
forsa - grunker
fort - fæstning w
forteklapa - flygel, klaver n
fortel - kneb n
fortepian - flygel, klaver n
foryster - udlænding w
fosfor - fosfor
fotograf - fotograf w
fotografia - fotografi n, foto n, billede n, fotografi w
fotograficzny - fotografisk
fotografie - fotografi n, foto n, billede n, fotografi w
fotomodel - fotomodel w
foton - foton w
fotowoltaiczny - fotovoltaisk
fotowoltaika - fotovoltaik
fowizm - fauvisme w
fragment - fragment n
frajer - fjols n
framuga - niche w, karm w
Francja - Frankrig n
francuski - fransk
francuski pocałunek - tungekys n
francuz - svensknøgle w, skiftenøgle w
Francuz - franskmand w
frank - franc w
frans - francium
fraternizacja - fraternisering w
frechowny - uforskammet, fræk
frela - pige m, kærste w
fresk - freske w, fresko w, freskomaleri n
frezarka - fræsemaskine w
frutarianizm - frugtarisme w
fryc - tysker w
Fryc - tysker w
fryzjer - frisør w
fuks - lykketræf n, slumpetræf n
fulać - lyve
fundamentalny - fundamental
funkcja - funktion w
funkcja stanu - tilstandsfunktion w
funkcjonować - fungere, funke
fura - bil w
furażerka - skråhue w
furdygarnia - fængsel n
furia - furie w
furt - igen
fusbal - fodbold w
fusekla - strompe w
futbol - fodbold w
futbolista - fodboldspiller w
futro - pels w
fyrać - flygte, rømme
fyrtel - vinkel w
gabardyna - gabardine
gablota - glasskab n
gad - krybdyr n, kryb
gadałka - spåkone w
gadolin - gadolinium
gag - gag
gaj - lund
gajowy - skovløber w
gal - gallium
Gal - galler w
gała - kugle w, knap w, øje n, fodbold w, tåbe w, høved w, ravn w, råge w, krage w
galaktyka - galakse w
galancie - mange, meget
galareta - gele w, gelé w, aspic w
gałąź - gren w, rand, branche w
galeon - galeon w
galera - galej w
Galilea - Galilæa
gałka - kugle w, knap w
gałka muszkatołowa - muskatnød w
galon - galon w, tresse w, gallon w
galoty - bukser
gamma - gamma n
ganc - helt, nok, komplet, fuldstændigt
ganek - veranda w
gang - bande w
gangster - gangster w
gapa - tåbe w, høved w, ravn w, råge w, krage w
gapić się - stirre, glo
gar - gryde w, cylinder w, cylinderhat w
gara - søvn w, drøm w
garaż - garage w
garb - pukkel w
garbus - bille
garderoba - garderobe w
gardło - hals w
garnek - gryde w, cylinder w, cylinderhat w
garota - garrotte w
gasa - gade w
gąść - spille, du, virke, fungere, stemme
gąsienica - larve w, larvefødder
gatunek - slags w, art w
gawron - råge w
gaz - gas w, gaspedal w, speeder w
gaża - gage w
gaz do dechy - giv motoren/den gas!, fart!
gazeta - avis w
gaz kominowy - røggas w
gaz musztardowy - sennepsgas
gaz spalinowy - røggas w
Gdańsk - Gdansk, Danzig
gdy - da, når
gdyby - hvis
gdy kota nie ma, myszy harcują - når katten er ude, spiller musene på bordet
gdyż - fordi
gdzie - hvor
gdzie kucharek sześć, tam nie ma co jeść - mange kokke fordærver maden (for)
gdzieniegdzie - her og der, hist og her
gdzie pieprz rośnie - hen hvor peberet gror
gdzieś - et eller andet sted, omkring, cirka
geburstag - fødselsdag w, fødsel w
gędźba - musik w
gędzić - spille, du, virke, fungere, stemme
gęgać - gække
gej - bøsse w
gemyla - rod n
generator - generator w
genetyczny - genetisk
Genezaret - Genesaret sø
geografia - geografi
geologia - geologi w
geologiczny - geologisk
geometria - geometri w
german - germanium
germański - germansk, tysk
gęś - gås w
gęsia skórka - gåsehud w
gęsiego - i gåsegang
gest - gestus, gebærde
gęstość zaludnienia - befolkningstæthed w
gibki - hurtig, hastig
gibko - hurtigt
gichać - hælde, pisse, futsko w
gierada - medgift w
giez - hestebremse w
giezło - skjorte w
gigant - gigant w
gilotyna - guillotine w
ginąć - blive tabt, omkomme, forsvinde
gira - ben w
gitara - guitar w
gitarzysta - guitarist w
głąb - dyb n
gladiator - gladiator w
glajda - mudder n, dynd n
glajza - thorium
glanc - glasur w
glapa - råge w, krage w
glaska - glas n
gleba - jord w
głębia - dyb n
głęboki - dyb
głęboko - dybt
glin - aluminium
glina - ler n, strømer w, strisser w, strissersvin n, politibetjent w, politimand w
gliniarz - strømer w, strisser w, strissersvin n, politibetjent w, politimand w
glista - regnorm w
glizda - regnorm w
globalne ocieplenie - global opvarmning w
globus - hoved n, leder w, overhoved n
głodny - sulten
głos - stemme w
głośnik - højttaler / højtaler w
głośno - højt
głośny - højlydt
głowa - hoved n, leder w, overhoved n
główny - hoved-
głuchoniemy - døvstum
głuchy - døv, hul
głupi - dum
głupiec - nar w, tomhovedet
głupi jak but - dum som et bræt, dum som en skovl, dum som en dør
głupota - dumhed w
gmina - kommune w
gnat - knogle w, ben n, terning w
gniazdo - rede w, kontakt, sokkel w
gniew - vrede w
gnot - barn n
gnu - gnu w
gnuśny - doven
go - go
godać - tale, sige, snakke
godka - tale w, tunge w, sprog n
godło - våben n, emblem n
godoć - tale, sige, snakke
Godzilla - Godzilla
godzina - time w, klokke w
godzina policyjna - udgangsforbud n, spærretid w
godzinnik - ur n
gołąb - due w
golarz - frisør w
golfista - golfer w, golfspiller w
golibroda - frisør w
golić - barbere
goły - bar, nøgen
gondola - gondol w
gongil - katar w
gonić - jage, rende, følge
goniec - løber w
gora - brand w
góra - bjerg n, loft n
górą - bjerg n
gorąc - varmt
gorąco - varmt
gorący - varm
gorączka złota - guldfeber w
górnik - minearbejder w
górnołużycki - højsorbisk, øvresorbisk
Górny Śląsk - Øvre Schlesien
gorzała - alkohol w
gość - gæst w
gościniec - landevej w, souvenir w
gotować - koge
gówno - lort w, lort n
gr - g
gra - spil n
graba - hånd w, arm w
grabarz - graver w
grabie - rive w
grać - spille, du, virke, fungere, stemme
gracz - spiller w
grad - hagl n
gradient - gradient w
gram - gram n
gramatyczny - grammatisk, grammatikalsk
gramatyka - grammatik w
gramofon - grammofon w, pladespiller w
granat - granat w, granatæble n
granatowy - mørkeblå
granica - grænse w
graniczyć - grænse
grat - spand w, vrag n
gratis - gratis
gratyfikacja - gratiale n
grdyka - adamsæble n
Grecja - Grækenland n
grecki - græsk
gregoriański - gregoriansk
Grek - græker w
greka - græsk
Grenlandia - Grønland n
grenlandzki - grønlandsk
grób - grav w
gróbarz - graver w
grobowiec - flygel, klaver n, kælder w
grobowy - grav-
gronostaj - lækat
gros - gros
groźny - truende, farlig
gruba ryba - stor kanon
gruby - tyk, fed, overvægtig
gruda - klump w
grudzień - december w
gruntownie - grundigt
grupa - gruppe w
grupa docelowa - målgruppe
gruszka - pære w
gruziński - georgisk
Gruzja - Georgien n
grycha - rundstykke n
gryf - grif w
gryfel - stift w, blyantstift w
gryfny - køn, pæn, net, nydelig, sød
grypa - influenza w
gryźć - bide
gryzoń - gnaver w
grzbiet - ryg, rygnig
grzebać - rode, grave, begrave
grzebień - kam w
grzech - synd w
grzesznica - synderinde w
grzesznik - synder w
grzeszyć - synde
grzyb - svamp w
gudżarati - gujarati
guła - kalkun w
gułag - gulag
gularz - kalkun w
guli - fordi
guma - præservativ n, kondom n
gumka - viskelæder n, præservativ n, kondom n
gust - smag w
guzik - knap w
gwałcić - voldtage, overtræde, bryde, krænke
gwałt - voldtægt w, vold w
gwer - riffel
gwiazda - stjerne w
gwiazdarz - astronom w
gwiaździarz - astronom w
Gwinea Równikowa - Ækvatorialguinea
gwinejski - guineansk
gwizdać - fløjte
gwóźdź - søm n
gybis - gebis n
gżegżółka - gøg w
gzub - barn n, mave w
ha - nå
habit - munkekutte w, kutte w, (habit w)
hafciarnia - broderi værksted n
hafn - hafnium
haiku - haiku
Haiti - Haiti
haja - ballade w
hajs - grunker
hajtok - kniv w
hak - hage w, krog w, godt og vel, uppercut w
haker - hacker w
haki - hage w, krog w, godt og vel, uppercut w
halabarda - hellebard
hałaburda - ballade w
hałas - larm w, støj w
halibut - helleflynder w
halo - hallo, halo w
hamować - bremse
hamulec - bremse w
hamulec ręczny - håndbremse w
Hanna - Hanne
harać - pukle
harcerz - spejder w
harować - pukle
harować jak wół - pukle røven ud af bukserne
has - hassium
hasło - slagord n, signal w, tegn n, adgangskode w
haszysz - hash w, hashish w
hau - vov, vuf
haw - der
hazard - hasard
hę - hvad, der, som, hver (dag, uge, ), -lig
hebdow - silke w
heftować - vomitere, kaste op
hej - hej
heksa - heks w
hektar - hektar w
hel - helium
helikopter - helikopter w
Hellada - Grækenland n
hemisfera - halvkugle w, hemisfære w, hjernehalvdel w
hemoliza - hæmolyse w
heparyna - heparin
herbarz - herbarium n
herbata - te
heroina - heltinde w
herpetologia - herpetologi w
het - fjernt, borte (lang), væk
heteroseksualizm - heteroseksualitet w, heterofili w
hetki - komplet, helt, fuldstændigt
hetman - dronning w, dame w
heurystyka - heuristik w
hiena - hyæne w
hieroglif - hieroglyf w
Himalaje - Himalaya
hindi - hindi n
Hindukusz - Hindu Kush, Hindukush
Hiob - Job
hiperbola - hyperbel w
hipis - hippie w
hipokryzja - hykleri n
hipopotam - flodhest w
hipoteka - pant
hipoteza - hypotese w
hippis - hippie w
hirsutyzm - hirsutisme w
histeria - hysteri n
historia - historie w
historiozofia - historiefilosofi
historyk - historiker w
Hiszpan - spanier w
Hiszpania - Spanien n
hit - hit n
hokeista - hockeyspiller w
hokej - hockey w
Holandia - Holland n, Nederland n, Nederlandene
Holandyja - Holland n, Nederland n, Nederlandene
holm - holmium
homeopatia - homøopati
homiletyka - homiletik f
homo - homoseksuel
homofobia - homofobi w
homofonia - homofoni w
homoseksualista - homoseksuel
homoseksualizm - homoseksualitet w, homofili w
Hongkong - Hongkong
Horus - Horus
hospitalizacja - indlæggelse w
hotel - hotel n
hrabia - greve w
hrabianka - greves datter w
humanistyka - humaniora
humbug - humbug
huragan - orkan w
huśtać - svinge
huśtawka - gynge w
huźdać - svinge
hycel - hundefanger w, hunderakker w
hydrauliczny - hydraulisk
hydraulik - blikkenslager w, vvs-mand w, vandmaster w, homoseksuel
hydroelektrownia - vandkraftanlæg n
hydrologia - hydrologi w
hydrostatyka - htdrostatik w
hymn - hymne w
i - og
ich - deres
Ida - Ida
idealny - ideel
identyczny - identisk, ens
idiota - idiot w
idol - idol n
idole - idol n
igła - nål w
igrać z ogniem - lege med ilden
igrzyska olimpijskie - Olympiske Lege
II wojna światowa - anden verdenskrig
ile - hvor mange, hvor meget
iloczyn - produkt n
iloraz - kvotient w
ilość - kvantitet m, kvantum n, mængde w
ilustracja - illustration w
iluzoryczny - illusorisk
imbir - ingefær w
imię - navn n
imiennik - navnefælle w
imiesłów - participium, tillæsgmåde
imiesłów przymiotnikowy bierny - præsens participium passiv
imiesłów przymiotnikowy czynny - præsens participium aktiv
imiesłów przymiotnikowy przeszły - præteritum participium n
imiesłów przysłówkowy uprzedni - perfektum gerundium
imiesłów przysłówkowy współczesny - præsens gerundium
immatrykulacja - immatrikulation w
imperator - kejser
imponderabilia - imponderabilier
impotencja - impotens w
i na żagiel, i na parę - biseksuel
ind - indium
indoeuropejski - indoeuropæisk
indolencja - indolens
indyjski - indisk
indyk - kalkun w
indywidualność - individualitet w
inercja - inerti w
infekcja - infektion w
infinitezymalny - infinitesimal
influenca - influenza
informacja - information w
informatyczny - informatik-, edb
informatyka - informatik w
infrastruktura - infrastruktur w
Inga - Inge
inicjalizować - initialisere, initiere
inkryminować - inkriminere
inkszy - anden, anderleses, forskellig
innojęzyczny - fremmedsproget
inny - anden, anderleses, forskellig
innymi słowy - i andre ord
ino - kun
insekt - insekt w
instalować - installere
instrument - instrument w
instytucja - institution w
instytut - institut n
intarsja - intarsia w
integracja - integratie
intensywność - intensitet
intensywny - intensiv
intercyza - ægtepagt w
interesujący - interessant
interlokutor - samtalepartner w
internet - Internet n
Internet - Internet n
internetowy - internet-, net-
interwencja - intervention w
interwencjonizm - interventionspolitik w, (interventionisme w)
interwenient - intervenient w
interweniować - intervenere
intratny - lukrativ
introligator - bogbinder w
intryga - intrige w
inundacyja - oversvømmelse w
inwencja - opfindsomhed w
inwentaryzacja - fortegnelse over inventaret
inwentarz - inventar n, inventarium n
inwestycja - investering w
iny - anden, anderleses, forskellig
inż. - ing.
inżynier - ingeniør w
inżynieria - ingeniørfag n
Irak - Irak n
Iran - Iran n
Irlandia Północna - Nordirland n
ironia - ironi w
ironicznie - ironisk
iryd - iridium
iść - gå
iście - sikkert, nok, vist, vistnok
iść na skibę - stjæle
iskra - gnist w
islam - islam w, muhamedanisme w
Islandczyk - islænder w, islænding w
Islandia - Island n
islandzki - islandsk
istnieć - eksistere, være, være til
Itaka - Ithaka
italski - italiensk
itd. - osv.
iterb - ytterbium
itr - yttrium
iż - at
izba - fred w, stue w, værelse n
ize - at
-izm - -isme w
Izrael - Israel
ja - jeg, jeg n
jabłko - æble n, rigsæble n
jabłko Adama - adamsæble n
jabłko niezgody - stridens æble n
jabłoń - æbletræ n
jad - edder w
jadać - spise
jadalny - spiselig
jadłospis - kost w
jagnię - lam n
jagoda - bær n, kind w
jaguar - jaguar w
jaja - kugler
jajko - æg n
jajnik - æggestok w, ovarie n
jajo - æg n
jajowód - æggeleder w, ægledder w
jak - hvordan, som, såvel som
jaka matka, taka córka - som moderen, så er datteren
jak amen w pacierzu - som amen i kirken
jaki - hvordan, hvilken, hvor for en/et, hvilket, hvilke, der, som
jakiś - en/et, nogen/noget, en/et eller anden/andet
jakmiarz - helt, nok
jako - som, hvordan, såvel som
Jakub - Jakob, Jacob
jałmużna - almisse w
Jan - Jan, Jens, Jais, Iben, Iven, Evan, Even
jangryst - stikkelsbærbusk, stikkelsbær
jantar - rav n
japa - hul n, tandhul n
Japonia - Japan n
japoński - japansk
jara - svigermor w
jarać - smøge
jarecka - mor m, moder w
jarzębina - røn w, rønnebærtræ n, rønnebær n
jarzmo - åg n, spænde
jarzyna - grøntsag / grønsag w
jasełka - julespil n
jaskółka - svale w
jaśmin - jasmin w
jastrząb - høg w
jaszczurka - øgle w, firben w
jątrew - svigerinde w
jątrznica - grynpølse w
jazda - kørsel w, fart w
jebać - kneppe, bolle, knalde
jebać to - op i røven (med …)
jebadło - soveværelse n, seng w
jechać - køre, ride
jedna jaskółka wiosny nie czyni - ét bevis er ikke nok
jednak - dog, alligevel
jednakowoż - dog, alligevel
jednobrzmiący - enslydende
jednocześnie - samtidig
jednoczesny - samtidig
jednooki - enøjet
jednorożec - næsehorn n
jednostka - enhed w
Jędrzej - Anders
jedwab - silke w
jedwabnik - silkeorm w
jedyny - eneste, unik
jedza - mad w, spise w, spisning w
jedzenie - mad w, spise w, spisning w
jego - hans, dens, dets
jej - hendes
jelito - tarm w
jelonek - hjortekalv w
jelonek rogacz - egehjort w
jełop - nar w, tomhovedet
jemioła - mistelten
jemiołuszka - silkehale w
jeniec - krigsfange w
jer - kvækerfinke w
Jerycho - Jeriko
Jerzy - Jørgen, Jørn, Georg, Geo
jeść - spise
jesień - efterår n, høst w
jesienny - efterårs-
jesion - ask w, asketræ n
jeśli - hvis, om, dersom, nærmest, snarere
jeśli wejdziesz między wrony, musisz krakać jak i one - man må hyle med de ulve man er iblandt, skik følge eller land fly
jest - være
jestestwo - jeg n, selv n
jeszcze - stadigvæk, endnu, en gang til, gen-
jętka - hanebånd n, hanebjæke w
jeż - pindsvin n
jeździć - køre, ride
jeżeli - hvis, om, dersom, nærmest, snarere
jezioro - sø w
Jezioro Galilejskie - Tiberiassøen
Jezioro Tyberiadzkie - Tiberiassøen
Jezus - Jesus
Jezus Chrystus - Jesus Kristus
język - tunge w, sprog n
język migowy - tegnsprog n
język obcy - fremmedsprog
język ojczysty - modersmål
jeżyna - brombærbusk w, brombær n
jidysz - jiddisch
jod - jod
joga - yoga w
jol - yawl
jota - jota n
jotacyzm - iotacisme w
judofob - antisemit w
Jugosławia - Jugoslavien
juny - ung
Jur - Jørgen, Jørn, Georg, Geo
jura - jura, juratiden
jutro - i morgen
jutrzejszy - fremtidens-
już - allerede, ikke længere
kaban - gris w, svin n
kabaret - kabaret m
kabat - kollega w
kabel - kabel n
kablówka - kabel w, kabel-tv n
kabza - lomme w
kac - tømmermand w
kacap - nar w, tomhovedet
kaczan - dyb n
kaczka - and w
kaczka dziennikarska - and w
kaczor - andrik w
Kaczor Donald - Anders And
kadencja - kadence w
kadm - kadmium
kadzidło - røgelse
kafar - rambuk w, faldhammer w, brolæggerstempel n
Kafarnaum - Kapernaum
kafej - café w, cafe w, kafé w, kafe w
kaffa - kaffeplante w, kaffe w, kaffeerstatning w, kornkaffe w
kainowe piętno - kainsmærke n
kaj - hvor
kajak - kajak
kajet - hæfte n
kajman - kaiman w, krokodille w
kakadu - kakadue
kakao - kakao w, anus w, endetarmsåbning w
kał - ekskrementer, fæces
kalafa - næse w, alkoholiker m, alkoholist w, ansigt n
kalafior - blomkål w
kałamarz - blækhus n
kalapitra - hoved n, leder w, overhoved n
kalcyt - kalk w
kalejdoskop - kalejdoskop n
kalendarz - kalender
kalenica - rygning w, tagryg w, tagrygning w, kip w, mønning w
kalfas - mave w
kalifat - kalifat
kaliforn - californium
kaligrafia - kalligrafi w
kalkulator - lommeregner w
kaloria - kalorie w
kam - hvorhen, hvortil, hvor
kamasz - sko w
kambr - kambrium
kamień - sten
kamień milowy - milepæl w
kamień spadł komuś z serca - falde en sten fra hjertet / falde en sten fra ens hjerte
kamień węgielny - hjørnesten w, grundsten w, grundpille w
Kamila - Camilla
kamizelka - vest w
Kanada - Canada n
kanadyjka - kano w
Kanadyjka - canadier w
kanał - kanal w
kanalia - kanalje w
kanapa - sofa w
kanar - kontrollør w
kangur - kænguru w
kanibal - kannibal w, menneskeæder w
kaniła - maske w, motorjelm w, hætte
kanka - vandkande w, blære w, boble w, marihuana w
kankan - cancan w
kanonizacja - kanonisering w
kantyna - kantine w
kapcylinder - hat w
kapeć - futsko w, dæk n
kapeluch - hat w
kapelusz - hat w
kąpielówki - badebukser w
kąpiółka - badeværelse n
kapitalik - kapitælskrift w, kapitæler
kapitalizm - kapitalisme w
kapitan - kaptajn w
kapitulacja - kapitulation w
kapłan - præst w
kaplica - kapel n
kapować - forstå
kappa - kappa n
kaptur - hætte
kapucyn - kapucinermunk w
kapuś - stikker w
kapusta - penge
kara - straf w, trillebør w
karaba - kat w
karabela - let krumsabel
karabin - riffel
karabinek - karabin
karabin maszynowy - maskingevær n
karać - straffe, afstraffe
kara cielesna - korporlig afstraffelse w
karakan - kakerlak w
karaluch - kakerlak w
karbitówa - spand w, vrag n
karbon - kultiden w, karbon
karczoch - artiskok w
kardigan - cardigan w
kardynał - kardinal w
Karina - Karen
kark - nakke w
karlica - hun-dværg w
karlus - dreng w
karma - foder n, karma w
karman - tegnebog w
karmin - karmin w
karo - ruder w, ruder
karp - karpe w
karta - kort n
karta pocztowa - postkort n
kartka - postkort n
kartofel - kartoffel w
kartografia - kartografi w
kartograficzny - kartografisk
karykatura - karikatur w
karzeł - dværg w
kasa - kasse w, grunker
kaseta magnetofonowa - kassettebånd n
kasiarz - pengeskabstyv w, rigmand w
kask - hjelm w
kastrat - kastrat w
kastrować - kastrere
kasyno - kasino n
kasza - gryn n
kasza gryczana - boghvedegryn n
kaszanka - grynpølse w
kaszubski - (kasjubisk)
kat - bøddel w, skarpretter w
kąt - vinkel w
katalog - katalog
Katalonia - Catalonien
kataloński - catalansk
katana - katana w, tømmermand w
katar - katar w
Katarzyna - Katrine f, Karen f, Karna f, Trine f
katastrofa - katastrofe w
katedra - domkirke m, katedral, kateder, lærestol m, lærestol, institut
kategoria - kategori w
kategorie - kategori w
katoda - katode w
katolicyzm - katolicisme w
katolik - katolik w
kąt prosty - ret vinkel w
katus - natugle w
Katyń - Katynmassakren
kaucja - kaution w
kawa - kaffeplante w, kaffe w, kaffeerstatning w, kornkaffe w
kawał - vittighed w, stykke n
kawałek - stykke n
kawaler - ungkarl w
kawaleria - rytteri n, kavaleri n
kawa wesoła - bordel n, horehus n
kawiarnia - café w, cafe w, kafé w, kafe w
kawior - kaviar w
kawka - allike w, søster f
kawon - vandmelon w
Kazachstan - Kasakhstan n
kazalnica - prædikestol w, hochstand
kazatelnica - prædikestol w, hochstand
każdy - hver
kazus - sag w
kciuk - tommelfinger
keczup - ketchup w
kędy - hvor
kejter - hund w, strissersvin n
kejza - ost w
keks - (sandkage med tørret frugt)
kelner - kelner w, tjener w
Kenia - Kenya
kibel - lokum n
kichać - nyse w
Kicia - mis w, missekat w
kiecka - kjole w
kiedy - hvornår, når, da
kiedyś - engang
kiejda - lomme w
kiełbasa - pølse w
kielnia - murske w
kiepeła - hoved n, leder w, overhoved n
kiepski - dårlig, ringe, elendig
kier - hjerter, hjerter-
kierować - lede, styre, føre, rette
kierowca - fører w, chauffør w, bilist w, kører w
kierownica - rat n
kierunek - retning w
kierz - busk w
kierzek - busk w
kieszeń - lomme w
kieszonkowiec - lommetyv w
kij - etage w, sal w
kilka - nogle, få
kilkujęzyczny - flersproget
kilkujęzykowy - flersproget
kilo - kilo n
kilo- - kilo-
kilometr - kilometer w
kimać - sove
kimono - kimono w, søvn w, drøm w
kino - bio w, biograf w, kino w
kinol - næse w, alkoholiker m, alkoholist w
kintop - bio w, biograf w, kino w
kiosk - kiosk w
kipiatok - kogende vand
kirchóf - kirkegård w
Kirgistan - Kirgisistan n
kis - grus n
kiść - håndled n
kiszka - tarm w, mælk w, slange w, grynpølse w
kit - kit n, løgn w
kiur - curium n, curie w
kiwi - kiwi w
kląć - bande, forbande
klacz - hoppe w
kładka - gangbro w
klajdać - klæde
klakson - horn n
kłamać - lyve
kłamca - løgner m, løgnhals w
kłamczuch - løgnhals w, løgner m
klamka - dørhåndtag n
kłamny - falsk
klamot - sten
kłamstwo - løgn w
klan - klan w
kłapaczka - mund w
klara - Solen
klasa - klasse w
klatka - bur n
klawiatura - tastatur
klawisz - tangent w, tast w
kłębek - (garn)nøgle n
klej - lim w, klister
klękać - knæle
klekotun - stork w
klepsydra - timeglas n
kler - kleresi n, præsteskab n
kliber - næse w, alkoholiker m, alkoholist w
klient - kunde w
klima - aircondition w, airconditioning w, luftkonditionering w, klimaanglæg n
klimat - klima n
klimatyzacja - aircondition w, airconditioning w, luftkonditionering w, klimaanglæg n
klin - kile w
kłódka miłości - kærlighedslåse
klon - løn w
kłos - aks n
kloszard - bums w
kłótnia - skænderi n
klub - klub w
kluber - næse w, alkoholiker m, alkoholist w
klucz - nøgle w
klucz francuski - svensknøgle w, skiftenøgle w
kluft - tøj n, klæder
kluka - næse w
klupać - søge, banke, slå, præge
kluza - fængsel n
KM - hk
kminek - kommen w
knefel - knap w
kniądz - prins w, præst w
knieja - urskov w
knipa - bog w
ko- - ko-
koalicja - koalition w
kobalt - kobolt
kobiecy - feminin
kobieta - kvinde w
kobieta lekkich obyczajów - prostitueret w
koc - tæppe n
kochać - elske
kochanka - elskerinde w
koci - katte-
kociamber - kat w
kocia muzyka - kattejammer w
kociątko - killing w
kocik - killing w
kociokwik - tømmermand w
kocioł - kedel w
kocur - hankat w
kod - kode w
kod kreskowy - stregkode
kodu - kode w
kod źródłowy - kildekode w
kofeina - koffein
kogut - kok w
koja - seng w
kojo - seng w
kok - knold w
kokietować - kokettere
koklusz - kighoste w
kokos - kokos w
kokosz - høne w
kokoszka - høne w, grønbenet rørhøne w
kokot - kok w
kokota - prostitueret w
kokotek - hane w, vandhane w, elevator w
koks - koks
koktajl - cocktail w
kolacja - (natmad w)
kolano - knæ n
kolarstwo - cykling w, cyklisme w
kołchoz - kolkhoz
kolęda - julesang w
kolega - kollega w
kolej - bane w
kolejka - kø w, række w, tog n, legetog n
kolekcja - samling w, kollektion w
kolekcjoner - samler w
kolekta - kollekt
kolektor - kollektor w, kollektør w
koleś - fyr w, mand w
kolizja - kollision w
kołnierz - krave w
koło - cirkel, hjul n, cykel w, omkring, cirka
kolonia - koloni w
Kolonia - Köln
kolonializm - kolonialisme
kolor - farve w
kolorowanka - malebog w
kolorowy - farverig
kołowy - stregspiller
koło zębate - tandhjul n
Kolumb - Columbus
Kolumbia - Colombia
kołysanka - vuggevise w
komar - myg w
komentator - kommentator w
komentować - kommentere
kometa - komet w
komfortowy - komfortabel
komin - skorsten w
kominek - pejs w, kamin w
kominiarka - elefanthue w
kominiarz - skorstensfejer w
komisariat - politistation
komoda - kommode w
komora gazowa - gaskammer n
komórka - mobiltelefon w
komp - computer w
kompas - kompas n
kompendium - kompendium n
kompilacja - kompilation w
kompilator - kompiler w
kompletny - komplet
kompost - kompost w
komputer - computer w
komputerowy - komputer
komuch - kommunist w
komunikacja - kommunikation
komunikat - meddelelse w
komunista - kommunist w
komunistyczny - kommunistisk
komunizm - kommunisme w
koń - hest w, penis w
kóń - hest w
koncern - koncern w
koncert - koncert w
kończyć - ende, slutte, afslutte
kondensacja - kondensationsreaktion
kondensator - kondensator w
kondom - præservativ n, kondom n
kondycja - kondition w
kondygnacja - etage w, sal n
konewka - vandkande w
konfigurować - konfigurere
konfiskować - konfiskere
konflikt - konflikt w
konfundować - konfundere
kongijski - congolesisk
koniec - ende w
koniec świata - verdens ende
konieczność - nødvendighed w
konik - søhest w
konik morski - søhest w
koniugacja - konjugation w
koniunkturalność - opportunisme w
konklawe - konklave n
koń mechaniczny - hestekraft w
konno - til hest
konsens - konsensus w
konsensus - konsensus w
konserwatywny - konservativ
konstantynopolitańczykowianeczka - lille pige boende i Konstantinopel
konstruktywizm - konstruktivisme w
konstruować - konstruere
konstytucja - forfatning w, konstitution w
konsultować - konsultere, konsulere
kontakt - kontakt w
konto - konto w
kontrabas - kontrabas w
kontrakt - kontrakt w
kontrast - kontrast w
kontrola - kontrol w
kontroler - kontrollør w
kontrolować - kontrollere
kontrwywiad - kontraspionage w
kontynent - kontinent n
kontynuować - fortsætte
konwalia - liljekonval w
konwenans - konvenies w
konwent - konvent n
kooperacja - kooperation w
kopa - skok w
kopać - sparke, grave
kopala - graver w
koparka - gravemaskine w, gravko w
Kopenhaga - København
kopenhaski - københavnsk
kopenhażanin - københavner w
koper - dild w
koperkowy - dild-
koperta - kuvert w, konvolut w
kopica - skok w
kopiować - kopiere
kopiowanie - kopiering w
kopniak - spark n
kopnięcie - spark n
kopruch - myg w
kopyto - hov w
kora - bark w
kord - kårde, sværd
kordialny - kordial
Koreańczyk - koreaner w
koreański - koreansk
Korea Północna - Nordkorea
korkować - stoppe, udstoppe
kornik - dødningeur n
korona - krone w
korpulencja - korpulence w
korpulentny - korpulent
korpus - korpus n
Korsyka - Korsika
korytarz - gang w
korzeń - rod w
korzystać - bruge, benytte, drage fordel (af ngt)
kos - solsort w, le w
Kos - Kos
kosa - le w, kniv w
kość - knogle w, ben n, terning w
kościół - kirke w
Kościół - kirke w
kość słoniowa - elfenben n
kosiarka - græsslåmaskine w, slåmaskine w, plænteklipper w
kosić - meje, slå
kosmologia - kosmologi w
kosmos - kosmos n
Kosowo - Kosovo / Kosova n
Kostaryka - Costa Rica
kostka - ankel w
kosz - kurv w
koszmar - mareridt n
kosztować - koste, smage
kosztowny - dyr, kær
koszula - skjorte w
koszulka - T-shirt w
kot - kat w
kotangens - cotangens w
kotek - killing w
kotka - hunkat w
kotku - killing w
kot syjamski - siameserkat w, siameser w
kotwica - anker n
kowadło - ambolt w
kowal - smed w, terper w
kowalno - ambolt w
koza - ged w
kozak - kosak w
Koziorożec - Stenbukken w
kradzież - tyveri n
kragel - krave w
kraj - land n, rige n, stat n, De, w mine damer og herrer, herskab w, herren og fruen, hr. og fru
krajać - skære, stjæle
krajacz do sera - ostehøvl w, osteskærer w
krajobraz - landskab n
Kraj Sudetów - Sudeterlandet
Kraków - Krakow
kran - hane w, vandhane w, elevator w
krancek - stykke n
kraść - stjæle
krasula - ko w
krauza - krukke w, glaskrukke w
krawat - slips n, strik/strikke w
krawatka - slips n, strik/strikke w
krawężnik - kantsten w, fortovskant w
krawiec - skrædder w
kreda - kridt n
kręgowiec - hvirveldyr n
krem - creme
krematorium - krematorium n, ligbrændingsanstalt w
krem do opalania - solcreme w, solkrem w
krew - blod n
krewetka - reje w
krogulczy - spurvehøgs-
krogulec - spurvehøg w
kroić - skære, stjæle
krok - skridt n
krokodyl - krokodille w
krokodyle łzy - krokodilletårer
krokus - krokus w
król - konge w
królestwo - rige n, kongerige n
król jest nagi - kejserens nye klæder, kejseren er nøgen
królowa - dronning w, dame w
król śledziowy - sildekonge
kromka - skive w
kropla - dråbe w
kropla w morzu - en dråbe i havet
krople - dråbe w
krosta - bums w
krótki - kort
krowa - ko w
krowi - ko-
krtań - strubehoved n
krucjata - korstog n
kruczek - kneb n
kruk - ravn w
krupniok - grynpølse w
kruty - stærk
krużganek - svalegang w
krybuny - kors n
krykiet - kricket
kryminał - krimi w, fængsel n
krypton - krypton
Krystian - Christian
krytyka - kritik w
krzak - busk w
krzeczek - hamster w
krzem - silicium n
krzesło - stol w
krzesny - gudfar / gudfader w
krzest - dåb w
krzew - busk w
krztusiec - kighoste w
krzyczeć - skrige
krzyk - råb n, vræl n, skrig n
krzywa - kurve w
krzywa stożkowa - kegelsnit n
krzyż - kors n
krzyżak - korsedderkop m
Krzyżak - korsridder w
krzyżówka - vejkryds n
ksenon - xenon
ksero - kopimaskine w, kopieringsmaskine w, fotokopieringsmaskine w
kserograf - kopimaskine w, kopieringsmaskine w, fotokopieringsmaskine w
ksi - xi n, ksi n
ksiądz - præst w
książę - prins w
książka - bog w
książka kucharska - kogebog w
książka telefoniczna - telefonbog w
księga - bog w
księgarnia - boghandel w
Księga Rodzaju - Genesis, Første Mosebog
księgowy - bogholder w
księgozbiór - bibliotek n
księżniczka - prinsesse w
księżyc - måne w
Księżyc - Månen, månen w
ksylofon - xylofon w
kształt - form w, skikkelse w, figur w
kształty - figur w, skikkelse w
kto - der, som, hvem, nogen
kto ma ręce do pracy, ten się naje kołaczy - man skal yde før man kan nyde
kto pod kim dołki kopie, sam w nie wpada - den, der graver en grav for andre, falder tit selv i den
który - hvilken, hvilket, hvilke, der, som
ktoś - nogen
któż - der, som, hvem, nogen
ku - mod
Kuba - Cuba
kubek - krus n
kubek w kubek - identisk, ens
Kubuś Puchatek - Peter Plys m
kucać - sidde / sætte sig på hug
kucharka - kokkepige w
kucharz - kok w
kuchnia - køkken n, komfur n
kucza - hytte w
kuć żelazo, póki gorące - man skal smede mens jernet er varmt
kufel - pokal w
kujon - terper w
kukułka - gøg w
kukurydza - majs w, majskolbe w
kula - kugle w, ben w
kulinaria - kogekunst w
kulka - kugle w
kulminacyjny - kulminations-
kulos - ben w
kultura - kultur w
kumkwat - limequat
kumpel - kumpan w
kuna - mår w
kunsztowny - kunstfærdig
kupa - ekskrementer, fæces
kupić kota w worku - købe katten i sakken
kupidło - pris w
kupować - købe
kupowanie - indkøb
kur - kok w
kura - høne w
kuraż - mod n
kurka - grønbenet rørhøne w, høne w
kurka wodna - grønbenet rørhøne w
kurki - grønbenet rørhøne w, høne w
kurnik - hønsehus n
kuropatwa - agerhøne w
kurs - kursus n, kurs w
kurtyzana - kurtisane w, prostitueret w
kurwa - ludder / luder w
kurwacik - slips n
kurz - støv n
kusić - friste, lokke
kusik - kys n
kuśka - penis w
kusy - djævel w
kutafon - pik w
kutas - pik w
kuter - kutter
kutwa - gnier w
kuzaj - fætter w
kuzyn - fætter w
kuzynka - kusine w
kwadrans - kvarter n
kwadrat - kvadrat n
kwadratowy - kvadratisk
kwark - kvark
kwartał - kvartal n
kwas - syre w
kwas chlorogenowy - klorogensyre, chlorogensyre
kwas mrówkowy - myresyre w
kwaśny - sur
kwatera - kvarter n, logi n
kwiat - blomst w
kwiecień - april w
kwota - beløb n, sum w
kynologia - kynologi w
łaba - pote w
Łaba - Elben
łabęć - svane w
łabędź - svane w
labirynt - labyrint w
lać - hælde, pisse, futsko w
łach - pjalt, klud
łacny - nem
lacz - hoved n, leder w, overhoved n, penis w, politibetjent w, politimand w
laczek - futsko w
łączyć - forbinde, sammenslutte, forene
ład - orden w
ładny - køn, pæn, net, nydelig, sød
laga - etage w, sal w
lajbik - brystholder w, bh w
łajdak - skurk w, slyngel w
łąka - eng m, græsmark w
laktoowowegetarianin - lakto-ovo-vegetarianer w
laktoowowegetarianizm - lakto-ovo-vegetarianisme w
laktowegetarianizm - laktovegetarianisme w
lala - dukke w, pige m, kærste w
lalka - dukke w
łamać - brække
łamaniec językowy - tungebrækker w
lambda - lambda n
lampa - lampe w
land - landsby w, land n, provins w
langusta - languster w, langust w
lantan - lanthan
łapa - pote w
lapoński - samisk, lappisk
łapówka - bestikkelse w
larmo - larm w, støj w, ballade w, alarm w
larwa - maske w, motorjelm w
las - skov w
łasica - væsel w
laska - stok m, stang w, sild w
lasso - lasso w
lat - år n
lata - år n
łata - plet w, lap w, lægte w
latarka - lygte w
latarnia morska - fyrtårn n
latawiec - drage w
lato - sommer w
łatwy - nem
lawa - lava w
lawina - lavine w
ławka - bænk w
łazienka - badeværelse n
le - men
lebera - leverpølse w
leberka - leverpølse w
leberwuszt - postej w
lebo - eller
łechtaczka - klitoris
lecz - men, kurere, helbrede, hele, behandle
leczniczy - lægende, helbredende
leczyć - kurere, helbrede, hele, behandle
legia - legion w
Legia Cudzoziemska - Fremmedlegionen
legion - legion w
legislacja - lovgivning w
lek - medicin w
lekarstwo - medicin w
lekarz - læge w
lekcja - time w
lekki - let
leksykon - leksikon n
lemoniada - limonade w, lemonade w, saftevand n
leń - dovenlars w
lenistwo - dovenskab w
leniwiec - dovenlars w
leniwieć - blive doven
leniwy - doven
lepak - igen
łepetyna - hoved n, leder w, overhoved n
lepiej - bedre, bedre, bedst
lepszy wróbel w garści niż gołąb na dachu - en fugl i hånden er bedre end ti på taget
lesbijka - lesbiske w
leśnictwo - forstvidenskab w, skovbrug w
leśny - skov-
-letni - -årig
letnik - sommergæst w
lew - løve
Lew - Løven w
lewa - stik n
leworęczny - kejthåndet person
lewszun - kejthåndet person
lewy - venstre
leżak - liggestol w
leżeć - ligge, sidde
łgać - lyve
łgarz - løgner m, løgnhals w
libański - libanesisk
libido - libido w
libretto - libretto w
licencja - licens w
liceum - gymnasium n
liczba - tal n, nummer n
liczba atomowa - atomnummer n
liczba mnoga - flertal n
liczba podwójna - dualis, to-tal n
liczba pojedyncza - ental n
liczebnik - talord n
liczebnik główny - kardinaltal n
liczebnik porządkowy - ordenstal n
liczebnik zbiorowy - mængdetal n
liczykrupa - gnier w
liga - liga w
ligatura - ligatur w
lilia - lilje w
limba - cembra-fyr
lingwista - lingvist m, sprogforsker w
lingwistyka - sprogvidenskab w, lingvistik w
link - link
linoleum - linoleum n
lipiec - juli w
lis - ræv w
liść - blad n
liść bobkowy - laurbærblad n
liść laurowy - laurbærblad n
list - brev n
lista - liste w
listek figowy - figenblad w
listonosz - postbud n
listopad - november w
list otwarty - åbent brev n
lit - lithium, litium
litera - bogstav n
literacki - litterær
literatura - litteratur w
litr - liter w
litra - liter w
Litwa - Litauen
lizać - slikke
lizak - slikkepind / slikpind w
lizus - spytslikker w
locha - so w
lód - is w
lodowiec - gletsjer w, jøkel w, bræ w
lodówka - køleskab n, havlit w
łodyga - stilk w, stængel w
łódź - båd w
logo - logo
logować - logge ind, logge på, logge
lojalizm - loyalisme w
lokatiwus - lokativ
łokieć - albue w, alen w
lokomotywa - lokomotiv n
lola - pige m, kærste w, etage w, sal w
lolek - fjols n
Londyn - London n
londyńczyk - londoner w
lont - lunte w
łopata - skovl w
lorens - lawrencium
łosoś - laks w
losować - trække
lotka - balanceklap w, svingfjer w, fjerbold w
lotnisko - lufthavn w
lotniskowiec - hangarskib
Łotwa - Letland
łowca - jæger w
łoże - seng w
łóżko - seng w
lub - eller
lubić - kunne lide
lubieżny - liderlig
luce - lakune w, mangel w
łucznik - bueskytte w
ludność - befolkning w
ludojad - menneskeæder w, kannibal w
ludowy - folkelig
ludożerca - menneskeæder w, kannibal w
ludzie - folk n, mennesker
łudzikwiat - april w
ludzki - human, menneskelig
lufa - løb n
łuk - bue w
luka - lakune w, mangel w
lukier - glasur w
luksemburczyk - luxembourger w, luxemburger w
Luksemburg - Luxembourg
lulka - pibe w, cigaret w, smøg w
luna - måne w
lunatyk - søvngænger w
lunatyzm - søvngængeri n
luńt - stykke n, hund w, strissersvin n
lupa - lup w, forstørrelsesglas n
lura - sprøjt n
lustro - spejl n
lutet - lutetium
lutować - banke, slå, præge
luty - februar w, blidemåned, kold
łużycki - sorbisk
lwi - løve-
lwica - løvinde w
łydka - læg n
łyk - bymenneske n
łyżka - ske w
łza - tåre w
łża - løgn w
mać - mor m, moder w
Macedonia - Makedonien
macha - mine w
maciek - mave w
macierz - matrix w
maciora - so w
maciupki - lillebitte, bittelille
macocha - stedmoder w
mączka - pudder n
mączkować - male
Madagaskar - Madagaskar n
Madera - Madeira
madla - jordemoder w
mądrość - klogskab w, visdom w
mądry - klog
mądry Polak po szkodzie - af skade bliver man klog
mafia - mafia w
magiczny - magisk
magister - (magister w), kandidat w
magnes - magnet w
magneto- - magnet-
magnetofon - båndoptager w
magnetofon szpulowy - spolebåndoptager w
magnez - magnesium n
magnolia - magnolia f
magulanka - slagsmål n
maj - maj w
majątek - formue w
majeranek - merian w
majonez - mayonnaise w, majonæse w
majtki - trusser
majuskuła - majuskel w
mąka - mel n
makabryczny - makaber
makaron - pasta w
makiawelizm - machiavellisme w
makówka - valmuekapsel w
makrela - makrel w
malaria - malaria w
malarz - maler w
malijski - malisk
malin - hindbær n
malina - hindbær n
malkontent - gnavpotte w, kværulant w, krakiler w
mało - få
malowanie - maling w
malowidło - maling w
małpa - abe w, snabel-a n
malstrom - malstrøm w
Malta - Malta
mały - lille
mały palec - lille finger w
małżeństwo - ægteskab n, ægtepar
małżonek - ægtefælle w, mand w
małżonka - kone w
mam - have, skulle, måtte, have nt for ng, have nt på, mor w
mama - mor w, svigermor w
mamałyga - majsgrød w
mamut - mammut
mandat - bøde w
mangan - mangan n
manipulacja - manipulation
manipulant - manipulator w
maniurka - pige m, kærste w
mańkut - kejthåndet person
manometr - manometer n
mapa - kort n
maras - snavs n, skidt n, mudder n, dynd n
maraton - maraton, maratonløb n
marchew - gulerod w
marchewka - gulerod w
Marcin - Martin, Morten
margaryna - margarine w
marginalny - marginal
Maria - Maria
Marianna - Marianne
marihuana - marihuana w
marionetka - marionet n
Marja - Maria
marka - frimærke n
markiza - markise w
marksizm - marxisme w
marmolada - marmelade w
marnować - spilde
mars - en sur mine
marsz - march w
martwy - død
Martyna - Martine
Maryja - Maria
Maryjka - Maria
marynarka - jakke w, søværn n
marynarz - sømand w
marzec - marts w
marzenie - drøm w
marzenie senne - søvn w, drøm w
marznący deszcz - isslag n
masa - masse w
masakra - massakre w
masa krytyczna - kritisk masse w
masara - flue m, butterfly w
masarnia - pølsefabrik w, slagteri n, kød-
maska - maske w, motorjelm w, ansigt n
maślanka - kærnemælk
masło - smør n
masło maślane - pleonasme w
masturbacja - masturbation w, onani w
maszkara - maske w, motorjelm w
maszyna - maskine w
maszyna do pisania - skrivemaskine w
maszyna do szycia - symaskine w
maszynista - togfører w
mat - mat, skatmat w, matteret
matematyczny - matematisk
matematyka - matematik w
materac - madras w
materiał - materiale n, stof n
materiał wybuchowy - sprængstof n
matka - mor m, moder w
matka chrzestna - gudmor / gudmoder w
Matka Matki Boskiej Pieniężnej - lønningsdag
matros - sømand w
mąż - mand w
mazak - skrivestift, griffel, fiberpen, ansigt n
mazojen - mayonnaise w, majonæse w
Mazowsze - Masovien
ME - EM
mebel - møbel n
mecenas - mæcen w, advokat w
mechaniczny - mekanisk
mechanizm - mekanisme w
mecz - match w, sportskamp w, kamp w
medal - medalje w
mediana - median w
medycyna - medicin w
medyk - læge w
meitner - meitnerium
męki Tantala - tantaluskvaler
Meksyk - Mexico n, Mexico City
melać - male, spytte
meldunek - melding w, meddelelse w
melić - male
melodia - melodi w
melodio - melodi w
meloman - musikelsker w
melon - melon w, patte w
memorandum - memorandum n
menażeria - menageri n
menda - strømer w, strisser w, strissersvin n
mendelew - mendelevium
menora - Menorah w
mentor - mentor w
merdać - logre, forveksle
Merkury - Merkur
męski - mandlig
meskineria - gerrighed w, nærighed w
meta - mål n, meta
metal - metal n
metan - metan n
meteor - meteor
meteorologia - meteorologi w
meteoryt - meteorit
metoda - metode w
metro - metro w, undergrundsbane w
metronidazol - metronidazol
metronom - metronom w
metroseksualny - metroseksuel
mewa - måge w
mężatka - en gift kvinde, ægtefælle w
mężczyzna - mand w
mezzosopranistka - mezzosopransangerinde w
mgła - tåge w
mgnienie oka - øjeblik n
Miami - Miami
mianownik - nominativ w, grundledsfald n, nævnefald n, nævner w
miasto - by w, i stedet
miasto stołeczne - hovedstad w
miau - miav, mjav
miażdżyca - åreforkalkning
Michał - Mikael, Michael
mieć - have, skulle, måtte, have nt for ng, have nt på
mieć gzik w kolanach - være bange
mieć miejsce - finde sted
mieć nierówno pod sufitem - have rotter på loftet
miecz - sværd n
miedź - kobber n
miedziany - kobber-
miedźwiedź - bjørn w
między - mellem
międzyczas - mellemtid
Międzynarodowy Dzień Kobiet - Kvindernes internationale kampdag w
międzyplon - mellemafgrøde w
miejsce - sted n, plads w
miejscownik - lokativ
miejska legenda - vandrehistorie
miejski - by-
mielcuch - bryggeri n, bajer w, øl w
mieli - have, skulle, måtte, have nt for ng, have nt på
mielić - male
mierzenie - måling w
mierzyć - måle
mieśćce - sted n, plads w
mieśce - sted n, plads w
miesiąc - måned m, måne w
miesiączek - måne w
miesięcznik - månedsblad n
mięsień - muskel w
mięsny - kød-
mięso - kød n
mięsopustnik - februar w, blidemåned, kold
mieszczuch - bymenneske n
mieszkać - bo
mieszkanie - lejlighed w
mieszkaniec - beboer w, indbygger w
mięta - mynte
miętowy - mynte-, pebbernynte-
migawka - lukker w
migotka - blinkhinde w
migrena - migræne w
mikro- - mikro-
mikrofon - mikrofon w
mikroorganizm - mikroorganisme w
mikroskopijny - mikroskopisk
Mila - Emilie, Emily
mile - rart, behageligt
miliardowy - milliardte
milioner - millionær w
militarny - militær
miłość - kærlighed f
miłośnica - elskerinde w
miły - rar, behagelig, sød
mimo - trods, ved (siden af), cirkel, hjul n
m.in. - bl.a.
mina - mine w
minaret - minaret w
minister - minister w
minuskuła - minuskel w
minusowy - negativ
minuta - minut n
miód - honning w, mjød w
miotła - kost w
misja - mission w
misjonarz - missionær m
mistrz - mester w
mistrzostwo - mesterskab n
mit - myte w
mityczny - mytisk
mizantropia - misantropi w
mł. - jr.
mleć - male
mleko - mælk w
mleko sojowe - sojamælk w
młody - ung
młodzież - unge w
młotek - hammer w
mnich - munk w
mnogdy - tit
mnogi - talrig, mangfoldig
moc - magt w, kraft w, styrke w
móc - kunne, måtte (gerne)
mocny - stærk
mocz - urin w
moczopędny - urindrivende
model - model w
modem - modem n
modernizacja - modernisering w
modlić się - bede
modlitwa - bøn w
modrakowy - blå
modraszka - blåmejse w
modry - blå
modrzew - lærk w, lærketræ n
mój - min, mit
Mojżesz - Moses
mokry - våd
mól - møl
Mołdawia - Moldavien
molibden - molybdæn n
molo - mole w
moment - moment n
momentalnie - lynhurtigt
Monachium - München
monarcha - monark w
monarchia - monarki n
moneta - mønt w
Mongolia - Mongoliet n
monitor - monitor w, skærm w
monocykl - unicykel w, ethjulet cykel w
monoftong - monoftong w
monotonia - monotoni
monstrancja - monstrans
mora - spøgelse n, ånd w
morał - moral w
mord - manddrab n, drab n, mord n
morderca - morder w, drabsmand w
morderczyni - morderske w
morderstwo - manddrab n, drab n, mord n
mordować - dræbe
morela - abrikos w
morena - moræne w
morfem - morfem n
morfina - morfin w
morkwa - gulerod w
mors - hvalros w
morski - hav-, sø-, søgrøn
morświn - marsvin n
morze - hav n
Morze Bałtyckie - Østersøen w
Morze Śródziemne - Middelhavet
mosiądz - messing, mønt w
mosiężny - messing-
Moskwa - Moskva n
moskwianin - moskovit w
most - bro w
mostek - lille bro w, brystben n, bro w
motor - motor w
motorówka - motorbåd w
motorowy - motor-
motyl - sommerfugl w
Mount Everest - Mount Everest
mowa - tale w, tunge w, sprog n
mowa jest srebrem, a milczenie złotem - tale er sølv, men tavshed er guld/tale er sølv, tavshed er guld, æbler af guld i skåle af sølv er ord, som tales i rette tid
mówić - tale, sige, snakke
mówić na ty - være dus
Mozambik - Mozambique / Mocambique n
moździerz - morter w, mortér w
może - måske, kunne, måtte (gerne)
mózg - hjerne w
możliwie - muligt, muligvis
możliwość - mulighed w
możliwy - mulig
mrowisko - myretue w
mrówka - myre w
mrówkolew - myreløve w
mrówkowy - myre-
mrównik - jordsvin n
mróz - frost w
Ms - lokativ
MŚ - VM
msza - gudstjeneste w
mszyca - bladlus w
mucha - flue m, butterfly w
muchomor - fluesvamp w
muchomór - fluesvamp w
muchomor czerwony - rød fluesvamp
mućka - ko w
mugol - Muggler
mundur - uniform
mundurowy - politibetjent w, politimand w
mur - mur w
muraszka - myre w
murchla - kælling w, gimpe w
murować - mure
mus - tvang w, mos w
musieć - skulle, måtte, behøve
muszka - flue w (lille), butterfly w, sigtekorn n
muszla - strandskal w
musztarda - sennep w
mutacja - mutation w
muzeum - museum n
muzułmanin - muslim w
muzułmański - muslimsk
muzyczny - musik-
mużyk - mand w
muzyka - musik w
my - vi
myć - vaske
mycka - hue w
mydelniczka - sæbeskål w
mydło - sæbe w
mykita - ræv w
mylić - forveksle
mylny - fejlagtig, forkert
mysikrólik - fuglekonge w
myśl - tanke w
myśleć - tænke
myśliwiec - jæger w
myśliwy - jæger w
mysz - mus w
myszy tańcują, gdy kota nie czują - når katten er ude, spiller musene på bordet
myt - myte w
N - ablativ w
na - på
nacja - nation w, nationalitet w
na cołki łeb - komplet, helt, fuldstændigt
naczynie - beholder w, køkkentøj n, kar n
nad - over
nadarzyciel - giver w, donor w
nadawca - afsender w
nade - over
nadgarstek - håndled n
nadwzroczność - langsynethed
nadziany - rig
nadzieja - håb n
naelektryzować - elektrisere
nagi - bar, nøgen
nagle - pludselig
nagły - pludselig
nagranie - optagelse w
nagroda - belønning w, pris w
nagrywarka - brænder w (CD)
Nairobi - Nairobi
najemnik - lejesoldat w, lejetropper w, lønarbejder w, daglejer w
najmniej - slet ikke, på ingen måde, langt fra
najstarszy zawód świata - kvindens ældste erhverv / verdens ældste erhverv
naleśnik - pandekage w
na lewą stronę - vrangen ud
należeć - tilhøre, høre til, man skal/må/bør
nalot - luftangreb
namiętnie - lidenskabeligt
namiot - telt w
naonczas - så, da
napad - overfald n, anfald n
napastnik - angriber w
na pewno - sikkert, nok, vist, vistnok
napięcie - spænding w
napisać - skrive
napiwek - drikkepenge w
napój - drik w
naprany - fuld, beruset, påvirket, den berusede
naprawiać - reparere
narba - ar n
narkoman - narkoman w
naród - nation w
narodowość - nationalitet w
narybek - fiskeyngel w, de unge
narząd - organ n
narzędnik - ablativ w
narzędzie - værktøj n
nasiono - frø n
następnie - dernæst, derefter
następny - næste
na sto procent - sikkert, nok, vist, vistnok, komplet, helt, fuldstændigt
nastrój - humør n, stemning w
nasz - vores
natenczas - så, da
natrętny - påtrængende
naturalny - naturlig
natychmiast - med det samme
natychmiastowo - med det samme, lynhurtigt
natychmiastowy - øjeblikkelig
nauczać - lære, undervise
nauczyciel - lærer w
nauczycielka - lærerinde w
nauka - videnskab w
naukowiec - videnskabsmand w, forsker w
naukowy - videnskabelig
nawet - selv
nawzajem - hinanden, i lige måde
nazad - tilbage, igen
na zdrowie - skål
nazod - tilbage, igen
nazwa - navn n
nazwisko - efternavn n
nazywać - nævne, hedde
nazywać rzeczy po imieniu - kalde en spade for en spade
n.e. - e.Kr.
neodym - neodym
neofaszysta - neofascist w
neon - neon
neonazista - nynazist w
neopren - neopren
Nepal - Nepal
neptun - neptunium
nerka - nyre w
nerwus - nervevrag n
nestorianin - nestorianer w
neutron - neutron w
newralgia - neuralgi w
ni - eller, heller ikke, ejheller, ikke (endnu) en/et, nej, ikke
nic - ingenting, ikke noget, intet
nić - tråd w
Niderlandy - Holland n, Nederland n, Nederlandene
nie - nej, ikke
nie- - u-, ikke-
niebawem - snart
niebezpieczeństwo - fare w
niebezpieczny - farlig
niebieski - blå
niebiosa - himmel w, Himmelen w
niebo - himmel w, Himmelen w
nie (być) - der (være) ingen…
nieć - fætter w
niech - lade
nieczystość - urenhed, urenlighed, affald, skrald
niedaleko pada jabłko od jabłoni - æblet falder ikke langt fra stammen
niedokrwienie - iskemi w
niedokrwistość - blodmangel w, anæmi w
niedokrwistość Addisona-Biermera - ondartet blodmangel w, perniciøs anæmi w
niedokrwistość złośliwa - ondartet blodmangel w, perniciøs anæmi w
nieduch - sygdom w
niedziela - søndag
niedzielny - søndags-
niedzielny kierowca - søndagsbilist w
niedźwiedź - bjørn w
niedźwiedzia przysługa - bjørnetjeneste w
niedźwiedzica - hunbjørn w
nieformalny - uformel
niegdyś - engang
niektóry - vis, nogen/noget/nogle
niełatwy - svær, hård
nie ma - der være / findes ingen / ikke / …
nie ma róży bez kolców - ingen roser uden torne
Niemcy - Tyskland n
Niemiec - tysker w
niemieć - blive stum
nie mieć - nej, ikke, have, skulle, måtte, have nt for ng, have nt på
Niemiecka Republika Demokratyczna - Tyske Demokratiske Republik
niemiecki - tysk
niemoc - impotens w
nienarodzony - ufødt
nienawidzić - hade
nieodmienny - ubøjelig
nie od razu Kraków zbudowano - Rom blev ikke bygget på en dag
niepamięć - amnesi w
niepewnie - usikkert
niepewny - usikker
niepodległość - uafhængighed w, selvstændighed w
nieporozumienie - misforståelse w
niepotrzebny - unødvendig
niepowodzenie - fiasko
nieprawda - usandhed w
nieprawidłowo - forkert, urigtig, ukorrekt
nieprzyjemny - ubehagelig
nieraz - en gang imellem
nieruchomo - stille
nie samym chlebem człowiek żyje - mennesket lever ikke af brød alene
nieść - bære
nieściora - kusine w
niesłychany - uhørt
niestety - desværre
nietoperz - flagermus w
niewiarygodny - utrolig
niewiasta - kvinde w
niewiele - få / lidt
niewinność - uskyld w
niewłaściwy - forkert
niewolnictwo - slaveri n
niewolniczy - slavisk
niewolnik - slave w, træl w
nie wszystko złoto, co się świeci - det er ikke alt guld, som skinner
niezależność - uafhængighed
niezależny - uafhængig
niezapominajka - forglemmigej w
niezdecydowanie - ubeslutsomhed w, ubeslutsomt
nieźle - ikke dårligt
niezwłocznie - med det samme
nigdy - aldrig
nigdzie - intetsteds, ingen steder
nikaj - intetsteds, ingen steder
nikiel - nikkel n
nikotyna - nikotin
nikt - ingen
nim - han, det, den
nimfomania - nymfomani w
niob - niobium
niski - lav
niszczyć - ødelægge
niszczyciel - ødelægger w, jager w, destroyer w
nitka - tråd w
niuton - newton w
Nix - Nix
niż - lavtryk n, end
niża - lavland n
nizina - lavland n
no - så, på denne måde, ja
nobel - nobelium
noc - nat w
nocny - natlig, nat-
noga - ben w
nogawice - bukser
nogawka - bukseben w
noktowizor - natkikkert w
nordycki - nordisk
norma - norm w
normalny - normal
Norweg - nordmand w
Norwegia - Norge n
norweski - norsk
nos - næse w, alkoholiker m, alkoholist w
nosić - bære, have på
nosorożec - næsehorn n
nosówka - hundesyge w
Nowa Zelandia - New Zealand
nowicjat - noviciat
nowotwór - neoplasma
nowy - ny
Nowy Rok - Nytår
nóż - kniv w
nożyce - saks w
nożyczki - saks w
np. - fx, f.eks.
n.p.m. - o.h.
nr - nr.
nudelzupa - suppe w
nudle - pasta w
nudny - kedelig
nudysta - nudist w, naturist w
numer - nummer n
numeryczny - nummerisk
Numidia - Numidien
nurkować - dykke
nyga - myg w
nylon - nylon
nyra - gnier w
nyrol - gnier w
o - om, på, mod
obcojęzyczny - fremmedsproget
obcokrajowiec - udlænding w
obelisk - obelisk w
oberchabka - bestikkelse w
obiad - middagsmad w
obiecadło - alfabet n
obiecny - almindelig, ordinær
obiecywać - love
obierać - pille, banke, slå, præge
obierać ogóra - spille pik
obietnica - løfte n
objaw - symptom n
obój - obo w
obojczyk - nøgleben n, kraveben n
obok - ved (siden af)
obolewiec - kejthåndet person
obora - stald w
obowiązek - pligt w
obowiązywać - gælde
obracać - dreje
obraz - maleri n, billede n, forestilling w, scene w, film w
obrażać - fornærme
obrotowy - stregspiller
obroża - halsbånd n
obrzydliwie - modbydeligt
obrzydliwy - modbydelig, afskyelig
obszar - område n
oburzony - indigneret
obwód - omkreds w, perimeter w, kreds w
obywatel - statsborger w
obywatelstwo - statsborgerskab n
obżarstwo - forslugenhed w, frådseri n
ocet - eddike w
ochota - lyst w
ociec - far w, fader w
oczekiwać - forvente
oczywiście - selvfølgelig, naturligvis
od - fra, siden, af, end
odbyt - anus w, endetarmsåbning w
odcisk palca - fingeraftryk n
odczytywać - aflæse
oddziaływać - påvirke
ode - fra, siden, af, end
odkurzacz - støvsuger w
odlotowy - fed
odmiana - bøjning w, slags w, art w, klasse w
odnośnie - angående
odnośnie do - angående
odór - odør w, stank w
odpowiadać - svare, svare til, være ansvarlig for ng(t)
odpowiedni - adækvat
odpowiedź - svar n
odpowiedzialność - ansvarlighed w
od ręki - straks, med det samme
odróżniać - skelne
odsyłacz - link
odszkodowanie - erstatning w
odtrutka - modgift w
odwaga - mod n
odważnik - lod n
odważny - modig
odzież - tøj n, klæder
ogień - ild w
ogier - hingst w
ognie świętego Elma - sanktelmsild w
ognisko - bål n
ogon - hale w, kø w
ogórek - agurk w
ogród - have w
ogród botaniczny - botanisk have
ogromny - enorm, kolossal
ojciec - far w, fader w
ojciec chrzestny - gudfar / gudfader w
Ojcze nasz - fadervor n, paternoster n
ojczyc - søn w
ojczym - stedfader w
ojczyzna - hjemland n
ojla - ugle w
okaryna - okarina w
okazja - lejlighed w
okłamywać - lyve
okno - vindue n
oko - øje n
oko cyklonu - orkanens øje
około - omkring, cirka
oko za oko, ząb za ząb - øje for øje, tand for tand
okrąg - cirkel w
okres - periode w
określenie - betegnelse w
okresowy - periodisk, cyklisk, midlertidig, forbigående
okręt podwodny - undervandsbåd, ubåd w
okropny - skrækkelig, frygtelig, forfærdelig
okrutnie - grusomt, umenneskeligt
okrutny - grusom, umenneskelig
okulary - briller
okulary przeciwsłoneczne - solbriller
okulista - øjenlæge w
okup - løsesum n, løsepenge
olbrzymi - enorm, kolossal
olcha - el
Olimpia - Olympia
olimpijski - olympisk
ołów - bly n
ołówek - blyant w
om - ohm w
oma - bedste m, bedstemor m, bedstemoder m, mormor m, farmor w
omieszkać - nej, ikke
omlet - omelet w
omnibus - omnibus w
omnipotencja - omnipotens w
on - han
ona - hun
onanizm - onani w
one - de
oni - de / De
onkolog - onkolog w
ono - det, den
ONZ - FN
oologia - oologi
opactwo - abbedi n
opal - opal
opat - abbed w
operacja - operation w
operator - operatør w
opiąć - igen
opięć - igen
opisywać - beskrive
opium - opium
opłata - gebyr n, afgift w
opona - dæk n
oportunizm - opportunisme w
opozycja - opposition w
oprych - bandit w
orać - pløje, pukle
oraz - og
ordnung - orden w
organ - organ n
organiczny - organisk
organizacja - organisation w
Organizacja Narodów Zjednoczonych - Forenede Nationer
organizm - organisme w
orgazm - orgasme w
orgia - orgie n
ornitolog - ornitolog w
ornitologia - ornitologi w
ortograf - stavefejl w
ortografia - retstavning w, ortografi w
ortoreksja - ortoreksi
ortyl - dom w
orzeł - ørn w, revers, bagside w
orżnąć - snyde, svindle, bedrage
osa - hveps w
Osaka - Osaka
ość - ben n
ósemka - otter w, ottetal n, ottendedel w
osioł - æsel n
ośle ucho - æseløre / æselsøre n
osm - osmium n
osoba - person w
osobisty - personlig
ostateczny - endelig
ostatni - sidste
Ostia - Ostia
ostracyzm - ostrakisme w
ostrężyna - brombærbusk w, brombær n
ostrodamski - amsterdamsk
ostrodomski - amsterdamsk
ostrożnie - forsigtigt
ostry - skarp, spids, stærk
ostrzegać - advare
ostrzeżenie - advarsel w
ostrzyć - skærpe
ostrzytko - blyantspidser w
oświadczać - erklære, meddele, kundgøre
oszukiwać - snyde, svindle, bedrage
oszust - snyder m, bedrager m, svindler w
oszustwo - bedrageri n, svindel w, snyd n
otoczenie - omgivelser
Ottawa - Ottawa n
otwarty - åben
otwierać - åbne, lukke op
otwór - hul n
otyłość - overvægt w, fedme w
-owa - -inde
owad - insekt w
owadoznawstwo - entomologi w
owal - oval w
owca - får n
owoc - frugt w
ożarty - fuld, beruset, påvirket, den berusede
ożyna - brombærbusk w, brombær n
pacan - nar w, tomhovedet
pach - lugt w
pachnąć - dufte, lugte
pachniarz - næse w
pachnieć - dufte, lugte
pacholę - dreng w
paciuk - rotte w
pacjent - patient w
padać - falde, tale, sige, snakke
padaczka - epilepsi w
padlina - ådsel n
pagaj - pagaj w
pager - personsøger w
pagórek - høj
pająk - edderkop w
pajęcznik - september w, oktober w, sædemåned, november w
pajęczyna - spindelvæv n, edderkopesppind n
pajucina - spindelvæv n, edderkopesppind n
pakiet - pakke w
Pakistan - Pakistan n
pakli - hvis, om, dersom, nærmest, snarere
pakować - pakke
pała - hoved n, leder w, overhoved n, penis w, politibetjent w, politimand w
palacz - ryger w, fører w, chauffør w, bilist w, kører w
palarnia - rygerum n
pale - hoved n, leder w, overhoved n, penis w, politibetjent w, politimand w
palec - finger w (palec u ręki), tå w (palec u nogi)
palec wskazujący - pegefinger w
palenie - rygning w
Palestyńczyk - palæstinenser
palić - brænde, ryge
palindrom - palindrom
pallad - palladium
palma - palme w
pamięć - hukommelse w
pamiętać - huske
pan - De, herr
Pan - Herre
pana - dæk n
panamczyk - panamaner w
panarabski - panarabisk
Pan Bóg - Herre
pancerz - skjold, panser
pani - De, fru
panna - frøken m, jomfru m, pige m, frøken w
Panna - Jomfruen
panować - herske
państwo - stat n, rige n, De, w mine damer og herrer, herskab w, herren og fruen, hr. og fru
panteon - panteon n
pantoflarz - tøffelhelt w
papa - papa w, tagpap
papeć - futsko w
papier - papir n
papier jest cierpliwy - papiret rødmer ikke
papieros - cigaret w
papierosowy - cigaret-
papierowy - papir-
papier wartościowy - værdipapir n
papież - pave w
paproć - bregne
papuć - futsko w, sko w
papuga - papegøje w
para - par, damp, dunst, vanddamp
parasol - paraply w
park - park w
parkować - parkere
parowóz - damplokomotiv n
partykuła - partikel w
partyzana - partisan
pasażer - passager w
pasierb - stedsøn w, stedbarn n
pasierbica - steddatter w
pasja - lidenskab, passion, raseri, vrede
pasożyt - parasit w
pasta do zębów - tandpasta w
pastylka - pastil w
pasz - mangel w
pasza - urskov w
paszkwil - paskvil w
paszport - pas n
pasztet - postej w
pasztet strasburski - foie gras
patchwork - patchwork n
patelnia - pande w, stegepande w
patetyczny - patetisk
pątnik - pilgrim
patria - hjemland n
patrzałki - briller
patrzeć - kigge, se på
patrzyć - kigge, se på
patyna - patina
pawęża - skjold n
październik - oktober w, sædemåned
paździerzeń - oktober w, sædemåned
paznokieć - negl w
pazur - klo w
pazura - hånd w, arm w
pchła - loppe w
pchli targ - loppemarked n, kræmmermarked n
pedał - pedal w, bøsserøv w
pederastia - pæderasti, paederastia
pedofil - pædofil n
pedofilia - pædofili w
pedryl - pedal w, bøsserøv w
pejoratywny - pejorativ
pekator - penis w
pelikan - pelikan w
pełnia - fuldmåne w
pełny - fuld
peniak - kujon w, ilder w
penis - penis w
pentagon - femkant, pentagon
pępek - navle w
Pepik - tjekker w
perfumeria - parfumeri n
perka - kartoffel w
perła - perle
perm - perm
peron - perron w
persona - person w
peruka - paryk w
pesymistyczny - pessimistisk
pesymizm - pessimisme w
petrologia - petrologi w
petronelka - mariehøne w
pewien - vis, sikker
pewny - vis, sikker
phi - phi n
piana - skum n, bajer w, øl w
piano - skum n
piasek - sand w
piaskownica - sandkasse w
piątek - fredag
pić - drikke
picie - drikeri n
piczka - fisse w, dåse w
pidżama - pyjamas w
piec - ovn w, kakkelovn w, bage
piechota - infanteri n, til fods
pięciokąt - femkant, pentagon
pieczęć - stempel n, segl n
piekarnia - bageri n
piekarz - bager w
piękny - smuk, pæn
pielęgniarka - sygeplejerske w
pielgrzym - pilgrim
pień - stamme w
pieniądz - penge
pieprz - peber w, peber n
pieprzyć - knallen, bolle
pierdolić - bolle
pierdzieć - prutte
pierożek - skråhue w
pierścień pośredni - mellemring w
piersiówka - lommelærke w
pierwiastek - grundstof n
pierwsza pomoc - førstehjælp
pies - hund w, strissersvin n
pięściarstwo - boks w, boksekamp w
pies do towarzystwa - selskabshund w
pieśń - sang w
pies pasterski - fårehund w, hyrdehund w
pies policyjny - politihund w
pies pracujący - brugshund w
pies przewodnik - førerhund
pieszo - til fods
pięta Achillesa - akilleshæl w
pięta achillesowa - akilleshæl w
piętro - etage w, sal w
pietuch - kok w
pijany - fuld, beruset, påvirket, den berusede
pijawa - regnbue w
pijawka - igle w, blodsuger w
pik - spar w
pikawa - hjerte n
piksel - pixel w
piła - sav w
piłka - bold w, boldkast w, sav w
piłka nożna - fodbold w
piłka ręczna - håndbold w
piłkarz - fodboldspiller w
piłkarzyki - bordfodbold
pilnować - vogte
pilot - pilot m, fjernbetjening w
pinakoteka - pinakotek n
pinezka - tegnestift w
piorun - lyn n
piosenka - sang w
piosenkarka - sangerinde w
Piotr - Peder, Peter, Per
Piotra - Petra f
pipa - fisse w, dåse w
piromania - pyromani
pisać - skrive
pisanka - malet påskeæg n
pisk - hvin n
pismo - alfabet n
pistolet maszynowy - maskinpistol
pisuar - urinal/urinale n, pissoir n
piterka - tegnebog w
Pittsburgh - Pittsburgh
piwnica - kælder w
piwo - bajer w, øl w
piżama - pyjamas w
pizda - fisse w, dåse w
pizgać - kaste, banke, slå, præge
PJM - Det Polske Tegnsprog
PKB - BNI w
plac - plads w
płacić - betale
płacz - gråd w
plądrować - plyndre, røve
plajster - plaster n
płakać - græde
płakać nad rozlanym mlekiem - græde over spildt mælk
plakat - plakat w
plama - plet w
planeta - planet w
planetarium - planetarium
planetoida - asteroide w
plan miasta - bykort n
planta - plante w
płaski - flad
plaster - plaster n
plastik - plastik (plastic )
platyna - platin n
plaża - strand w
płeć - køn n
plecak - rygsæk w
pleonazm - pleonasme w
pleść - flette, vikle, sludre, vrøvle
plik - bundt n, fil w
plożyć - tjene
pluć - spytte
płuco - lunge w
plusk - plask n, plask
pluskiewka - tegnestift w
pluskwa - væggelus w, bug w
pluton - plutonium, peloton w, deling w
Pluton - Pluto
płyn - væske w
płynąć - svømme
płynny - flydende, væske
płyta - plade w
płyta główna - bundkort n, systemkort n, moderkort n
pływać - svømme, flyde
pływaczka - svømmerske w
p.n.e. - f.Kr.
pneumatyczny - pneumatisk, tryklufts…
po - på, efter
pocałować w dupę - du kan rende mig i røven
pocałunek - kys n
pocałunek z języczkiem - tungekys n
pochodzenie - oprindelse w
pochodzić - stamme
POChP - KOL
pochwa - skede w
pociąg - tog n
pociąg pocztowy - posttog
pocić się - svede, transpirere
początek - begyndelse w
poczta pantoflowa - folkesnak w
pocztówka - postkort n
pocztowy - postal, post-
pod - under, mod
podanie - ansøgning w
podatek - skat w
podatek kościelny - kirkeskat
podatkowy - skatte-
podczas - under, i løbet af, mens
pode - under, mod
podejmować - fortsætte
podeszwa - sål w, fodsål w
pod gołym niebem - under åben himmel
podkolanówka - knæstrømpe w
podkowa - hestesko w
podłoga - gulv n
podłogowy - gulv-
podłużny - langstrakt
podmiot - subjekt n, grundled n
podniebienie - gane w
podomka - slåbrok, morgenkåbe
podówczas - så, da
podpalenie - brandstiftelse w
podpis - underskrift w
podpułkownik - oberstløjtnant
podręcznik - håndbog w
podróż - rejse w
podstawa - fod w
podstawek - underkop w
podstawka - underkop w
podstawowy - basis-, basal
poduszka - pude w, ruder w, ruder
podwórko - gård w
poeta - digter w, poet w
poganin - hedning w
pogardliwy - foragtelig
pogoda - vejr n
pogrzeb - begravelse w, jordfæstning w
pohybel - galge w
pojazd - køretøj n
pojedynczy - enkelt
pojemnik - beholder w
pojutrze - i overmorgen
pokal - pokal w
pokład - dæk n
pokój - fred w, stue w, værelse n
pokrywać - dække
pół - halv
Polak - polak w
polarnik - polarforsker w
pole - mark m, ager w
polecać - pålægge, anbefale, rekommandere
poleku - langsomt
polepszenie - forbedring w
policja - politi n
policjant - politibetjent w, politimand w
policjantka - politikvinde w
policzek - kind w
poliglota - polyglot
polityczny - politisk
polityk - politiker w
polityka - politik
półkula - halvkugle w, hemisfære w, hjernehalvdel w
północ - midnat, nord
Północ - Norden
północny - nordlig, nord, nørre, midnats-
polon - polonium
położenie - beliggenhed w
półsamogłoska - halvvokal w
Polska - Polen
polski - polsk
półtora - halvanden
półtorej - halvanden
półudenyk - middagsmad w
południe - middag, middagstid, syd
Południe - de sydlige lande
południk - meridian
półwysep - halvø w
połykać - synke
pomagać - hjælpe
pomarańcza - appelsin w
pomarańczowy - orange
pomidor - tomat w
pomidorówka - tomatsuppe w
pomiędzy - mellem
pomnik - monument
pomoc - hjælp w
Pomorze - Pommern
pompa - pumpe w
pomyłka - fejl w, forkert nummer n
poniedziałek - mandag
ponieważ - fordi
ponownie - igen
ponton - ponton w
ponury - dyster
popielniczka - askebæger n
popiół - aske
poprawny - rigtig, korrekt
poprzedni - gammel
por - porre w
por. - sml., cf., jf.
pora roku - årstid w
porcelana - porcelæn
porcelano - porcelæn
pornograficzny - pornografisk
port - havn w, lufthavn w
portfel - tegnebog w
portki - bukser
portretować - portrættere
portu - havn w, lufthavn w
Portugalia - Portugal n
portugalski - portugisisk
porucznik - Premierløjtnant
poruta - skam w, skandale w, ballade w
porządek - orden w
posag - medgift w
posesor - ejer w
posiadać - eje, have
posiadłość - sted n
posiłki - forstærkning w
pośladek - balde w
pośledni - sidste
pośród - blandt, iblandt, mellem, imellem
postanawiać - bestemme
postanowienie - bestemmelse w
postęp - fremgang w, fremskridt n
pot - sved w
potas - kalium
potek - gudfar / gudfader w
potem - efter det
potencjalny - potentiel
potężny - diger
potka - gudmor / gudmoder w
potmanyj - tegnebog w
potop - oversvømmelse w
potrafić - kunne
potrzeba - behov n, brug w
potrzeba jest matką wynalazków - nød lærer nøgen kvinde at spinde
potrzebizna - behov n, brug w
potrzebować - behøve
potwierdzić - bekræfte
potwór - uhyre n, monster w
powątpiewać - tvivle
powiedziałeś A, powiedz B - har man sagt a må man også sige b
powiedzieć - sige
powieka - øjenlåg n
powierzchnia - overflade w
powieść - roman w
powiestka - bøn w, navn n
powieszenie - hængning w
powietrze - luft w
powinien - skulle, burde
powitanie - velkomst w
powód - grund w, årsag w
powodować - årsage, forårsage
powódź - oversvømmelse w
powodzenia - held og lykke
powoli - langsomt
powtarzać - gentage, repetere
pożar - brand w
pozawczoraj - i forgårs
poziomica - vaterpas n, højdekurve w
późno - sent
późny - sen
pozór - opmærksomhed w, agt w, bemærkning w, bebrejdelse w, reprimande w, pas på!
pozwany - sagsøgte
pożyczać - låne
pożyteczny idiota - nyttige idioter
pożywienie - mad w, spise w, spisning w
p.p.m. - u.h.
praca - arbejde n
praca domowa - hjemmearbejde n, lektier
prącie - penis w
pracodawca - arbejdsgiver w
pracoholik - arbejdsnarkoman w
pracoholizm - arbejdsnarkomani w
pracować - arbejde
pracownik - medarbejder w
praczka - vaskekone w
Praga - Prag
pragnienie - tørst w
pralka - vaskemaskine w
pranie - vasketøj n, vask w
prawa człowieka - menneskerettighederne
prawa ręka - højre, ærlig, hånd w, arm w
prawa zwierząt - dyrs rettigheder
prawda - sandhed w
prawdziwych przyjaciół poznaje się w biedzie - i nøden skal man kende sine venner
prawica - højre n
prawie - næsten, snart
prawko - kørekort n
prawnik - jurist w
prawo - lov w, højre
prawo jazdy - kørekort n
prawy - højre, ærlig
prazeodym - praseodym
precyzja - præcision w
precz - væk
prędko - hurtigt
prefiks - præfiks n, forstavelse w
pręgierz - gabestok w
prek - væk
preludium - præludium n
premier - statsminister w
premiera - premiere
prenumerata - abonnement n, subskruption w
prenumerator - abonnent w, subskribent w, prænumerant w
prezent - gave w
prezerwatywa - præservativ n, kondom n
prezydent - præsident w
próba - prøve w, forsøg n, test w
problem - problem n
próbować - prøve, forsøge, smage
proca - slangebøsse w
procent - procent w
proces - proces w
proch - støv n
produkować - producere
profanacja - profanation m, blasfemi w
profesor - professor w
profit - profit w
program - program n
programista - programmør w
progres - fremgang w, fremskridt n
prokurator - anklager w
prom - færge w
promet - promethium
promień - stråle w, radius w
propaganda - propaganda w
propagando - propaganda w
proroctwo - profeti w
prosię ziemne - jordsvin n
prosta - linje w
prostokąt - rektangel
prostokątny - rektangulær
prostytucja - prostitution w
prostytutka - prostitueret w
proszek - pulver n
protaktyn - protactinium
protein - æggehvide w, hvide w
proteina - æggehvide w, hvide w
protest - protest w
protestant - protestant
protestować - protestere
protokół - protokol w
proton - proton w
prowadzić - føre, lede, køre
prowansalski - Occitansk
prowincja - provins w
prowodyr - anstifter w
prowokacja - provokation w
prowokacyjny - provokerende
prowokator - provokatør w
prowokować - provokere
Prusy - Preussen
przać - elske
przebaczać - tilgive
przebaczenie - tilgivelse
przebieg - forløb n
przebiśnieg - vintergæk w, sommergjæk w
przebój - hit m
przebytek - lejlighed w
przeceniać - overvurdere
przeciw - mod, imod
przeciwko - mod, imod
przeciwutleniacz - antioxidant / antioxydant w
przed - foran, for, før, inden
przede - foran, for, før, inden
przedimek - artikel w, kendeord n
przedimek nieokreślony - ubestemt artikel w
przedimek określony - bestemt artikel
przedmieście - forstad w
przedmiot - ting n, fag n, skolefag n, emne n
przedostatni - næstsidst
przedrostek - præfiks n, forstavelse w
przedsiębiorstwo - virksomhed w
przedszkolak - børnehavebarn n
przedszkolanka - børnehavepædagog w, børnehavepædagogmedhjælper w
przedwczoraj - i forgårs
przegroda nosowa - næseskillevæg w
przejrzysty - klar
przejście - overgang w
przekaz - anvisning / bankanvisning / postanvisning / pengeanvisning w, anvisningsblanket w
przekaźnik - relæ n
przeklinać - bande, forbande
przekonanie - overbevisning w
przekształcać - ændre
przekupka - torvekone w
przemoc - vold w
przemysłowy - industriel
przenosić - flytte
przeorysza - priorinde w, abbedisse w
przepiórka - vagtel w
przepis - bestemmelse w, forskrift w, opskrift w
przepraszam - undskyld
przeprowadzać - flytte
przestarzały - forældet, gammeldags
przestępca - forbryder m, lovovertræder w
przestraszyć - forskrække, skræmme, blive bange
przestrzegać - advare, følge, overholde, respektere
przestrzeń kosmiczna - ydre rum
przeszkadzać - forstyrre
przeważność - mod n
przewijać - omvikle, spole (tilbage/frem), skifte, scrolle
przewrotka - saksespark
przeziębienie - forkølelse
przeznaczenie - bestemmelse w
przezroczysty - transparent, gennemsigtig
przeźroczysty - transparent, gennemsigtig
przoć - elske
przy - ved
przychodzić - komme
przygoda - eventyr n
przyimek - forholdsord n, præposition w
przyjaciel - ven w
przyjaciółka - veninde w, elskerinde w
przyjazny - venlig
przyjemny - behagelig
przyjmować - ansætte, modtage, tage
przykład - eksempel n
przymiotnik - tillægsord n, adjektiv n
przynosić - bringe
przypadek - tilfælde n, træf, fald n, kasus w, sag w
przypominać - minde, ligne
przyprawa - kryderi n
przyprawiać - krydre
przyroda - natur w
przyrostek - suffiks n, endelse w
przysada - mangel w
przysłówek - biord n
przysłowie - ordsprog n
przyspieszenie - acceleration w
przyśpieszenie - acceleration w
przystanek - stoppested n
przystanek autobusowy - busstopested n
przyszłość - fremtid w
przyszły - fremtidig, næste
przytcza - eksempel n, tilfælde n, træf, fald n, kasus w, sag w
przywiązywać wagę do czegoś - lægge vægt på noget
psalm - salme w
psiarnia - politi n
psisko - hund w, strissersvin n
psor - professor w
psychiczny - psykisk
pszczoła - bi w
Ptah - Ptah
ptak - fugl w, penis w
ptasia grypa - fugleinfluenza w
ptaszę - fugl w, penis w
publiczność - publikum n
publika - publikum n
puchacz - stor hornugle
puchar - pokal
pudel - puddel w, puddelhund w
pudełko - æske w, lille kasse w
puder - pudder n, melis w, flormelis w, florsukker n
pugilares - tegnebog w
pukać - banke
pukieltasia - rygsæk w
pula - pulje w
pułapka na myszy - musefælde w
pulares - tegnebog w
pularysek - tegnebog w
pultok - kalkun w
punkt - punkt n
pupa - numse w, ende w
purpurowy - purpur, purpurrød
puste - tom
pustelnik - eremit w
pustkowie - ødemark
pusty - tom, dum
pustynia - ørken w
pustynny - ørkenagtig
puszcza - ødemark
puszczać - slippe
puszczyk - natugle w
puszka - dåse w, fængsel n, bajer w, øl w
puszka Pandory - Pandoras æske w
puter - kalkun w
putnia - spand w, spand
pycha - hovmod, indbildskhed, storartet!
Pyjter - Peder, Peter, Per
pynzyjo - pension w
pyra - kartoffel w
pyskówka - skænderi n, kiv w
pyszny - lækker, deliciøs
pyta - penis w
pytać - spørge
pytanie - spørgsmål n
pytanie retoryczne - retorisk spørgsmål n
rabarbar - rabarber w
rabat - rabat w
rabdomioliza - rhabdomyolyse
rachatłukum - tyrkisk delight, tyrkisk lokum
rachunek - regning w
raciądz - ridder w
racja - ret w, ration w
rad - radium, glad
radio - radio w
radiotelegrafista - radiotelegrafist w
radiowy - radio-
radon - radon
rafka - fælg
raj - paradis n, Eden n
Rajch - Tyskland n
rajza - rejse w, tur w, udflugt w
rak - krebs w, kræft w
Rak - krebs
rakarz - hundefanger w, hunderakker w
rana - sår n
raniuszek - halemejse w
rannik - erantis w
ranny - såret, kvæstet, morgen
rasizm - racisme w
ratusz - rådhus n
razdziawa - tåbe w, høved w, ravn w, råge w, krage w
rdza - rust
re- - re, gen
reagować - reagere
reakcja - reaktion w
ręczna - håndbold w
ręcznik - håndklæde n
ręczny - håndbremse w
redyska - radise w
redźka - radise w
referendum - folkeafstemning w, referendum
regał - reol w
regent - regent
regularnie - regelmæssigt
regularny - regelmæssig
ręgulec - bedrageri n, svindel w, snyd n
rej - række w
ręka - hånd w, arm w
rekin - haj w
reklama - reklame w
reklamacja - reklamation w
reklamować - reklamere
rekomendować - anbefale
relatywnie - relativt
religijny - religiøs
ren - rhenium
renoma - renommé, ry
renowacja - renovering w
reporter - reporter w
reprezentant - repræsentant w
Republika Federalna Niemiec - Forbundsrepublikken Tyskland
Republika Słowacka - Slovakiske Republik
reputacja - reputation w, anseelse w, ry n, renomme n
restauracja - restaurant w, restauration w
reszta - rest w
rewers - revers, bagside w
rewolucja - revolution
rewolwer - revolver w
rezerwować - reservere
riposta - et slagfærdigt svar ripostere)
robić - lave, gøre
robić na drutach - strikke
robić z igły widły - en lille fjer kan blive til fem høns
robot - robot w
robótka - håndarbejde n
rocznica - årsdag w
roczny - årlig
rod - rhodium
rodentycyd - rodenticid n
rodzajnik - artikel w, kendeord n
rodzajnik nieokreślony - ubestemt artikel w
rodzajnik określony - bestemt artikel w
rodzic - forælder w
rodzić - føde, blive født
rodzina - familie f
rodzynek - rosin w
rodzynka - rosin w
róg Amaltei - overflødighedshorn n
róg obfitości - overflødighedshorn n
rok - år n
rok przestępny - skudår n
rolki - rulleskøjte
romantyczny - romantisk
romb - rombe
rondo - rundkørsel w, rondo w
ropień - byld
ropucha - tudse w
róść - vokse, hæve
Rosja - Rusland n
roślina - plante w
rosnąć - vokse, hæve
rosyjski - russisk
roszada - rokade w
rotmistrz - ritmester
rouza - rose w
rower - cykel w
rowerzysta - cyklist w
równak - dog, alligevel
równanie - ligning
również - også
równik - ækvator w
równoległy - parallel
równonoc - jævndøgn n
równość - ligestilling w, lighed w
róża - rose w
rozczarowanie - skuffelse w
rozgałęzienie - forgrening w
rozgwiazda - søstjerne w
rozkład - skema n, råd n, råddenskab w, forrådnelse w, dekomposition w
rozładować - aflæsse, aflade
rozmowa - samtale w, konversation w
rozmówki - parlør w
rozmyślnie - forsætlig, med vilje
różnica - differens w, forskel w
różnojęzyczny - flersproget
różnojęzykowy - flersproget
różny - forskellig, anderledes
różowy - lyserød
rozpychać się łokciami - albue
rozsądny - fornuftig, ræsonnabel, rationel
rozsierdzie - vrede w
roztomaity - forskellig, anderledes
rozumieć - forstå
rozważać - overveje
rozwidlenie - gaffeldeling w
rozwielitka - dafnie w
rozwód - skilsmisse w
rozwój - udvikling w
rtęć - kviksølv
rubid - rubidium
ruch - bevægelse w, trafik
ruchome schody - rulletrappe
ruch posuwisto-zwrotny - frem-og-tilbage bevægelse w
ruda - malm w
rudawiec - al w
rudny - rød, kommunist w
rufa - balde w
rum - rom w
Rumun - rumæner w
Rumunia - Rumænien n
rumuński - rumænsk
rupia - rupi w
rura - rør n, løb n
ruten - ruthenium
rutherford - rutherfordium
ryba - fisk w
rybak - fisker w
Ryby - Fiskene
rycerz - ridder w
rym - rim n
ryma - katar w, influenza w
rynka - gryde w, cylinder w, cylinderhat w
rytm - rytme w
ryż - ris w
rząd - regering m, styre n, række w, orden
rzadki - sjælden, tynd
rzadko - sjældent, tyndt
rzadny - grim
rządzić - regere, styre
rzecz - ting n, sag w
rzeczownik - substantiv n, navneord n
rzeczywistość - virkelighed w
rzeczywisty - virkelig, reel, konkret, håndgribelig
rzeka - flod w
rzemieślnik - håndværker w
rzemiosło - håndværk
rzęsa - øjenvippe w
rzeźnia - slagteri n
rzeżucha - karse w
rzić - røv w, fisse w
rzodkiewka - radise w
rzucać - kaste
rzucać perły przed wieprze - kaste perler for svin
rzut karny - straffespark n
rzut rożny - hjørnespark n
rzygać - vomitere, kaste op
rzykać - bede
Rzym - Rom n
rzymianin - romer w
s. - s.
SA - A/S, a/s
Sabina - Sabine, Sabina
sabotaż - sabotage w
sabotować - sabotere
sadzielnik - skorstensfejer w
safari - safari w
sagan - hoved n, leder w, overhoved n, kedel w
sałaciarz - taxachauffør
salamandra - salamander w
sałata - salat w, taxa ), grunker
sałatka - salat w
salceson - politibetjent w, politimand w
Salwador - El Salvador
samar - samarium
samica - hun w
samobójca - selvmorder w
samobójstwo - selvmord n
samochód - bil w
samochód osobowy - personbil
samodzielnie - selvstændingt, uafhængigt, autonomt, suverænt
samodzielny - selvstændig, uafhængig, autonom, suveræn
samogłoska - selvlyd w, vokal w
samolot - fly n, flyvemaskine w
samoświadomość - selvbevidsthed
samotny - ensom
samowar - samovar w
sandacz - sandart w
Sardynia - Sardinien
sarkastyczny - sarkastisk
sarkazm - sarkasme w
sarkofag - sarkofag w
sarna - rådyr n
sarnapa - giraf w
sąsiad - nabo w
sąsiadka - naboerske w
satelita - satellit w
satyna - satin
sauna - sauna w
scena - scene w
sceptycyzm - skepticisme
schody - trappe w
schody ruchome - rulletrappe
schodzić na psy - gå i hundene
ściana - væg w
ściany mają uszy - væggene har ører
ścięgno - sene w
ściemniać - lyve
ścierka - klud w
ściernica - slibesten w
ścierwo - ådsel n
se - sig, sigselv, migselv, osv.
seaborg - seaborgium
sędzia - dommer w
segregacja rasowa - raceadskillelse w
sekcja - sektion w, autopsi w, obduktion w
sekret - hemmelighed w
seks - sex w
seks oralny - oralsex, mundsex
sekstant - sekstant w
seksualny - seksuel
sekunda - sekund n
selen - selen n
seler - selleri w
sen - søvn w, drøm w
senny - søvnig
sen zimowy - vintersøvn w
separatystyczny - separatistisk
sepsa - sepsis w, blodforgiftning w
ser - ost w
Serb - serber w
Serbia - Serbien n
Serbia i Czarnogóra - Serbien og Montenegro
serbski - serbisk
serce - hjerte n
serdce - hjerte n
serdecznie - hjerteligt
serdeczny - hjertelig
serdeczny palec - ringfinger w
seroka - skade w
serowy - rå
setka - hund w
Sewilla - Sevilla
sfinks - sfinks w
si - denne, dette
siać - så
siano - hø
siarka - svovl
siarkowodór - svovlbrinte
siatkówka - volleyball w, volley w, nethinde w
się - sig (mig/mig self, dig/dig selv, osv.)
sieczeń - februar w, blidemåned
siedzieć - sidde, sidde i fengsel
siemię lniane - hørfrø n
sierociniec - børnehjem n
sierpień - august w
siestrzan - nevø w
siestrzeniec - nevø w
sikać - tisse
siki - urin w
sikora - mejse w
sikora bogatka - musvit w
sikora modra - blåmejse w
sikora sosnówka - sortmejse w
siła wyższa - force majeure w
silnik - motor w
silno - meget, megen, mere, mest +
silny - stærk
Singapur - Singapore
siodło - sadel w
sioło - landsby w, land n
siostra - en søster
siostrzan - nevø w
siostrzanek - nevø w, svoger w
siostrzeniec - nevø w
sipa - skovl w
sirpień - august w
sitko - mikrofon w
siurać - tisse
siusiak - tissemand w
skakać - hoppe
skała - klippe
skand - skandium
skandal - skandale w
Skandynawia - Skandinavien n
skandynawski - skandinavisk
skąpiec - gnier w
skąpstwo - gerrighed w, nærighed w
skarb - skat w
skarpeta - strompe w
skiba - tyveri n
skibać - stjæle
skład - butik w, forretning w, kælder w
składać - samle, folde, bestå (af)
sklep - butik w, forretning w, kælder w
skoczek - hest w
skok o tyczce - stangspring
skomplikowany - kompliceret, indviklet
skończony - ende, slutte, afslutte
skop - bede w
Skop - Vædderen w
skóra - hud w, læder n
skorek - ørentvist w
Skorpion - Skorpionen
skorupa - skorpe w
skorupa ziemska - jordskorpe w
skoruśniak - røn w, rønnebærtræ n, rønnebær n
skot - kvæg n
skowroda - pande w, stegepande w
skra - gnist w
skręcać - dreje
skromne - beskeden
skromny - beskeden
skrótowiec - akronym n
skrytka pocztowa - postboks w
skrzydło - ving w
skrzynka - kasse w, postkasse w
skrzynka pocztowa - postkasse w
skrzypce - violin w
skrzyp polny - Ager-Padderok w
skrzyżowanie - vejkryds n
skuteczność - effektivitet w
słaby - svag
slang - slang n
Śląsk - Schlesien
sławny - berømt, kendt
śleboda - frihed w, uafhængighed w
śledź - sild w, slips n, strik/strikke w
śledziona - milt w
ślepa uliczka - blind vej w
ślepiec - blind
śleptać - græde
ślepucha - høne w
ślepy - blind
ślepy lelek - flagermus w
ślimak - snegl w
ślina - mundvand n, spyt n
ślips - slips n, strik/strikke w
ślipundyr - tåbe w, høved w
śliwka - blomme w
słodki - sød
słodko - sødt
słodkość - sødme w
słoik - krukke w, glaskrukke w
słomka - strå n, sugerør n
słoń - elefant w
słońce - Solen, sol w
Słońce - Solen
słowa - ord n
Słowacja - Slovakiet n
słowacki - slovakisk
Słowak - slovak w
Słowenia - Slovenien n
słowiański - slavisk
słowik - nattergal w
słownik - ordbog w, ordforråd, gloseforråd, leksik, vokabular
słowo - ord n
ślub - bryllup n
słuch - hørelse w
słuchać - lytte
słuchalnia - foredragssal w, auditorium n
słuchawka - hovedtelefon w
sługa - tjener w
slup - slup
słup - søjle w
służyć - tjene
słynny - berømt, kendt
słyszeć - høre
smacznego - god appetit!
smaczny - velsmagende
smak - smag w
smakować - smage
smerf - Smølf w
śmieciarz - skraldemand w
śmierć - død w
śmierdolić - lugte, stinke
śmierdzieć - lugte, stinke
śmiertelny - dødelig
śmieszny - sjov
śmietana - fløde w
smok - drage w
smród - stank w
smrodyla - solbær n
SMS - sms w
smutniak - brød n
snajper - finskytte, snigskytte
śniadanie - morgenmad w
śniedny - spiselig
śnieg - sne w
śnieżyć - sne
sobaka - hund w, strissersvin n
sobie - sig, sigselv, migselv, osv.
sobota - lørdag
sobowtór - dobbeltgænger w
socjalistyczny - socialistisk
socjalizm - socialisme w
socjolog - sociolog w
socjologia - sociologi w
socynianin - socinianer w
socynista - socinianer w
socynjanin - socinianer w
soczewica - linse w
soczysty - saftig
sód - natrium
sokół - falk w
sól - salt n
solidarność - solidaritet w
solniczka - saltbøsse w
somnambulik - søvngænger w
somsiad - nabo w
sonata - sonate w
sopran - sopran w
sopranistka - sopransangerinde w
sos - sauce w, sovs
sosna - fyr w, fyrretræ n
sosnówka - sortmejse w
sos sojowy - sojasovs w
sowa - ugle w
spać - sove
spacer - spadseretur w
spać jak kamień - sove som en sten
spadek - arv w
spadochron - faldskærm w
spaghetti - spaghetti w, spagetti w
specjalny - speciel
specyficzny - specifik
spektrum - spøgelse n
spekulant - spekulant w
sperma - sperm w, sperma, sæd
śpiewać - synge
śpiewnik - sangbog w
spiłować - file
spinacz - clips / klips w, papirclips / papirklips w
śpioch - syvsover m, sovetryne w
spirulina - spirulina
spisek - konspiration w
spis rzeczy - indholdsfortegnelse
spis treści - indholdsfortegnelse
śpiwór - sovepose w
spiż - gunmetal n
spodek - underkop w
spodnie - bukser
spójnik - bindeord n
spółgłoska - medlyd w, konsonant w
spółka akcyjna - aktieselskab n
spółka zależna - datterselskab n
sporadycznie - sporadisk
sport - sport w, idræt w
sposób - måde w
spowiedź - skrifte
spóźniać się - tabe
spożywczy - fødevare-
sprawa - sag w
sprawdzać - kontrollere, tjekke
sprawiedliwość - retfærdighed w, justits w
sprawiedlność - retfærdighed w, justits w
sprężać - komprimere, sammentrykke
spróbować - smage
sprzątać - rengøre
sprzątaczka - rengøringskone w, rengøringsdame w, rengøringsassistent w
sprzątanie - rengøring w
sprzedawać - sælge
sprzedaż - salg n
sprzęgło - kobling w
spychacz - bulldozer w
spycharka - bulldozer w
spylać - flygte, rømme
sp. z o.o. - ApS
srać - skide
sraczka - tyndskide, møllebæ w
sraka - tyndskide, møllebæ w
srebrna - sølv
srebrny - sølv
srebro - sølv n
średnica - diameter w
średnik - semikolon n
średniowiecze - middelalder
Sri Lanka - Sri Lanka
ŚRK - KV
środa - onsdag
środek - center n, middel w
środki produkcji - produktionsmidler
środowisko - miljø n
sroka - skade w
srokosz - stor tornskade w
śruba - bolt w
śrubokręt - skruetrækker w
śrupać - bide
śryż - sjapis w
ssać - suge
ssak - pattedyr n
ssanie - sug n
stać - stå
stacja - station w
stacja benzynowa - tank w, tankstation w, benzinstation w
staczać się po równia równi pochyłej - … på (et) skråplan
stąd - herfra
stal - stål n
stała - konstant w
stale - konstant
stały - konstant, stabil, stadig
stan - tilstand w, stat w
stanik - brystholder w, bh w
Stany - Amerikas Forenede Stater, De Forenede Stater
Stany Zjednoczone - De Forenede Stater
Stany Zjednoczone Ameryki - Amerikas Forenede Stater, De Forenede Stater
stara miłość nie rdzewieje - gammel kærlighed ruster ikke
starek - farfar w, morfar w, olding w
stare miasto - gammel, by w, i stedet
starka - bedste m, bedstemor m, bedstemoder m, mormor m, farmor w
starość - alderdom w
starosek - farfar w, morfar w, olding w
staroszek - farfar w, morfar w, olding w
starszy - far w, fader w
stary - gammel
starzec - olding w
starzyk - farfar w, morfar w, olding w
statek - skib n
statki - beholder w, køkkentøj n, kar n
statory - beholder w, køkkentøj n, kar n
status - status w
statystyczny - statistisk
statystyka - statistik w
staw - led n
stawiać - stille, sætte, bygge, rejse, give, vædde, modsætte sig
staw łokciowy - albue w
stempel - stempel n
sterczeć - stikke ud, stå
stereotyp - stereotyp w
sterownik - driver w
stłuczka - glasaffald w, kollision w
stocznia - værft n
stojeć - stå
stół - bord n
stolica - hovedstad w
stołowy - bord-
stomatolog - tandlæge w
stonka - coloradobille w
stonoga - tusindben n
stop - legering w, stands!
stopa - fod w
stopień - trin n, trappetrin n, vinkelgrad w, grad w, rang w, mål n, styrke w, karakter w
stopniowo - gradvis
stopniowy - gradvis
stosować - bruge, benytte, anvende
stosunek - forhold n, relation w, sammenhæng w, samleje w
stosunek płciowy - samleje w
stówa - hund w
stowarzyszenie - forening w
str. - s.
strach - angst m, frygt w, fugleskræmsel n
strachliwy - ængstelig, sky
strach na wróble - angst m, frygt w, fugleskræmsel n
stracić twarz - miste ansigt, tabe ansigt
strajk - strejke w
strąk - bælg w
strąpacz - februar w, blidemåned, kold
straszliwy - skrækkelig
strata - tab n
strateg - strateg w
strategia - strategi w
strażak - brandmand w
stringi - g-streng w
strofa - vers n, strofe w
strój - påklædning w, antræk w, outfit n, stemning w
strona - side w, diatese w, art w
strona bierna - lideform w, passiv w
strona czynna - handleform w, aktiv w
stront - strontium
stróż - vagt w
struna głosowa - stemmebånd
struś - struds w
strych - loft n
strychnina - stryknin
stryczek - strik/strikke w
stryj - farbror w, farbroder w, onkel w
stryjek - farbror w, farbroder w, onkel w
stryjenka - tante w
stryjna - tante w
stryjno - tante w
śtrykować - strikke
strzała - pil w
strzałka - pil w
strzelec - skytte w, målscorer w
Strzelec - Skytten
student - studerende w
studiować - læse, studere
stuk - bank, banken n
stulecie - alder w, århundrede n
stworzenie - kræ n
styczeń - januar w, glugmåned
styl - stil w
substancja - substans w
substytucja - substitution w, erstatning w
suchy - tør
sufiks - suffiks n, endelse w
suka - hundhund w, tæve w, mær w
sukces - succes
sukienka - kjole w
suma - sum w
sumienie - samvittighed w
superkontynent - superkontinent n
supermarket - supermarked n
surowiec - råvare w
surowy - rå
surrealistyczny - surreel
sutek - brystvorte w
świat - verden w
świat arabski - den arabiske verden w
światło - lys n
świeca - lys n
świecę - lys n, lyse
świecić - lyse
świecznik - lysestage, kandelaber
świekra - svigermor w
świeść - svigermor w
świeży - frisk
świgać - kaste
świnia - gris w, svin n
świnka - fåresyge w
świnka morska - marsvin n
świostka - svigermor w
świt - daggry w
świtanie - daggry w
swój - sin
swoje - sin
swok - farbror w, farbroder w, onkel w
syczeć - hvæse
syfilis - syfilis w
syjam - siameserkat w, siameser w
syjonizm - zionisme w
syk - hvislen w
sylaba - stavelse w
sylur - Silur
symbol - symbol n
symptom - symptom n
syn - søn w
synapsa - synapse
synek - dreng w
synonim - synonym n
synonimiczny - synonym
synowiec - nevø w, brorsøn w, brodersøn m
syntetyczny - syntetisk
sypialnia - soveværelse n
syra - ben w
syrena - sirene w, søko w
syrop klonowy - ahornsirup w
system - system n
system operacyjny - styresystem n, operativsystem n
system plików - filsystem n
sytuacja - situation w
szach - skak w, shah w
szachownica - skakbræt n
szachta - skakt w
szachy - skak w
szacowanie - skøn n, vurdering w
szafa - skab n
szafran - krokus w
szajs - lort w, lort n
szansa - chance w
szantaż - afpresning w
szantażysta - afpresser w
szary - grå
szarytka - sumpmejse w
szaszok - kujon w, ilder w
szczać - pisse
Szczecin - Stettin
szczęka - kæbe w
szczelina - sprække w, revne w
szczeniak - hvalp
szczenię - hvalp
szczepionka - vaccine
szczerk - grus n
szczery - ærlig
szczęśliwy - lykkelig, heldig
szczewik - sko w
szczoteczka do zębów - tandbørste w
szczotka - børste w
szczuć - hetze, pudse
szczun - hvalp
szczupak - gedde w
szczur - rotte w
szczurołap - rottefænger w
szczyny - pis n
szczypawka - ørentvist w
szczypior - purløg w, purløg n
szczypiorniak - håndbold w
szczyt - top w, tinde w, topmøde n, orgasme w
szept - hvisken w
szeptać - hviske
szereg - række w
szeroki - bred
szerzyć - udbrede, udsprede
sześcian - kube w, terning w
szewc - skomager w
szewc bez butów chodzi - smedens hest og skomagerens kone har ofte de dårligste sko
szkielet - skelet n
szkira - pige m, kærste w
szkita - ben w
szklanka - glas n
szkliwo - tandemalje/emalje w
szkło - glas n
Szkocja - Skotland n
szkocki - skotsk
szkoda - skade w
szkodnik - skadedyr n
szkoła - skole w
szkop - tysker w
szkuner - skonnert
szlachtuz - slagteri n
szlafrok - slåbrok, morgenkåbe
Szląsk - Schlesien
szlauch - slange w
szlips - slips n, strik/strikke w
szlug - smøg w, cigaret w
szmaja - kejthåndet person
szmania - kejthåndet person
szminka - læbestift w
szmucha - bedrageri n, svindel w, snyd n
szneka - ansigt n, murske w
sznita - skive w
sznur - snor w
sznurowadło - snørebånd n, snørelidse w
sznurówka - snørebånd n, snørelidse w
sznyt - snitsår n
sznytka - skive w
szpic fiński - finsk spids w
szpic japoński - japansk spids
szpieg - spion w
szpinak - spinat w
szpital - sygehus n, hospital n
szpuk - due w
szpulka - spole w
szrank - skab n
sztof - materiale n, stof n
Sztokholm - Stockholm n
sztokholmczyk - stockholmer w
sztrof - straf w
sztrofa - straf w, trillebør w
sztrykować - strikke
sztućce - bestik n
sztuciec - et stykke bestik, bestik n
sztuczny - kunstig
sztuka - kunst w, kunnen, færdighed w, styk n, stykke n, skuespil n, pige m, kærste w
szubienica - galge w
szukać - søge
szukać igły w stogu siana - en nål i en høstak
szulak - høg w
szurzy - svoger w
szwab - tysker w
Szwabia - Schwaben
szwaczka - syerske w
szwagier - svoger w
szwaja - ben w
Szwajcaria - Schweiz n, Svejts n
Szwecja - Sverige
Szwecyjo - Sverige
Szwed - svensker w
Szwedka - svensker w
szwedzki - svensk
szwestera - en søster
szwindel - svindel w
szyb - skakt w
szyba - rude w
szybki - hurtig, hastig
szybko - hurtigt
szybkość - hastighed w
szyć - sy
szyfr - chiffer n, kode w
szyja - hals w
szyjka - hals w
szyjka macicy - livmoderhals w
szykowny - køn, pæn, net, nydelig, sød
szympans - chimpanse w
szynal - søm n
szynd - voldtægt w, vold w
szynobus - skinnebus w
szynszyla - chinchilla w
szyszka - kogle w
ta - denne, dette
tabaka - tobak w
tablica rejestracyjna - nummerplade w
tabu - tabu n
taca - bakke w
tachykardia - takykardi
tacik - far w, fader w, farfar w, morfar w, olding w
taczka - trillebør w
Tadżyk - tadsjiker w
Tadżykistan - Tadsjikistan n
tajemnica - hemmelighed w
tajemniczy - mysteriøs
tajga - tajga w
Tajlandczyk - thailænder w
Tajlandia - Thailand
tajlandzki - thailandsk
tajny - hemmelig
tajski - thailandsk
tak - så, på denne måde, ja
taki - så, sådan
taksówka - taxa )
taksówkarz - taxachauffør
także - også
tak zwany - såkaldt
tal - thallium
talent - talent n, talent w
talerz - tallerken w
tam - der
tamdotąd - der
tan - dans w
tańczyć - danse
tangens - tangens w
tango - tango
tani - billig
taniec - dans w
taniec brzucha - mavedans w
tank - tank w
tanksztela - tank w, tankstation w, benzinstation w
tantal - tantal
Tanzania - Tanzania
tapeta - tapet n
tarantula - tarantel w
tarcza - skjold n, urskive w, ansigt n, slibesten w
tarcza krystaliczna - skjold n
tarcza strzelecka - skjold n, urskive w, ansigt n, slibesten w
tarcza szkolna - skjold n
tarcza szlifierska - slibesten w
targ - torv n
taśka - håndtaske w
taśma perforowana - hulstrimmel
taśtać - bære
Taszkent - Tasjkent
tatar - tatar w
taternictwo - bjergbestigning
tautologia - tautologi w
tchórz - kujon w, ilder w
te - denne, dette
teatr - teater n
technet - technetium
techniczny - teknisk
technik - tekniker w
technika - teknik w
tęcza - regnbue w
tej - du, De
Tekla - Tekla, Thekla
tekst - tekst w
tektoniczny - tektonisk
telefon - telefon w
telefoniczny - telefonisk, telefon…
telefon komórkowy - mobiltelefon w
telefonować - telefonere, ringe
telegrafista - telegrafist w
teleskop - teleskop n
teletekst - tekst-tv n
telewizja - television w
telewizor - fjernsyn n
tellur - tellur
temat - emne n, tema n
temperatura - varmetilstand, temperatur w
temperatura pokojowa - stuetemperatur w
temperówka - blyantspidser w
tempo - tempo n
temu - for … siden
ten - denne, dette
tendencyjny - tendentiøs
ten sam - lige
ten śmiać się śmieje, kto śmiać się śmieje ostatni - den der ler sidst, ler bedst
tenże - denne, dette, det
teozoficzny - teosofisk
tępy - sløv
terapeuta - terapeut
terapia - terapi
teraz - nu
terb - terbium
teren - område n
terier brazylijski - brasiliansk terrier
terier szkocki - skotsk terrier
termin - term w, termin w
termodynamika - termodynamik
termometr - termometer n
Termopile - Thermopylæ
teściowa - svigermor w
tęsknota - længsel, hjemve
testament - testamente n
test ciążowy - graviditetstest w
tętnica - arterie w, pulsåre w, færdselsåre w
tetragon - firkant w
też - også
Timor Wschodni - Østtimor
tj. - dvs.
tkactwo - vævning
tkanka - væv
tlen - ilt w
tlenek węgla - kulilte
tłok - stempel n
tłumacz - oversætter w, tolk w
tłumaczenie - oversættelse w, forklaring w
tłumaczyć - forklare, oversætte, fortolke
to - denne, dette, det
tobie - du, De
tokarka - drejebænk w
Tomasz - Thomas, Tomas, Tom
tona - ton
tonąć - synke, drukne
topór - økse w
tor - thorium
torebka - håndtaske w
tornado - tornado w
tornister - tornyster n
tors - torso w
tort - lagkage w
tory - thorium
totalitarny - totalitær
totalitaryzm - totalitarisme w
totem - totem
towar - vare w
trącać - at skubbe
trącić - at lugte (af ngt)
trąd - spedalskhed
tradycja - tradition w
tradycyjny - traditionel
trądzik - akne w
traf - tilfælde n, træf, fald n, kasus w, sag w
trafić trafiło się ślepej kurze ziarno - en blind høne finder også et korn
tragedia - tragedie w
trajkotka - atlingand w
trambimba - sporvogn w
tramwaj - sporvogn w
tramwajka - sporvogn w
transformator - transformator w
translator - oversætter w, tolk w
transliteracja - translitteration w
transparentny - transparent, gennemsigtig
transsubstancjacja - transsubstantiation
tranzystor - transistor w, transistorradio w, radio w
trapez - trapez n, trapez w
trawa - græs n
trawnik - plæne
trener - træner w, coach w
trias - trias, triastiden
trichotillomania - trikotillomani
trimaran - trimaran w
trochę - lidt
tróhła - ligkiste w, kiste w
trójkąt - trekant w
Trójprzymierze - Tripelalliancen w
trójskok - trespring n
troll - trold w
truchło - lig n
trucizna - gift w
trudnić się - beskæftige sig
trudny - svær, hård
trujący - giftig
trumna - ligkiste w, kiste w
trup - kadaver n, lig n
trupia czaszka - dødningehoved n
truskawka - jordbær w
trutka - gift w
tryb rozkazujący - imperativ w, bydemåde w, bydeform w
trza - der må / skal / bør +, man / du må / skal / bør +, det er nødvendigt at…
trzeba - der må / skal / bør +, man / du må / skal / bør +, det er nødvendigt at…
trzęsienie ziemi - jordskælv n
trzeźwy - ædru
trzmielojad - hvepsevåge w
trznadel zwyczajny - gulspurv
trzustka - bugspytkirtel w
trzymać - holde
trzymać język za zębami - holde tand for tunge
tsunami - tsunami w, tsunamibølge w, flodbølge w
tu - her
tudzież - og
tukej - her
tuleja - bøsning w
tu leży pies pogrzebany - her ligger hunden begravet
tulipan - tulipan w
tulp - tulipan w
Tunezja - Tunesien n
Tunezyjczyk - Tuneser w
tungsten - wolfram n
turban - turban w
Turcja - Tyrkiet n
Turkmenistan - Turkmenistan n
turysta - turist w
tutaj - her
tuż - næsten
tuzin - dusin n
TV - tv n
twardy - hård
twardziel - harddisk w, (fastpladelager w)
twarz - ansigt n
twierdza - borg w
twierdzić - påstå
twój - din
twórca - skaber w
tworzyć - skabe
ty - du, De
Tybetańczyk - tibetaner w
tyć - tage på
tydzień - uge w
tygr - tiger w
tygrys - tiger w
tyj - te
tylko - kun
tymczasowy - midlertidig, temporær, foreløbig
tyn - mur w
typ - type w, række w
typografia - typografi
typowy - typisk
tytan - titan w, titanium n, titan n
Tytan - Titan w
tytoń - tobak w
tzn. - dvs.
u - ved
ubezpieczenie - forsikring w, sikring w
ubierać - klæde
ubogi - fattig
ubóstwiać - forgude, tilbede
ubóstwo - fattigdom
ubranie - tøj n
ucho - øre n, håndtag n, hank w
uciekać - flygte, rømme
uczeń - elev w
uczestniczyć - deltage
uczyć - lære, undervise
udziec - ben
UE - EU
ufnal - søm n
Uganda - Uganda n
UGW - ØMU
uj - onkel w, morbror w, farbror w
ujec - onkel w, morbror w, farbror w
ujek - onkel w, morbror w, farbror w
ujemny - negativ
ukamienowanie - stening
układ okresowy - periodiske system
układ okresowy pierwiastków - periodiske system
ukleja - løje w
Ukraina - Ukraine n
Ukrainiec - ukrainer w
ukraiński - ukrainsk
ukrop - kogende vand
ul - bikube w
ulepszanie - forbedring w
ulepszenie - forbedring w
ulica - gade w
ulotka - flyveblad n
ulubiony - yndlings, favorit
umfal - tilfælde n, ulykke w
umiak - konebåd
umieć - kunne
umierać - dø
umowa - aftale w
umożliwiać - muliggøre, gøre ngt muligt
umyślnie - forsætlig, med vilje
umywać ręce - vaske sine hænder
umywalka - håndvask w, vask w
Unia Europejska - Europæiske Union w
uniform - uniform w
unikat - unikum n
uniwerek - universitet n
uniwersytet - universitet n
uón - han
upiór - vampyr w, spøgelse n
uprawiać - kultivere, dyrke
Ural - Uralbjergene, Uralfloden
urbanizacja - urbanisering w
urępny - smuk, pæn
urodziny - fødselsdag w, fødsel w
urodziwy - køn, pæn, net, nydelig, sød
urologia - urologi
uryna - urin w
urządzenie - anlæg n
usługa - tjeneste w
uśmiechać się - smile
usta - mund w
ustawa - lov w
uszny - øre-
utęsknienie - længsel, hjemve
utwór - værk n
utworzenie - dannelse w
uwaga - opmærksomhed w, agt w, bemærkning w, bebrejdelse w, reprimande w, pas på!
uważać - passe på, synes, finde, anse
uwertura - ouverture w
uwielbiać - elske
uwodzić - lokke, forføre
uzależnienie - afhængighed w
Uzbekistan - Usbekistan n
uzus - brug w, skik w, vane w
użycie - brug w
użyteczny idiota - nyttige idioter
użytkownik - bruger w
używać - bruge, benytte, anvende
volapük - volapyk n
w - i, mod, på
w. - årh.
wacha - benzin w, regn w, hav n, vand n
wąchać - lugte
wachlarz - vifte w
wada - mangel w
waga - vægt w
Waga - Vægten
wagon - vogn w
wahować - vogte
wajco - æg n
wakacje - ferie w
walczyć - kæmpe
walczyć z wiatrakami - kæmpe mod vejrmøller
Waldemar - Valdemar
walec - motortromle w, cylinder w, valseværk n
wałek - bedrageri n, svindel w, snyd n
walet - knægt w
Walia - Wales
walić - slå, banke
walić konia - spille pik
waliza - kuffert w
walizka - kuffert w
walka - kamp
walka z wiatrakami - kamp mod vejrmøller
waltornia - valdhorn n
waluta - valuta
wampir - vampyr w
wanad - vanadium, vanadin
wanna - badekar n
wanta - vant n
wapń - calcium n, kalcium n
wapniak - forælder w
war - kogende vand
waran - varan w
warchoł - kværulant w
wardawy - kejthåndet person
warga - læbe w
wariat - tosse w, fjols n
Warkocz Bereniki - Berenikes Lokker
Warszawa - Warszawa
wartość - værdi w
wartościowy - værdifuld
warunek - betingelse w
warunek konieczny - nødvendig betingelse w
warunek wystarczający - tilstrækkelig betingelse w
warząchew - grydeske w, øseske w
warzyć - koge
warzywniak - grønthandler w
warzywo - grøntsag / grønsag w
wąsatka - skægmejse w
waserwaga - vaterpas n, højdekurve w
waserwaśka - vaterpas n, højdekurve w
waserwoga - vaterpas n, højdekurve w
wąski - smal, snæver, tæt
wasz - jeres
waszkorb - kurv w
wata cukrowa - candyfloss w
wątpić - tvivle
wątpliwość - tvivl w
wątpliwy - tvivlsom
wątroba - lever w
wątrobianka - leverpølse w
Watykan - Vatikan
wąż - slange w
ważka - guldsmed w
ważny - vigtig, gyldig, gældende
wazon - vase w
ważyć - veje, overveje
wchodzić - komme ind
w czasie - under, i løbet af, mens
wczoraj - i går
wdowa - enke w
wdowiec - enkemand w
wdowula - enke w
wdzięczny - taknemmelig
we - i, mod, på
węborek - spand w, spand
wedle - ifølge
według - ifølge
weganin - veganer w
wegetarianizm - vegetarisme w, vegetarianisme w
węgiel - kulstof n, karbon n
węgiel kamienny - stenkul
węgierski - ungarsk
węglarz - kulsvier
węgorz - ål w
Węgry - Ungarn n
wełna - uld w
wełniany - ulden
wentroba - lever w
wentylator - ventilator w
weranda - veranda w
weredyk - sandhedsapostel w
Weronika - Veronika
wersalka - sovesofa w
wersor - enhedsvektor w
wesoło - lystigt
Wesołych Świąt - glædelig Jul
westa - vest w
weterynaria - veterinærvidenskab w
weterynaryjny - veterinær
weterynarz - dyrlæge w, veterinær w
wet za wet - lige for lige
węzeł - knob n
wezwanie - bøn w, navn n
wg - if.
wiać - blæse
wiadomość - meddelelse w
wiadro - spand w, spand
wiatr - vind w
wiatrak - vindmølle w, vejrmølle w
wiatrówka - luftbøsse w
widać - vist, vistnok
widelec - gaffel w
wideoklip - musikvideo
widły - greb w
widmo - spøgelse n
widołka - gaffel w
widownia - publikum n, tilskuerplads w
widzenie - besøg n
widzieć - se
więc - så, derfor
wieczera - (natmad w)
wieczerza - (natmad w)
wieczność - evighed w
wieczny - evig
wieczór - aften w
wiedeńczyk - wiener w
wiedza - viden w
wiedzieć - vide
wiek - alder w, århundrede n
większość - flest
wiela - hvor mange, hvor meget, hvilken, hvilket, hvilke, der, som
wiele - mange, meget
Wielkanoc - påske w
wielki - stor
Wielki Piątek - Langfredag w
wielkość - størrelse w
wielojęzyczny - flersproget
wielojęzykowy - flersproget
wielokulturowość - multikulturalisme w
wierny - tro, trofast
wiersz - digt w, linje w
wierzba - pil w, piletræ n
wierzchołek - top w, spids w
wierzyć - tro
wieś - landsby w, land n
wieśniak - en landmand, en bonde, bonderøv
wietnamski - vietnamesisk
wietrzyk - brise w, luftning w
wiewiórka - egern n
wieża - tårn n
więzienie - fængsel n
więziennictwo - fængselsvæsen n
więzy krwi - blodbånd n
wigilia - juleaften w
wigor - vigør w
wigwam - wigwam w
Wikipedia - Wikipedia w
wikipedysta - wikipedist w
Wikisłownik - Wikiordbog w
Wikiźródła - Wikisource
wiktoria - sejr w
wilczy - ulve-
wilczyca - ulvinde w, hunulv w
wilia - juleaften w
wilija - juleaften w
wilk - ulv w
wilk morski - søulk w
wilkołak - varulv w
willa - villa
Wilno - Vilnius n
wina - skyld w
Wincenty - Vincent (Vincents, Vincentz)
winda - elevator w
windziarz - elevatorfører w
winien - skyldig, skulle, burde
winny - skyldig
wino - vin w, spar w
winograd - vinstok w, vinranke w, vinbusk w, vindrue w, vin w, spar w
winogrono - vindrue w
winorośl - vinstok w, vinranke w, vinbusk w
wiolencja - vold w
wiolonczela - cello w, violoncel w
wioska - landsby w, land n
wioślarka - roer w
wioślarz - roer w
wiosło - åre w, pagaj w
wiosna - forår n
Wirakocza - Viracocha
wirtualny - virtuel
wisieć - hænge
Wisła - Wisła
wiśnia - kirsebær
wista - vest w
wiszczeć - skrige
Wit - Vittus, Vitus
witlinek - hvilling w
wiwenda - føde w
wiza - visum n
wizerunek - billede n
wizjer - sigte w, viser w, søger, dativ w
wizyta - besøg n
wizytkarta - visitkort n
wizytówka - visitkort n
wkrótce - snart
w kwiecie wieku - i sin bedste alder
władca - regent w
władza - magt w, regering w, kraft w, styre w, ledelse w, myndigheder
właściciel - ejer w
właścicielka - ejerinde w
właściwość - egenskab w
właśnie - lige
własny - egen
Włochy - Italien
włos - hår n
włoski - italiensk
w mgnieniu oka - i et øjeblik, øjeblikkeligt
wnęk - barnebarn n
wnęka - niche, datterdatter w, søndatter w, barnebarn n
wnioskodawca - forslagsstiller w
wniwecz - komplet, helt, fuldstændigt
WNP - SNG
wnuczka - datterdatter w, søndatter w, barnebarn n
wnuk - barnebarn n
wobec - i påsyn af
woda - vand n
w odniesieniu do - angående
Wodnik - Vandmanden
wodny - vand-
wodór - brint w, hydrogen n
wodospad - vandfald n
w ogóle - generelt, overhovedet
wojak - soldat w
wojaż - rejse w
województwo - voivodskab
wojna - krig w
wojna domowa - borgerkrig w
wojna religijna - hellig krig
wojskowy - militær, soldat w
wokabularz - ordbog w, ordforråd, gloseforråd, leksik, vokabular
w okamgnieniu - i et øjeblik, øjeblikkeligt
wokanda - retsliste w, sagsliste w
wokół - omkring
wół - okse w
wołacz - vokativ
woleć - foretrække, ville heller
wolfram - wolfram n
wolność - frihed w, uafhængighed w
wolny - fri, ledig, langsom
wołowina - oksekød w
won - skrid
wosk - voks
wózek dziecięcy - barnevogn
wózek sklepowy - indkøbsvogn
w pełni - komplet, helt, fuldstændigt
wpływ - indflydelse w
wpływać - påvirke, influere, indkomme
wrak - vrag n
wróbel - spurv w
wróbelek - lille spurv
wrodzony - medfødt
wróg - fjende w
wrogi - fjendtlig
wrogo - fjendtligt
wrona - krage w
wrotka - rulleskøjte
wróżka - spåkone w
wrzątek - kogende vand
wrzesień - september w
wrzód - mavesår, ulcus
wrzutnia - døgnboks w
ws. - vedr.
wsadzić sobie coś w dupę - op i røven
wschód - opgang, øst
Wschód - Østen n, øst n, østblokken w
wschodni - østlig
wschodzić - stå op
wścieklizna - rabies w, hundegalskab w
wsiok - en landmand, en bonde, bonderøv
wskazywać - pege, vise, indikere, indicere
Wspólnota Niepodległych Państw - Fællesskabet af Uafhængige Stater
wspólny - fælles
współżyć - samleje
wspomagać - støtte
wśród - blandt, iblandt, mellem, imellem
wstręt - væmmelse w
wstrząsy - diskotek n
wstyd - skam w
wszędzie dobrze, ale w domu najlepiej - ude godt, men hjemme bedst, øst, vest - hjemme bedst
wszystkie drogi prowadzą do Rzymu - alle veje fører til Rom
wszystko - alt
wtedy - så, da
wtenczas - så, da
wtorek - tirsdag
w trakcie - under, i løbet af, mens
w tym - i, mod, på, denne, dette, det
wuj - onkel w, morbror w, farbror w
wujek - onkel w, morbror w, farbror w
wujko - onkel w, morbror w, farbror w
wujo - onkel w, morbror w, farbror w
wulgarnie - vulgært
wulgaryzm - vulgaritet w
wulkan - vulkan w
wulkaniczny - vulkansk
wuszt - pølse w
wy - I
wybaczać - tilgive
wybierać - vælge, kåre
wybór - valg n
wybory - valg n
wybrzeże - kyst w
Wybrzeże kość Kości Słoniowej - Côte d'Ivoire
wyć - hyle
wychodzić za mąż - gifte sig
wyciąg krzesełkowy - stolelift w
wycieczka - tur w, udflugt w
wydawnictwo - forlag n
wydłużać - forlænge
wydłużyć - forlænge
wydma - klit w
wydra - odder w
wygląd - udseende n
wyglądać - se ud
wyjątek - undtagelse
wyjgwajzer - vejskilt n
wykałaczka - tandstikker w, pind w
wykonywać - producere, realisere, udføre, gennemføre
wykrzyknik - udråbstegn n, interjektionstegn n, udråbsord n, interjektion w
wykształcenie - uddannelse w, dannelse w
wykusz - karnap, veranda w
wyłącznie - udelukkende
wylogowywać - logge af
wymieniać - veksle, navne
wymienianie - udveksling
wymiennik ciepła - varmeveksler w
wymiotować - vomitere, kaste op
wymowa - udtale w
wynajmować - udleje, leje (ud), leje
wyobrażać - forestille, forestille sig
wyobrażenie - billede
wypadek - tilfælde n, ulykke w
wypalać - brænde
wyposażenie - udstyr n, tilbehør n, materiel n
wypowiedź - udtalelse w
wyprzedaż - udsalg n
wyprzedzać - overhale
wypukły - konveks
wyraz - ord n
wyrok - dom w
wyróżniać - fremhæve
wyrzucać pieniądze przez okno - kaste penge ud ad vinduet, smide penge ud ad vinduet
wyrzygiwać - vomitere, kaste op
wysoki - høj
wysoko - højt
wyspa - ø w
Wyspa Świętego Wyspy Świętego Tomasza i Wyspa Książęca - Sao Tome og Principe
Wyspy Kanaryjskie - Kanariske Øer
Wyspy Owcze - Færøerne
występować - optræde, spille, afgå, fratræde, forekomme, findes
wysublimować - sublimere
wytrysk - ejakulation w, sædafgang w
wywoływać - fremkalde, forårsage, bevirke
wyżymaczka - vridemaskine w
wzdręga grecka - græsk rudskalle
względny - relativ
wziąć byka za rogi - tage tyren ved hornene
wzrok - syn n
wzrost - højde w, vækst w
-yzm - -isme w
z - fra, af, med
-ż - dog, hvor
za - bag, om, for, efter, i
ząb - tand w
żaba - frø w, skobeslag n, frosch, gardinklips m, brystsvømning w
zabawka - legetøj n
żabie oczko - forglemmigej w
zabijać - dræbe
żabka - skobeslag n, frosch, gardinklips m, brystsvømning w
żabnica - havtaske w
zabójstwo - manddrab n, drab n, mord n
zabraniać - forbyde
Zabulon - Zebulon m
zabyły - dum
zachłannie - grådigt
zachód - nedgang (månens, solens), vest, umage, anstrengelse, bestræbelse
Zachód - Vesten n
zachodni - vest-, vestlig
zachować zimną krew - have is i maven
zaciągać - lade sig påmønstre, træde i tjeneste, inhalere
zaćmienie - formørkelse w
zaczynać - begynde
żądać - forlange, kræve
zadanie - opgave w, job n
zadanie domowe - hjemmearbejde n, lektier
żaden - ingen
żagiel - sejl n
żaglówka - sejlbåd w, sejler w
zagranica - udland n
zagraniczny - udenlandsk
zagrożenie - trussel
zaimek - stedord n
zaimek dzierżawczy - ejestedord n, possessivt pronomen n, possessivpronomen n
zając - hare w
zajefajny - fin
zajmować - tage, optage, fylde, tage i besiddelse, beskæftige
zakazany owoc - forbuden frugt w
zakład - bedrift w, forretning w, virksomhed w, institution w, væddemål n, fold w
zakład karny - fængsel n
zakłócenie - forstyrrelse w
zakluczyć - låse
zakon - orden w
zakończenie - slutning w
zakonnica - søster f
zakonnik - munk w
za kratkami - bag tremmer
zakup - indkøb
żal - sorg
załącznik - bestikkelse w
zalany - fuld, beruset, påvirket, den berusede
zalesiać - beplante
zależność - afhængighed w
zależny - afhængig
żałosny - ynkelig
założyć - tage på
zamach stanu - statskup n
zamek - slot n, lås w, lynlås w
zamężna - gift
zamiast - i stedet
zamknąć - lukke<!--, holde kæft-->
zamówić - bestille
zamrażarka - fryser w
zamsz - ruskind n
zapach - lugt w
zapad - nedgang (månens, solens), vest, umage, anstrengelse, bestræbelse
zapalenie - betændelse w, inflammation w
zapalenie płuc - lungebetændelse
zapalenie wyrostek wyrostka robaczkowego - blindtarmsbetændelse
zapałka - tændstik w
zapaść - kollaps n
zapładniać - befrugte
zapobiegać - forebygge
zapominać - glemme
zapora - spærring w
zapraszać - indbyde, invitere
zaprzaństwo - forræderi n, utroskab w
zarabiać - tjene
zarastać - læge
zaraz - snart
zaraza - epidemi n
zarobek - fortjeneste w
zarost - skæg n
żarówka - pære w (elektrisk)
zarozki - snart
zaś - igen
zasada - princip n, base w
zasnąć - falde i søvn
zasobnik - beholder w
zastrużka - blyantspidser w
zatoka - bugt w, bihule w
Zatoka Biskajska - Biscayabugten w
zawał serca - hjerteanfald n
zawartość - indhold n
zawierać - indeholde
zawodowy - faglig, professionel, prof
zawój - turban w
zawór - ventil w
zawór bezpieczeństwa - sikkerhedsventil w
zawsze - altid, konstant, stadigvæk, alligevel
zawżdy - altid, konstant, stadigvæk, alligevel
zazdrość - misundelse, jalousi
zazula - gøg w
zazulka - mariehøne w
zbierać - samle
zbieracz - samler w
zbiór - samling w, bundt n, fil w
zbliżenie - samleje w
zbrodnia - forbrydelse w
zbrodnia katyńska - Katynmassakren
zbuk - råddent æg n
zbyt - for
żdać - at vente (på)
zdalasiały - træt
zdanie - sætning w, mening w
zdecydować - beslutte
zderzak - kofanger
zdjęcie - fotografi n, foto n, billede n, fotografi w
zdrada - forræderi n, utroskab w
zdradzać - afsløre, forråde, være utro, røbe
zdrobnienie - diminutiv n
zdrowie - sundhed w
zdrowy - sund
zdrzadło - spejl n
ździebluchno - lidt
ze - fra, af, med
że - at
-że - dog, hvor
zebra - zebra w, fodgængerfelt n
żebrak - tigger w
żebro - ribben n
żeby - for at
żeby mieć kołaczy, trzeba użyć pracy - man skal yde før man kan nyde
żec - brænde, ryge
zefir - zefyr
zegar - ur n
zegarmistrz - urmager w
zegar słoneczny - solur n
żeglarz - sejler w
żegleń - kulstof n, karbon n
że ho ho - mange, meget
żel - tallerken w
Zelandia - Sjælland, Zeeland
żelazko - strygejern n
żelazo - jern n
żelazobeton - jernbeton w, armeret beton w
żelbet - jernbeton w, armeret beton w
zemrzeć - dø
zemsta - hævn
żenąć - løbe
żeńczyna - kvinde w
żeński - feminin, kvindelig
zespół hipoplazji lewego serca - hypoplastisk venstre hjerte syndrom n
zespół niedorozwoju lewego serca - hypoplastisk venstre hjerte syndrom n
zeszyt - hæfte n
zewłok - ådsel n
zez - skelen w, fra, af, med
zezwalać - tillade
z góry - på forhånd, i forvejen, forud
zgryz - bid n, sammenbid n
ziarno - korn n
zicherka - sikkerhedsnål w
ziele angielskie - allehånde w
zielnik - herbarium n
zielona herbata - grøn te w
zielonawy - grønlig
zielonkawy - grønlig
zielony - grøn
ziemia - jord w, land n
Ziemia - Jorden
Ziemia Święta - Det hellige land
ziemniak - kartoffel w
zieziulka - gøg w
zima - vinter w
zimny - kold
zimorodek - isfugl
ziobro - ribben n
zista - bedste m, bedstemor m, bedstemoder m, mormor m, farmor w
zjednoczenie - forening w, forbund n, union w
Zjednoczone Królestwo Wielka Wielkiej Brytanii i Irlandia Irlandii Północnej - Forenede Kongerige Storbritannien og Nordirland
zjeżdżalnia - legetøjsrutsjebane
źle - dårligt
zło - onde n
złodziej - tyv w
złotnik - guldsmed w
złoto - guld n
złotówa - taxachauffør
złotówka - gylden, guld-, zloty
złoty - gylden, guld-, zloty
złoty spadochron - gyldent håndtryk
złożony - samle, folde, bestå (af)
zły - sur, ond, dårlig
zmęczony - træt
zmiana - ændring w, forandring w, skift n
zmieniać - skifte, veksle
zmienna - variabel w
zmierzch - tusmørke n, mørkning w
zmrok - tusmørke, mørkning w
zmuszać - tvinge
znać - kende, vide, kunne
znaczek - frimærke n
znaczek pocztowy - frimærke n
znaczenie - betydning w, mening w, vigtighed w
znaczyć - betyde, mene, forestille, markere
znajdować - finde, findes, befinde sig
znak wodny - vandmærke n
znak zapytania - spørgsmålstegn n
znalezisko - fund n
znicz - gravlampe w
zniczek - rødtoppet fuglekonge w
znienacka - pludselig
zniszczenie - ødelæggelse w
żniwa - høst w
znów - igen
znowu - igen
zol - gulv n
zola - gulv n
żołądek - mave w
żółć - gul
żołnierz - soldat w
żółtaczka - gulsot w
żółtawy - gullig
żółty - gul
żółw - skildpadde w
żółw lamparci - leopardskildpadde
żona - kone w
żonaty - gift
żongler - jonglør w
zoo - zoo w
zostawać - forblive, blive
zozula - gøg w
z powrotem - tilbage, igen
źrebak - føl w, fole w
źrebię - føl w, fole w
źrebiec - føl w, fole w
z reguły - som regel, i reglen
źrenica - pupil w, syn n, øje n
źródło - kilde w
ZSRR - USSR n
zszywacz - hæftemaskine/heftemaskine w
zszywka - hæfteklamme / hefteklamme w, hæfte / hefte n
żuchwa - underkæbe w
żuk - skarabæ w
zupa - suppe w
zupełnie - komplet, helt, fuldstændigt
żuraw - trane w, kran w
żurawina - almindelig Tranebær
żurnal - tidsskrift n
Zurych - Zürich
Zuzanna - Susanne, Susanna, Susan
zwać - nævne, hedde
związać - binde, forbinde
związek - forbindelse w
Związek Socjalistycznych Republik Radzieckich - Unionen af Socialistiske Sovjetrepublikker
związywać - binde, forbinde
zwierciadło - spejl n
zwierzak - dyr n
zwierzę - dyr n
zwierzę domowe - husdyr n
żwir - grus n
zwłoki - lig n
zwrotka - vers n, strofe w
zwycięstwo - sejr w
zwycięzca - vinder w
zwyczajny - almindelig, ordinær
zwykle - normalt
żyć - leve
życie - liv n
życiowy - livs-
żyć jak pies z kotem - leve som hund og kat
żyć na kartę rowerową - bo på polsk
żyć na kocią łapę - bo på polsk
życzenie - ønske n
życzyć - ønske
żyd - jøde w, gnier w
Żyd - jøde w
Zygfryd - Sigfrid, Sigfred, Siegfred, Siegfried, Seifert
żyjątko - lille / mikroskopisk smådyr n
żyła - åre w
żyletka - barberblad n
zymft - sennep w
żymła - rundstykke n
żyniaczka - bryllup n
żyrafa - giraf w
zysk - profit w, gevinst w
żywe srebro - kviksølv n, have kviksølv i kroppen, have kviksølv i enden, kviksølv
żywić - spise
żywność - føde w
