Abakan - Абакан
abat - абат m | святар m
abażur - абажур
abbuś - ксёндз | святар m
abecadło - азбука f | алфавіт m | пісьмо n
Abidżan - Абіджан m
abiecadło - азбука f | алфавіт m | пісьмо n
ablegierek - дзіця n
abolicjonizm - абаліцыянізм m
absolutny - абсалютны | абсалютысцкі
absolutyzm - абсалютызм m
abstrakcjonizm - абстракцыянізм m
absurd - абсурд m
absurdalny - абсурдны
aby - каб
Adana - Адана
Adelajda - Адэлаіда
administracja - апарат m | адміністрацыя f
adres - адрас m
adresat - адрасат m
adresowy - адрасны
adwentnik - снежань m
aeroplan - самалёт m
afa - малпа f | сабака | смоўж | слімак
Afganistan - Афганістан m
Afryka - Афрыка f
afrykański - афрыканскі
AGD - бытавая тэхніка
agnostycyzm - агнастыцызм m
agnostyczny - агнастычны
agnostyk - агностык m
agrarny - аграрны
agresja - агрэсія f
agresor - агрэсар m
agrest - агрэст m
agresywny - агрэсіўны
ajmer - вядро n
ajnfachowy - кепскі | дрэнны
akcja - акцыя
akordeonista - акардэаніст m
aktyn - актыній m
aktywność - актыўнасць f
akuratny - акуратны
alarm - трывога f
Albańczyk - албанец m
Albania - Албанія f
Albanka - албанка f
albański - албанскі | албанская мова f
albinizm - альбінізм m
albinos - альбінос m
ale - але
alegoryczny - алегарычны
aleja - алея f | праспект m
Aleksander - Аляксандр m
alergia - алергія f
alfa - альфа f
alfabet - азбука f | алфавіт m | пісьмо n
alfabetu - азбука f | алфавіт m | пісьмо n
algebra - алгебра f
algebraiczny - алгебраічны
algida - прастытутка f
Algieria - Алжыр m
algorytm - альгарытм m
Alina - Аліна
alkohol - алкаголь m
alkoholiczka - алкагалічка f
alkoholik - алкагалік m
alkoholizm - алкагалізм m
alkoholowy - алкагольны
Allach - Алах m
Allah - Алах m
alleluja - алілуя
almanach - каляндар m
alpinizm - альпінізм m
Alpy - Альпы
aluminiowy - алюмініевы
aluminium - алюміній m
amajza - мурашка f | мурашкі
Ambroży - Эмброуз m
ameryk - амерыцый m
Ameryka - Амерыка f
Ameryka Łacińska - Лацінская Амерыка f
Amerykanin - амерыканец m
amerykanizacja - амерыканізацыя f
Amerykanka - амерыканка f
amerykański - амерыканскі
Ameryka Północna - Паўночная Амерыка f
Ameryka Południowa - Паўднёвая Амерыка f
Amman - Аман
amoniak - амоняк
amper - ампер m
Amsterdam - Амстэрдам m
Amu-daria - Амудар'я
anachoreta - анахарэт m
anachroniczny - анахранічны
anachronizm - анахранізм m
analfabetyzm - непісьменнасць f
analityczny - аналітычны
analiza - аналіз m
analizator - аналізатар m
analizować - аналізаваць
analogia - аналогія f
analogiczny - аналагічны
Ananiasz - Анани
anarchista - анархіст m
anarchizm - анархізм
Anatolia - Анатоля f
anatom - анатам m
anatomiczny - анатамічны
Andora - Андора f
Andromeda - Андрамеда
Andrzej - Андрэй m
Andy - Анды
aneksja - анексія f
Angielka - англічанка f
angielski - англійскі
Anglia - Англія f
Anglija - Англія f
Anglik - англічанін m
anglikanin - англіканец m
anglikanka - англіканка f
angol - англічанін m | англійскі
Angol - англічанін m
Angola - Ангола f
angryst - агрэст m
aniżeli - чым
Ankara - Анкара
anonimowość - ананімнасць f
antagonizm - антаганізм m
Antananarywa - Антананарыва
Antares - Антарэс
Antarktyda - Антарктыда
Antigua i Barbuda - Антыгуа і Барбуда
antologia - анталогія f
antologie - анталогія f
Antoni - Антон
antrejka - ганак m | калідор m
antropofagia - антрапафагія f
antropolog - антраполаг m
antropologia - антрапалогія f
antropologiczny - антрапалагічны
antropomorfizm - антрапамарфізм m
antybiotyk - антыбіётык m
antyfaszysta - антыфашыст m
antyfaszyzm - антифашызм m
antykomunista - антыкамуніст m
antykomunistka - антыкамуністка f
antykomunistyczny - антыкамуністычны
antykomunizm - антыкамунізм m
Antyle Holenderskie - Нідэрландскія Антылы
antymon - сурма f
antyrasizm - антырасізм
antysemicki - антысеміцкі
antysemita - антысеміт m
antysemitka - антысемітка f
antysemityzm - антысемітызм m
aparatczyk - апаратчык m
apasz - злачынец m
Apeniny - Апенински планини
Apia - Апія
apiologia - апіялогія f
apostata - вераадступнік m
apryl - красавік m
apryl-apryl - Дзень дурня m
Arabia Saudyjska - Саудаўская Аравія
arachnologia - арахналогія f
arak - арак m
Ararat - Арарат m
archeologia - археалогія f
archeologiczny - археалагічны
archeozoologia - архезаалогія f
Archimedes - Архімед m
Argentyna - Аргентына
argentyński - аргентынскі
argon - аргон m
arkebuz - аркебуз
Armenia - Арменія f
armia - армія f
Armia Krajowa - Армія Краёва f
armijo - армія f
arsen - мыш'як
arsenał - арсенал
arteria - артэрыя f
artykuł - артыкул
artykuły gospodarstwa domowego - бытавая тэхніка
arystokrata - арыстакрат m
arystokratka - арыстакратка f
Arystoteles - Арыстоцель m
as - туз m
aspiryna - аспірын m
astat - астат m
astma oskrzelowa - бранхіяльная астма f
astmatyczka - астматычка f
astmatyk - астматык m
astrologia - астралогія f
astrologiczny - астралагічны
astrologio - астралогія f
Asyria - Асірыя
aszynbecher - попельніца
atak serca - інфаркт
atandzić - страляць
ateistka - атэістка f
ateizm - атэізм m
Ateny - Афіны
Atlantyk - Атлантычны акіян m
atmosfera - атмасфера f
atmosferyczny - атмасферны
atomowy - атамны
aukcja - аўкцыён m
Australia - Аўстралія f
Australijczyk - аўстраліец m
Australijka - аўстралійка f
australijski - аўстралійскі
Austria - Аўстрыя f
austriacki - аўстрыйскі
Austriaczka - аўстрыйка f
Austriak - аўстрыец m
autobus - аўтобус m
automobilista - аўтамабіліст m
autor - аўтар m
Azerbejdżan - Азербейджан
azerski - азербайджанскі | азербайджанская мова f
Azja - Азія f
Azja Mniejsza - Малая Азія f
Azjata - азіят m
Azjatka - азіятка f
azjatycki - азіяцкі
azot - азот m
azotowy - азотны
babcia - бабуля f
babie lato - бабіна лета n
Babilon - Вавілон m
babka - бабуля f
bać się - баяцца
bać się jak diabeł święconej wody - баяцца як чорт пасвячонай вады | баяцца як чорт крыжа | баяцца як чорт грому
bać się jak ognia - баяцца як агню
bać się o swoją skórę - дрыжаць за сваю шкуру
bagienny - багністы | балоцісты
bagnet - штык m
bajer - хлусня f | мана f | падман m
bajtel - дзіця n
bajzel - публічны дом m
bakałarz - настаўнік m
bakteriolog - бактэрыёлаг m
bakteriologia - бактэрыялогія f
Bałtyk - Балтыйскае мора n
bana - цягнік m | поезд m | прага | цяга | трамвай m
bandzioch - жывот m
Bangladesz - Бангладэш m
bania - галава f
baniaczek - капялюш m | шапачка | шапка f
baniak - галава f
banka - трамвай m
bańka mydlana - мыльны пузыр m | мыльная бурбалка f
bankructwo - банкруцтва n | неплацежаздольнасць f
baptyzm - баптызм m
bara bara - туці фруці
baran - баран m
Baran - Авен
Barbados - Барбадас
bardzo - вельмі | дужа
barok - барока
barwa - колер
barzej - вельмі | дужа
bas - жывот m
basen - басейн m
basetla - басэтля f
batłąch - бутэлька f
bebech - жывот m | страўнік m
bęben - жывот m
beczeć - плакаць
beczka - бочка f
bedki - грыб m
bejc - п'яніца
bejm - грошы
belfer - настаўнік m
Belg - бельгіец m
Belgia - Бельгія
Belgijka - бельгійка f
belgijski - бельгійскі
Belgrad - Бялград m
belgradzki - белградскі
Belize - Беліз m
bengalski - бенгальскі
Benin - Бенін m
berbela - гарэлка | водка
berbelucha - самагон m
Bergamo - Бергама
berkel - берклій m
Berlin - Берлін m
berliński - берлінскі
Berlin Zachodni - Заходні Берлін
Bermudy - Бермудскія астравы
beryl - берылій m
Beskidy - Бяскіды
bezalkoholowy - безалкагольны
bezdroże - бездараж f
bezdzietność - бяздзетнасць f
bezdzietny - бяздзетны
bezhołowie - безгалоўе n
bezimienny - безназоўны
bezkrytyczny - некрытычны
bezludny - бязлюдны
beznadziejny - безнадзейны
bezosobowy - безасабовы
bezpotomność - бяздзетнасць f
bezrobotny - беспрацоўны | беспрацоўны m
bezsilny - бяссільны
bezuch - візіт m
bezwstydny - бессаромны
bezzębny - бяззубы
biała gorączka - белая гарачка f
biała herbata - белы чай
Białoruś - Беларусь
białoruski - беларускі | беларуская мова f
Białostocczyzna - Беласточчына
biały - белы
Białystok - Беласток (Belastok)
biber - капялюш m | шапачка | шапка f
Biblia - Біблія f
biblioteka - бібліятэка f
bić - калоць
bić w dzwony na trwogę - біць трывогу
biedny - бедны
biegun - полюс m
bimba - трамвай m
bimber - самагон m
bimbrownictwo - самагонаварэнне n
bimbrowniczy - самагонны
bimbrownik - самагоншчык m
binia - дзяўчына f
biochemia - біяхімія f
biografia - біяграфія f
biologia - біялогія f
biologiczny - біялагічны
biopsja - біяпсія f
biotechnologia - біятэхналогія f
biskup - епіскап m
biurokracja - бюракратыя f
Bizancjum - Візантый m | Візантыя f
bizantyjski - візантыйскі
bizantyński - візантыйскі
bizmut - вісмут m
biznes - бізнес m
biznesmen - бізнесмен m
bladolicy - бледнатвары
błąd ortograficzny - арфаграфічная памылка f
blady - бледны
blady jak śmierć - бледны як смерць
bladź - прастытутка f
blaga - хлусня f | мана f | падман m
błahy - малаважны
błędny - памылковы
błękit - блакіт m
błękitny - блакітны
Bliski Wschód - Блізкі Усход m
blisko - блізка
Bliźnięta - Блізняты
bliższa koszula ciału - свая кашуля бліжэй да цела
boba - шапка f | марыхуана f
bocian - бацян
Bóg - Бог
Bogarodzica - Багародзіца f
bogaty - багаты
Bóg jeden wie - аднаму богу вядома
Bogurodzica - Багародзіца f
bohr - борый m
bojaźliwy - баязлівы
Boliwia - Балівія f
boliwijski - балівійскі
bolszewicki - бальшавіцкі
bolszewik - бальшавік m
bomba - бомба f (bomba)
bombel - дзіця n
bombowiec - бамбардзіроўшчык m | бамбавоз m
Bonn - Бон m
bor - бор m
bór - бор m
bordo - бардовы
bordowy - бардовы
borowik szlachetny - баравік m
borówka - шчака f
borówka bagienna - дурні́цы | буякі
borowy - борны
bóść - басьці | калоць
Bośnia - Боснія f
Bośnia i Hercegowina - Боснія і Герцагавіна
botaniczny - батанічны
botanika - батаніка f
Botswana - Батсвана f
brakować - бракаваць
Bratysława - Браціслава
brązowy - карычневы
Brazylia - Бразылія f | Бразілія f
brazylijski - бразільскі
brele - акуляры
brew - брыво n
broda - барада f
brom - бром m
broń - зброя f
broń biała - халодная зброя f
Bronisław - Браніслаў m
broń palna - агнястрэльная зброя
browar - піва n
browarz - півавар m
bryka - самаход m
bryle - акуляры
brzeg - бераг
brzmienie - гук
brzuch - жывот m
brzydki - брыдкі
buchalter - бухгалтар m | бухгалтарскі
buda - школа f
Budapeszt - Будапешт
buddysta - будыст m
buddystka - будыстка f
buddyzm - будызм m
budynek - будынак m
buła - мускул m | цягліца f | мышца f
Bułgar - балгарын m
Bułgaria - Балгарыя f
Bułgarka - балгарка f
bułgarski - балгарскі | балгарская мова f
bułka - мускул m | цягліца f | мышца f
bunt - мяцеж m
burdel - публічны дом m | бардэль m | беспарадак m
burdynek - дуэль f
Burgundia - Бургундыя f
Burkina Faso - Буркіна-Фасо f
Burundi - Бурунды f
burza w szklance wody - бура ў шклянцы вады f
burzowiny - піва n
butelka - бутэлька f
być - быць
być bez grosza przy duszy - не мець ни шэлега за душой
być na noże - быць на нажах
być w siódmym niebie - быць на сёмым небе
byk - бык m
Byk - Цялец m
Była Jugosłowiańska Republika Macedonii - Былая Югаслаўская Рэспубліка Македонія f
bywać - бываць
cacanka - цацанка f
cajtung - газета f
całkiem - цалкам | поўнасцю | зусім | даволі | дастаткова
cegielnia - цагельня f
cegła - цэгла f | цагліна f
ceglany - цагляны
ceglasty - цагляны
celtycki - кельцкі
cel uświęca środki - мэта апраўдвае сродкі
cena - цана f
centralny - цэнтральны
centrum - цэнтр m
cer - цэрый m
cerkiew - царква f
certacja - барацьба f
cetologia - кеталогія f
cez - цэзій m
chachoł - карак
chachor - п'яніца
chamera - хмара f
charlać - кашляць
chata - хата f
chcieć - хацець
chemia biologiczna - біялагічная хімія f | біяхімія f
chemiczny - хімічны
chichrać się - смяяцца
Chile - Чылі f
Chińczyk - кітаец m
Chinka - кітаянка f
chiński - кітайскі | кітайская мова f
Chiny - Кітай m
chira - гарэлка | водка
chirus - п'яніца
chleb - хлеб m
chłodny - халодны
chłopiec - хлапец m | хлопец m
chłopyszek - хлапец m | хлопец m
chlor - хлор m | п'яніца
chlorofil - хларафіл m
chmiel - піва n
chmura - хмара f
choć - хаця
choćby - напрыклад
chocia - хаця
chociaż - хаця
chocieć - хацець
choinka - калядная ёлка f
chójk - калядная ёлка f
chojna - хвоя f | сасна f
chomik - хомяк m
Chorwacja - Харватыя
chorwacki - харвацкі | харвацкая мова f
Chorwat - харват m
Chorwatka - харватка f
chrom - хром m
chromosfera - храмасфера f
chruścik - шыцік
chrystianizacja - хрысціянізацыя f
chrystianizm - хрысціянства n
Chrystus - Хрыстос m
chrześcijanin - хрысціянін m
chrześcijanka - хрысціянка f
chrześcijaństwo - хрысціянства n
chudy - худы
chujowy - кепскі | дрэнны
churchać - кашляць
chuśle - скрыпка f
chwalipięta - самахвал m | хвалько m | выхваляка m
chyc - гарачыня f | спёка f
ciało - цела n
ciasnocha - кашуля f
ciebie - ты
cielny - цельны
ciemny - цёмны
ciężki - цяжкі
ciga - каза f
cios - ўдар m
cios poniżej pasa - ўдар ніжэй пояса
ciota - педаль f
ciśnienie tętnicze - крывяны ціск
cisza - цішыня | ціша f
ciut - крыху | крышачку | трохі | чуць
ćma - прастытутка f
ćmaga - гарэлка | водка
ćmić - гарэць | паліцца
ćmik - цыгарэта f | папяроса f (bez filtra)
ćmy - цёмны
cokolwiek - што-небудзь
co nagle, to po diable - паспех – людзям на смех
coś jest niewarte złamanego grosza - ламаны грош цана ў базарны дзень каму, чаму | не варты выедзенага яйца
coś niewarte złamanego szeląga - ламаны грош цана ў базарны дзень каму, чаму | не варты выедзенага яйца
ćpać - есці
cudowny - цудоўны
cug - цягнік m | поезд m | прага | цяга
cukier - цукар
cukrzyca - дыябет m
cupać - кашляць
cwel - педаль f
ćwiczenia - практыкаванне n
ćwiczenie - практыкаванне n
cyferblat - твар m
cygareta - цыгарэта f | папяроса f (bez filtra)
cygaretka - цыгарэта f | папяроса f (bez filtra)
cyklon - цыклон m
cymes - цымес m
cyna - волава f
cyngiel - акуляры
cynizm - цынізм m
cynk - цынк m
Cypr - Кіпр
cyrkon - цырконій m | цыркон m
cytadela - крэпасць f
Czad - Чад
czador - чадра f
czajnik - галава f
czapka - шапка f
czarna dziura - чорная дзірка f
czarna niewdzięczność - чорная няўдзячнасць f
czarne złoto - чорнае золата n
Czarnogóra - Чарнагорыя f
czarnosecinny - чарнасоценны
czarny - чорны
czas - час m
czasownik - дзеяслоў m
czaszka - чэрап m
czciciel - прыхільнік m
Czech - чэх m
Czechosłowacja - Чэхаславакія f
Czecho-Słowacja - Чэхаславакія f
czechosłowacki - чэхаславацкі
Czeczenia - Чачня
czędo - дзіця n
czekać - чакаць
czemergies - самагон m | самагонка f
czeremcha - чаромха f
czerwcowy - чэрвеньскі
czerwiec - чэрвень m
czerwonawy - чырванаваты
czerwony - чырвоны | камуніст m
cześć - прывітанне
część - частка f | элемент m
czeski - чэшскі | чэшскі m
często - часта
częstoskurcz - тахікардыя f
Czeszka - чэшка f
człowieczy - чалавечы | людскі
człowiek - чалавек
człowiek człowiekowi wilkiem - чалавек чалавеку воўк
czołg - танк m
czoło - лоб m
czorny - чорны
czwartek - чацвер
czwartkowy - чацвярговы
czyhunka - торый m
czyrwiec - чэрвень m
czyrwień - чэрвень m
czysło - лічба | лік
czytać - чытаць
czytać między wierszami - чытаць паміж радкоў
czytanka - чытанка
czytelnia - чытальня f | чытальная зала f
czytelnik - чытальнік m | чытач m
czyżyk - хлапец m | хлопец m
dąb - дуб m
dach - дах m
Dagestan - Дагестан
dalece - вельмі | дужа
dalej - далёка
daleko - далёка
dana - даваць
Dania - Данія f
dany - даваць
darmohardy - самаўпэўнены
darmsztadt - дармштатый m
dawać - даваць
dedykacja - прысьвячэньне n
dekiel - галава f
deklamować - дэкламаваць
deknąć - ударыць
dekolonizacja - дэкаланізацыя f
demagog - дэмагог m
demagogia - дэмагогія f
demografia - дэмаграфія f
demokrata - дэмакрат m
Demokratyczna Republika Konga - Дэмакратычная Рэспубліка Конга f
Demokratyczna Republika Wyspy Świętego Tomasza i Wysp Świętego Tomasza i Książęcej - Дэмакратычная Рэспубліка Сан-Тамэ і Прынсіпі
demokratyczny - дэмакратычны
demokratyzacja - дэмакратызацыя f
demonstracja - дэманстрацыя f
demonstrować - дэманстраваць
dendrologia - дэндралогія f
dermatolog - дэрматолаг m
dermatologa - дэрматолаг m
deszcz - дождж m
dewastator - разбуральнік m | разаральнік m | спусташальнік m
deżdż - дождж m
dezerter - дэзерцір m
dezinformacja - дэзінфармацыя f
dezodorant - дэзадарант m
diabeł - д'ябал m | сумчаты д'ябал m
diabetologia - диабетология f
diament - алмаз m
diecezja - епархія f | дыяцэзія f
diecezjalny - епархіяльны
dietetyka - дыеталогія f
dla - для
dłoń - далонь f
długi - доўгі
długość - даўжыня | працягласць | даўгата f
Dniepr - Дняпро
doba - суткі
dobranoc - дабранач | спакойнай ночы
dobro - дабро | карысць
dobrobyt - дабрабыт m
dobry - добры | акуратны | які падыходзіць | удалы | паспяховы | смачны | смакавіты | выхаваны | дасканалы | выдатны | цікавы | высокаякасны | вясёлы | радасны
dobry wieczór - добры вечар (dobry wečar)
dogmatyzm - дагматызм f
dojrzały - сталы
doktor - урач m
doktryna - дактрына f
doktryner - дактрынёр m
doktrynerski - дактрынёрскі
doktrynerstwo - дактрынёрства n
dolina - даліна f
dom - дом m
Dominika - Дамініка f
Dominikana - Дамініканская Рэспубліка
domowej roboty - хатні
dom publiczny - публічны дом m
dopiero - толькі
doradca - саветнік m
dorosły - дарослы | дарослы m
dostany - сталы
dostojnik - саноўнік m
dostojny - дастойны
doświadczenie - эксперымент m
dowódca - камандзір m
droga - дарога f
druga wojna światowa - другая сусветная вайна f
druh - сябар m | сябра m
drwal - лесаруб m
drzewo - дрэва n
dubn - дубній m
duchowny - святар m
dudlać - плакаць
dudy - лёгкае n
Dunaj - Дунай m
Duńczyk - датчанін m
Dunka - датчанка f
duński - дацкі
dupek - мудак m
dureń - дурань m | дурань
durniacha - даверлівы
durnica - дурні́цы | буякі
dutek - грошы
dwulicowość - двудушнасць f
dwulicowy - двудушны
dychawica oskrzelowa - бранхіяльная астма f
dycht - цалкам | поўнасцю | зусім | даволі | дастаткова
dycki - заўсёды
dydaktyczny - дыдактычны
dydek - грудзі
dyktator - дыктатар m
dymbcok - дуб m
dymisja - адстаўка f
dyplomata - дыпламат m
dyplomatyczny - дыпламатычны
dyscyplina - дысцыпліна f
dysproz - дыспрозій m
dysputacja - спрэчка f
dzban - гаршчок
dziadek - дзядуля m
działać - працаваць | дзейнічаць | уплываць | уздзейнічаць
dziąsło - дзясна f
Dżibuti - Джыбуты f
dzieciństwo - дзяцінства n
dzieciszczko - дзіця n
dziecko - дзіця n
dziękówa - дзякуй | дзякую
dziękówka - дзякуй | дзякую
dziękuję - дзякуй | дзякую
dziela - для
dzielić skórę na niedźwiedziu - дзяліць шкуру незабітага мядзведзя
dzień - дзень
dzień dobry - добры дзень
dziennikarstwo - журналістыка f
dziennikarz - журналіст m
dzierżyć - трымаць
dziesięciolecie - дзесяцігоддзе n
dziewa - дзяўчына f
dziewczę - дзяўчына f
dziewczyna - дзяўчына f
dzik - кабан m
dziołcha - дзяўчына f
dziopa - дзяўчына f
dziś - сёння | сягоння
dzisiaj - сёння | сягоння
dzisiejszy - сённяшні
dziunia - дзяўчына f
dziura ozonowa - дзірка азонавая f
dziura w moście - дзірка у мосце f
dziwny - дзіўны | надзвычайны | чароўны | дзівосны
edyficjum - будынак m
efekt - эфект m
efekt cieplarniany - парніковы эфект m
efektowny - эфектны
efekt szklarniowy - парніковы эфект m
efektywny - эфектыўны
Egipcjanin - егіпцянін m
Egipcjanka - егіпцянка f
egipski - егіпецкі
Egipt - Егіпет m
egoista - эгаіст m
egoistyczny - эгаістычны
egoizm - эгаізм m
egotyzm - самаўлюбёнасць f
egzamin - экзамен m
egzaminacyjny - экзаменацыйны
egzaminować - экзаменаваць
egzamin wstępny - уступны экзамен m
einstein - эйнштэйній m
ekolog - эколаг m
ekologia - экалогія f
ekologiczny - экалагічны
ekologio - экалогія f
ekosystem - экасістэма f
ekran - экран m
ekspedycja - экспедыцыя f
ekspert - эксперт m
eksperyment - эксперымент m
eksperymentalny - эксперыментальны
eksport - экспарт m
eksportować - экспартаваць
eksportowy - экспартны
ekspozycja - экспазіцыя f
ekstaza - экстаз m
ekstremista - экстрэміст m
ekstremistyczny - экстрэмісцкі
ekstremizm - экстрэмізм m
Ekwador - Эквадор m
ekwiwalent - эквівалент m
elastyczność - эластычнасць f | гнуткасць f
elefant - слон m
elegancki - элегантны | элеганцкі
elektroliza - электроліз
elektroniczny - электронны
elektryczność - электрычнасць n
elektryczny - электрычны
elektryk - электрык m
Elza - Елізавета f
Elżbieta - Елізавета f
emigracja - эміграцыя f
emir - эмір
energia - энергія f
entomologia - энтамалогія f
enuncjacja - заява f
epidemia - эпідэмія f
epidemio - эпідэмія f
epidemiologia - эпідэміялогія f
epikureizm - эпікурэізм m | эпікурэйство n
epoka - эпоха f
era - эра f
era kenozoiczna - кайназойская эра
era mezozoiczna - мезазойская эра
erb - эрбій m
erotyka - эротыка f
Erytrea - Эрытрэя f
eskalacja - эскалацыя f
eskalator - эскалатар m
eskulap - урач m
espresso - эспрэса f
estetyka - эстэтыка f
Estończyk - эстонец m
Estonia - Эстонія
Estonka - эстонка f
estoński - эстонскі
Etiopia - Эфіопія f
etiopski - эфіопскі
etologia - эталогія f
etologiczny - эталагічны
etyczny - этычны
etyka - этыка f
etymologia - этымалогія f
eufemizm - эўфемізм m
eukaliptusowy - эўкаліптавы
Eurazja - Еўразія f
euro - еўра f
europ - еўропій m
Europa - Еўропа
Europa Wschodnia - Усходняя Еўропа f
Europejczyk - еўрапеец m
Europejka - еўрапейка f
europejski - еўрапейскі
eurosceptycyzm - еўраскептыцызм m
eutanazja - эўтаназія f
Ezop - Эзоп m
fabryka - фабрыка f
fabrykant - фабрыкант m
facet - мужчына m
facetka - жанчына f
facjata - твар m
fajek - цыгарэта f | папяроса f (bez filtra)
fajerwer - цыгарэта f | папяроса f (bez filtra)
fajka - цыгарэта f | папяроса f (bez filtra)
fakt - факт m
fala - хваля f
familio - сям'я f
famuła - сям'я f
fana - сцяг m
fanatyczny - фанатычны
fanatyk - фанатык m
fanatyzm - фанатызм m
fanfaron - фанфарон m
faryna - цукар
faszysta - фашыст m
faszyzm - фашызм m
federacja - федэрацыя f
Federacja Rosyjska - Расійская Федэрацыя f
federalny - федэратыўны
fefrać się - баяцца
feministka - феміністка f
feministyczny - феміністычны
feminizm - фемінізм m
Fenicja - Фінікія f
Fenicjanin - фінікіец m
Fenicjanka - фінікійка f
fenicki - фінікійскі | фінікійская мова f
fenomenalny - фенаменальны
ferm - фермій m
fest - вельмі | дужа
festiwal - фестываль m
fetor - сморад m | смурод m
filatelistka - філатэлістка f
filatelistyka - філатэлія f
filip - заяц m
Filip - Піліп m
Filipiny - Філіпіны
film - фільм m
filozof - філосаф m
filozofia - філасофія f
filozofia dziejów - філасофія гісторыі f
filozofia historii - філасофія гісторыі f
filozoficzny - філасофскі
Fin - фін m
finka - фінка f
Finka - фінка f
Finlandia - Фінляндыя
finlandzki - фінскі
fiński - фінскі
fioletowy - фіялетавы
fiord - фіёрд m
fizjologia - фізіялогія f
fizjologiczny - фізіялагічны
flag - сцяг m
flaga - сцяг m
flaszka - бутэлька f
flecista - флейтыст m
flecistka - флейтыстка f
flerow - флеровій m
flet - флейта f
fliger - самалёт m
flora - флора f
fojerman - пажарнік m | пажарны m
fojerwera - пажарная каманда f
folga - прыпынак m
fonetyka - фанетыка f
fonologia - фаналогія f
formalista - фармаліст m
formalność - фармальнасць f
formalny - фармальны
forteca - крэпасць f
fosfor - фосфар m
fragment - фрагмент m
Francja - Францыя f
francuski - французскі | французская мова f
Francuz - француз m
Francuzka - францужанка f
frans - францый m
fraza - фраза f
frazeologia - фразеологія f
frazeologiczny - фразеалагічны
frazeologizm - фразеалагізм m
frazes - фраза f
frechowny - самаўпэўнены
frela - дзяўчына f
fresk - фрэска
fryc - немец m
Fryc - немец m
ftyzjatra - пульманолаг m | пульманолаг f
funta kłaków niewarte - не варты выедзенага яйца
fura - самаход m
furt - зноў | ізноў
fusbal - футбол
futbol - футбол
Gabon - Габон m
gad - рэптылія f
gadolin - гадаліній m
gal - галій m
gała - вока n (woka) | футбол | варона
Galilea - Галілея f
Gambia - Гамбія f
gambit - гамбіт m
ganc - цалкам | поўнасцю | зусім | даволі | дастаткова
ganek - ганак m
gapa - варона
garbaty - гарбаты
gasa - вуліца f
gaz - газ m
gazeta - газета f
gazowany - газаваны
gaz szlachetny - інертны газ m
gaz ziemny - прыродны газ m
gdzie - дзе
gdzieś - каля | ля | прыкладна | на круг
genetyczny - генетычны
genetyka - генетыка f
gentamycyna - гентаміцін m
geograficzny - геаграфічны
geolog - геолаг m
geologia - геалогія f
geologiczny - геалагічны
geometria - геаметрыя f
geometryczny - геаметрычны
german - германій m
germański - нямецкі | нямецкі m
gęś - гусь f
gęstość - шчыльнасць f
Ghana - Гана
gibki - хуткі | шпаркі
gichać - смяяцца
giełd - біржа f
giełda - біржа f
giełdowy - біржавы
giez - авадзень
giezło - кашуля f
ginekolog - гінеколаг m
ginekologia - гінекалогія f
gira - нага f
gitara - гітара f
gitarzysta - гітарыст m
glacok - лысы
glajza - торый m
glapa - варона
glaska - шклянка f
gleba - глеба f
głębokość - глыбіня f
glin - алюміній m
glina - паліцэйскі m | паліцыянт m | палісмен m
gliniarz - паліцэйскі m | паліцыянт m | палісмен m
globalizacja - глабалізацыя f
globus - галава f
głośno - голасна
głowa - галава f
glukoza - глюкоза f
głuszec - глушэц m
gnat - косць f | пісталет m
gnot - дзіця n
gnu - гну
gnuśny - лянівы
godka - язык m | мова f
godzina - гадзіна f
gongil - насмарк m | катар m
goniec - слон m
gora - пажар m
góra - гара f
górą - гара f
górnik - шахцёр
Górny Śląsk - Верхняя Сілезія f
gorzała - алкаголь m
gorzałka - гарэлка | водка
gorzki - горкі
gorzoła - гарэлка | водка
gość - госць m
gościniec - гасцінец m | гасцініца f
gościnność - гасціннасць f
gościnny - гасцінны
gotówka - гатоўка f | наяўнасць f
gówno - гаўно n
gra - гульня f
graba - рука f | далонь f
grabarz - могильщик m
grać na nerwach - іграць на нервах
gracz - гулец m (huliec)
gramatyczny - граматычны
gramatyka - граматыка f
granatowy - цёмна сіні
granica - мяжа f | граніца f
graniczyć - межаваць
gra słów - гульня слоў f
Grecja - Грэцыя
grecki - грэчаскі
Greczynka - грачанка f
gregoriański - грыгарыянскі
Grek - грэк m
greka - грэчаскі
Grenada - Грэнада
Grenlandia - Грэнландыя f
grób - магіла f
gróbarz - могильщик m
Grodno - Гродна
Grodzieńszczyzna - Гродзеншчына
grom - гром m
gronostaj - гарнастай m
grubiański - грубы
grudzień - снежань m
grupa - група f
Gruzin - грузін m
Gruzinka - грузінка f
gruziński - грузінскі | грузінская мова f
Gruzja - Грузія f
gruźlica - туберкулёз m
grzesznica - грэшніца f
grzmot - гром m
grzyb - грыб m
Gujana - Гаяна
guma - прэзерватыў m
gumka - прэзерватыў m
gwałtowny - раптоўны
Gwatemala - Гватэмала
gwiazda - зорка f | звязда f
Gwinea Równikowa - Экватарыяльная Гвінея f
gwizdnąć - ударыць
gzub - дзіця n | жывот m
haczka - матыка f
hafn - гафній m
Haga - Гаага
Haiti - Гаіці
hajtok - нож m
halucynacja - галюцынацыя f
hangar - ангар
hara - гарэлка | водка
harfista - арфіст m
harować jak wół - рабіць як чорны вол
has - хасій m
hawerz - сапёр m
hedonizm - геданізм m
hel - гелій m
Hellada - Грэцыя
hełm - шлем m
Helsinki - Хельсінкі
Hemera - Гемера
heparyna - гепарын
herc - герц m
Herod - Ірад m
herpetologia - герпеталогія f
het - далёка
hica - гарачыня f | спёка f
hidżab - хіджаб m
hierarcha - іерарх m
higiena - гігіена f
Himalaje - Гімалаі
hinduistka - індуска f
hinduizm - індуізм m
Hindukusz - Гіндукуш
Hindus - індус m
Hinduska - індуска f
hipokryta - крывадушнік m
hipokryzja - крывадушнасць f | двудушнасць f
hipopotam - бегемот m
historiozofia - філасофія гісторыі f
Hiszpan - іспанец m
Hiszpania - Іспанія f
hiszpanka - іспанка f
Hiszpanka - іспанка f
Holandia - Галандыя f | Нідэрланды
Holandyja - Галандыя f | Нідэрланды
Holender - галандзец m | нідэрландзец m
Holenderka - галандка f | нідэрландка f
holenderski - галандскі | галандская мова f | нідэрландская мова f
holm - гольмій m
homeopatia - гамеапатыя f
homo - гомасексуаліст m
homoseksualista - гомасексуаліст m
homoseksualizm - гомасексуалізм m
homoseksualny - гомасексуальны
Honduras - Гандурас
Hongkong - Ганконг
Honolulu - Ганалулу
hotel - гатэль
hrabia - граф m
huk - гром m
humor - гумар m
hyca - гарачыня f | спёка f
hydraulik - трамбаніст m | гомасексуаліст m
hydrologia - гідралогія f
i - и
ichtiologia - іхтыялогія f
ichtiologiczny - іхтыялагічны
idea - ідэя f
idealista - ідэаліст m
idealistka - ідэалістка f
idealny - ідэальны
ideologia - ідэалогія f
ideologiczny - ідэалагічны
igrać z ogniem - гуляць з агнём
II wojna światowa - другая сусветная вайна f
ilość - колькасць f | лік m
imię - імя n
imieniny - імяніны
imiesłów - дзеепрыслоўе n | дзеепрыметнік m
imperator - імператар m
imperialista - імперыяліст m
imperium - імперыя f
implikacja - наступства n | імплікацыя f
import - імпарт m
impotencja - імпатэнцыя f
impotent - імпатэнт m
impresario - імпрэсарыё m
impuls - імпульс m | штуршок m | стымул m
impulsywny - імпульсіўны
ind - індый m
Indie - Індыя f
indoeuropejski - індаеўрапейскі
Indonezja - Інданезія f
Indonezyjczyk - інданезіец m
Indonezyjka - інданезійка f
indonezyjski - інданезійскі
indyferentny - індыферэнтны
indyferentyzm - індыферэнтызм m
indyjski - індыйскі
Indyk - Індыйскі акіян m
indywidualista - індывідуаліст m
indywidualistka - індывідуалістка f
indywidualność - індывідуальнасць f | выдатная асоба f
indywidualny - індывідуальны
infekcja - інфекцыя
inkszy - другі | іншы
inkwizycja - інквізіцыя f
innowierca - іншаверац m
inny - другі | іншы
ino - толькі
instrukcja - інструкцыя f
instruktor - інструктар m
instruować - інструктаваць
insurekcyjny - паўстанцкі
integralność - цэласнасць f
integralny - інтэгральны
interesujący - цікавы | займальны
internista - тэрапеўт m
intryga - інтрыга f
intryganctwo - інтрыганства n
iny - другі | іншы
inżynier - інжынер m
Irak - Ірак m
Iran - Іран m
irański - іранскі
Irkuck - Іркуцк m
Irlandczyk - ірландзец m
Irlandia - Ірландыя
Irlandia Północna - Паўночная Ірландыя f
Irlandka - ірландка f
irlandzki - ірландскі
ironia - іронія f
ironiczny - іранічны
ironizować - іранізаваць
iryd - ірыдый m
iść - ісці
islam - іслам m
islamista - ісламіст m
islamistka - ісламістка f
islamizm - ісламізм m
Islandczyk - ісландзец m
Islandia - Ісландыя
Islandka - ісландка f
islandzki - ісландскі
istnieć - існаваць
istny - жаніх m
Italok - італьянец m
italski - італьянскі
iterb - ітэрбій m
itr - ітрый m
I wojna światowa - першая сусветная вайна f
izba - мір m | пакой m
-izm - -ізм
Izrael - Ізраіль m
Izraelczyk - ізраільцянін m
izraelski - ізраільскі
ja - я
jabłko - яблык (jáblyk) m
jabłko Adama - адамаў яблык
jabłoń - яблынь f
Jaćwież - Дайнава | Дайнова | Судавія | Судава | Судува | Яцвезь | Ятвезь | Яцвягія | Ятвягія
jadać - есці
jadalny - ядомы
jagoda - шчака f
jajnik - яечнік m
jajo - яйка n
jak - як | калі | так… як і…
jak grom z jasnego nieba - як гром з яснага неба | як снег на галаву
jakie drzewo, taki klin, jaki ojciec, taki syn - якое дрэва, такі клін, які бацька, такі сын
jakmiarz - цалкам | поўнасцю | зусім | даволі | дастаткова
jako - як | калі | так… як і…
jakość - якасць f
jak trwoga, to do Boga - як трывога, тады да Бога | калі трывога, тады да Бога
jak u Pan Pana Boga za piecem - як у Бога за печкай
jałówka - ялаўка f | ялавіца f
jangryst - агрэст m
Japonia - Японія f
japoński - японскі
jarecka - маці f
jarmułka - ярмолка f
jarosz - вегетарыянец m
jarzębina - рабіна f
jaskółka - ластаўка f
jasny - светлы
Jaworzno - Явожна
jebadło - ложак m
jechać - ехаць | катацца | смярдзець
jedna jaskółka nie czyni wiosny - першая ластаўка вясны не робіць | першы шпак вясны не робіць
jedna jaskółka wiosny nie czyni - першая ластаўка вясны не робіць | першы шпак вясны не робіць
jednobarwny - манахромны
Jędrzej - Андрэй m
jedza - ежа f | харч m | корм m | яда
jedzenie - ежа f | харч m | корм m | яда
Jemen - Йемен
jemeński - йеменскі
Jerozolima - Іерусалім f
jeść - есці
jesień - восень f
jesień życia - восень жыцця f
jest - быць
jeszcze - яшчэ
jeż - вожык (vožyk) m
jezuicki - езуіцкі
jezuita - езуіт m
Jezus - Ісус m
Jezus Chrystus - Ісус Хрыстос
język - язык m | мова f
język obcy - замежная мова f
język ojczysty - родная мова f
językoznawca - мовазнавец m | мовавед m
językoznawczy - мовазнаўчы
językoznawstwo - мовазнаўства n
jidysz - ідыш
jod - ёд
joga - ёга f
Jordania - Іарданія f
judaizm - іўдаізм m
judofob - антысеміт m
Jugosławia - Югаславія f (Juhasłavija)
juny - малады
jutro - заўтра
już - ужо
kaban - свіння f
kabza - кішэнь f
kadm - кадмій m
kadzidło - фіміям m
kafej - кафэ n | кавярня f
kaganat - каганат m
kaj - дзе
kajet - сшытак m
Kaka - Кака f
kalafa - нос m | алкагалік m | твар m
kalapitra - галава f
kalendarz - каляндар m
kalenica - (вільчык)
kalfas - жывот m
kaliforn - каліфорній m
Kalifornia - Каліфорнія f
kalifornijski - каліфарнійскі
kaloria - калорыя f
kalwin - кальвініст m
kalwinista - кальвініст m
kalwinistka - кальвіністка f
kalwinizm - кальвінізм m
kalwinka - кальвіністка f
kam - дзе
Kambodża - Камбоджа f
kambr - кембрый m
kamelarz - служачы m
Kamerun - Камерун
kameruński - камерунскі
kamienny - каменны
kampania - кампанія f
Kanada - Канада f
Kanał Sueski - Суэцкі канал
kanibalizm - канібалізм m
kanka - марыхуана f
kanonizacja - кананізацыя f
kapcylinder - капялюш m | шапачка | шапка f
kapeluch - капялюш m | шапачка | шапка f
kapelusz - капялюш m | шапачка | шапка f
kapitalista - капіталіст m
kapłan - ксёндз | святар m
kapować - разумець
kapral - капрал m
kapusta - грошы
kapusta kiszona - капуста квашаная f
karaba - кот m
karczoch - артышок
kark - карак
karlus - хлапец m | хлопец m
karta kredytowa - крэдытная картка f
Karwat - харват m
kaszel - кашаль
kaszleć - кашляць
katalityczny - каталітычны
Katalonia - Каталония
kataloński - каталонскі | каталонская мова f
katar - насмарк m | катар m
Katar - Катар m
katechizm - катэхізіс m
katedra - кафедральны сабор m | кафедра f
katolicki - каталіцкі
katolicyzm - каталіцызм m
katoliczka - каталічка f
katolik - каталік m
Katyń - Катынь m
kawa wesoła - публічны дом m
kawiarnia - кафэ n | кавярня f
Kazachstan - Казахстан m
kazanie - казань f | казанне n
każdy - кожны
kaznodzieja - казальнік m
kciuk - вялікі палец m
kędy - дзе
kejter - сабака (sabaka)
Kenia - Кенія f
kenijski - кенійскі
kici, kici - кыць-кыць
kiedykolwiek - калі-небудзь
kiedyś - калісьці | некалі | колісь | калі-небудзь
kiejda - кішэнь f
kielczyć się - смяяцца
kiep - кеп m
kiepeła - галава f
kiepski - кепскі | дрэнны
kierownictwo - кіраўніцтва n
kierownik - начальнік
kierz - куст m
kierzek - куст m
kieszeń - кішэнь f
kij - кій m
Kijów - Кіеў m
kijowski - кіеўскі
kilogram - кілаграм m
kino - кіно n
kinol - нос m | алкагалік m
kintop - кіно n
kira - гарэлка | водка
kirgiski - кіргізскі
Kirgistan - Кыргызстан m
kit - хлусня f | мана f | падман m
kitajka - кітаянка f | кітайка f
kitajski - кітайскі | кітайская мова f
kiur - кюрый m
kląć jak szewc - лаяцца апошнімі словамі
kłamstwo - хлусня f | мана f | падман m
kłapaczka - вусны
klara - Сонца
klarnecista - кларнетыст m
klarnet - кларнет m
klawiatura - клавіятура f
klekotun - бацян
klepać biedę - не мець ни шэлега за душой
klerykalizm - клерыкалізм m
klęska - паражэнне
kliber - нос m | алкагалік m
klimat - клімат m
klimatyczny - кліматычны
kłótnia - спрэчка f
kluber - нос m | алкагалік m
kłuć - калоць
kluka - нос m
klupać - шукаць | калоць
kniądz - князь m | ксёндз | святар m
knipa - кніга f (kniha)
koalicja - кааліцыя f
kobalt - кобальт m
kobieta - жанчына f
kobieta lekkich obyczajów - прастытутка f
kochać - кахаць | любіць
kochanie - каханне
kochany - любімы
kociamber - кот m
kod kreskowy - штрых-код m
koja - ложак m
kojec - манеж m
kojo - ложак m
kokota - прастытутка f
kołacz - калач (kaláč) m
kolano - калена n
kołchoz - калгас
kolektywizacja - калектывізацыя f
kolektywnie - калектыўна
kolektywny - калектыўны
koleś - мужчына m
koleżeński - таварыскі
koło - каля | ля | прыкладна | на круг
kolonia - калонія f | пасёлак | паселішча
Kolonia - Кёльн f
kolonializm - каланіялізм m
kolonialny - каланіяльны
kolonista - каланіст m
kolonizator - каланізатар m
kolor - колер
kolorowy - каляровы
kolos na glinianych nogach - калос на гліняных нагах m
Kolumb - Калумб m
Kolumbia - Калумбія f
kolumbijski - калумбійскі
komedia - камедыя f
komercyjny - камерцыйны
kometa - камета f
komisja - камісія f
komórka - клетка f | мабільнік m
Komory - Каморскія астравы
komp - кампутар m
kompania - рота f
komputer - кампутар m
komuch - камуніст m
komunista - камуніст m
komunistka - камуністка f
komunistyczny - камуністычны
komunizm - камунізм m
koń - конь
kóń - конь
kondom - прэзерватыў m
konfederacja - канфедэрацыя f
konfesjonał - канфесіяналь m
konflikt - канфлікт m
konfliktowy - канфліктны
konformista - канфарміст m
konformistka - канфармістка f
konformistyczny - канфармісцкі
konformizm - канфармізм m
koniec - канец m
koniunkturalność - апартунізм m
koniuszy - канюшы m
konował - канавал m
konserwatysta - кансерватыст m
konserwatyzm - кансерватызм m
kontrabanda - кантрабанда f
kontrabas - кантрабас m
kontrabasista - кантрабасіст m
koń trojański - траянскі конь m
kontrola - кантроль f
kontrrewolucja - контррэвалюцыя f
kontrwywiad - контрразведка f
kontynent - кантынент m | мацярык m
kontynentalny - кантынентальны
kopala - могильщик m
Kopenhaga - Капенгаген
kopernik - каперніцый m
kopia - копія f
kopyto - пісталет m
Koran - Каран m
Korea - Карэя
koreański - карэйскі
korona z głowy nie spadnie - карона з галавы не зваліцца | карона з галавы не спадзе
korowód - карагод m
korytarz - калідор m
kosa - нож m
kość - косць f
kościół - касцёл m | царква | храм m
Kościół - касцёл m | царква f | храм m
Kościuszko - Касцюшка m
kosmopolita - касмапаліт m
Kosowo - Косава n
Kostaryka - Коста-Рыка
kostium - касцюм m
kosz - лагер m
koszula - кашуля f
kot - кот m
koteria - кліка f
koza - каза f
Kozak - казак m
Koziorożec - Казярог m
koźlarz babka - падбярозавік звычайны m
koźlarz czerwony - падасінавік m
kożuch - дублёнка f | кажух m
kradzież - крадзеж m
kraj - дзяржава f | краіна f | спадарства n | вы | спадары
Kraków - Кракаў
krasomówca - красамоўца m | прамоўца m
krasula - карова f
krauza - банка f
kreacjonizm - крэацыянізм m
Kreta - Крыт m
krętacz - прайдзісвет m
krew - кроў f
król - кароль m
królestwo - каралеўства n | царства n
królewicz - каралевіч m
królewski - каралеўскі
królowa - каралева f
krótki - кароткі
krowa - карова f
krowi - каровін | каравячы | каровячы
kruk krukowi oka nie wykole - груган гругану вока ня выдзяўбе
kruty - дужы | моцны
krwionośny - крывяносны
krwotok - крывацёк m
krybuny - крыж m
krymski - крымскі
Krynki - Крынкі
krypel - царква f
krypton - крыптон m
kryzys - крызіс
krzak - куст m
krzeczek - хомяк m
krzem - крэмній m
krzew - куст m
krzywonogi - крываногі
krzywoprzysięstwo - клятвапарушэнне n
krzywoprzysięzca - клятвапарушальнік m
krzywousty - крывавусты
krzyż - крыж m
Krzyżak - тэўтонец m
Ksenia - Ксенія f
ksenofilia - ксенафілія f
ksenofobia - ксенафобія f
ksiądz - ксёндз | святар m
książę - князь m
książka - кніга f (kniha)
księgarnia - кніжны магазін m
księgowość - бухгалтэрыя f
księgowy - бухгалтар m | бухгалтарскі
księgozbiór - бібліятэка f
księstwo - герцагства n | княства n
księżna - герцагіня f | княгіня f
księżyc - месяц m
kto - хто | хтосьці | хто-небудзь
któż - хто | хтосьці | хто-небудзь
Kuba - Куба f
kubizm - кубізм m
kucać - кашляць
kucharz - кухар m
kucza - хата f
kuć żelazo, póki gorące - каваць жалеза, пакуль гарачае
kudłacz - калдун
kukuruźnik - кукурузнік m
kula - куля f | нага f
kulinarny - кулінарны
kulka - куля f
kulomb - кулон m
kulos - нага f
kulturalny - культурны
kulturowy - культурны
kup - купіць
kupić - купіць
kupić kota w worku - купіць ката ў мяшку
kupidło - цана f
kuraż - адвага f
kurdupel - курдупель m
Kurówka - Кураўка
kurtyzana - прастытутка f
kusić - страшыць
kusy - д'ябал m | сумчаты д'ябал m
kutwa - скупянда m | скнара m
Kuwejt - Кувейт
kwantowy - квантавы
kwartet - квартэт m
kwas chlebowy - квас m
kwas siarkowy - серная кіслата f
kwiat - кветка f | краска f | цвет m
kwiczoł - рабіннік m
kwiecień - красавік m
kwietniowy - красавіцкі | красавіковы
kwitnąć - красаваць
laboratorium - лабараторыя f
laboratoryjny - лабараторны
lać - смяяцца
lacz - галава f | паліцэйскі m | паліцыянт m | палісмен m
laga - кій m
lala - дзяўчына f
łamać sobie głowę - ламаць галаву
land - вёска f | сяло n
lantan - лантан m
larmo - трывога f
las - лес
lat - год m
lata - год m
lato - лета n
latopis - летапіс f
łatwowierność - даверлівасць f
łatwowierny - даверлівы
łazanki - лазанкі
le - але
lecz - але
legalizacja - легалізацыя f
legalny - легальны
legenda - легенда f
legendarny - легендарны
lekarz - урач m
lekarz chorób płuc - пульманолаг m | пульманолаг f
lekarz choroby chorób kobiecych - гінеколаг m
lekcja - урок m
lekki - лёгкі
lekkomyślność - легкадумнасць f
lekkomyślny - легкадумны
leksyka - лексіка f
leksykolog - лексіколаг m
leksykologia - лексікалогія f
leniwy - лянівы
lepak - зноў | ізноў
łepetyna - галава f
lepiej z mądrym zgubić, niż z głupim znaleźć - лепш з разумным згубіць, чым з дурнем знайсці
lepszy wróbel w garści niż gołąb na dachu - лепш сініца ў руках, чым журавель у небе
lesbijka - лесбіянка f
leśny - партызан m
Lesotho - Лесота f
Lew - Леў
lewy - левы
leżeć - ляжаць | знаходзіцца | размяшчацца
Lhasa - Лхаса f
Liban - Ліван m
Liberia - Ліберыя f
Libia - Лівія f
licencja - ліцэнзія f
liczba - лічба | лік
liczebnik - лічэбнік
liczykrupa - скупянда m | скнара m
liliput - ліліпут m
lingwista - лінгвіст m
lingwistka - лінгвістка f
lingwistyczny - лінгвістычны
lingwistyka - лінгвістыка f
lipiec - ліпень
liść - ліст m
list - пісьмо n
listopad - лістапад m
lit - літый m
literacki - літаратурны
litewski - літоўскі
Litwa - Літва f
Litwin - літовец m | літвін m | ліцвін m
liwermor - ліверморый m
łochynia - дурні́цы | буякі
lód - лёд | марожанае
lodówka - халадзільнік m
logiczny - лагічны
logika - логіка f
logiko - логіка f
lojolita - езуіт m
łokieć - локаць m
lola - дзяўчына f | кій m
Londyn - Лондан m
lorens - лаўрэнсій m
łotewski - латвійскі | латышская мова f
lotniskowiec - авіяносец m
Łotwa - Латвія f
Łotysz - латыш m
Łotyszka - латышка f
łoże - ложак m
łóżko - ложак m
lub - або
łucznictwo - стральба з лука f
ludność - насельніцтва n
ludożerstwo - людаедзтва n
łudzikwiat - красавік m
ludzki - чалавечы | людскі
Luksemburg - Люксембург m
lulka - цыгарэта f | папяроса f (bez filtra)
luna - месяц m
luńt - сабака (sabaka)
luteranin - лютэранін m
luteranizm - лютэранства n
luteranka - лютэранка f
lutet - лютэцый m
lutować - калоць
luty - люты m
łysy - лысы
łża - хлусня f | мана f | падман m
mać - маці f
Macedonia - Македонія f
macedoński - македонскі
macica - матка f
maciek - жывот m
Madagaskar - Мадагаскар
Madryt - Мадрыд m
MAEA - МАГАТЭ
magister - камандзір m
magnez - магній m
maj - май
majątkowy - маёмасны
mak - мак m
makiawelista - макіявеліст m
makiawelizm - макіявелізм m
malaria - малярыя
Malawi - Малаві f
Malediwy - Мальдывы
Mali - Малі f
małoduszność - маладушнасць f
małpa - малпа f | сабака | смоўж | слімак
mały palec - мезенец m
małżonek - муж m
małżonka - жонка f
mam - валодаць | мець | мусіць | трэба | распараджаць | быць апранутым | спадзавацца
mangan - марганец m
maniurka - дзяўчына f
manufaktura - мануфактура f
maoista - мааіст m
mapa topograficzna - топографска карта
marcowy - сакавіцкі
marihuana - марыхуана f
marksista - марксіст m
marksizm - марксізм m
marny - дрэнны | кепскі
Maroko - Марока
marskość - цыроз m
marzec - сакавік m
marzenie - мара
maska - твар m
maślak - масляк m
maślarz - масляк m
matka - маці f
Matka Boska - Маці Божая f
mąż - муж m
mazak - твар m
mecz - матч m
medycyna - медыцына f
medyk - урач m
meitner - мейтнерый m
Meksyk - Мексіка f | Мехіка f
meksykański - мексіканскі
melizmat - мелізма f
melodia - мелодыя f
melodio - мелодыя f
menadżer - начальнік
mendelew - мендзялевій m
menel - п'яніца
Merkury - Мэркурый (Merkúryj)
metafizyczny - метафізычны
metal - метал m
metalowy - металічны
meteoryt - метэарыт
metr - метр m
metr kwadratowy - квадратны метр m
mężczyzna - мужчына m
Mezopotamia - Месапатамія f
mezozoik - мезазой m
mgła - туман m
Miami - Маямі
mianownik - назоўны склон m | намінатыў m | назоўнік m
miasto - горад m
miasto stołeczne - сталіца
miażdżyca - атэрасклероз m
Michał - Міхал (nichał) m
mieć - валодаць | мець | мусіць | трэба | распараджаць | быць апранутым | спадзавацца
mieć głowę na karku - мець галаву на плечах
mieć gzik w kolanach - баяцца
mieć muchy w nosie - мець мухі ў носе
miedź - медзь f
miedziany - медны
miedźwiedź - мядзведзь m
między - паміж | між
Międzyrzec Podlaski - Мендзыжац-Падляскі
miejski - гарадскі
mielcarz - півавар m
mielcuch - піва n
mieli - валодаць | мець | мусіць | трэба | распараджаць | быць апранутым | спадзавацца
miesiąc - месяц m
miesiąc miodowy - мядовы месяц m
miesiączek - месяц m
mięsień - мускул m | цягліца f | мышца f
mięsopustnik - люты m
mieszkać - жыць | пражываць
mieszkanie - кватэра f
mikologia - мікалогія f
mikrobiologia - мікрабіялогія f
milicja - міліцыя f
militarny - ваенны
miłość - любоў f | каханне n
mimowolny - мімавольны | міжвольны
minimalistka - мінімалістка f
miński - мінскі
misjonarz - місіянер m
mistrzostwo - чэмпіянат
mitologia - міфалогія
mitologiczny - міфалагічны
młody - малады
młodzieniec - маладзенец
młodzież - моладзь f
mnogdy - часта
móc - магчы
mocny - дужы | моцны
modrakowy - сіні
modry - сіні
Mojżesz - Майсей
Mołdawia - Малдова
molibden - малібдэн m
Molier - Мальер m
Monako - Манака f
monarcha - манарх m
monarchista - манархіст m
moneta - манета f
Mongolia - Манголія f
mongolski - мангольскі
monoteistka - монатэістка f
monoteizm - манатэізм m
moralista - мараліст m
mordować - забіць
morfologia - марфалогія f
morski - марскі
morze - мора n
Morze Bałtyckie - Балтыйскае мора n
Morze Barentsa - Баранцава мора
Morze Białe - Белае мора n
Morze Czarne - Чорнае мора
Morze Norweskie - Нарвежскае мора
Morze Północne - Паўночнае мора n
Morze Śródziemne - Міжземнае мора
mosiądz - манета f
Moskwa - Масква f
most - мост m
mostek - грудзіна f | мост m
moszna - машонка f
mosznowy - машоначны
motyka - матыка f
Mount Everest - Эверэст | Эвэрэст
mowa - язык m | мова f
Mozambik - Мазамбік m
może - магчы
mózg - мозг m
możliwość - магчымасць f
mrówka - мурашка f | мурашкі
mróz - мароз
muchomor - мухамор m
muchomór - мухамор m
muchomor czerwony - мухамор чырвоны m
muchomor plamisty - мухамор пантэрны m
muchomor sromotnikowy - бледная паганка f
muchomor zielonawy - бледная паганка f
mućka - карова f
mugol - магл
mundurowy - паліцэйскі m | паліцыянт m | палісмен m
muraszka - мурашка f | мурашкі
Murzyn - негр m
Murzynka - негрыцянка f
muzeum - музей m
muzułmanin - мусульманін m
muzułmański - мусульманскі
mużyk - мужчына m
my - мы
mycka - шапка f
mydlić oczy - замазваць вочы
mykologia - мікалогія f
mylny - памылковы
myrmekologia - мірмекалогія f
myślenie - мысленне n
myśliwiec - знішчальнік m
Myszka Miki - Мікі Маўс m
na - на | па | у
nacja - народ m
nacjonalista - нацыяналіст m
nacjonalistka - нацыяналістка f
nacjonalistyczny - нацыяналістычны
nacjonalizacja - нацыяналізацыя f
nacjonalizm - нацыяналізм m
naczalstwo - кіраўніцтва n
naczyniowy - судзінкавы
nadawca - адрасант m
na dwoje babka wróżyła - бабка надвае гадала | бабка надвае варажыла
nadziany - багаты
nagle - знянацку | нечакана | неспадзявана | знячэўку | раптоўна
nagły - раптоўны | нечаканы
naiwność - наіўнасць f
naiwny - наіўны
najwyższy czas - самая пара
Namibia - Намібія f
naprany - п'яны | п'яны m
na przykład - напрыклад
nareszcie - нарэшце
narkomania - наркаманія f
naród - народ m
narodowy socjalizm - нацыянал-сацыялізм m
narzeczony - жаніх m
nasienie - насеньне n
naślennik - наступнік m | наследнік m
następca - наступнік m | наследнік m
następnie - потым | затым
na szczęście - на шчасце
natura ciągnie wilka do lasu - воўк да лесу цягня
naturalność - натуральнасць f
naturalny - натуральны
nauczyciel - настаўнік m
naukowy - навуковы
na wagę złota - на вагу золата
nawałnica - навальніца f
nawet - нават
na zdrowie - будзьце здаровы
nazista - нацыст m
nazizm - нацызм m
na złodzieju czapka gore - на злодзеі шапка гарыць
nazwa - назва f | названне n | найменне n | імя n
neodym - неадым m
neofaszysta - неафашыст m
neofaszyzm - неафашызм m
Nepal - Непал m
neptun - нептуній m
Neptun - Нептун m
nerka - нырка f
neurochirurgia - нейрахірургія f
neurochirurgiczny - нейрахірургічны
neurolog - неўролаг m
neutralność - нейтралітэт m
neutralny - нейтральны
ni - не | ні
Niderlandy - Нідэрланды | Галандыя f
nie - не | ні
niebieski - сіні
niebiosa - неба n
niebo - неба n
niech - хай | няхай
niech żyje - няхай жыве!
niedaleko pada jabłko od jabłoni - яблык ад яблыні недалёка коціцца | яблык ад яблыні недалёка падае
niedowierzanie - недавер'е n
niedziela - нядзеля f
niedźwiedź - мядзведзь m
niegdyś - калісьці | некалі | колісь | калі-небудзь
niegramotny - непісьменны
nie kijem (go), to pałką - не кіем дык палкай
niektóry - некаторы
nie ma dymu bez ognia - няма дыму без агню
niemal - амаль
Niemcy - Нямеччына f | Германія f | немцы
Niemen - Нёман
Niemiec - немец m
nie mieć - не | ні | валодаць | мець | мусіць | трэба | распараджаць | быць апранутым | спадзавацца
Niemiecka Republika Demokratyczna - Германская Дэмакратычная Рэспубліка f
niemiecki - нямецкі | нямецкі m
Niemka - немка f
niemoc - імпатэнцыя f
nieoczekiwany - нечаканы | неспадзяваны
nieodpowiedzialny - безадказны
nieopłacalny - нерэнтабельны
niepodległość - незалежнасць f (niezaliežnasć)
niepodległy - незалежны
nie śmierdzieć groszem - не мець ни шэлега за душой
niespodziewany - неспадзяваны | нечаканы | непрадбачаны
niestety - на жаль
nieszczęście - няшчасце n
nie taki diabeł straszny, jak go malują - не такі страшны чорт, як яго малююць
niewart - не варты
niewdzięczność - няўдзячнасць f
niewdzięczny - няўдзячны
niewiasta - жанчына f
nie widzieć dalej niż czubek własnego nosa - не бачыць далей свайго носа
niewierny - няверны
niewierny Tomasz - Фама няверны m
nie wszystko złoto, co się świeci - не ўсё тое золата, што блішчыць
niewypłacalność - неплацежаздольнасць f
niewypłacalny - неплацежаздольны
niezależność - незалежнасць f
niezależny - свабодны | незалежны
Niger - Нігер m
Nigeria - Нігерыя f
nihilista - нігіліст m
nihilistka - нігілістка f
nihilizm - нігілізм m
Nikaragua - Нікарагуа f
nim - ён
niob - ніобій m
niski - нізкі
niszczyciel - разбуральнік m | разаральнік m | спусташальнік m | эсмінец m | эскадраны мінаносец m
niż - чым
NKWD - НКВД
no - так
nobel - набелій m
noc - ноч f
nocny - начны
nocować - начаваць
noga - нага f
nonkonformista - нонканфарміст m
nonkonformistka - нонканфармістка f
nonkonformistyczny - нонканфармісцкі
nonkonformizm - нонканфармізм m
normalność - нармальнасць f
normalny - нармальны
Norweg - нарвежац m
Norwegia - Нарвегія f
norweski - нарвежскі | нарвежская мова f
Norweżka - нарвежка f
nos - нос m | алкагалік m
Nowa Zelandia - Новая Зеландыя f
nowicjat - навіцыят m
noworodek - немаўля n
nowotwór - наватвор m
nowy - новы
Nowy Jork - Нью-Йорк m
Nowy Rok - Новы Год
nóż - нож m
nudelzupa - суп m
nudny - нудны
nurek - вадалаз
nyra - скупянда m | скнара m
nyrol - скупянда m | скнара m
oaza - аазіс m
obchodzić - абыходзіць | адзначаць | святкаваць | адносіцца | абысціся
obcy - чужы
obelisk - абеліск m
obiad - абед m
obiecadło - азбука f | алфавіт m | пісьмо n
obiecanka - абяцанка f
obiecanki cacanki - абяцанкі-цацанкі
obiekt - аб'ект m
obierać - ачышчаць | калоць
obłuda - крывадушнасць f
obłudnik - крывадушнік m
obłudny - крывадушны
obój - габой m
obojczyk - ключыца
obowiązek - абавязак m
obowiązkowość - добрасумленнасць f | абавязкавасць f
obowiązkowy - абавязковы | акуратны
obóz - лагер m
obóz koncentracyjny - канцэнтрацыйны лагер m | канцлагер m
obraz - карціна f | выява f | абраз m | ікона f | вобраз m | прадстаўленне n | апісанне n | фільм m
obserwator - назіральнік
OBWE - АБСЕ
obywatel - грамадзянін m
obywatelka - грамадзянка f
obywatelstwo - грамадзянства n
ocean - акіян m
Ocean Atlantycki - Атлантычны акіян m
oceaniczny - акіянічны
Ocean Indyjski - Індыйскі акіян m
Ocean Spokojny - Ціхі акіян m
ociec - бацька m
od - ад
odczuwalny - пачуццёвы
oddział - атрад m
ode - ад
Odessa - Адэса f
odludek - адлюднік m | бязлюднік m | нялюднік m
odludzie - немарач f
odór - сморад m | смурод m
odpłacać taki taką samą monetą - плаціць той жа манетай
odpoczynek - прыпынак m
odpowiedź - адказ m
odpowiedzialność - адказнасць f | адказ m
odrębny - асобны
odwaga - адвага f
odwieczny - спрадвечны
odwrotny - адваротны
ogień - агонь m
oglądać - глядзець | прыглядацца | разглядаць
ogólny - агульны
ogórek - агурок m
ogród botaniczny - батанічны сад m
ogrodnik - садоўнік m
ogród zoologiczny - заалагічны парк m
ojciec - бацька m
ojczyc - сын m
ojczysty - родны
ojczyzna - радзіма f
ojla - сава f
oko - вока n (woka)
około - каля | ля | прыкладна | на круг
około- - каля-
okop - окоп
okrągły - круглы
okręt - карабель m
okręt podwodny - падводная лодка f
okulary - акуляры
okulista - акуліст m
okultyzm - акультызм m
okupacja - акупацыя f
olej - алей m
oligarcha - алігарх m
oligarchia - алігархія f
ołów - свінец m
oma - бабуля f
Oman - Аман
omieszkać - не | ні
omlet - омлет m
on - ён
ona - яна
onkologiczny - анкалагічны
onomastyka - анамастыка f
ontologia - анталогія f
ONZ - ААН
oologia - аалогія f
opactwo - абацтва n
opalać - загарацца
opat - абат m
operacja - аперацыя f
operacyjny - аперацыйны
opiąć - зноў | ізноў
opięć - зноў | ізноў
opłacalność - рэнтабельнасць f
opłacalny - рэнтабельны
oportunista - апартуніст m
oportunistka - апартуністка f
oportunistyczny - апартуністычны
oportunizm - апартунізм m
opozycja - апазіцыя f
oprócz - апроч
opuścić nos na kwintę - павесіць нос на квінту
oraz - и
organista - арганіст m
organistka - арганістка f
Organizacja Narodów Zjednoczonych - Арганізацыя Аб'яднаных Нацый
organizator - арганізатар m
organizatorka - арганізатарка f
organizm - арганізм m
orgazm - аргазм m
Ormianin - армянін m
Ormianka - армянка f
ormiański - армянскі | армянская мова f
ortograf - арфаграфічная памылка f
-ość - -асць
osm - осмій m
osmański - асманскі
osoba - асоба f
osobliwy - асаблівы
ostatni - апошні
ostracyzm - астракізм m
oszczędny - ашчадны | эканомны
Ottawa - Атава f
owadoznawstwo - энтамалогія f
owca - авечка f
owczy - авечы
o wilku mowa - лёгкі на ўспамін | пра воўка памоўка, а воўк і тут
o wilku mowa, a wilk tu - пра воўка памоўка, а воўк і тут | лёгкі на ўспамін
o wilku mowa, a wilk tuż - лёгкі на ўспамін | пра воўка памоўка, а воўк і тут
owocnik - пладовае цела грыба | спаракарп m | карпафор m
owulacja - авуляцыя f
ożarty - п'яны | п'яны m
ożyrok - п'яніца
pachnąć - пахнуць
pachniarz - нос m
pachnieć - пахнуць
pacholę - хлапец m | хлопец m
paciuk - пацук
Pacyfik - Ціхі акіян m
pacyfistka - пацыфістка f
padalec - вераценніца f | мядзянка f
pajęcznik - верасень m | кастрычнік m | лістапад m
Pakistan - Пакістан m
pała - галава f | паліцэйскі m | паліцыянт m | палісмен m
palcem nie kiwnąć - пальцам не крануць
pale - галава f | паліцэйскі m | паліцыянт m | палісмен m
palec - палец m
palec wskazujący - указальны палец m | ківун m
paleontologia - палеанталогія f
paleozoologia - палеазаалогія f
palić - гарэць | паліцца
palindrom - паліндром
pallad - паладый m
palny - агнястрэльны
pamiątka - памятка f | сувенір m
pamięć - памяць f
pamiętliwy - злапамятны | злапамятлівы | злапомны
pan - спадар m | пан m
Pan - Госпадзь
panamski - панамскі
Pan Bóg - Госпадзь
pandemia - пандэмія f
pani - спадарыня f | пані f | багіня f
Panna - Дзева f
państwo - дзяржава f | краіна f | спадарства n | вы | спадары
państwowy - нацыянальны | дзяржаўны
pańszczyzna - паншчына f
papieros - цыгарэта f | папяроса f (bez filtra)
papież - папа рымскі
Paragwaj - Парагвай m
parasol - парасон n
park - парк m
parlament - парламент m
parlamentarny - парламенцкі
parszywiec - паршывец m
parszywy - паршывы | пархаты
partyzant - партызан m
pasażer - пасажыр m
pasieka - пасека
pasować jak wół do karety - прыйшоўся як вол да карэты
paszport - пашпарт m
patria - радзіма f
patriota - патрыёт m
patriotka - патрыётка f
patriotyczny - патрыятычны
patriotyzm - патрыятызм m
patrzałki - акуляры
patrzeć - глядзець | пазіраць | назіраць | прыглядацца
patrzeć przez palce - глядзець праз пальцы
patrzeć przez różowe okulary - глядзець праз ружовыя акуляры
patrzeć wilkiem - воўкам глядзець
patrzyć - глядзець | пазіраць | назіраць | прыглядацца
październik - кастрычнік m
paździerzeń - кастрычнік m
paznokieć - пазногаць m | ногаць m
pazura - рука f
pedał - педаль f
pedant - педант m
pedantka - педантка f
pedantyczny - педантычны
pedofil - педафіл m
pedofilia - педафілія f
pedryl - педаль f
pędziwiatr - вецер m
peniak - баязлівец m | тхор m
penicylina - пеніцылін m
pępek - пупок m
Pepik - чэх m
persona - асоба f
Peru - Перу
peryfraza - перыфраз m | перыфраза f
piana - піва n
piątkowy - пятнічны
piec - печка f
piechota - пяхота f
piegowaty - рабаціністы
piekło - смала f
piękno - прыгажосць f
piękność - прыгажосць f
pieniądz - грошы
pieniądze - грошы
pieniądze nie śmierdzą - грошы не пахнуць
pierś - грудзі
pierwiastek chemiczny - хімічны элемент m
pierwszak - першакласнік m
pierwsza wojna światowa - першая сусветная вайна f
pierwszoklasista - першакласнік m
pies - сабака (sabaka)
pieski - псі | сабачы
Pieśń nad pieśniami - Песня песень f
pigułka - пілюля f
pijak - п'яніца
pijanica - п'яніца | дурні́цы | буякі
pijany - п'яны | п'яны m
pikawa - сэрца n
piłka nożna - футбол
piłkarski - футбольны
piorun - маланка f
pismo - пісьмо n | часопіс m | газета f | азбука f | алфавіт m
Pismo - Святое пісанне n
pistolet - пісталет m
Pittsburgh - Пітсбург m
piwo - піва n
piwowar - півавар m
piwowarstwo - піваварэнне n
pizgać - калоць
piznąć - ударыць
plaga egipska - егіпецкая кара f
płakać - плакаць
planeta - планета f
planetarny - планетарны
planta - расліна f
Platon - Платон m
platyna - плаціна f
platynowy - плацінавы
plaża - пляж m
plecy - спіна f
plemię - племя n
pleśń - цвіль
płuco - лёгкае n
pluton - плутоній m | узвод m
płynąć - плысці | плыць | цячы | рухацца
płynny - вадкі
pneumonolog - пульманолаг m | пульманолаг f
po - пасля
pobożność - набожнасць f
pocałować - пацалаваць
pocałować klamkę - пацалаваць клямку
pocestny - падарожнік m | вандроўнік m
pochodzenie - паходжанне n
POChP - ХАХЛ
pochwa - похва f
pociąg - цягнік m | поезд m | прага | цяга
poczta - пошта f
pocztowy - паштовы
poczucie humoru - пачуццё гумару n
podeszwa - падэшва f
pod gołym niebem - пад адкрытым небам | пад голым небам
Podlasie - Падляшша
podniebienie - паднябенне n
podobać się - падабацца
podobny - падобны
podróż - падарожжа n
podróżnik - падарожнік m | вандроўнік m
podstawowy - асноўны | галоўны
podziemny - падземны | падпольны
pogański - язычніцкі
pojąć - зразумець
pojedynek - дуэль f
pójść - пайсці
pójść z torbami - з торбай ісці
pokładać się ze śmiechu - качацца са смеху
pokój - мір m | пакой m
Polak - паляк m
polemika - палеміка f
policjant - паліцэйскі m | паліцыянт m | палісмен m
policzek - шчака f
politeizm - політэізм m
polityczny - палітычны
polityk - палітык m
polityka - палітыка
półka - паліца f
północ - поўнач f
północnoamerykański - паўночнаамерыканскі
polon - палоній m
polonizacja - паланізацыя f
połowa - палова f | палавіна f
półowa - палова f | палавіна f
położenie - месцазнаходжанне n
Polska - Польшча f
polski - польскі | польскі m
półudenyk - абед m
południe - поўдзень
południk - мэрыдыян
południowoamerykański - паўднёваамерыканскі
półwysep - паўвостраў m
połykać - глытаць
połykać łzy - глытаць слёзы
pomarańczowy - аранжавы
pomiędzy - паміж | між
pomrzeć - памерці
pomysł - ідэя f
poniedziałek - панядзелак
ponownie - зноў | ізноў
ponton - пантон m
popadia - пападдзя f
popielniczka - попельніца
poprawność polityczna - палітычная карэктнасць f | паліткарэктнасць f
pornografia - парнаграфія f
pornograficzny - парнаграфічны
porównanie - параўнанне n
portier - парцье m
Portugalczyk - партугалец m
Portugalia - Партугалія f
Portugalka - партугалька f
portugalski - партугальскі | партугальская мова f
posiadać - валодаць | мець | умець
pośladek - ягадзіца f
pośledni - апошні
potem - потым | затым
potrafić - умець
potrzebny - патрэбен
potrzebny jak dziura w moście - патрэбен як у мосце дзірка
poufny - канфідэнцыйны | даверлівы
poważny - сталы
powiedzieć - сказаць
powieka - павека n
powieść - раман m
powiestka - назва f | названне n | найменне n | імя n
powietrze - паветра n
powietrzny - паветраны
powód - прычына f
powstańczy - паўстанцкі
powstanie - паўстанне n
poza - апроч
pożar - пажар m
pożarniczy - пажарны
pozawczoraj - пазаўчора
pozłacać - залаціць
pozostały - астатні
pozytywny - пазітыўны
pożywienie - ежа f | харч m | корм m | яда
praca - праца | работа f
pracochłonność - працаёмкасць f
pracodawca - працадаўца m
pracowitość - працавітасць f
pracowity - працавіты
pracownik - працаўнік m | супрацоўнік m | рабочы m
pracuś - працавік m | рабацяга m
praczka - пральля
Praga - Прага f
pragmatyk - прагматык m
praktyczny - практычны
prawak - баравік m
prawa ręka - рука f
prawda w oczy kole - праўда вочы коле
prawdopodobieństwo - праўдападобнасць f | імавернасць f
prawdopodobny - праўдападобны
prawdziwek - баравік m
prawdziwy - праўдзівы | сапраўдны | рэальны | натуральны
prawosławie - праваслаўе n
prawosławny - праваслаўны | праваслаўны m
prawowity - легітымны | легальны | законны
prazeodym - празеадым m
pretensjonalny - прэтэнцыёзны
prezerwatywa - прэзерватыў m
prezes - прэзідэнт m
prezydent - прэзідэнт m
prima aprilis - Дзень дурня m
próba - рэпетыцыя f | спроба f | выпрабаванне n | праверка f | проба f
proces - працэс
prócz - апроч
produkt krajowy brutto - валавы ўнутраны прадукт m
profesor - прафесар m
program - праграма f
programista - праграміст m
promet - праметый m
prosić - прасіць
prostoduszność - прастадушнасць f
prostoduszny - прастадушны
prosto z mostu - проста з моста
prosty - просты | роўны | лёгкі | нескладаны | звычайны | неадукаваны | прастадушны | нявопытны
prostytucja - прастытуцыя f
prostytutka - прастытутка f
proszę - калі ласка | прашу
protagonista - пратаганіст m
protaktyn - пратактыній m
protekcjonizm - пратэкцыянізм m
protest - пратэст m
protestancki - пратэстанцкі
protestant - пратэстант m
protestantka - пратэстантка f
protestantyzm - пратэстанцтва n | пратэстантызм m
protestować - пратэставаць
protokół - пратакол m
protozoologia - протазаалогія f
prowansalski - Правансальскай | Правансальская
pruski - прускі
prymatologia - прыматалогія f
prymitywny - прымітыўны
pryncypialny - прынцыповы
prywaciarz - прыватнік m
prywatnie - прыватна
prywatny - прыватны | асабісты
prywatyzacja - прыватызацыя f
przać - кахаць | любіць
przebytek - кватэра f
przechadzka - прагулка f | шпацыр m
przeciwpożarowy - проціпажарны | супрацьпажарны
przeczytać - прачытаць
przed - перад | да | ад
przede - перад | да | ад
przedostatni - перадапошні
przedszkole - дзіцячы сад m
przedwczoraj - пазаўчора
przemysł - прамысловасць f | індустрыя f
przemysłowy - ﻿прамысловы | індустрыяльны
przemytniczka - кантрабандыстка f
przemytnik - кантрабандыст m
przepraszam - прабачце | даруйце | выбачайце
przestępca - злачынец m
przestępczość - злачыннасць f
przestępczy - злачынны
przestępstwo - злачынства n
przeważność - адвага f
przoć - кахаць | любіць
przodek - продак m
przyimek - прыназоўнік
przyjaciel - сябар m | сябра m
przyjacielski - сяброўскі | прыяцельскі
przyjebać - ударыць
przyjemność - прыемнасць f
przyjemny - прыемны
przyjść - прыйсці
przymiotnik - прыметнік m
przynęta - прынада f
przyroda - прырода f | натура f
przyrodniczy - прыродны
przysłówek - прыслоўе n
przyszłość - будучыня m | будучае n
przyszły - будучы
przytośtać - прыйсці
przytulić - абняць
psi - псі | сабачы
psisko - сабака (sabaka)
psor - прафесар m
psychiatra - псіхіятр m
psychiatria - псіхіятрыя f
psychiczny - псіхічны
psychika - псіхіка f
psycholog - псіхолаг m
psychologia - псіхалогія f
psychologiczny - псіхалагічны
psychopata - псіхапат m
psychopatyczny - псіхапатычны
psychoza - псіхоз m | псіхоз
publicystyka - публіцыстыка f
pukać - страляць
puklaty - гарбаты
pulmonolog - пульманолаг m | пульманолаг f
pulmonologia - пульманалогія f
pulyr - п'яніца
punktualność - пунктуальнасць f
punktualny - пунктуальны
purpurowy - пурпурны
purysta - пурыст m
purytański - пурытанскі
pustynia - пустыня f
puszka - піва n
putnia - вядро n
puzonista - трамбаніст m
puzonistka - трамбаністка f
pyrrusowe zwycięstwo - пірава перамога f
r. - г.
raciądz - рыцар m
racjonalista - рацыяналіст m
racjonalistka - рацыяналістка f
rad - радый m
radioaktywny - радыеактыўны
radocha - радасць f | задаваленне n
radon - радон m
radość - радасць f | задаваленне n
radziecki - савецкі
Rajch - Нямеччына f | Германія f | немцы
rajza - падарожжа n | экскурсія f
Rak - Рак (Rak)
rakuski - аўстрыйскі
ramię - плячо n
rana - рана f
ranek - рана | раніца f
rano - рана | раніца f
rasa - раса f
rasizm - расізм m
razdziawa - варона
razem - разам
reakcjonista - рэакцыянер m
realistka - рэалістка f
ręce do góry - рукі ўверх!
referendum - рэферэндум m
ręka - рука f
religia - рэлігія f
relikwia - рэліквія f
ren - рэній m
Ren - Рэйн m
rencista - пенсіянер m
rentowny - рэнтабельны
repatriacja - рэпатрыяцыя f
reporter - рэпарцёр m
Republika Południowej Afryki - Паўднёва-Афрыканская Рэспубліка f
Republika Słowacka - Славацкая Рэспубліка
reumatyczny - рэўматычны
reumatyzm - рэўматызм m
rewolucja - рэвалюцыя f
rewolucja październikowa - Кастрычніцкая рэвалюцыя f
rho - ро
RNA - РНК f
ro - ро
robić - рабіць | займацца
robić dobrą minę do złej gry - рабіць вясёлую міну пры дрэннай гульні
robić z igły widły - рабіць з мухі слана
robić z muchy słonia - рабіць з мухі слана
robieniec - работнік m
robota nie zając, nie ucieknie - работа ня воўк, у лес ні ўцячэ
robotnik - работнік m
rod - родый m
rodzic - бацькі
rodzina - сям'я f
roentgen - рэнтгеній m
rok - год m
rokoko - ракако n
rok świetlny - светлавы год m
rolnictwo - земляробства n | сельская гаспадарка f
romantyzm - рамантызм m
ropień - абсцэс
ropowica - флегмона f
róść - павялічвацца | расці | даспяваць
Rosjanin - рускі m (człowiek narodowości rosyjskiej) | расіянін m (obywatel Rosji)
Rosjanka - расіянка f | руская f
roślina - расліна f
roślinność - расліннасць f
rosnąć - павялічвацца | расці | даспяваць
rosyjski - расійскі | рускі
rowerowy - веласіпедны | роварны
rówieśniczka - равесніца f
rówieśnik - равеснік m
równanie - раўнанне n
również - таксама
równik - экватар m
równina - раўніна
równość - роўнасць f
równoważny - эквівалентны
różny - розны
różowy - ружовы
rozpustnik - распуснік m
rozrzutny - марнатраўны
rozsądny - дыпламатычны
roztomaity - розны
rozum - розум m
rozumieć - разумець
rozumny - разумны
rtęć - ртуць f
rubel - рубель m
rubid - рубідый m
ruchome schody - эскалатар m
ruczaj - ручай m
rudny - чырвоны | камуніст m
rufa - ягадзіца f
rugby - рэгбі n
Rumun - румын m
Rumunia - Румынія
Rumunka - румынка f
rumuński - румынскі | румынская мова f
rusofobia - русафобія f
rusyfikacja - русіфікацыя f
ruszyć głową - варушыць мазгамі
ruten - рутэній m
rutherford - рэзерфордый m
Rwanda - Руанда
Ryby - Рыбы
rycerz - рыцар m
ryma - насмарк m | катар m
rytuał - рытуал m | абрад m
rywal - супернік m
rywalizować - супернічаць
ryż - рыс m
rzadko - рэдка
rzadny - брыдкі
rzeczownik - назоўнік m
Rzeczpospolita - Рэч Паспалітая f
rzeczywisty - рачавісты | рачаісны
rzeka - рака f
rzemiosło - рамяство n
rzęsa - вейка f
rzeźbiarz - скульптар m
rzucać słowa na wiatr - кідаць словы на вецер | пускаць словы на вецер
Rzym - Рым m
sagan - галава f
saksofonista - саксафаніст m
saksofonistka - саксафаністка f
salceson - сальцісон | сальтысон | паліцэйскі m | паліцыянт m | палісмен m
samar - самарый m
Samarkanda - Самарканд m
samobójstwo - самагубства n | самазабойства n
samochód - самаход m
samochwalstwo - самахвальства n
samogon - самагон m | самагонка f
samolot - самалёт m
samotnik - самотнік m | адзінотнік m
samotny - адзін
samowar - самавар m
saper - сапёр m
sarna - казуля f
sąsiad - сусед m
satysfakcja - дуэль f
sceptycyzm - скептыцызм m
schizofrenia - шызафрэнія f
schizofreniczka - шызафрэнічка f
schizofreniczny - шызафрэнічны
schizofrenik - шызафрэнік m
schody - лесвіца f
schody ruchome - эскалатар m
schodzić na drugi plan - адыходзіць на задні план
ściana - сцяна f
ścichapęk - неспадзяваны | нечаканы | непрадбачаны
ścięgno - сухажылле n
seaborg - сіборгій m
sejsmiczny - сейсмічны
sejsmologia - сейсмалогія f
seks - секс m
seks oralny - аральны секс
seksualność - сексуальнасць f
seksualny - сексуальны
seksuologia - сексалогія f
sekunda - секунда f
selen - селен m
semantyczny - семантычны
semantyka - семантыка f
semazjologia - семасіялогія f
senność - санлівасць f
separatyzm - сепаратызм m
Serb - серб m
Serbia - Сербія f
Serbka - сербка f
serbski - сербскі
serce - сэрца n
serdce - сэрца n
serdeczny palec - безымянны палец m | пярсцец m
serwatka - сыроватка f
sesja - сесія f
Seszele - Сейшэльскія Астравы
si - гэты
siarka - сера f
siarkowy - серны
sieczeń - люты m
Siedmiogród - Сяміградзе n | Трансільванія f
siedzieć jak na szpilkach - сядзець як на іголках
sierpień - жнівень m
sikora - сініца f
silno - вельмі | дужа
silny - дужы | моцны
sinologia - сіналогія f | кітаязнаўства n
sioło - вёска f | сяло n
siostrzenica - пляменніца f
sirpień - жнівень m
skand - скандый m
skandaliczny - скандальны
skąpiec - скупянда m | скнара m
skarbonka - скарбонка f
skarga - скарга f
skaut - скаўт m
skiba - крадзеж m
skład - магазін m | крама f
sklep - магазін m | крама f
skomplikowany - складаны
Skop - Авен
Skopje - Скоп'е n
skóra - скура
Skorpion - Скарпіён
skoruśniak - рабіна f
skrepnąć - памерці
skroń - скронь f
skrupulatny - скрупулёзны
skrzypce - скрыпка f
skrzypek - скрыпач m
skrzyp polny - хвошч палявы
Śląsk - Сілезія f
slawistyka - славістыка f
śleboda - свабода f (swaboda)
śledziona - селязёнка
śleptać - плакаць
ślicznotka - красуха f
ślimak - смоўж m | слімак m
słoik - банка f
słoń - слон m
słońce - сонца
Słońce - Сонца
słowa - слова n | абяцанне
Słowacja - Славакія f
słowacki - славацкі | славацкі m
Słowaczka - славачка f
Słowak - славак m
Słowenia - Славенія (Słavienija)
Słoweniec - славенец m
Słowenka - славенка f
słoweński - славенскі | славенская мова f
Słowianin - славянін m
Słowianka - славянка f
słowiański - славянскі
słownik - слоўнік
słowo - слова n | абяцанне
słuchać - слухаць | чуць
śmiać się - смяяцца
śmiech - смех m
śmierć - смерць f
smoła - смала f
smród - сморад m | смурод m
smrodliwy - смуродны
smutniak - хлеб m
smysł - розум m
śniedny - ядомы
śnieg - снег m
sobaczy - псі | сабачы
sobaka - сабака (sabaka)
sobota - субота f
sobotni - суботні
socjalista - сацыяліст m
socjalistyczny - сацыялістычны
socjalizm - сацыялізм m
socjolog - сацыёлаг m
socjologia - сацыялогія f
socjologiczny - сацыялагічны
soczysty - сакавіты
sód - натрый m
Sodoma i Gomora - Садом і Гамора
solidarność - салідарнасць f
Somalia - Самалія f
somsiad - сусед m
Sopot - Сопат m
sosna - хвоя f | сасна f
sosnowy - сасновы
sowa - сава f
sowa śnieżna - белая сава | палярная сава f
spadkobierca - спадкаемец m
spalić za sobą mosty - спаліць свае караблі
specjalista - спецыяліст m
specjalistka - спецыялістка f
specjalność - спецыяльнасць f
spektakularny - паказны
sperma - сперма | насенне | эякулят
śpiew - спеў m
śpiewać - спяваць
spółka - таварыства n
spółka akcyjna - акцыянернае таварыства n
spółka z ograniczoną odpowiedzialnością - таварыства з абмежаванай адказнасцю n
spór - спрэчка f
sport - спорт m
sportowiec - спартовец m
sportowy - спартыўны
spotkanie - сустрэча f
spowiednia - канфесіяналь m
spowiedź - споведзь
sprawiedliwie - справядліва
sprawiedliwość - справядлівасць f
sprawiedliwy - справядлівы
sprawiedlność - справядлівасць f
sprytny - спрытны
sprzątaczka - прыбіральшчыца f
spuścić nos na kwintę - павесіць нос на квінту
srebrna - срэбны
srebrny - срэбны
srebro - серабро n
srebrzysty - серабрысты
średniowiecze - сярэднявечча n | сярэдневякоўе n
środa - серада f
środek - цэнтр m | нутро n | сярэдзіна f | мера f | сродак m
stabilność - стабільнасць f
stabilny - стабільны
stać - стаяць
stadion - стадыён
stalinista - сталініст m
stalinowiec - сталініст m
Stany - Злучаныя Штаты Амерыкі
Stany Zjednoczone Ameryki - Злучаныя Штаты Амерыкі
stara panna - старая дзева f
starek - дзядуля m
stare miasto - стары | непрыгодны | нясвежы | несапраўдны | чувак m | прэдкі | горад m | стары горад m
starka - бабуля f
starość - старасць f
starosek - дзядуля m
staroświecki - старасвецкі
staroszek - дзядуля m
starówka - стары горад m
starszy - бацька m
stary - стары | непрыгодны | нясвежы | несапраўдны | чувак m | прэдкі
starzyk - дзядуля m
statek - карабель m
staw - сустаў m
sterczeć - стаяць
stojeć - стаяць
stół - стол m
stolarz - сталяр m
stolica - сталіца
stomatologia - стаматалогія f
stomatologiczny - стаматалагічны
stopa - ступня f
stopień wyższy - вышэйшая ступень
strach - страх m
strach na wróble - страх m
strąpacz - люты m
straszny - страшны | страшэнны | жудасны
straszyć - страшыць
strażak - пажарнік m | пажарны m
straż pożarna - пажарная каманда f
streptomycyna - стрэптаміцын m
stront - стронцый m
strzec jak źrenicy oka - берагчы як зрэнку вока
strzelać - страляць
Strzelec - Стралец
stulecie - узрост m | стагоддзе n | век m
styczeń - студзень
stymulować - стымуляваць
subiektywny - суб'ектыўны
suchy - сухі
sukinsyn - сукін сын m
sumienie - сумленне n
sumienność - добрасумленнасць f
sumienny - добрасумленны | акуратны
Surinam - Сурынам m
Surja - Сур'я f
surrealista - сюррэаліст m
suwenir - сувенір m
suwerenność - суверэнітэт m
suwerenny - суверэнны
świadom - дасведчаны
świadomy - дасведчаны
świat - свет m
światło - святло n
światopogląd - светапогляд m
światowy - сусветны
świątynia - храм m
Świetlana - Святлана f
święty Marcin - сьвяты Марцін
świnia - свіння f
świt - золак | досвітак | світанак
świtanie - золак | досвітак | світанак
swoisty - своеасаблівы
swój - свой
swoje - свой
swołocz - сволач f | свалата f
syjonistyczny - сіянісцкі
symbol - сімвал m
symboliczny - сімвалічны
symbolizować - сімвалізаваць
sympatia - сімпатыя f
sympatyczny - сімпатычны
sympatyzować - сімпатызаваць
syn - сын m
synchroniczność - сінхроннасць f
synek - хлапец m | хлопец m
syn marnotrawny - блудны сын m
syntetyczny - сінтэтычны
synteza - сінтэз m
syra - нага f
system - сістэма f
system operacyjny - аперацыйная сістэма f
system plików - файлавая сістэма
syty - сыты
szac - жаніх m
szacherka - шахрайства n
szacher-macher - шахер-махер m
szachista - шахматыст m
szachraj - шахрай m
szachrajski - шахрайскі
szachrajstwo - шахрайства n
szajs - гаўно n
szary - шэры
szaszok - баязлівец m | тхор m
szczęście - задаваленне n | шчасце n | поспех m | удача m
szczur - пацук
szczyt - аргазм m
szept - шэпт m
szermierka - фехтаванне n
szkira - дзяўчына f
szkita - нага f
szklanka - шклянка f
Szkocja - Шэтландыя f
szkocki - шатландскі
szkoła - школа f
szkop - немец m
Szkot - шатландзец m
szlag - ўдар m
Szląsk - Сілезія f
szlifierka - шліфавальны станок
szlug - цыгарэта f | папяроса f (bez filtra)
szmal - грошы
szmuglerka - кантрабандыстка f
szneka - твар m
szogun - сёгун m (sjóhun)
szowinista - шавініст m
szowinistka - шавіністка f
szowinizm - шавінізм m
szpiegostwo - шпіянаж m
szpital - бальніца f
sztajmes - п'яніца
sztetl - щетъл m
Sztokholm - Стакгольм m
sztuczny - штучны | сінтэтычны
sztuka - дзяўчына f
szukać - шукаць
szukać guza - шукаць гуза на галаву | шукаць гуза на лоб
szwab - немец m
Szwabia - Швабія f
szwaja - нага f
Szwajcar - швейцарац m
Szwajcaria - Швейцарыя f
Szwajcarka - швейцарка f
szwajcarski - швейцарскі
Szwecja - Швецыя f
Szwecyjo - Швецыя f
Szwed - швед m
Szwedka - шведка f
szwedzki - шведскі
szybki - хуткі | шпаркі
szyja - шыя
szyjka macicy - шыйка маткі f
szykowny - элегантны | элеганцкі
tachykardia - тахікардыя f
tacik - бацька m | дзядуля m
Tadżykistan - Таджыкістан
Tajlandia - Таіланд m | Тайланд m
tajlandzki - тайландзкі
tajski - тайскі | тайландзкі
Tajwan - Тайвань
tajwański - тайваньскі
tak - так
tak czy owak - так ці сяк | так ці інакш | так ці іначай | так ці так
taki - такі
także - таксама
tal - талій m
tam, gdzie diabeł mówi dobranoc - у чорта на рагах | у віру на калу
tank - танк m
tantal - тантал
Tanzania - Танзанія f
tarcza - твар m
tarcza strzelecka - твар m
Tarnów - Тарнаў
tarzać się ze śmiechu - качацца са смеху
Tasmania - Тасманія f
taternictwo - альпінізм m
tchawica - трахея f
tchórz - баязлівец m | тхор m
tchórzliwy - баязлівы
te - гэты
technet - тэхнецый m
tej - ты
telewizja - тэлебачанне n
telewizyjny - тэлевізійны
tellur - тэлур m
temat - тэма f
temperatura - тэмпература f | гарачка f
tempo - тэмп m
ten - гэты
tenże - гэты
teologia - тэалогія f
teologiczny - тэалагічны
terapeuta - тэрапеўт m
terapeutyczny - тэрапеўтычны
terapia - тэрапія f
teraz - цяпер
terb - тэрбій m
teriologiczny - тэрыялагічны
terminologia - тэрміналогія f
terminologiczny - тэрміналагічны
terrorysta - тэрарыст m
terrorystka - тэрарыстка f
terytorium - тэрыторыя f
tęsknić - сумаваць
teszarz - сталяр m
tętnica - артэрыя f
tetum - тэтум
też - таксама
tkanka - тканка f
tlen - кісларод m
tobie - ты
Togo - Тога
tolerancja - талерантнасць f
tor - торый m
torpeda - тарпеда f
tory - торый m
tost - тост m
totalitarny - таталітарны
totalitaryzm - таталітарызм m
towarzyski - таварыскі
towarzystwo - таварыства n
towarzysz - таварыш m
tradycja - традыцыя f
tradycjonalistka - традыцыяналістка f
tradycjonalistyczny - традыцыяналісцкі
tradycyjnie - традыцыйна
tradycyjny - традыцыйны
tragicznie - трагічна
tragikomedia - трагікамедыя f
trambimba - трамвай m
tramwaj - трамвай m
tramwajka - трамвай m
transmisja - трансляцыя
transporter opancerzony - бронетранспарцёр m
trawienie - страваванне n
trebusz - трыбук m
trochę - крыху | крышачку | трохі | чуць
trockista - трацкіст m
tróhła - труна f | дамавіна f
trolejbus - тралейбус
trumna - труна f | дамавіна f
truskawka - трускаўка f
trwoga - трывога f
Trynidad i Tobago - Трынідад і Табага
trzęsienie ziemi - землетрасенне
trzustka - падстраўнікавая залоза f
trzymać - трымаць
trzymać język za zębami - трымаць язык за зубамі
trzymać kciuki - трымаць кулакі
trzymać rękę na pulsie - трымаць руку на пульсе
tsunami - цунамі (tsunámi) f
tuberkuloza - туберкулёз m
tudzież - и
tul - тулій m
tu leży pies pogrzebany - вось дзе сабака закапаны
tunel - тунэль m | падземны ход m
Tunezja - Туніс m
tungsten - вальфрам m
Turcja - Турцыя
Turczynka - турчанка f
turecki - турэцкі | турэцкая мова f
Turek - турак m
Turkmen - туркмен m
turysta - турыст m
turystka - турыстка f
twarz - твар m
twórczość - творчасць
ty - ты
tydzień - тыдзень m
tyfus - тыф m
tygr - тыгр m
tygrys - тыгр m
tyle, co kot napłakał - як кот наплакаў
tylko - толькі
tysiąclecie - тысячагоддзе n
tytan - тытан m
tytanowy - тытанавы
tzn. - г.зн.
ubranie - вопратка f | адзенне n | адзежа f
ucho - вуха n
uchodźca - уцякач m
uczennica - вучаніца f
uderzyć - ударыць
ufny - даверлівы
Uganda - Уганда
układ - сістэма f | дагавор m | пагадненне n | дамова f
układ krwionośny - крывяносная сістэма f
układ okresowy pierwiastków - перыяды́чная сістэ́ма хімі́чных элеме́нтаў
Układ Słoneczny - Сонечная сістэма f
Ukraina - Украіна f
Ukrainiec - украінец m
ukrainizm - украінізм m
Ukrainka - украінка f
ulica - вуліца f
ultramaryna - ультрамарын m
ulubiony - любімы
umieć - умець
umierać - паміраць | уміраць
umierać ze śmiechu - паміраць са смеху | паміраць з рогату | уміраць са смеху | уміраць з рогату
umowa - умова f | дагавор m
umrzeć - памерці
umrzeć pod nożem - памерці пад нажом
Unia Europejska - Еўрапейскі Саюз
uniwerek - універсітэт
uniwersytet - універсітэт
ununhexium - унунгексій m
ununoctium - унуноктый m
ununpentium - унунпентый m
ununquadium - унунквадый n
ununseptium - унунсептый m
ununtrium - унунтрый m
uón - ён
upał - гарачыня f | спёка f
uparty - упарты
upiec dwie pieczenie na jednym ogniu - адным ударам двух зайцоў забіць
upór - ўпартасць f
uporczywy - упарты
uprawiać - займацца
urlopowicz - адпачывальнік m
Urugwaj - Уругвай m
urzędnik - служачы m
usta - вусны
uzasadniać - апраўдваць
uzbecki - узбекскі | узбекская мова m
Uzbekistan - Узбекістан m
w. - ст.
wacha - дождж m | варта f | мора n | вада (wada)
wąchać - нюхаць
Waga - Шалі
wakacje - канікулы
wakacyjny - канікулярны
Walia - Уэльс m
waliza - чамадан m
walizka - чамадан m
walka - барацьба f
wanad - ванадый m
Wandal - вандал m
wandalizm - вандалізм m
wanta - ванта f
wapń - кальцый m
wapniak - бацькі
waran - варан m
Warszawa - Варшава
warszawski - варшаўскі
warta - варта f
wątroba - печань f
Watykan - Ватыкан (Vatykan)
ważny - важны | значны | сапраўдны
wcześnie - рана | раней
wcześniej - рана | раней
wczoraj - учора
wczorajszy - учарашні
wdzięczność - ўдзячнасць f
wdzięczny - ўдзячны
węborek - вядро n
wegetarianin - вегетарыянец m
wegetarianizm - вегетарыянства n
węgiel brunatny - буры вугаль m
węgiel kamienny - каменны вугаль m
Węgier - венгерац m
Węgierka - венгерка f
węgierski - венгерскі | венгерская мова f
Węgry - Венгрыя
wena - натхненне
Wenecja - Венецыя f
wenecjanin - венецыянец m
wenecjanka - венецыянка f
wenecki - венецыянскі | венецыянскі m
Wenezuela - Венесуэла f
Wenezuelczyk - венесуэлец m
Wenezuelka - венесуэлка f
wenezuelski - венесуэльскі
wentroba - печань f
wesoło - весела
wesoły - вясёлы
Wesołych Świąt - з Калядамі | з Нараджэннем
Westa - Веста f
wezwanie - назва f | названне n | найменне n | імя n
wezyr - візір | везір
wiadro - вядро n
wiatr - вецер m
wiązać koniec z końcem - звесці канец з канцамі | звесці канцы з канцамі
wieczny - спрадвечны
wieczór - вечар m
Wiedeń - Вена f
wiek - узрост m | стагоддзе n | век m
wiek emerytalny - пенсійны ўзрост
większość - большасць f
wielbłąd - вярблюд m
Wielka Brytania - Вялікабрытанія f
Wielkanoc - Вялікдзень (Vjalikdzjenʹ) m | Пасха (Pascha) f
wielkomocarstwowy - вялікадзяржаўны
wielkorosyjski - вялікарускі | вялікарасейскі
wielkoruski - вялікарускі | вялікарасейскі
wielkość - велічыня f
wielokrotny - шматразовы
wieś - вёска f | сяло n
wietnamski - в'етнамскі
wietrzny - ветраны
wiewiórka - вавёрка f
wieża - вежа f | ладдзя f | музычны цэнтр m
Wikipedia - Вікіпедыя
Wikisłownik - Вікіслоўнік (Vikisłoŭnik)
wiktoria - перамога f
Wileńszczyzna - Віленшчына
wilgoć - вільгаць f
wilgotność - вільготнасць f
wilgotny - вільготны
wilk - воўк m
wilk morski - марскі воўк m
wilk syty i owca cała - і каза цэлая, і воўк сыты | воўк сыты й козы цэлы
wilk w owczej skórze - воўк у авечай шкуры m
willa - віла f | дача f
Wilno - Вільня f | Вільнюс
w imię - дзеля
wiolonczela - віяланчэль f
wiolonczelista - віяланчэліст m
wiolonczelistka - віяланчэлістка f
wiosenny - вясновы
wioska - вёска f | сяло n
wiosło - вясло n
wiosna - вясна f
wirusologia - вірусалогія f
Wisła - Вісла
witraż - стъклопис
wiza - віза f
wizyta - візіт m
w końcu - нарэшце
władza - улада f | кіраванне n | панаванне n
władze - кіраўніцтва n
Włoch - італьянец m
Włochy - Італія f
włos - волас m
włoski - італьянскі
Włoszka - італьянка f
wnęta - прынада f
wnioskodawca - аўтар прапановы m
wobec - перад | у дачыненні да
woda - вада (wada)
wóda - гарэлка | водка
wódka - гарэлка | водка
wodniczka - чарацянка вяртлявая f
Wodnik - Вадалей
wodny - водны
wodór - вадарод m
wodospad - вадаспад m
wodzić za nos - вадзіць за нос
wojak - салдат m | жаўнер m | баец m | ваеннаслужачы m | воін m
wojaż - падарожжа n
wojna - вайна f
wojna domowa - грамадзянская вайна f
wojskowy - салдат m | жаўнер m | баец m | ваеннаслужачы m | воін m
wokabularz - слоўнік
wół - вол m
wolfram - вальфрам m
wolność - свабода f (swaboda)
wolność słowa - свабода слова f
wolny - свабодны
wolny rynek - свабодны рынак m
Wołoszczyzna - Валахія f
woniączka - гарэлка | водка
wosk - воск m
wreszcie - нарэшце
wróg - вораг m
wrogi - варожы
wrogość - варожасць f
wrona - варона
wrzesień - верасень m
wrzód - язва
Wschód - Блізкі Усход m
wschodni - усходні
wschodniosłowiański - ўсходнеславянскі
wścieklizna - вадабоязь f
wskazywać - указваць
wspólnie - разам
Wspólnota Niepodległych Państw - Садружнасць Незалежных Дзяржаў
wstępny - уступны
wszechstronnie - усебакова
wszechstronny - рознабаковы | усебаковы
wszeteczeństwo - вшетеченство n
wtorek - аўторак
wtorkowy - аўторкавы
wulkan - вулкан m
wy - вы
wyborca - выбаршчык m
wyborczy - выбарчы
wybory - выбары
wybrzeże - узбярэжжа n
Wybrzeże kość Kości Słoniowej - Кот-д'Івуар
wycieczka - экскурсія f
wydawnictwo - выдавецтва n | публікацыя f
wydma - дзюна f
wyglądać - выглядаць
wyjątek - выключэнне n
wyjść - выйсці
wykusz - эркер | ганак m
wyraz - слова n | абяцанне
wyrzucać pieniądze przez okno - выкідаць грошы на вецер
wyrzucać pieniądze w błoto - выкідаць грошы на вецер
wyskoczyć jak filip z konopi - выскачыць як піліп з канапель | выскачыць як заяц з крапівы | выскачыць як чорт з балота
wysoki - высокі
wyspa - востраў m
Wyspa Świętego Wyspy Świętego Tomasza i Wyspa Książęca - Сан-Тамэ і Прынсіпі
Wyspy Kanaryjskie - Канарскі архіпэляг
wyznanie - канфесія f
-yzm - -ізм
z - з
ząb - зуб m
zabijać - забіць
zachód - закат m | захад m | захады | намаганне
zachodni - заходні
zachód słońca - захад сонца m
zachowanie - паводзіны
zacięty - упарты
zacząć - пачаць | стаць | пачацца
zaczynać - пачынаць | брацца | пачынацца | распачынацца
zadowolenie - задавальненне n
żagiel - парус m | ва́тразь m
zaimek - займеннік m
zając - заяц m
zajebać - ударыць
zajmować - займацца
zakazany owoc - забаронены плод
zakażenie - інфекцыя f
żako - жако | шэры папугай m
żal - гора
zalany - п'яны | п'яны m
założyciel - заснавальнік m
Zambia - Замбія
zamek - замак m | замок f | засцежка m | замок
zamkowy - замкавы
Zamość - Замасьць | Замошч
zapad - закат m | захад m | захады | намаганне
zapalenie - запаленне
zapalenie płuc - пнеўманія | taraszkiewica пнэўманія
zapierdolić - ударыць
zaprzaństwo - здрада f
zaraza - эпідэмія f
zarozumiałość - ганарлівасць f
zarozumiały - самаўпэўнены
zaś - зноў | ізноў
zasnąć - засинати
zatoka - заліў m
Zatoka Fińska - Фінскі заліў m
Zatoka Perska - Персідскі заліў m
zatrudnianie - працаўладкаванне
zawracać głowę - круціць галаву
zawsze - заўсёды
zawżdy - заўсёды
za żadne skarby świata - ні за якія грошы
zbór - збор
z całego serca - ад усяго сэрца
zdać - здаць
żdać - чакаць
zdrada - здрада f
zdradzać - здраджваць
zdradzić - здрадзіць
zdradziecki - здрадніцкі
zdrowie - здароўе n
zdrowy - здаровы | здароў
ździebluchno - крыху | крышачку | трохі | чуць
ze - з
żeby - каб
żec - гарэць | паліцца
żelazny - жалезны
zemrzeć - паміраць | уміраць
żeńczyna - жанчына f
zepsuć - знішчыць | спусташыць | сапсаваць | зламаць | пашкодзіць
zespół - калектыў m | група f | ансамбль m | гурт m | гурток m | сіндром
zeszyt - сшытак m
zez - з
żgać - джгаць | калоць
zgraja - банда f
zielona herbata - зялёны чай
zielonawy - зеленаваты | зеленкаваты | зелянявы
zielonkawy - зеленаваты | зеленкаваты | зелянявы
zielony - зялёны
ziemia - зямля
Ziemia Święta - Святая зямля f
zima - зіма f
Zimbabwe - Зімбабвэ f
zimna wojna - халодная вайна f
zimno - холад m (holad)
zista - бабуля f
Zjednoczone Emiraty Arabskie - Аб'яднаныя Арабскія Эміраты
Zjednoczone Królestwo - Злучанае Каралеўства n
źle - дрэнна
złocić - залаціць
złodziej - злодзей m
złodziejstwo - зладзейства n | крадзеж m
złoto - золата n
złotówka - залаты
złoty - залаты
zmiana - змяненне
zmyć głowę - змыць галаву
znajdować - знайсці | знаходзіцца | размяшчацца
znaleźć - знайсці
znienacka - знянацку | нечакана | неспадзявана | знячэўку | раптоўна
znów - зноў | ізноў
znowu - зноў | ізноў
żołądek - страўнік m
żółć - жоўты
żołnierz - салдат m | жаўнер m | баец m | ваеннаслужачы m | воін m
żółtodziób - жаўтаротае птушанё n | жаўтаротае птушаня n
żółty - жоўты
żona - жонка f
zoo - заапарк m
zoolog - заалагічны парк m
zoologia - заалогія f
zoologiczny - заалагічны
zooplankton - зоапланктон m
zręczny - спрытны
z ręką na sercu - палажыўшы руку на сэрца
źrenica - зрэнка f | вока n (woka)
źródłosłów - этымалогія f
zrozumiały - зразумелы
zrozumieć - зразумець
źrzały - сталы
żubr - зубр m
żul - п'яніца
zupa - суп m
żur - жур
żurnalista - журналіст m
związek chemiczny - хімічнае злучэнне n
Związek Radziecki - Савецкі Саюз m
Związek Socjalistycznych Republik Radzieckich - Саюз Савецкіх Сацыялістычных Рэспублік
związek zawodowy - прафесійны саюз m | прафсаюз m
zwiększyć - павялічыць
zwierzak - жывёла f | звер m | жывёліна f
zwierzę - жывёла f | звер m | жывёліна f
zwiesić nos na kwintę - павесіць нос на квінту
zwinny - спрытны
zwolennik - сябар m
zwrotnik - тропік m
zwycięstwo - перамога f
z wyjątkiem - апроч
z wyłączeniem - апроч
żyć - жыць
życie - жыццё n
życiorys - жыццяпіс m
żyć jak pączek w maśle - плаваць як сыр у масле
żyć jak pies z kotem - жыць як кот з сабакам | жыць як кошка з сабакам
żyd - скупянда m | скнара m
żydaczowski - жыдачаўскі
żydożerstwo - антысемітызм m
Zyga - Жыгімонт m
Zygmunt - Жыгімонт m
żyła - вена f
żyrandol - жырандоль
żywe srebro - жывое серабро n | ртуць f
żywić - есці
żywica - смала f
