AA - AA (Anonim Alkoholisták)
Aaron - Áron
abat - apát
abażur - lámpaernyő
Abchaz - abház
Abchazja - Abházia
Abdon - Abdon
abdykacja - feladás, lemondás
abdykować - lemond
abecadło - betűrend, ábécé
abfal - hiba, anomália
Abidżan - Abidjan
abiecadło - betűrend, ábécé
ablutomania - mosakodási kényszer
abonament - előfizetés, bérlet
abonent - előfizető
aborcja - abortusz
Abraham - Ábrahám
Abruzja - Abruzzo
ABS - ABS
absolutyzm - abszolutizmus
absolwent - végzős
absorpcja - abszorpció
abstynencja - absztinencia
abstynent - antialkoholista
acetaldehyd - acetaldehid
Achilles - Akhilleusz m
Adam - Ádám m
adamaszek - damaszt
adapter - lemezjátszó
Adelajda - Adelaida
administrator - adminisztrátor, ügyintéző
Adonis - Adónisz
adopcja - örökbefogadás
adrenalina - adrenalin
adresat - címzett
adwokat - ügyvéd
aerodrom - repülőtér
aeroplan - repülő, repülőgép
afa - majom
afelzina - narancs
Afganistan - Afganisztán
afrykanerski - afrikaans
agawa - agáve
Agnieszka - Ágnes, Ági
agonia - agónia
agresja - agresszió
agrest - egres
agresywny - agresszív
agronom - agronómus
aikido - aikidó
ajmer - vödör
ajzynbaniok - vasutas
akacja - akác
akcent - hangsúly, ékezet
akordeon - harmonika
akrobata - akrobata
aksamit - bársony
aktor - színész
aktorka - színésznő
aktyn - aktínium
akupresura - akupresszúra
akupunktura - akupunktúra
akuratnie - alaposan
akuratny - alapos
akuszer - szülész
akuszerka - szülésznő, bába
akwarela - akvarell
akwarium - akvárium
alabaster - alabástrom
Albańczyk - albán
Albania - Albánia
albański - albán
albatros - albatrosz
Albin - Albin
albinos - albínó
Aldebaran - Aldebaran
aldehyd octowy - acetaldehid
ale - de
aleja - fasor
Aleksander - Sándor
alergia - allergia
alergiczny - allergiás
alergologia - allergológia
alfabet - betűrend, ábécé
alfabetu - betűrend, ábécé
Alfred - Alfréd
algebra - algebra
algebraiczny - algebrai
Algieria - Algéria
algorytm - algoritmus
Alicja - Aliz
aligator - alligátor
Alina - Alina
alka - alka
alka zwyczajna - alka
alkoholik - alkoholista
alkoholizm - alkoholizmus
alkoholowy - alkoholos
Allach - Allah
Allah - Allah
allel - allelomorfikus gén
allopurinol - allopurinol
almanach - naptár
Alojz - Alajos
Alojzy - Alajos
alpinista - hegymászó
Alpy - Alpok
altruista - altruista
altruizm - altruizmus, önzetlenség
aluminium - alumínium
Amadeusz - Amadeusz
amajza - hangya
amator - amatőr
Amazonka - Amazonas
ambasada - nagykövetség
ambicja - becsvágy
ambitny - becsvágyó
ambulans - mentőautó
ambulatoryjny - ambuláns
ameba - amőba
ameryk - amerícium
amerykański - amerikai
Ameryka Północna - Észak-Amerika
Ameryka Południowa - Dél-Amerika
Ameryka Środkowa - Közép-Amerika
amfa - amfetamin
amfetamina - amfetamin
amfiteatr - amfiteátrum
Amman - Ammán
amnestia - amnesztia
amnestyja - amnesztia
amoniak - ammónia
Amos - Ámos
amper - amper
amperomierz - árammérő
ampułka - ampulle
amputacja - amputáció
Amu-daria - Amu-darja
anachronizm - anakronizmus
analiza - analízis, elemzés
ananas - ananász
anarchia - anarchia
anarchizm - anarchizmus
Anastazja - Anasztázia
Anastazy - Anasztáz
Anatol - Anatol
anatomia - anatómia
andaluzyjski - andalúziai
andragogika - andragógia
Andrea - Andrea
Andromeda - Androméda
Andrzej - András
Andy - Andok
anegdota - adoma, anekdota
anekdota - adoma, anekdota
anemia - vérszegénység
anestezjolog - altatóorvos, aneszteziológus
Aneta - Anetta
anewryzm - körülírt értágulat
Angelika - Angyalka, Angelika
angielski - angol
angiografia - érábrázolás
Anglia - Anglia, Angolország
Anglija - Anglia, Angolország
angol - angol
angryst - egres
Ania - Ancsa
Aniela - Angéla
anioł - angyal
anion - anion
Anita - Anita
aniżeli - mint
anjoł - angyal
Ankara - Ankara
ankieta - ankét
Anna - Anna
Annamaria - Annamária f
anoda - anód
anodowanie - eloxálás
anodyzacja - eloxálás
anomalia - anomália
anonimowy - névtelen
anons - hirdetés, hirdetmény
anoreksja - anorexia
antagonista - antagonista
Antananarywa - Antananarivo
Antares - Antares
Antarktyda - Antarktisz
Antigua i Barbuda - Antigua és Barbuda
Antoni - Antol
antonim - antonima
antrejka - folyosó
antropologia - antropológia
antybakteryjny - baktériumellenes
antybiogram - antibiogramm
antybiotyk - antibiotikum
antyczny - antik
antyfaszysta - antifasiszta
antygen - antigén
antykoagulant - alvadásgátló szer
Antyle Holenderskie - Holland Antillák
antylopa - antilop
antymon - antimon
antypatia - ellenszenv
antyrasizm - fajgyűlölet-ellenesség
antysemityzm - antiszemitizmus
antyseptyczny - antiszeptikus
anyż - ánizs
anyżek - ánizs
aorta - aorta
aparat rentgenowski - röntgenkészülék
apasz - bűnöző
apatia - apátia
Apeniny - Appenninek
aperitif - aperitif
apetyt - apetítus, étvágy
apetyt rośnie w miarę jedzenia - evés közben jön meg az étvágy
aplikator - applikátor
aplikować - bead
apluzyna - narancs
Apolinary - Apollinár
apostrof - aposztróf
aprobata - jóváhagyás
aprykoza - sárgabarack
apryl - április
aptek - gyógyszertár
apteka - gyógyszertár
aptekarz - gyógyszerész
Arab - arab
Arabia Saudyjska - Szaúd-Arábia
arabus - arab
Aragonia - Aragónia
arbuz - dinnye
archanioł - arkangyal
archeolog - archeológus
archeologia - archeológia, régészet
architekt - építész
arfa - hárfa
Argentyna - Argentína
Argentyńczyk - argentin
Argentynka - argentin
argentyński - argentin
argon - argon
arka Noego - Noé bárkája
armata - ágyú
armia - hadsereg, honvédség, had, sereg
armijo - hadsereg, honvédség, had, sereg
aromaterapia - aromaterápia
arsen - arzén
artefakt - mütermék
artykuł - cikk,szócikk
artysta - művész
Aruba - Aruba
arytmia - szívritmuszavar, aritmia
asceta - aszkéta
aseksualny - aszexuális
asfalt - aszfalt
asfaltowy - bitumenes
aspiryna - aszpirin
asta - ág
astat - asztácium
astma - asztma
astrofizyka - asztrofizika
astrolog - asztrológus, csillagjós
astrologia - asztrológia, csillagjóslás
astrologio - asztrológia, csillagjóslás
astronomia - asztronómia, csillagászat
astronomio - asztronómia, csillagászat
asygnata - bankjegy
Asyria - Asszíria
asza - hamu
atak - roham
ateista - ateista m
ateizm - ateizmus
Ateny - Athén
ateusz - ateista m
Atlantyk - Atlanti-óceán
atlas - atlasz
atmosfera - atmoszféra, légkör
atom - atom
atu - adu
atut - adu
Augiasz - Augeiasz
August - Ágost
aukcja holenderska - holland árverés
Australia - Ausztrália
Australijczyk - ausztrál
Australijka - ausztrál
australijski - ausztrál
Austria - Ausztria
Austro-Węgry - Osztrák–Magyar Monarchia
autentyczny - autentikus
auto - autó
autobana - autópálya
autobus - busz, autóbusz
autograf - autogram
autoklaw - autokláv
autonomia - autonómia
autostrada - autópálya
autyzm - autizmus
awaria - üzemzavar
awatar - avatára
awokado - avokádó
Azerbejdżan - Azerbajdzsán
Azja - Ázsia
Azja Mniejsza - Kis-Ázsia
Azjata - ázsiai
Azjatka - ázsiai
azjatycki - ázsiai
azot - nitrogén
babcia - nagymama
babka - nagymama
baca - bácsi
Badenia-Wirtembergia - Baden-Württemberg
badyl - gaz
Bagdad - Bagdad
Bahamy - Bahama-szigetek
bajzel - rendetlenség, rumli, bordély
bąk - dongó
bakałarz - tanár
bakcyl - bacilus
bakteria - baktérium
bakteriobójczy - csíraölő
bakteriolog - bakteriológus
bakteryjny - bakteriális
bal - bál
bala - labda
bałagan - rendetlenség, rumli
balet - balett
bałkański - balkáni
Bałkany - Balkán
balkon - balkon
ballada - ballada
bal maskowy - álarcosbál
balsam - balzsam
balsamiczny - balzsamos
Bałtyk - Balti-tenger
bałwan - hóember, bálvány
bambus - bambusz
bana - vonat, villamos
banan - banán
banana - banán
banda - banda
bandaż - védőkötés
bandzioch - has
Bangladesz - Banglades
bania - fej
baniaczek - kalap
baniak - fej
baniok - vasutas
baniorz - vasutas
bank - bank
banka - villamos
bańka - kanna
bank krwi - vérbank
banknot - bankjegy
bankomat - bankautomata, bankjegykiadó automata
bank spermy - spermabank
bar - bárium
barabola - burgonya
baran - bárány
Baran - Kos
baranina - bárányhús
Barbados - Barbados
bardzo - nagyon
bark - váll
barki - váll
barokowy - barokk
barometr - barométer
barszcz - borscs
Bartłomiej - Bertalan
barwa - szín
barykada - barikád
barzej - nagyon
bas - basszus, basszista, has
Bask - baszk
baszta - bástya
batłąch - üvegpalack, palack
Bawarka - bajor
bawół - bivaly
baza - alap
bazalt - bazalt
bażant - fácán
bazar - bazár
Bazylea - Bázel
bazylia - bazsalikom
bebech - has, gyomor
bęben - has
beczeć - sír
beczka - hordó
bedki - gomba
befsztyk - bifsztek
Bejrut - Bejrút
belfer - tanár
Belgia - Belgium
belgijski - belga
Belize - Belize
Belmopan - Belmopan
Beniamin - Benjámin
Benin - Benin
benzyna - benzin
berbela - pálinka
Bergamo - Bergamo
berkel - berkélium
Berlin - Berlin
Berlin Zachodni - Nyugat-Berlin
Bermudy - Bermuda
Berta - Berta
beryl - berillium
Betlejem - Betlehem
beton - beton
bety - pizsama
beza - habcsók
bezdech - légzésleállás
bezgorączkowy - láztalan
bezlistny - levéltelen, lombtalan
bezmocz - vizeletelapadás
bezosobowy - személytelen
bez pracy nie ma kołaczy - aki nem dolgozik, ne is egyék
bez pracy nie ma płacy - aki nem dolgozik, ne is egyék
bezwarunkowo - feltétlenül
białaczka - leukémia
białko - fehérje
Białoruś - Fehéroroszország, Belorusszia, Belarusz
białoruski - fehérorosz
biały - fehér
Bianka - Bianka
biber - kalap
Biblia - Biblia
biblioteka - könyvtár
bibliotekarz - könyvtáros
biedronka - katicabogár
biegacz - futó
biegunka - hasmenés
bierne palenie - passzív dohányzás
biglosko - vasaló
bikini - bikini
bikorn - bölény
bilet - jegy
bimba - villamos
bindasz - hímvessző
binder - nyakkendő
bindka - nyakkendő, védőkötés
biografia - biográfia, életrajz
biograficzny - életrajzi
biolog - biológus
biologia - biológia
biseksualizm - biszexualitás
biskup - püspök
bitwa - csata
biurko - íróasztal
biuro podróży - utazási irodában
bizmut - bizmut
bizon - bölény
blacha - bádog
błąd - hiba
błecha - bolha
bliski - közeli
blizna - forradás, sebhely
Bliźnięta - Ikrek
bliźnięta syjamskie - sziámi ikrek
błona dziewicza - szűzhártya
błona śluzowa - nyálkahártya
blumkol - karfiol
bluza - blúz
bo - mert
boba - sapka
bóbr - hód
bocian - gólya
bodziec - inger
Bóg - Isten
Bóg pomaga tym, co sami sobie pomagają - segíts magadon, s az Isten is megsegít
Bohemia - Csehország, Bohémia f
boja - bója
bojler - bojler
bojtel - kiszögellés
boks - ökölvívás, boksz
ból - kín
Boliwia - Bolívia
bomba - bomba
bomba atomowa - atombomba
bonsai - bonszai
bor - bór
borowina - iszap
borówka - bogyó, arc, arculütés
borsuk - borz
Bośnia i Hercegowina - Bosznia és Hercegovina
Bośniak - bosnyák
botanik - botanikus
botanika - botanika
boża krówka - katicabogár
boźdór - kisfiú
brachol - fivér, fiútestvér
bracieniec - fivér, fiútestvér
brak miesiączki - periódus kimaradása
brat - fivér, fiútestvér
bratanek - unokaöcs
bratek - árvácska
Bratysława - Pozsony
brąz - bronz
brązowy - barna
Brazylia - Brazília
brele - szemüveg
brew - szemöldök
brifkastla - postaláda
briftreger - postás
brodawka sutkowa - mellbimbó
brokuł - brokkoli
brom - bróm
broń - fegyver
browar - sör
brudny - piszkos, mocskos, koszos
Brunei - Brunei
brunet - barna
brydż - bridzs
bryka - autó
bryle - szemüveg
brytyjski - brit
brzmienie - hang
brzoskwinia - őszibarack
brzoza - nyírfa
brzuch - has
brzydki - csúnya, ronda
buda - iskola
Budapeszt - Budapest
buddyzm - buddhizmus
budowla - építmény
budyń - puding
budynek - épület
budzik - vekker
buła - izom
bulba - burgonya
Bułgar - bolgár
Bułgaria - Bulgária
Bułgarka - bolgár
bułgarski - bolgár
bulić - fizet
bulimia - étkezési hányinger
bułka - izom
bulwa - burgonya
burak - répa
burdel - bordély
Burkina Faso - Burkina Faso
burza mózgów - ötletgyűjtés
burzowiny - sör
but - cipő
butelka - üvegpalack, palack
butersznyt - szendvics
butik - butik
być - lenni
byk - bika
Byk - Bika
Była Jugosłowiańska Republika Macedonii - Macedónia Volt Jugoszláv Köztársaság
bzybzać - vág, lop
Caracas - Caracas
cebula - hagyma
cedi - cedi
cegła - tégla
cel uświęca środki - a cél szentesíti az eszközt
cement - cement
cenotaf - kenotáfium
centralny - központi
centrum - központ
certyfikat - bizonyítvány
cesarskie cięcie - császármetszés
cetyryzyna - cetirizin
cewka moczowa - húgycső
cewnik - katéter
chabić - lop
chamera - felhő
charczeć - horkol
charkać - köp
chemia - kémia
chemik - vegyész
chemioterapia - kemoterápia
chemoterapia - kemoterápia
Chile - Chile
Chiny - Kína
chira - pálinka
chirurg - sebész
chirurgia kosmetyczna - kozmetikai sebészet
chlać - iszik
chleb - kenyér
chlew - disznóól
chłopak - kisfiú
Chłopek - Parasztocska
chlor - klór
chmiel - komló, sör
chmura - felhő
chodnik - járda
chodzić - jár
choinka - karácsonyfa
chójk - karácsonyfa
cholesterol - koleszterin
chomik - hörcsög
chór - kórus
chore - beteg
choroba - betegség
choroba morska - tengeribetegség
choroba Parkinsona - Parkinson megbetegedés
chorobotwórczość - kórokozó tulajdonság
Chorwacja - Horvátország
chorwacki - horvát
chory - beteg
chrapać - horkol
chrobak - kukac
chromosom - kromoszóma
chruścik - tegzes, tegzes-moly
chrząstka - porc
chrząszcz - bogár
chuj ci w dupę - bazd meg!
chuśle - hegedű
chustka - szövet, posztó, kendő
chwast - gaz
chwiejny - bizonytalan
chwost - gaz, farok
chyc - meleg
ciąć - vág
ciągnik - traktor
ciało - test
ciało obce - idegen test
cicha woda brzegi rwie - lassú víz partot mos
ciebie - te, maga, ön
ciecz łzowa - könnyfolyadék
ciemnia - sötétkamra
ciemnia fotograficzna - sötétkamra
ciemno - sötét
ciemność - sötét
ciemny - sötét
cień - árny, árnyék
ciepło - hő
ciepły - meleg
cieść - após
ciężarówa - teherautó
ciężarówka - teherautó
ciężki - nehéz
ciga - kecske
ciocia - nagynéni
cios - csapás
cipka - tyúk
Cisa - Tisza
ciśnienie - nyomás
cisza - csend
ciupa - börtön
ciurlocek - hímvessző
ciurma - börtön
ciżma - cipő
cka - deszka
ćma - sötét
ćmaga - pálinka
cmentarz - temető
ćmy - sötét
co dwie głowy, to nie jedna - több szem többet lát
cos - cos
ćpać - eszik
ctg - ctg
cud - csoda
cudzołóstwo - házasságtörés
cug - vonat
cukier - cukor
cukiernia - cukrászda
cukrowiec lekarski - cukornád
cukrzyca - cukorbetegség
ćwiczenie czyni mistrza - ismétlés a tudás anyja, gyakorlat teszi a mestert
ćwierć - negyed
ćwikła - célkla
cybernetyka - kibernetika f
cyferblat - arc
cyfra - cifero
cyga - dongó
Cygan - cigány m
cygański - cigány
cyklista - biciklista, kerékpáros
cyngiel - szemüveg
cynk - cink
cypel - kiszögellés
Cypr - Ciprus
cyrk - cirkusz
cyrkiel - körző
cytryna - citrom
cytrynat - citrom
cytrynowożółty - citromsárga
cząber - borsikafű
czador - csador
czaj - tea
czajnik - kanna, fej
czapka - sapka
czarna dziura - fekete lyuk
czarna skrzynka - fekete doboz
Czarnogóra - Montenegró
Czarnogórzec - montenegrói
czarny - fekete
czarny humor - akasztófahumor
czarny koń - sötét ló
czarodziej - varázsló
czarownica - boszorkány
czary - boszorkányság
czas - idő
czasownik - ige
czas to pieniądz - az idő pénz
czciciel - imádó
Czech - cseh
Czechosłowacja - Csehszlovákia
Czecho-Słowacja - Csehszlovákia
Czechy - Csehország, Bohémia f
czekolada - csokoládé
czekoladka - bonbon
czereśnia - cseresznye
czernica - szeder
czerwiec - június
czerwony - piros, vörös
Czerwony Krzyż - Vöröskereszt f
czerwony olbrzym - vörös óriás
cześć - szia, szervusz
czeski - cseh
cześnia - cseresznye
częstoskurcz - tachycardia
czkawka - csuklás
członek - hímvessző
człowieczy - emberi, humán
człowiek - ember
człowiek człowiekowi wilkiem - ember embernek farkasa
człowiek strzela, Pan Bóg kule nosi - ember tervez, Isten végez
czoło - homlok
czorny - fekete, piszkos, mocskos, koszos
czosnek - fokhagyma
czucie - érzés
czujność - óvatosság
czujny - óvatos
czwartek - csütörtök
czworokąt - négyszög
czyhunka - tórium
czyrwiec - június
czyrwień - június
czyściec - tisztítótűz, purgatórium
czytać - olvas
Dafne - Daphné
Dagestan - Dagesztán
daktyl - datolya
dalece - nagyon
Dania - Dánia
dar - ajándék, adottság
darowanemu koniowi w zęby się nie zagląda - ajándék lónak ne nézd a fogát
darwinista - darwinista
Debreczyn - Debrecen
definicja - meghatározás
dega - szablya
dekiel - fej
dekoracja - dekoráció, díszítés
delikatny - gyengéd
demografia - demográfia
Demokratyczna Republika Wyspy Świętego Tomasza i Wysp Świętego Tomasza i Książęcej - São Tomé és Príncipe Demokratikus Köztársaság
dentysta - fogorvos
deprecha - depresszió
depresja - depresszió
dermatologia - bőrgyógyászat, dermatológia
deska - deszka
despota - despota
deszcz - eső
deszczówka - esővíz
deżdż - eső
dezerter - dezertőr
dezinformacja - félretájékoztatás
dialekt - nyelvjárás
diament - gyémánt
dioda - dióda
Diogenes - Diogenész, Diogenész (Szinópéi)
dłoń - kéz
dłużnik - adós
dmuchnąć - lop
Dniepr - Dnyeper
dobitnie - határozottan
dobranoc - jó éjszakát
dobrobyt - prosperitás
dobry - jó
dobry wieczór - jó estét
dochtór - doktor
dodatek - függelék
dodawać - összead
dogmat - dogma
dogmatyzm - dogmatizmus
dokładnie - alaposan
dokładny - alapos
doktor - doktor, orvos
dołek - depresszió
dolina - völgy
dolny - alsó
dom - ház
dom dziecka - árvaház
domofon - kaputelefon
domowej roboty - házi
domowy - házi
dom publiczny - bordély
doradca - tanácsadó
dorosły - felnőtt
Dorota - Dorottya
dorożka - bérkocsi
doś - mennyi
dostojnik - méltóság
dotyk - érintés
dotykać - megérint
do widzenia - viszontlátásra, viszlát
do zobaczenia - viszontlátásra, viszlát
draństwo - csőcselék
drapać - vakar
droga - út
Droga Mleczna - Tejút, Tejútrendszer
druh - barát
drukarnia - nyomda
drumla - doromb
drwal - favágó
drzewo - fa
drzwi - ajtó
duch - lélek
dudlać - sír, iszik
dudy - tüdő
duet - kettős
dukat - dukát
dumnie - büszkén
Dunaj - Duna
dupek - seggfej
dusza - lélek
duży - nagy
dychawica - asztma
dyktator - diktátor
dym - füst
dyplom - diploma
dyr - igazgató
dyrcio - igazgató
dyrektor - igazgató
dyro - igazgató
dyrygent - karmester
dyskryminacja - diszkrimináció
dyskryminować - diszkriminál
dysleksja - diszlexia
dżem - íz
dziadek - nagyapa
dziąsło - íny
dziękówa - köszi, köszönöm, megköszön
dziękować - megköszön
dziękówka - köszi, köszönöm, megköszön
dziękuję - köszi, köszönöm, megköszön
dziękuję bardzo - nagyon köszönöm
dzień dobry - jó reggelt
dziennikarstwo - újságírás, zsurnalisztika
dziennikarz - újságíró
dzierżyć - tart
dziewa - szűz
dziewica - szűz
dziób - csőr
dziura - barlang
dziurkacz - irodai lyukasztógép
dziurkacz biurowy - irodai lyukasztógép
dziwny - fura, furcsa
dżungla - dzsungel
edyficjum - épület
Edyta - Edit
Egina - Éjina
Egipt - Egyiptom
egoizm - egoizmus, önzés
egzemplarz - minta
ejber - kisfiú
eka - banda, sarok
Ekwador - Ecuador
elefant - elefánt
elektron - elektron
elektronika - elektronika
elektrownia - erőmű
elektryczność - villamosság
elektryczny - villamos
elektryk - villanyszerelő
Eligiusz - Elígiusz
eloksalacja - eloxálás
eloksalowanie - eloxálás
Elza - Erzsébet
Elżbieta - Erzsébet
Emerencjana - Emerencia
emigracja - emigráció
Emili - Emilia
Emilia - Emilia
energia - energia
epitafium - sírfelirat
erb - erbium
Eris - Erisz
Eryda - Erisz
Erytrea - Eritrea
ESBC - KBER
eschatologia - eszkatológia
eskalator - mozgólépcső
eskimoski - eszkimó
eskulap - orvos
esperancki - eszperantó
esperanto - eszperantó
espresso - eszpresszó, eszpresszókávé
Estera - Eszter
Estonia - Észtország
etanol - etanol
Etiopia - Etiópia
etola - stóla
etymologia - szófejtés
euforia - eufória
Eugeniusz - Jeno m
Europa Środkowa - Közép-Európa
Europa Wschodnia - Kelet-Európa
Ewaryst - Evariszt, Evarisztusz
eż - hogy
Ezdrasz - Ezra
Ezop - Aiszóposz
fabryka - gyár
facet - férfi
facetka - nő, tanárnő
facjata - arc
fajfus - hímvessző
fakt - tény
fala - hullám
fałat - bankjegy
fałszywy przyjaciel - hamis barát
familio - család
famuła - család
fanatyczny - fanatikus
farmaceuta - gyógyszerész
faryna - cukor
faryzeusz - farizeus
fasola - bab, paszuly
faszysta - fasiszta
faszystowski - fasiszta
fazan - fácán
fedra - rugó
fedrować - dolgozik, ás
fefer - bors
feminizm - feminizmus
ferska - őszibarack
fest - nagyon
feta - amfetamin
fezeła - méh
Fidżi - Fidzsi-szigetek
figa - füge
filip - nyúl
Filip - Fülöp m
Filipiny - Fülöp-szigetek
filolog - filológus, bölcsész
filozof - filozófus
filozofia dziejów - történelemfilozófia
filozofia historii - történelemfilozófia
Finlandia - Finnország
fitogeografia - növényföldrajz
fiza - fizika
fizjologia - élettan
fiżon - bab, paszuly
fizyka - fizika
flaszka - üvegpalack, palack
fliger - repülő, repülőgép
Florencja - Firenze
flota - flotta
fluor - fluor
fojerman - tűzoltó
foka - fóka
folklor - folklór
fontanna - szökőkút
forint - forint
formoterol - formoterol
fort - vár
fosfor - foszfor
fotorealizm - fotórealizmus
frajda - móka
Franciszka - Franciska
Francja - Franciaország
fresk - freskó
fryzjer - borbély
fundament - fundamentum
funkcja - funkció
fura - autó
furdygarnia - börtön
furosemid - furoszemid
furt - újból, ismét
fyjderbiksa - tolltartó
fyjderkasta - tolltartó
gad - hüllő
gała - szem, holló, varjú
galarypa - karalábé
gałąź - ág
Galicja - Galícia
Galilea - Galilea
Gambia - Gambia
gapa - holló, varjú
garaż - garázs
gasa - utca
gąść - zenél
gąsior - demizson
gaza - géz
gazo - géz
gdy kota nie ma, myszy harcują - ha nincs otthon a macska, cincognak az egerek
gdyż - mert
gdzie - ahol, ahová
gędźba - zene
gędzić - zenél
gemyla - rendetlenség, rumli
genetyczny - genetikai, genetikus
Genowefa - Genovéva f
geograf - földrajztudós
geologia - földtan, geológia
geometria - geometria, mértan
gepard - gepárd
geriatria - geriátria
Gerwazy - Gerváz m
getto - gettó
giez - bögöly
ginekolog - nőgyógyász
ginekologia - nőgyógyászat
gips - gipsz
gira - láb
gitara - gitár
gitarzysta - gitáros
glajza - tórium
glapa - varjú
glaska - pohár
głaskać - simogat
glin - alumínium
glina - agyag, rendőr
gliniarz - rendőr
globalne ocieplenie - globális felmelegedés
globus - fej
głośnik - hangosbeszélő
głowa - fej
głuchota - süketség
głupota - butaság
gnat - csont
gniew - harag
gnu - gnú
gnuśny - lusta
godka - nyelv
godzina - ora
gołąb - galamb
golarz - borbély
golem - gólem
goleń - sípcsont
golibroda - borbély
goły - meztelen
góra - hegy
górą - hegy
gorączka - láz
gorączka złota - aranyláz
góralek - szirtiborz
górnictwo - bányászat
górnik - bányász
górny - felső
gorzałka - pálinka
gorzelnia - szeszfőzde
gorzoła - pálinka
gospodyni domowa - háziasszony
gotować - főz
gówno - szar
goździk - szegfű
graba - kéz
grabie - gereblye
grabież - rablás
grać - zenél
Gracjan - Gracián
gracz - játékos
gramofon - lemezjátszó
granatowy - sötétkék
granica - határ
granit - gránit
grdyka - ádámscsutka
Grecja - Görögország
grecki - görög
Grek - görög
greka - görög
Grenlandia - Grönland
grobowiec - pince
grota - barlang
groźba - fenyegetés
gruba - bánya
grupa docelowa - célcsoport
gruszka - körte
Gruzja - Grúzia
gryźć - harap
Grzegorz - Gergely
grzyb - gomba
Gujana - Guyana
guła - pulyka
gułag - gulag
gularz - pulyka
guli - mert
Gwatemala - Guatemala
gwer - puska, karabély
gwiazda - csillag
gwiazdarz - asztrológus, csillagjós
gwiaździarz - asztrológus, csillagjós
Gwinea Bissau - Bissau-Guinea
Gwinea Równikowa - Egyenlítői-Guinea
gwóźdź - szög
gzub - has
Haiti - Haiti
hajtok - kés
hałas - zaj
halka - alsószoknya
Hamburg - Hamburg
hara - pálinka
harfa - hárfa
harmonia - harmónia
hau - vau
hedonizm - hedonizmus
heksa - boszorkány
hel - hélium
Hellada - Görögország
Helsinki - Helsinki
heparyna - heparin
herbarz - növénygyűjtemény
herbata - tea
Herod - Heródes
hiacynt - jácint
Hiacynt - Jácint m
hica - meleg
hierarchiczny - hierarchikus
hindi - hindi
Hindukusz - Hindukus
hipokryta - álszent
hipopotam - víziló
historiozofia - történelemfilozófia
historyk - történész
Hiszpania - Spanyolország
hiszpanka - spanyolnátha
Holandia - Hollandia
Holandyja - Hollandia
homeopatia - homeopátia
homiletyka - homiletika f
Honduras - Honduras
Hongkong - Hongkong
honor - becsület
hoplita - hoplita
Horacy - Horác
hormonozależny - hormonfüggő
Horus - Hórusz
horyzont - látóhatár
hotel - hotel, szálloda
Hucuł - Huculok
hyca - meleg
hydrologia - hidrológia
hymn - himnusz
i - és
idealny - tökéletes
identyczny - azonos
idol - bálvány
idole - bálvány
ikra - ikra
ile - mennyi
imię - név
imieniny - névnap
imigracja - bevándorlás
imperialista - imperialista
import - import
Indie - India
Indonezja - Indonézia
indyk - pulyka
informatyk - informatikus
infrastruktura - infrastruktúra
ino - csak
instynkt - ösztön
instytut - intézet
integracja - integráció
interes - ügy
internet - internet
inundacyja - árvíz
inwestować - befektet
inżynier - mérnök
Irak - Irak
Irena - Iren
Irlandia - Írország
iryd - irídium
iść - megy
iście - bizonnyal, bizonyára, biztosan
iść na skibę - lop
iskra - szikra
islamizm - iszlamizmus
Italok - olasz m
italski - olasz
iż - hogy
izba - béke, szoba
ize - hogy
izotop - izotóp
Izrael - Izrael
ja - én
jabłko - alma
jabłko Adama - ádámcsutka, ádámscsutka
jabłoń - almafa
Jacek - Jácint m
jacht - jacht
jad - méreg
jadać - eszik
jąderko - sejtmagvacska
Jadwiga - Hedvig
jagoda - bogyó, arc, arculütés
jajko - tojás
jajnik - petefészek
jajo - tojás
jakie drzewo, taki klin, jaki ojciec, taki syn - amilyen az apa olyan a fiú
jaki ojciec, taki syn - amilyen az apa olyan a fiú
jakiś - egy
jak Kuba Bogu, tak Bóg Kubie - amilyen az adjonisten, olyan a fogadjisten
jakość - minőség
jak sobie pościelesz, tak wyspać się wyśpisz - ki mint vet, úgy arat
jałmużna - alamizsna
jałowiec - boróka
Jamajka - Jamaika
Jan - János
jangryst - egres
japa - barlang
jara - anyós
Jarosław - Jaroszlav, Jaroszláv
jaskier - boglárka
jaskinia - barlang
jątrznica - hurka
jebadło - hálószoba, ágy
jeden za wszystkich, wszyscy za jednego - egy mindenkiért, és mindenki egyért
jedlina - jegenyefenyő
jedna jaskółka wiosny nie czyni - egy fecske nem csinál nyarat
jednooki - félszemű
jednorożec - orrszarvú
Jędrzej - András
Jemen - Jemen
jemioła - fagyöngy
jemiołuszka - csonttollú
Jeruzalem - Jeruzsálem
Jerzy - György
jeść - eszik
jesień - ősz
jesienny - őszi
jeśli - ha, vajon
jeśli wejdziesz między wrony, musisz krakać jak i one - ha Rómában élsz, élj úgy, mint a rómaiak
jest - lenni
jeszcze - még
jeż - sün
jeżeli - ha, vajon
jezioro - tó
Jezus - Jézus
Jezus Chrystus - Jézus Krisztus
język - nyelv
język obcy - idegen nyelv
język ojczysty - anyanyelv
jeżyna - szeder
jidysz - jiddis
jodła - jegenyefenyő
jogurt - joghurt
Jozafat - Jósafát m
Judyta - Judit
Jugosławia - Jugoszlávia
Juliusz - Juliánusz
juny - fiatal, ifjú
jupa - blúz
Jur - György
jurta - jurta
już - már
kaban - sertés
kabanina - sertéshús
Kabul - Kabul
kabza - zseb
Kafarnaum - Kafarnaum
kafej - kávéház
kaj - ahol, ahová
kajak - kajak
kajzerka - császárzsemle
kakadu - kakadu
kakao - végbélnyílás
kałabania - pocsolya
kalafa - alkoholista, arc
kalafior - karfiol
kalapitra - fej
kalarepa - karalábé
kałasznikow - kalasnyikov
kalejdoskop - kaleidoszkóp
kalendarz - naptár
kalfas - has
kałuża - pocsolya
kam - ahol, ahová
kamasz - cipő
Kambodża - Kambodzsa
kambr - kambrium
Kamerun - Kamerun
kamfora - kámfor
kanapka - szendvics
kanarek - kanári
kancerogenny - rákkeltő
kandydat - pályázó, jelölt
kangur - kenguru
kanibalizm - kannibalizmus
kanka - kanna
kapcylinder - kalap
kapeć - abroncs
kapecytabina - kapecitabin
kapeluch - kalap
kapelusz - kalap
kąpiółka - fürdőszoba
kapusta - káposzta
karaba - macska
karabin - puska, karabély
karabin maszynowy - géppuska
karakuły - perzsabunda
karate - karate
karawana - karaván
karczoch - articsóka
karetka - mentőautó
Karlik - Károly
Karol - Károly
karp - ponty
Karpaty - Kárpátok
karta kredytowa - hitelkártya
kartofel - burgonya
kasjer - pénztáros
kastoreum - hódzsír, kasztoreum
kasza gryczana - hajdinakása
kaszalot - ámbráscet
kaszanka - hurka
kasztan - gesztenye
Katalonia - Katalónia
Katar - Katar
Katarzyna - Katalin f, Kata f, Kato f, Katinka f
katedra - székesegyház
Katyń - Katyńi vérengzés
kawaler - agglegény, lovag
kawa wesoła - bordély
kawiarnia - kávéház
kawka - csóka, apáca
kawon - dinnye
kaznodzieja - prédikátor m
kciuk - hüvelykujj
kędy - ahol, ahová
kefir - kefir
kejter - kutya
kejza - sajt
kelner - pincér
Kenia - Kenya
kenotaf - kenotáfium
kenotafium - kenotáfium
keta - lánc
kicz - giccs
kiejda - zseb
kiełbasa - kolbász
kiepeła - fej
kierowca - autóvezető, sofőr, vezető m, járművezető
kierownik - vezető m
kierz - bokor
kierzek - bokor
kieszeń - zseb
kieszonkowiec - zsebtolvaj
kij - emelet
Kilimandżaro - Kilimandzsáró
kilka - néhány, egy pár
kimać - alszik
kino - mozi
kinol - alkoholista
kintop - mozi
kira - pálinka
kirchóf - temető
Kirgistan - Kirgizisztán
Kiribati - Kiribati
kiszka - tej, hurka
kit - gitt
kłącze - rizóma
klajdać - öltöztet
klakson - autóduda
kłamstwem daleko się nie zajdzie - a hazug embert hamarabb utolérik, mint a sánta kutyát
kłamstwo ma krótkie nogi - a hazug embert hamarabb utolérik, mint a sánta kutyát
klapsznita - szendvics
klara - Nap
klasy - ugróiskola
klej - ragasztószer
klekotun - gólya
kliber - alkoholista
klimat - éghajlat, klíma
kłódka miłości - szerelmesek lakatjai
kluber - alkoholista
kluza - börtön
knipa - könyv
koala - koala
kobalt - kobalt
kobieta - nő
kochać - szeretkezik
kociamber - macska
kocioł - katlan
kociołek - bogrács
kod kreskowy - vonalkód
kogut - kakas
koja - ágy
kojo - ágy
kokon - báb
kokosz - tyúk
kokoszka - tyúk
kokot - kakas
kokotek - csap
kolano - térd
kołchoz - kolhoz
kolejarz - vasutas
kolejność - sorrend
koleś - férfi
koło - kerékpár, bicikli
kolor - szín
kolorowy - színes
Kolumb - Kolumbusz
Kolumbia - Kolumbia
kołysanka - altatódal
koma - kóma
komar - szúnyog
komat - kóma
kominiarz - kéményseprő
komp - számítógép
kompres - borogatás
komputer - számítógép
koń - ló, hímvessző
kóń - ló
koncert - koncert
kondensator - kondenzátor
kondygnacja - emelet
konewka - kanna
konfitura - íz
konformizm - konformizmus
Konfucjusz - Konfuciusz
koniak - borpárlat
koń ma cztery nogi i też potknąć się potknie - a lónak négy lába van, mégis megbotlik
koń mechaniczny - lóerő
konspiracja - konspiráció
konstruktywizm - konstruktivizmus
konstytucja - alkotmány
konsumpcjonizm - konzumizmus
kontynent - földrész, kontinens
kopać - ás
kopalnia - bánya
koper - kapor
kopernik - kopernícium
Kopernik - Kopernikusz
kopruch - szúnyog
kora - kéreg
Koran - Korán
korona - korona
korrida - bikaviadal
korytarz - folyosó
kos - fekete rigó
Kos - Kosz
kosa - kés
kość - csont
kościsty - csontos
kosmogoniczny - kozmogóniai
Kostaryka - Costa Rica
koszary - laktanya, kaszárnya
kosztować - megkóstol
kot - macska
kowal - kovács
koza - kecske
kozioł ofiarny - bűnbak
Koziorożec - Bak
koźlak - barna gyűrűstinóru
koźlarz babka - barna érdestinóru
koźlarz czerwony - vörös érdestinóru
koźlę - kiskecske, kecskegida, bakkecske
kraj - ország, állam
krajać - vág, lop
krajopis - földrajztudós
Kraj Sudetów - Szudétavidék
Kraków - Krakkó
kran - csap
kraść - lop
krasula - tehén
krauza - korsó
krawat - nyakkendő
krawatka - nyakkendő
krawiec - szabó
kręgosłup - gerinc
krepel - fánk
krew - vér
Krista - Krisztina
kroić - vág, lop
król - király m
królestwo - királyság
królewski - királyi
królik - nyúl
kronika - krónika
kropla - csepp, esőcsepp '
krople - csepp, esőcsepp '
krowa - tehén
krowa, która dużo ryczy, mało mleka daje - amelyik kutya ugat, az nem harap
krtań - gége
krucjata - keresztes háborúk
kruk - holló
krupier - krupié
krupniok - hurka
krybuny - kereszt, keresztcsont
krykiet - krikett
kryminał - börtön
kryptografia - kriptográfia
Krystyna - Krisztina
krzak - bokor
krzeczek - hörcsög
krzesło - szék
krzew - bokor
krzyczeć - kiált, kiabál
Krzysztof - Kristóf
krzywa - görbe
krzyż - kereszt, keresztcsont
Ksenia - Xénia
książka - könyv
książka kucharska - szakácskönyv
księgarnia - könyvesbolt
księgozbiór - könyvtár
księżniczka - hercegnő
Księżyc - Hold
kto chce żyć z swojej pracy, dolegać nie trzeba - ki korán kel, aranyat lel
kto ma ręce do pracy, ten się naje kołaczy - aki nem dolgozik, ne is egyék
kto pod kim dołki kopie, sam w nie wpada - aki másnak vermet ás, maga esik bele
kto rano wstaje, temu Pan Bóg daje - ki korán kel, aranyat lel
kto sieje wiatr, ten zbiera burzę - aki szelet vet, vihart arat
kubek w kubek - azonos
Kubuś Puchatek - Micimackó
kucharz - szakács
kuć żelazo, póki gorące - addig üsd a vasat, amíg meleg
kukurydza - kukorica
kula - golyó, láb
kulka - golyó
kulos - láb
kultura - kultúra
kuna - nyest, nyuszt
kupować - elad, vásárol
kur - kakas
kura - tyúk
kurczak - csirke
kurka - tyúk
kurki - tyúk
kurwacik - nyakkendő
kurwa twoja mać - a kurva anyad
kuśka - hímvessző
Kusz - Kús m
kuter - kutter
Kuwejt - Kuvait
kuzaj - unokatestvér
kuzyn - unokatestvér
kuzynka - unokatestvér
kwadrat - négyzet
kwas - sav
kwas akrylowy - akrilsav
kwas askorbinowy - aszkorbinsav
kwas chlorogenowy - klorogénsav
kwas krotonowy - krotonsav
kwiecień - április
lacz - fej, hímvessző, rendőr
laga - emelet
lala - baba
lalka - baba
lampa - lámpa
łańcuch - lánc
łańcuch pokarmowy - tápláléklánc
land - falu
larmo - zaj
las - erdő
laser - lézer
lat - év
lata - év
lato - nyár
Laura - Laura
łazienka - fürdőszoba
le - de
łechtaczka - csikló
lecz - de
lekarz - orvos
lekarz choroby chorób kobiecych - nőgyógyász
lekka atletyka - atlétika
lekkoatletyka - atlétika
leksykon - lexikon
lelek - lappantyú
lelek kozodój - lappantyú
len - len
leniwy - lusta
lepak - újból, ismét
łepetyna - fej
lepiej późno niż wcale - jobb későn, mint soha
lepszy wróbel w garści niż gołąb na dachu - jobb ma egy veréb, mint holnap egy túzok
Lesotho - Lesotho
lew - oroszlán
Lew - Oroszlán
lewicowy - baloldali
liceum - líceum, lyceum
liczba podwójna - kettős szám
Lidia - Lídia
Lima - Lima
linia - járat
linie lotnicze - légitársaság
lipiec - július
lis - róka
liść - falevél
liść bobkowy - babérlevél
liść laurowy - babérlevél
listonosz - postás
listopad - november
litania - litánia
literat - író
liturgiczny - liturgikus
Litwa - Litvánia
Lizbona - Lisszabon
lód - jég, fagylalt
lodowiec - gleccser
łódź - csónak
lojalność - hűség
łokieć - könyök
lokomotywa - mozdony
lola - emelet
Londyn - London
łopata - lapát
lorandyt - lorándit
łosoś - lazac
lotnisko - repülőtér
lotniskowiec - repülőgép-hordozó
lotos - lótusz
lotus - lótusz
Łotwa - Lettország
łowca - vadász
łoże - ágy
łóżko - ágy
lub - vagy
lubić - kedvel
łucznictwo - íjászat
łudzikwiat - április
ludzki - emberi, humán
łuk - íj
Luksemburg - Luxemburg
luksus - luxus
lumbago - hexensussz
luńt - kutya
lustro - tükör
luty - február, enyheges
lwia część - oroszlánrész
łza - könny
macha - arc
machinacja - machináció
macica - anyaméh, méh
Maciej - Mátyás
maciek - has
macoszka - árvácska
Madera - Madeira
madla - szülésznő, bába
mądrej głowie dość dwie słowie - az okos ember félszóból is ért
mądry - bölcs
MAEA - NAÜ
Maghreb - Magreb
magnet - magnó
magnetofon - magnetofon, magnó
maj - május
mak - mák
mąka - liszt
makaron - tészta
makrela - makréla
malarstwo - festészet
malarz - festő, festőművész
Malawi - Malawi
Malezja - Malajzia
Mali - Mali
małpa - majom
Malta - Málta
mam - mama
mama - mama, anyós
mammografia - mammográfia
mamut - mamut
manierka - kulacs
mapa - térkép
maraton - maraton
Marceli - Marcell
marchew - sárgarépa
marchewka - sárgarépa
Marek - Márk
marmolada - íz
Mars - Mars
martwy - halott
Martyna - Martina
marynarz - tengerész
marzec - március (marcjusz)
marznący deszcz - ónos eső
masakra - mészárlás
masara - légy
maska - arc
maślak sitarz - tehéntinóru
maślak żółty - sárga gyűrűstinóru
maślak zwyczajny - barna gyűrűstinóru
masło - vaj
maszt - árboc
maszyna - gép
maszyna do szycia - varrógép
maszynista - mozdonyvezető
matematyk - matematikus
matematyka - matematika
Matiasz - Mátyás
matrioszka - matrjoska
matros - tengerész
Matuzal - Matuzsálem m
Matuzalem - Matuzsálem m
Mauritius - Mauritius
mazak - arc
Mazowsze - Mazóvia
mecenas - ügyvéd
męczennik - vértanú, mártír
meczet - mecset
mediana - medián
medyk - orvos
Meksyk - Mexikó
melać - köp
melodyjny - dallamos
melon - sárgadinnye
menadżer - vezető m
Merkury - Merkúr
meskalina - meszkalin
metafora - metafora
metempsychoza - lélekvándorlás
meteoryt - meteorit
metr kwadratowy - négyzetméter
Metuszelach - Matuzsálem m
mewa - sirály
mężczyzna - férfi
mgła - köd
miałki - sekély
Miami - Miami
miasto - város
miasto stołeczne - főváros
micela - micella
Michał - Mihály
miecz - kard
miedź - réz, vörösréz
miedźwiedź - medve
miejsce - hely
miejscowość - helység, hely
miejska legenda - szóbeszéd, városi legenda
miejski - városi
mielcuch - sör
mieśćce - hely
mieśce - hely
miesiąc - hónap
mięsień - izom
mięsopustnik - február, enyheges
mięsożerca - húsevő
mieszkanie - lakás
Mila - Emilia
miłość - szerelem
mina - arc
minaret - minaret
miód - méz
miotła - seprű
miska - tálacska, tálka
mistrz - bajnok
mitra - mitra
mleko - tej
młody - fiatal, ifjú
młodziec - csecsemő, baba
młodzież - fiatal
młyn - malom
młynarz - molnár
mnich - barát
Mojżesz - Mózes
mokry - nedves
Mołdawia - Moldova
monocykl - egykerekű
monopolowy - italbolt
monstrancja - monstrancia
mora - lélek
Morawa - Morva
mordować - agyonüt
morela - sárgabarack
morkwa - sárgarépa
Morskie Oko - Halastó
morze - tenger
Morze Adriatyckie - Adriai-tenger
Morze Bałtyckie - Balti-tenger
Morze Śródziemne - Földközi-tenger
most - híd
motyl - lepke
Mount Everest - Mount Everest
mowa - nyelv
mowa jest srebrem, a milczenie złotem - beszélni ezüst, hallgatni arany
mózg - agy
możliwość - lehetőség
mrowisko - hangyaboly
mrówka - hangya
mróz - fagy
mucha - légy
muchomor mglejarka - szürke selyemgomba
mućka - tehén
muezin - müezzin
mugol - mugli
mumia - múmia
mundurowy - rendőr
muraszka - hangya
musztarda - mustár
muzyk - zenész
mużyk - férfi
muzyka - zene
my - mi
mycka - sapka
mydło - szappan
mykita - róka
myśl - gondolat
myśliwiec - vadász
myśliwy - vadász
mysz - egér
Myszka Miki - Miki Egér
myszy tańcują, gdy kota nie czują - ha nincs otthon a macska, cincognak az egerek
nacja - nemzetiség
nacjonalizować - államosít
naczyniowy - vaszkuláris
nadzieja - remény
nagi - meztelen
nagórny - felső
Nairobi - Nairobi
naleśnik - palacsinta
namiot - sátor
na pewno - bizonnyal, bizonyára, biztosan
napletek - fityma
narba - forradás, sebhely
narciarz - síelő
nareszcie - végül
narodowość - nemzetiség
na sto procent - bizonnyal, bizonyára, biztosan
natura ciągnie wilka do lasu - kutyából nem lesz szalonna
nauczyciel - tanár
nauczycielka - tanárnő
Nauru - Nauru
na wszelki wypadek - mindenesetre
na zdrowie - egészségedre
nazwisko - vezetéknév
neapolitański - nápolyi
nekrolog - nekrológ, gyászjelentés
neofaszysta - neofasiszta
neogotycki - neogótikus
neon - neon
neonatologia - neonatológia
neutralność - semlegesség
neutron - neutron
ni - nem
niacyna - niacin
nic - semmi
Niderlandy - Hollandia
nie - nem
nieć - unokatestvér
nie chwal dnia przed zachodem słońca - ne igyál előre a medve bőrére
niech żyje - vivát!
niecierpliwy - türelmetlen
niedaleko pada jabłko od jabłoni - nem esik messze az alma a fájától
niedokrwistość - vérszegénység
niedopałek - csikk
nie dospać trzeba, kto chce dostać chleba - ki korán kel, aranyat lel
nieduch - betegség
niedźwiedź - medve
niegrzeczny - udvariatlan
niemal - majdnem
nie ma róży bez kolców - nincsen rózsa tövis nélkül
Niemcy - Németország
nie mieć - nem
Niemiecka Republika Demokratyczna - Német Demokratikus Köztársaság
niemiły - kellemetlen
niemowlę - csecsemő, baba
nienawidzić - utál
niepodległość - függetlenség
nieprzyjazny - barátságtalan, rideg
nierówność - egyenlőtlenség
nieściora - unokatestvér
nieśmiertelny - halhatatlan
niestety - sajnos
nie szata zdobi człowieka - nem a ruha teszi az embert
nieszczęścia chodzą parami - a baj nem jár egyedül
nieuczciwy - becstelen
niewiarygodny - hihetetlen
niewiasta - nő
nie wszystko złoto, co się świeci - nem mind arany, ami fénylik
niewybaczalny - megbocsáthatatlan
niewyobrażalny - elképzelhetetlen
nie wywołuj wilka z lasu - ne keltsd fel az alvó oroszlánt, ne ébreszd fel az alvó oroszlánt
niezgrabny - ügyetlen
Niger - Niger
nihilizm - nihilizmus
Nikaragua - Nicaragua
nim - ő
niski - alacsony
Niue - Niue
niż - mint
niża - alföld
nizina - alföld
no - igen
noc - éjszaka
noga - láb
nogawka - nadrágszár
nonkonformizm - nonkonformizmus
Norbert - Norbert
Norweg - norvég
Norwegia - Norvégia
nos - alkoholista
nosorożec - orrszarvú
Nowa Zelandia - Új-Zéland
nowicjat - noviciátus
nowy - új
Nowy Jork - New York
nóż - kés
nożyce - olló
nożyczki - olló
nuda - unalom
nudelzupa - leves
nudle - tészta
nudny - unalmas
nyga - szúnyog
obelisk - obeliszk
obiecadło - betűrend, ábécé
obiekt - tárgy
obiektywność - objektivitás, tárgyilagosság
obłok - felhő
obój - oboa
obojczyk - kulcscsont
obóz koncentracyjny - koncentrációs tábor
obraza - sértés
obrotnica - forditókorong
obrus - abrosz
obserwator - megfigyelő
obserwować - észlel
obywatel - állampolgár
obywatelstwo - állampolgárság
ocean - óceán
Ocean Atlantycki - Atlanti-óceán
Ocean Spokojny - Csendes-óceán
ocelot - ocelot
ocet - ecet
ociec - apa
octan - acetát
od - -tól
oda - óda
odbyt - végbélnyílás
odcisk palca - ujjlenyomat
odczuwać - érez
oddzielnie - külön
ode - -tól
odpowiadać - válaszol
odpowiedź - felelet, válasz
odrębny - különálló
odwiedzać - meglátogat
Ofelia - Ofélia
oftalmologiczny - szemészeti
ogień - tűz
ogon - farok
ogórecznik lekarski - borágó
ogórek - uborka
ogród - kert
ogród zoologiczny - állatkert
ojciec - apa
ojczyc - fiú
ojczym - mostohaapa
ojczyzna - szülőföld
Ojgen - Jeno m
ojla - bagoly
okazja czyni złodzieja - alkalom szüli a tolvajt
okno - ablak
oko - szem
okoń - sügér
okrągły - kerek
okręt lotniczy - anyahajó
okręt podwodny - tengeralattjáró
okruch - szilánk
okulary - szemüveg
okulista - szemész
okulistyczny - szemészeti
okultyzm - okkultizmus
olcha - éger
Olimpia - Olümpia, Olimpia
ołów - ólom
ołtarz - oltár
oma - nagymama
omdlenie - ájulás
omieszkać - nem
on - ő
ona - ő
one - ők
oni - ők
ono - ő
opactwo - apátság
opal - opál
opat - apát
opera - opera, operaház
opero - opera, operaház
opiąć - újból, ismét
opięć - újból, ismét
opium - ópium
opona - abroncs
Oradea - Nagyvárad
oraz - és
orgazm - orgazmus
Orla Perć - Sas-út
ormiański - örmény
oryginalność - eredetiség
orzeł - sas
osa - darázs
osetyjski - oszét
osioł - szamár
ośmiornica - polip
osoba - személy
osobliwy - sajátos
osobno - külön
ostatecznie - végül
ostatni - utolsó
ostrężyna - szeder
ostry - éles, csípős
ostryga - osztriga
ouberiba - karalábé
owca - juh, birka
owies - zab
owoc - gyümölcs
owulacja - ovuláció
ożyna - szeder
pacha - hónalj
paciuk - patkány
pacjent - ápolt
Pacyfik - Csendes-óceán
pączek - fánk
pagórek - domb
pająk - pók
pajęcznik - szeptember, november
pakistański - pakisztáni
pakli - ha, vajon
pała - fej, hímvessző, rendőr
palacz - autóvezető, sofőr, vezető m, járművezető
Palau - Palau
pale - fej, hímvessző, rendőr
palec - ujj
Palestyna - Palesztina
Palestyńczyk - palesztin
palimpsest - palimpszeszt
palindrom - palindrom
palladianizm - palladianizmus
pana - abroncs
panna - kisasszony
Panna - Szűz
panorama - panoráma
państwo - állam
państwowy - állami
pantoflarz - papucsférj, papucs
papuć - cipő
papuga - papagáj
paragraf - paragrafus
Paragwaj - Paraguay
parasol - esernyő
park - park
parzysty - páros
pątnik - zarándok
patria - szülőföld
patrzałki - szemüveg
pawęża - pajzs
październikowy - októberi
paznokieć - köröm
pchła - bolha
pchli targ - bolhapiac
pech - balszerencse
pediatra - gyermekorvos
pędzel - ecset
pekator - hímvessző
Pelagiusz - Pelágiusz
pełny - tele, teli
pendżabski - pandzsábi
peniak - gyáva
penis - hímvessző
pępek - köldök
Pepik - cseh
Peregryn - Pellegrin
perfumy - illatszer, parfüm
perka - burgonya
perła - gyöngy
peron - peron
Perpetua - Perpétua
persona - személy
personifikacja - megszemélyesítés
Peru - Peru
petronelka - katicabogár
piana - sör
pianista - zongorista
piasek - homok
piaskownica - homokozó
piątek - péntek
pić - iszik
pidżama - pizsama
pieczara - barlang
pieczęć - bélyegző
pieczeń - sült, ügy
piędź - arasz
piegowaty - szeplős
pielgrzym - zarándok
pieprz - bors
pierścionek - gyűrű
pierwsze wrażenie - első benyomás
pies - kutya
pięść - ököl
pięściarstwo - ökölvívás, boksz
pieśń - ének
pieszy - gyalogos
piętro - emelet
pietruszka - petrezselyem
pietruziel - petrezselyem
pietuch - kakas
pigularz - gyógyszerész
pigwa - birsalma
pijawa - szivárvány
piłka - labda
piłka ręczna - kézilabda
piłkarzyki - csocsó
ping-pong - asztalitenisz
pingwin - pingvin
piórnik - tolltartó
pióro - toll
piorun - villám, villámcsapás
piosenka - ének, dal
Piotr - Péter
Piotra - Petra
piro- - piro-
piromania - pirománia
pisarz - író
pismo - betűrend, ábécé
pistolet maszynowy - géppisztoly
Pittsburgh - Pittsburgh
piwnica - pince
piwo - sör
piżama - pizsama
pizza - pizza
płaca - bér
płacić - fizet
płakać - sír
planeta - bolygó
planetarium - planetárium
płaz - kétéltű
plaża - strand
plecy - hát
płetwonurek - békaember
pluć - köp
płuco - tüdő
płyn - közeg
płynąć - úszik
płynny - cseppfolyós
płytki - sekély
pływać - úszik
pływak - úszó
pływanie - úszás
pochwa - hüvely
pociąg - vonat
poczucie humoru - humorérzék
podać - bead
podanie - beadvány
podatek - adó
poddasze - padlás
podkowa - lópatkó
podłoga - padló
podniebienie - szájpadlás
podpis - aláírás
podpułkownik - alezredes
podróżować - utazik
podwójny - kettős
poezja - költészet
pogłoska - szóbeszéd
pogoda - idő, időjárás
pohybel - akasztófa
pokaz - bemutató
pokój - béke, szoba
Polak, Węgier – dwa bratanki, i do szabli, i do szklanki - lengyel, magyar – két jó barát, együtt harcol, s issza borát
polędwica - bélszín
poleku - lassan, lassacskán
poli- - poli-
policjant - rendőr
policzek - arc, arculütés
polifenol - polifenol
poliginia - többnejűség
poligynia - többnejűség
Polinezja Francuska - Francia Polinézia
politura - sellakpolitúr
polityka - politika
północ - éjfél
polon - polónium
połowa - fél
półowa - fél
położnik - szülész
Polska - Lengyelország
południe - dél
półwysep - félsziget
połykać - nyel
pomagać - segít
pomarańcza - narancs
pomarańczowy - narancs
pomidor - paradicsom
pomidorówka - paradicsomleves
pomoc - segítség
poncz - puncs
poniedziałek - hétfő
ponieważ - mert
ponownie - újból, ismét
popiół - hamu
Poprad - Poprád
poprawny - helyes
popularny - népszerű
por - póréhagyma, pórus
pornografia - pornográfia
pornograficzny - pornográf, trágár, szeméremsértő
poronienie - abortusz
Portoryko - Puerto Rico
portret - arckép
Portugalia - Portugália
porucznik - főhadnagy
poruta - szégyen
porzeczka - ribizli
poseł - követ
posiadacz - birtokló
posiadłość - birtok
pośladek - fenék
pośledni - utolsó
posowa - mennyezet
potas - kálium
potoczny - köznyelvi
potrzeba jest matką wynalazków - a szükség találékonnyá tesz
powieka - szemhéj
powiestka - név
powietrze - levegő
powódź - árvíz
powoli - lassan, lassacskán
pozaziemski - földönkívüli
pożyteczny idiota - hasznos idióta
pozywać - beidéz
praca - dolog, munka
praca domowa - házi feladat
prącie - hímvessző
pracować - dolgozik
pracowity - szorgalmas
pracownik - dolgozó, alkamazott
prąd - áram
Praga - Prága
pragnienie - áhítozás, szomjúság
prawda - igazság
prawdopodobny - valószínű
prawdziwych przyjaciół poznaje się w biedzie - bajban ismerszik meg a jó barát
prawnik - jogász
prawny - jogi
prawo - jog
Prawo i Sprawiedliwość - Jog és Igazságosság
prędkość - sebesség
premiera - bemutató
prenumerata - előfizetés
prenumerator - előfizető
prezent - ajándék
prezydent - államelnök
próba - próba
probiotyk - probiotikum
próbować - kóstol, megkóstol
produkcja - termelés
prom - komp
promień - sugár
prorok - próféta
prostopadły - merőleges
proszę - kérem
protein - fehérje
proteina - fehérje
proton - proton
prowadzić - vezet
prowansalski - okcitán
Prusy - Poroszország
przać - szeretkezik
przebiśnieg - hóvirág
przebój - sláger
przebytek - lakás
przedmieście - külváros w
przedmiot - tárgy
przedsiębiorstwo - vállalat
przedsięwzięcie - vállalkozás
przekąska - imbisz
przekształcenie - átalakítás, megváltoztatás
Przełęcz pod Chłopkiem - Vadorzóhágó
przemysł - ipar
przenośnia - metafora
przeorysza - apátnő
przepowiednia - prófécia
przesądny - babonás
przestarzały - elavult
przestępca - bűnöző
przestraszyć - megijeszt
przestrzeń kosmiczna - világűr
przeszkoda - akadály
przoć - szeretkezik
przychodzić - jön
przyjaciel - barát
przyjaciółka - barátnő
przyjaźń - barátság
przyprawa - fűszer
przypuszczalnie - feltételezhetően
przyroda - természet
przysięgać - esküszik
przystanek - megálló
przystanek autobusowy - autóbuszmegálló
przyszłość - jövő
pseudonauka - pszeudotudománynak
psisko - kutya
pstrąg - pisztráng
psy szczekają, karawana idzie dalej - a kutya ugat, a karaván halad
pszczoła - méh
pszenica - búza
Ptah - Ptah
ptak - madár, hímvessző
ptaszę - madár, hímvessző
pultok - pulyka
puma - puma
puste - üres
pustka - üresség
pusty - üres
pustynia - sivatag
puszka - börtön, sör
puter - pulyka
putnia - vödör
Pyjter - Péter
pyra - burgonya
pyta - hímvessző
pytać - kérdez
pytanie - kérdés
rabarbar - rebarbara
rąbek - szövet, posztó, kendő
rachatłukum - lokum
raciądz - lovag
radar - rádiólokátor
radio - rádió
radocha - öröm
radon - radon
radość - öröm
ragóżka - ablaktörlő
Rajch - Németország
rajzować - utazik
Rak - Rák
rasizm - rasszizmus
ratusz - városháza
razdziawa - holló, varjú
reagować - reagál
reaktor - reaktor, atomreaktor
realizm - realizmus
ręczna - kézilabda
regent - régens
rekin - cápa
reklama - hirdetés, reklám
rekluza - reclusa
religia - vallás
relikwia - ereklye, relikvia
republika bananowa - banánköztársaság
Republika Czeska - Cseh Köztársaság
Republika Federalna Niemiec - Német Szövetségi Köztársaság
Republika Słowacka - Szlovák Köztársaság
respekt - vonatkozás
restauracja - étterem
rewolucjonista - forradalmár
RNA - RNS
robak - kukac
Robert - Róbert
robić - csinál
robieniec - munkás
robotnik - munkás
rodzić - szül
rodzina - család
róg - sarok
rok - év
Roland - Roland, Lóránt
rolnictwo - agrárium
Rom - roma
Roman - Román
ropa naftowa - kőolaj, ásványolaj
ropień - tályog
Rosja - Oroszország
rosomak - rozsomák
rouza - rózsa
rower - kerékpár, bicikli
rowerzysta - biciklista, kerékpáros
równanie - egyenlet
również - is
równik - Egyenlítő
równina aluwialna - alluviális síkság
równoważny - egyenértékű
róża - rózsa
rozmawiać - beszélget
rozsierdzie - harag
rozum - értelem
różyczka - rubeola
rtęć - higany
rubel - rubel
rubid - rubídium
ruchome schody - mozgólépcső
rudny - piros, vörös
rufa - fenék
rum - rum
Rumun - román
Rumunia - Románia
ruten - ruténium
Ryby - Halak
rycerz - lovag
rysować - rajzol
rysowanie - rajzolás
rysownik - rajzoló
rysunek - ábra, rajz
Rysy - Tengerszem-csúcs
rytuał - szertartás, rítus
rywal - rivális, versenytárs
ryż - rizs
rzadny - csúnya, ronda
rzeciądz - lánc
rzecz - dolog, tárgy
rzeczownik - főnév
rzeka - folyó
rzeź - mészárlás
Rzym - Róma
SA - rt.
sąd - bíróság
sadło - szalonna
sadzielnik - kéményseprő
sagan - fej, kanna
saharyjski - szaharai
sala - terem
sałatka - saláta
salceson - disznósajt, rendőr
salon - szalon
Salwador - El Salvador, Salvador
samar - szamárium
Samoa Amerykańskie - Amerikai Szamoa
samobójstwo - öngyilkosság
samochód - autó
samolot - repülő, repülőgép
samowar - szamovár
sanki - szánkó
sardela - ajóka
sarkofag - szarkofág
sarna - őz
sarnapa - zsiráf
sąsiad - szomszéd
śćdza - ösvény
schody ruchome - mozgólépcső
ściana - fal
ściany mają uszy - a falnak is füle van
ścieżka - ösvény
Scylla - Szkülla
scyzoryk - zsebkés
śdza - ösvény
sędzia - bíró
seks oralny - orális szex
seksualność - szexualitás
sekularyzacja - szekularizáció
selen - szelén
seler - zeller
senność - álmosság
senny - álmos
ser - sajt
Serbia - Szerbia
Serbia i Czarnogóra - Szerbia és Montenegró
serwatka - savó
Sfederowane Stany Mikronezji - Mikronéziai Szövetségi Államok
siano - széna
siarka - kén
siarkowodór - hidrogén-szulfid, kén-hidrogén
sieć - háló
sieczeń - február, enyheges
siedem grzechów głównych - hét főbűn
Siedmiogród - Erdély
sierociniec - árvaház
sierpień - augusztus
Sierra Leone - Sierra Leone
siestrzan - unokaöcs
siestrzeniec - unokaöcs
silno - nagyon
sin - sin
Singapur - Szingapúr
sioło - falu
siostrzan - unokaöcs
siostrzanek - unokaöcs
siostrzeniec - unokaöcs
sipa - lapát
sirpień - augusztus
skała - szikla
skałosz - szirtiborz
skand - szkandium
skibać - lop
skład - bolt, pince, mennyezet
sklep - bolt, pince, mennyezet
sklep monopolowy - italbolt
skok - ugrás
skok o tyczce - rúdugrás
Skop - Kos
skopowina - bárányhús
skóra - bőr
Skorpion - Skorpió
skowronek - pacsirta
skra - szikra
skrobia - keményítő
skromność - szemérem
skrzynka pocztowa - postaláda
skrzypce - hegedű
słaby - gyenge
śledź - nyakkendő
śledziona - lép
śleptać - sír
ślepucha - tyúk
ślimak - csiga
ślips - nyakkendő
śliwowica - sligovica
słoik - korsó
słoń - elefánt
Słońce - Nap
słonina - szalonna
słonka - szalonka
słowa - szó
Słowacja - Szlovákia
słowacki - szlovák
Słowenia - Szlovénia
Słowianin - szláv
słowiański - szláv
słownik - szótár
słowo - szó
ślusarz - lakatos
smacznego - jó étvágyat
smaczny - jóizű
smakować - megkóstol
smerf - Törp, Törpök
smutniak - kenyér
smyczek - vonó
smysł - értelem
śnieg - hó
sobaka - kutya
sobota - szombat
socjalista - szocialista
socjologia - szociológia
sód - nátrium
sokół - sólyom
Solon - Szolón
Somalia - Szomália
somsiad - szomszéd
sopel - csap, jégcsap
sos - szósz, mártás
sowa - bagoly
spać - alszik
spaghetti - spagetti
spawacz - hegesztő
śpiący - álmos, álmosító
śpiew - ének
śpiewać - énekel
śpiewak - énekes
spiker - bemondó
spis rzeczy - tartalomjegyzék, tartalom
spis treści - tartalomjegyzék, tartalom
społeczeństwo - társadalom
społeczny - társadalmi
sport - sport
sportowiec - sportoló
spowiednik - gyóntató, gyóntatóatya
spragniony - szomjas
sprawa - dolog, kérdés, ügy
Sprawiedliwy wśród Narodów Świata - Világ Igaza
sprężyna - rugó
spróbować - megkóstol
sprzedawać - árul, elad
sp. z o.o. - Kft
srać - szarik
srebro - ezüst
średni - közepes
średnia - átlag
średniowiecze - középkor
Sri Lanka - Srí Lanka
środa - szerda
śródmieście - belváros
Śródziemie - Középfölde
śrupać - harap
stacja - állomás
stadion - stadion
stal - acél
stała - állandó
Stany - Egyesült Államok, Amerikai Egyesült Államok
Stany Zjednoczone - Egyesült Államok, Amerikai Egyesült Államok
Stany Zjednoczone Ameryki - Egyesült Államok, Amerikai Egyesült Államok
stara panna - vénkisasszony
starek - nagyapa
stare miasto - régi, város
starka - nagymama
starosek - nagyapa
staroszek - nagyapa
starszy - apa
stary - régi
starzyk - nagyapa
statek - hajó
staw łokciowy - könyök
Stefan - István
stół - asztal
stolarz - asztalos
stolica - főváros
stomatolog - fogorvos
strach - félelem, madárijesztő
strach na wróble - félelem, madárijesztő
strąpacz - február, enyheges
straszny - szörnyű
strażak - tűzoltó
strit - sor
strona internetowa - weboldal
strucla - bejgli
struktur - szerkezet
struktura - szerkezet
struna głosowa - hangszál
stryj - bácsi
stryjek - bácsi
strzała - nyíl
Strzelec - Nyilas
styczeń - január
styl - stílus
sudeckoniemiecki - szudétanémet
Sudety - Szudéták
sufit - mennyezet
sukces - siker
sumienność - lelkiismeretesség
sumienny - lelkiismeretes
supermarket - bevásárlóközpont
Surinam - Suriname
Surja - Szúrja
surrealizm - szürrealizmus
suterena - alagsor
swędzić - viszket
świadomość - tudatosság
świat - világ
świeca - gyertya
świecę - gyertya
świekier - após
świekra - anyós
świeść - anyós
Święty Hufiec - szent csapat, szent sereg
Święty Zastęp - szent csapat, szent sereg
świeży - friss
świnia - sertés
świostka - anyós
swok - bácsi
syfilis - szifilisz
Syjam - Sziám
Sylwester - Szilveszter
symbol - jelkép, szimbólum
syn - fiú
synapsa - szinapszis
syndrom miodowy miodowego miesiąca - nászutas szindróma
synkretyzm - szinkretizmus
synonim - szinonima
synowiec - unokaöcs
synteza - szintézis
sypialnia - hálószoba
syra - láb
szabla - szablya
szajs - szar
szałwia - zsálya
szaman - sámán
szantaż - zsarolás
szarlotka - almáslepény
szary - szürke
szaszok - gyáva
szatański - sátáni
szczaw - sóska
szczegół - adat
szczęka - állkapocs
szczęśliwego Nowy Nowego Roku - boldog új évet
szczewik - cipő
szczoteczka do zębów - fogkefe
szczotka - kefe
szczur - patkány
szczypiorniak - kézilabda
szczyt - orgazmus
szechina - Sekina
Szechina - Sekina
szept - suttogás
szeroki - széles
szkita - láb
szklanka - pohár
Szkocja - Skócia
szkoła - iskola
szlag - csapás
szlauch - kígyó
szlips - nyakkendő
szminka - rúzs, ajakrúzs
szneka - arc
sznur - kötél
szok - sokk
szpadel - ásó
szpak - seregély
szpuk - galamb
sztrom - áram
szubienica - akasztófa
szwaja - láb
Szwajcaria - Svájc
Szwecja - Svédország
Szwecyjo - Svédország
szyć - varr
szynal - szög
tableau - tabló
tachykardia - tachycardia
tacik - apa, nagyapa
Tadżykistan - Tádzsikisztán
tajemnica poliszynela - nyílt titok
tajfun - tájfun
tajga - tajga
Tajlandia - Thaiföld
tak - igen
taksonomia - rendszertan
taksydermia - taxidermia
także - is
tal - tallium
talent - adottság
Tallinn - Tallinn
Tamara - Tamara
tangens - tangens
tani - olcsó
tantal - tantál
tapczan - rekamié
tarcza - pajzs, arc
tarcza krystaliczna - pajzs
tarcza strzelecka - pajzs, arc
tarcza szkolna - pajzs
tarczyca - pajzsmirigy
tartrazyna - tartrazin
taśma perforowana - lyukszalag
tchórz - gyáva
tchórzliwy - gyáva
technet - technécium
technologia - technológia
tęcza - szivárvány
tej - te, maga, ön
telewizor - televízió
tellur - tellúr
temat - tárgy, téma
tenis stołowy - asztalitenisz
Teofania - Teofánia
teraz - most
terb - terbium
termit - termesz
Termopile - Thermopülai-szoros
teść - após
teściowa - anyós
teszarz - asztalos
tetragon - négyszög
tetum - tetum nyelv
też - is
Tezeusz - Thészeusz
tg - tg
Timor Wschodni - Kelet-Timor
Tirsa - Tirca f
tisztuch - abrosz
tiul - tüll
tlen - oxigén
tłum - tömeg
tłumaczenie - fordítás
tobie - te, maga, ön
Togo - Togo
toksyna - méreg
topór - fejsze
tor - tórium
tory - tórium
tożsamość - azonosság
trąd - lepra
traktor - traktor
trambimba - villamos
tramwaj - villamos
tramwajka - villamos
transliteracja - átírás
transmigracja - lélekvándorlás
transsubstancjacja - transzszubsztanciáció
tranzystor - rádió
trasa - járat
trawa - fű
troć - pisztráng
tróhła - koporsó
trójkąt - háromszög
Trójmiasto - Hármasváros
trumna - koporsó
trup - hulla
truskawka - eper
trychologia - hajgyógyászat, trichológia
Trynidad i Tobago - Trinidad és Tobago
trzaszczka - szár, szál
trzcina cukrowa - cukornád
trzeźwy - józan
trzmiel - dongó
trznadel zwyczajny - citromsármány
trzymać - tart
tsunami - cunami, szökőár
tudzież - és
tuńczyk - tonhal
tunel - alagút
Tunezja - Tunézia
tunfisz - tonhal
turbina - turbina
Turcja - Törökország
Turkmenistan - Türkmenisztán
turkusowy - türkiz, türkizkék
Turyn - Torino
Tuvalu - Tuvalu
tuzin - tucat
twardość - keménység
twarz - arc
twierdza - vár
twórca - alkotó
tworzyć - alkot
ty - te, maga, ön
Tybet - Tibet
tyj - tea
tylko - csak
typografia - tipográfia
tyrania - zsarnokság
ubierać - öltöztet
ubóstwo - szegénység
uczuć - érzés, érzelem
uczucie - érzés, érzelem
udziec - befogó
ufnal - szög
Uganda - Uganda
UGW - EGMU, GMU
uj - bácsi
ujec - bácsi
ujek - bácsi
ukaz - ukáz
układ okresowy - periódusos rendszer
układ okresowy pierwiastków - periódusos rendszer, kémiai elemek periódusos rendszere
Układ Słoneczny - Naprendszer
Ukraina - Ukrajna
ul. - u.
ulica - utca
umiak - oomiac, oomiak, umiac, umiak, umialak, umiaq
umywalka - mosdó
Unia Europejska - Európai Unió
unikać - elkerül
ununpentium - ununpentium
ununtrium - ununtrium
uón - ő
upał - meleg
uparty - önfejű
upiec dwie pieczenie na jednym ogniu - két legyet üt egy csapásra
upijać - megrészegít
upór - makacsság
Ural - Urál
urologia - urológia
Urugwaj - Uruguay
uzależnienie - függőség
uzasadniać - igazolják
Uzbek - üzbég
Uzbekistan - Üzbegisztán
użyteczny idiota - hasznos idióta
wacha - benzin, eső, tenger, víz
Wag - Vág
Waga - Mérleg
wajco - tojás
wałach - herélt
Walia - Wales
Walijczyk - walesi
waltornia - vadászkürt
waran - sárkánygyík, varánusz
warga - ajak
warstwowy - rétegzett
Warszawa - Varsó
warzyć - főz
wąski - szűk
wat - watt
wata cukrowa - vattacukor
wątpliwość - kétely
Watykan - Vatikán
wąż - kígyó
ważny - fontos
wcześniactwo - koraszülés
wcześnie - korán
wcześniej - korán
wczoraj - tegnap
węborek - vödör
weganizm - veganizmus
wegetarianizm - vegetarianizmus
węgiel - szén
węgierski - magyar
węgorz - angolna
Węgry - Magyarország
wena - ihlet
Wenezuela - Venezuela
wesele - nász
wesoło - vígan
Wesołych Świąt - boldog karácsonyt, kellemes húsvétot
weterynarz - állatorvos
wezwanie - név
wiadro - vödör
wiatr - szél
wideo - videó
widnokrąg - látóhatár
wieczność - örökkévalóság
wieczysty - örök
Wiedeń - Bécs
wiedzieć - tud
wiela - mennyi
wielbłąd - teve
Wielka Brytania - Nagy-Britannia
Wielkanoc - húsvét
Wielkie Antyle - Nagy-Antillák
Wielki Piątek - Nagypéntek
wielobóstwo - többistenhit
wielokulturowość - multikulturalizmus
wielokulturowy - multikulturális
Wielopole - Szélesmező, Valopolya
wieloryb - bálna
wielorybnictwo - bálnavadászat
wielożeństwo - többnejűség
wieprzowina - sertéshús
wierzba - fűzfa
wierzyć - elhisz
wieś - falu
wieśniak - falusi
wietrzny - szeles
więzienie - börtön
Wikipedia - Wikipédia
Wikisłownik - Wikiszótár
Wikiźródła - Wikiforrás
wiktoria - győzelem
wilk - farkas
wimperga - vimperga
wino - bor
winograd - bor
wiolonczela - cselló, gordonka, kisbőgő
wiolonczelista - csellista
wioska - falu
wiosna - tavasz
Wisła - Visztula
wiszczeć - kiált, kiabál
Wit - Vitus
w końcu - végül
władza - tekintély
Włoch - olasz m
Włochy - Olaszország
włos - haj
włoski - olasz
Włoszka - olasz
wnęk - unoka
wnuk - unoka
woda - víz
wóda - pálinka
woda mineralna - ásványvíz
wódka - pálinka
Wodnik - Vízöntő
wodór - hidrogén
wojak - katona
wojna - háború
wojskowy - katona
wokabularz - szótár
wolność słowa - szólásszabadság
woniączka - pálinka
worek - kiszögellés
wosk - viasz
wóz - kocsi
wózek dziecięcy - babakocsi
wózek sklepowy - bevásárlókocsi
wrażenie - benyomás
wreszcie - végül
Wrocław - Boroszló
wróg - ellenség
wrona - varjú
wrzesień - szeptember
wrzód - fekély
wścieklizna - veszettség
wsiok - falusi
wstyd - szégyen
wszędzie dobrze, ale w domu najlepiej - mindenütt jó, de legjobb otthon
wszystkie drogi prowadzą do Rzymu - minden út Rómába vezet
wtorek - kedd
wuj - bácsi
wujek - bácsi
wujko - bácsi
wujo - bácsi
wuszt - kolbász
wy - ti, maguk, önök
wyborca - választó
wybory - választás
wybrzeże - tengerpart
wycieraczka - ablaktörlő
wydma - dűne
wyjątek potwierdza regułę - a kivétel erősíti a szabályt
wyjście - kijárat
wykonalny - végrehajtható
wymowa - kiejtés
wyraz - szó
wysoki - magas
wyspa - sziget
Wyspa Bożego Narodzenia - Karácsony-sziget
Wyspa Świętego Wyspy Świętego Tomasza i Wyspa Książęca - São Tomé és Príncipe
Wyspy Kanaryjskie - Kanári-szigetek
Wyspy Marshalla - Marshall-szigetek
wystarczający - elegendő
wzrok - látás
ząb - fog
żaba - béka
zabijać - agyonüt
zabraniać - megtilt
zachłanny - kapzsi
zadanie domowe - házi feladat
żądło - fullánk
zagadnienie - kérdés
żagiel - vitorla
żaglowiec - vitorláshajó
Zagrzeb - Zágráb
zaimek dzierżawczy - birtokos névmás
zając - nyúl
zakażenie - fertőzés
zakład karny - börtön
zakonnica - apáca
zakonnik - barát
za kratkami - rács mögött
żal - bánat
założyciel - alapító
zamach stanu - államcsíny
Zambia - Zambia
zamieć - hóvihar, hófúvás, hóförgeteg
zapalenie płuc - tüdőgyulladás
zapominalski - feledékeny
żarłok - haspárti, nagyétkű
żart - tréfa, vicc
zaś - újból, ismét
zawistny - irigy, irigykedő
zawód - hivatás
zazdrosny - féltékeny
zazulka - katicabogár
żbik - vadmacska
zbiornik - tartály
zboże - gabona
zbrodnia katyńska - Katyńi vérengzés
zdalasiały - aggódó
zdecydować - elhatároz
zdrzadło - tükör
źdźbło - szár, szál
że - hogy
zebra - zebra
żebrak - koldus
zebranie - gyűlés
żebro - borda
żeby mieć kołaczy, trzeba użyć pracy - aki nem dolgozik, ne is egyék
żeglarz - hajós
żegleń - szén
żelazko - vasaló
żelazo - vas
zelter - ásványvíz
zemsta - bosszú
żeńczyna - nő
zielnik - növénygyűjtemény
Ziemia Święta - Szentföld
ziemniak - burgonya
ziewnięcie - ásítás
zima - tél
Zimbabwe - Zimbabwe
zimnica - láz
zimno - hidegen
zimorodek - jégmadár
ziobro - borda
ziołolecznictwo - gyógynövény
zista - nagymama
Zjednoczone Królestwo - Egyesült Királyság
złodziej - tolvaj
złotnik - ötvös
złoto - arany
zmartwiony - aggódó
zmierzch - alkonyat
zmuszać - kényszerít
znaczenie - értelem
znajomy - ismerős
znak wodny - vízjel
żniwa - aratás
znów - újból, ismét
znowu - újból, ismét
znużenie - bágyadtság
zol - padló
zola - padló
żołądek - gyomor
żółć - epe, sárga
żołnierz - katona
żółty - sárga
żółw - teknősök, teknősbéka
żółw lamparci - leopárdteknős
żongler - zsonglőr
zoolog - állatkert
zoologia - állattan, zoológia
źrebak - csikó
źrebię - csikó
źrebiec - csikó
zręczność - ügyesség
źrenica - pupilla, szembogár, látás, szem
źródło - forrás
zuchwały - szemtelen
zupa - leves
żurawina - tőzegáfonya
żurnalista - újságíró
Zurych - Zürich
Zuzanna - Zsuzsanna
Związek Socjalistycznych Republik Radzieckich - Szovjet Szocialista Köztársaságok Szövetsége
zwierciadło - tükör
zwierzak - állat
zwierzę - állat
zwrotnica - kitérő
zwycięski - győzelmes
zwycięstwo - győzelem
życie - élet
żydożerstwo - antiszemitizmus
żyła - véna
żyletka - borotvapenge
zymft - mustár
zyprazydon - ziprazidon
żyrafa - zsiráf
żyrandol - csillár
żywe srebro - higany
żywić - eszik
