abazja - abasia f
abdykować - abdicare
abecadło - alphabetum n, abecedarium n
Abelard - Abaelardus, Abelardus
abfal - purgamen, purgamentum, anomalia f
Abidżan - Abidjan
abiecadło - alphabetum n, abecedarium n
abituria - abitus
ablatyw - ablativus
aborcja - abortus m, abortiō f
Abraham - Abraham
absencja - absentia
absolucja - absolutio
absolut - absolutus
absolutny - absolutus
absolutorium - absolutorium
absolutyzm - absolutus
aby - ut
aceton - acetonum n
acetylen - acetylenum n
Achilles - Achilles m
Adam - Adamus m
adapter - discophonum
adorować - adorare
adwena - advena
adwent - adventus
adwentnik - December m
adwokat - advocatus m
adwokat Boga - advocatus Dei
adwokat diabła - advocatus diaboli
adyton - adytum n
afa - simia f, simius m
afekcja - affectio
afekt - affectus
afektacja - affectatio
afektować - affectare
Afganistan - Afgania, Afganistania, Ariana
afonia - aphonia f
Afryka - Africa f
afta - aphtha, apta
Agata - Agatha f
agawa - Agave, agave
agresja - aggresio
akacja - acacia
akadyjski - accadicus
akordeon - harmonica diductilis
aksolotl meksykański - Ambystoma mexicanum f
aktorka - actrix
aktyn - actinium n
akuzatyw - accusativus
akwedukt - aquae ductus
Akwileja - Aquileia f
akwilejczyk - Aquileienses
akwilejski - Aquileiensis
Akwilon - Aquilo m
Akwitania - Aquitania f
Akwizgran - Aquisgranum
Albania - Albania f
Aldebaran - Aldebaran
ale - autem, sed
alegoria - allegoria f
Aleksander - Alexander m
Aleksandra - Alexandra f
Aleksja - Alexia
alfabet - alphabetum n, abecedarium n
alfabetu - alphabetum n, abecedarium n
Alfred - Alfredus
Algieria - Algerium
algorytm - alrogithmus m
aligator - aligator
alkan - alkanum n
alken - alkenum n
alkin - alkinum n
Alkione - Alcyone f
alkoholizm - alcoholismus
almanach - kalendarium
Alojz - Aloisio, Aloysius
Alojzy - Aloisio, Aloysius
aloza - Alosa alosa
aluminium - aluminium
Alzacja - Elisatia
Amadeusz - Amadeus
amajza - formīca f
Amalia - Amalia
ambirz - zingiber
Ambroży - Ambrosius m
ambus - incus
ambystoma meksykańska - Ambystoma mexicanum f
ameryk - americium n
Ameryka - America f
Amilkar - Hamilcar m, Amilcar m
aminokwas - acidum aminicum n
amlodypina - amlodypinum
amputacja - amputatio
Amu-daria - Oxus
amur biały - Ctenopharyngodon idella
Ananke - Necessitas f, Anance f
Anastazja - Anastasia
anatomia - anatomia f
Andaluzja - Vandalitia f
Andrea - Andrea
andromeda - andromeda
Andromeda - Andromeda
Andrychów - Andrichovia
Andy - Andes
anemia - anaemia
Anglia - Anglia f
Anglija - Anglia f
ani - nec
Aniela - Angela f
anioł - angelus m
Anioł - Angelus m
aniżeli - quam
anjoł - angelus m
anomalia - anomalia f
Antananarywa - Antananarivo
Antares - Antares
Antarktyda - Antarctica
Antoni - Antonius m
Antonia - Antonia
Antonina - Antonina f
antykwariusz - antiquarius
antykwarz - antiquarius
Antyle Holenderskie - Antillae Nederlandenses
antymon - stibium n, antimonium n
Anzelm - Anselmus
aorta - aorta f
Apeliotes - Solanus m
Apeniny - Apenninus
Apia - Apia
aprobować - approbo
apryl - Aprilis m
ara - Ara
Arabia Saudyjska - Arabia Saudiana
arabika - Coffea arabica
archanioł - archangelus
architraw - epistylium
arcykapłan - pontifex m
areszt domowy - custodia libera
argon - argon n
Arkadiusz - Arcadius m
Arktur - Arcturus
armia - vires f, exercitus m
armijo - vires f, exercitus m
arsen - arsenicum
arteria - arteria
arytmia - arrhythmia f, arrythmia f
asafetyda - asafoetida
Asklepios - Aesculapius m
aspiryna - Acidum acetylosalicylicum n
asta - termes m
astma oskrzelowa - asthma bronchiale
astma sercowa - asthma cardialis
astrofizyka - astrophysica f
astrolog - astrologus m
astronom - astronomus m
astronomia - astronomia
astronomio - astronomia
Asyria - Assyria
asystent - asystenta
atawizm - atavismus m
ateista - atheos
Ateny - Athenae
ateusz - atheos
atrium - atrium
Augiasz - Augeas m
August - Augustus m
Augustyn - Augustinus m
aulos - aulus m
Aureliusz - Aurelius m
auspicje - auspicium
Auster - Auster, Notus
Austria - Austria f
Austro-Węgry - Austro-Hungaria f
autor - autor
autyzm - autismus
Azerbejdżan - Adrabigania
Azja - Asia f
azot - nitrogenium n
B - accusativus
Bachus - Bacchus m
Badenia-Wirtembergia - Badenia-Virtembergia
bagno - Ledum
bajzel - lupanar n
bakałarz - magister m
Bałtyk - Mare Balticum
bandzioch - venter m
bania - cucurbita f
bar - barium n
Baran - Aries m
Baranek Boży - Agnus Dei m
barchan - barcanus
barok - barocus
Bartłomiej - Bartholomaeus m
barwa - color m
barwena - Barbus barbus
barzoł - Ledum
bas - venter m
basior - flagellum n
basza - cibaria, cibus m, pabulum n, pastus m, caballatio f, capitum n, capetum n
bażant - Phasianus colchicus
Bazylea - Basilia
Bazylisa - Basilissa f
Beatrycze - Beatrix f
beatyfikacja - beatificatio
bebech - venter m, stomachus m
bęben - venter m
bębenek - membrana tympani f
beczeć - lacrimo
befsztyk - caro costalis assa
bejc - potor m
bejm - pecunia f
bele kaj - ubicumque, alicubi, quacumque, sicubi
belfer - magister m
Bellona - Bellona f
belona - Belona belona
Beniamin - Beniaminus m
Benin - Beninum
benzokaina - benzocainum n, anaesthesinum, etoformium, aethylum aminobenzoicum, aethylium p-aminobenzoicum, ethylis aminobenzoas, aethylis aminobenzoas, anaesthinum
Beocja - Boeotia f
Berenika - Berenice f
Bergamo - Bergomum
berkel - berkelium n, bercelium
beryl - beryllium n
bety - paiama
bez - sambucus, sine, syringa
bez- - in-, il-, im-, ir-
beze - sambucus, sine, syringa
bezimienny - innominatus
bez pracy nie ma kołaczy - sine labore non est panis in ore / sine labore non erit panis in ore
bez pracy nie ma płacy - sine labore non est panis in ore / sine labore non erit panis in ore
Białoruś - Russia Alba
biały - albus, blancus, candidus
biały kruk - rara avis f
Biblia - Biblia f
bicz - flagellum n
biedronka - coccinella f
bieg - cursus m
biegać - currere
biegunka - diarrhoea f
biegus zmienny - Calidris alpina
biernik - accusativus
bilirubina - bilirubinum n
bindał - cincticulus
bindasz - penis m, sopio m, sopitio f, mentula f, cauda f, coda f, membrum virile n
binks - lapsus m
binol - lapsus m
biochemia - biochemia
biografia - biographia f
biskup - episcopus m
bitwa pod Termopilami - pugna ad Thermopylas f
Bizancjum - Byzantium n
bizmut - bisemutum n
błagać - orare, implorare, deprecari, exorare, supplicare, comprecari, obsecrare
błaganie - invocatio
blasfemia - blasphemia f
Błażej - Blasius m
błecha - pulex m, pulix m
błędne koło - circulus vitiosus, circulus in demonstrando, circulus in definiendo, idem per idem
bliski - arest
Bliźnięta - Gemini
błona bębenkowa - membrana tympani f
bluszcz - hedera f, edera f
błyskawica - fulgur n
bo - quia, quod, quoniam, cum, propter
bób - faba f
bóbr - castor m
bóg - deus m
Bóg - Deus m
Bogu świeczka, a diabłu ogarek - uni sacrificio, ut prosit, alteri, ne noceat
Bohemia - Bohemia, Czechia f, Tzechia
bohr - bohrium n
bojaźń - timor
boleściwy - dolorosus
Bolonia - Bononia f
Bonifacy - Bonifatius m
bor - borium n, borum n
Boreasz - Boreas m, Aquilo m
borelioza - borreliosis
borowik - boletus
Borys - Boris
botulizm - botulismus m
boża krówka - coccinella f
Boży Grób - Sanctum Sepulchrum
brachol - frater
bracianek - patruelis m
bracieniec - frater
bransoleta - armilla f
brat - frater
bratanek - fratris filius m
bratanica - fratris filia f
brat cioteczny - matruelis m
braterstwo - fraternitas
brat mniejszy - frater minor
brat stryjeczny - patruelis m
Bratysława - Posonium
brawo - macte, macte animo, euge, poeta
brąz - aes n
brązowy - aereus
Brazylia - Brasilia
broda - barba f
broda mędrcem nie czyni - barba non facit philosophum
brodawczak - papilloma n
brodziec śniady - Tringa erythropus
brom - bromium n
broń - tēlum n, ferrum n, arma n
browar - cervisia, cerevisia
brozda - sulcus
brudzić - inquino
bruzda - sulcus
bryndza - caseus vlachiscus m
brzana - Barbus barbus
brzmienie - sonus m
brzoza - betula
brzuch - venter m
brzuchomówca - ventriloquus m
brzusiec - venter m
brzydki - foedus, turpis
brzytwa - novacula f
buda - schola f, collegium n, ludus m
budowla - exstructio f
budynek - diaeta f
buk - fagus f
bukowy - faginus, fagineus
buła - musculus
bułka - musculus
burchel - vesicam
bursztyn - glaesum n, glesum n, electrum n, sucinum n
burzowiny - cervisia, cerevisia
but - calceus m
butan - butanum n
buzi - basium n, osculum n
być - esse, adesse
Bydgoszcz - Bidgostia
bydło - taurus
Byk - Taurus m
bylica piołun - Artemisia absinthium
bździuch - mephitis
C - dativus
całki - totus, omnis
całkiem - plane, omnino
całować - basiare, osculari
całus - basium n, osculum n
cały - totus, omnis
c.b.d.o. - Q.E.D.
cebula - cepa f
cecha - genus
cedr - cedrus f
Cefeusz - Cepheus m
Celestyn - Caelestinus m
celownik - dativus
celtycki - Celtus
cel uświęca środki - exitus acta probat
cenotaf - cenotaphium n
centurion - centurio
cer - cerium n
cera - filia f
Cerber - Cerberus m
Cerera - Ceres
Ceres - Ceres
cesarski - dominicus
cetyryzyna - cetirizinum n
cez - caesium n
chaber piękny - Centaurea pulcherrima
chachoł - collum n
chachor - potor m
chamera - nubes, nubis f, nubs f, nebula f, nimbus m, aer m
charakterystyka - characteristica f
charlać - tussio
chcieć - malo, volo
chciwy - avidus, cupidus
chemia - chemica
chemia biologiczna - biochemia
Cheronea - Chaeronea
Cheroneja - Chaeronea
Chiny - Sina, Sinae
chirus - potor m
chitozan - chitosani hydrochloridum
chlać - bibo
chleb - panis m, pane m
chlew - hara f
chłodny - frigidus
chlor - chlorium n, potor m
chlorek sodu - natrii chloridum
Chloris - Chloris
chlormetyna - chlormethinum n
chmiel - Humulus m, humulus m, cervisia, cerevisia
chmura - nubes, nubis f, nubs f, nebula f, nimbus m, aer m
choćby - ut, si, etsi, tametsi, denique, saltem, utque, dumtaxat, vel, velut, veluti, ad exemplum, exempli gratia
chocieć - malo, volo
chód - gressus m, itus m
choinka - arbor natalicia f
chójk - arbor natalicia f
chomik - cricetus m
chór - chorus m
choroba - aegritudo
choroba von Willebranda - morbus von Willebrandi
chrom - chromium n
chromy - claudus
chrypka - raucitas f
Chrystus - Christus m
chryzopraz - chrysoprasius
chrzestna - commater f
churchać - tussio
chwalebny - laudabilis
chwost - cauda f, coda f
ciało szkliste - corpus vitreum
ciebie - tu
ciecierzyca pospolita - Cicer arietinum
cielesieństwo - actus sexuales
ciemnia - camera obscura f
ciemnia fotograficzna - camera obscura f
ciemnoskóry - ater, furvus, fuscus
cień - umbra f
ciepło - calor
ciernisty - spinosus
cieśń gardzieli - isthmus faucium
cieszyć - gaudere, laetari
ciężki - gravis m, f
ciocia - matertera
ciorać - inquino
ciotka - amita
cis - taxus f, larix
cis japoński - taxus cuspidata
cis pospolity - taxus baccata
citalopram - citalopramum n
ciurlocek - penis m, sopio m, sopitio f, mentula f, cauda f, coda f, membrum virile n
ciżma - calceus m
ćma - papilio m
ćmik - sigarellum, fistula nicotiana
cnota - virtus f
cołki - totus, omnis
córa - filia f
córczysko - filia f
córka - filia f
coś jest na wodzie pisane - in aqua scribis
co wolno wojewodzie, to nie tobie, smrodzie - quod licet Iovi, non licet bovi
cud - miraculum
cudzołożnica - moecha f
cukier - saccharum
cupać - tussio
CV - CV
ćwiczenie czyni mistrza - repetitio est mater studiorum
ćwierćfinał - quarterfinalis
cyferblat - facies f
cygan - fraudator m
cygareta - sigarellum, fistula nicotiana
cygaretka - sigarellum, fistula nicotiana
cyklofosfamid - cyclophosphamidum n
cykoria - Cichorium n, cichorium n
cyna - stannum n
cynk - zincum n
Cyprian - Cyprianus m
cyprofloksacyna - ciprofloxacinum n
cyraneczka - anas crecca
Cyrenajka - Cyrenaica
cyrk - circus
cyrkon - zirconium n
Cyryl - Cyrillus m
cytryńcowate - Schisandraceae
cywilizacja - civilizatio
czad - monoxidum carbonii, monoxidum carbonis
czarna dziura - gurges ater
czarna porzeczka - ribes nigrum
czarnogłówka zwyczajna - Poecile montanus
Czarnogóra - Mons Niger
czarnoskóry - ater, furvus, fuscus
czarnowron - Corvus corone
czarny - ater, cacabatus, caccabatus, furvus, fuscus, morulus, niger, nigrans, nigricolor, piceus, picinus, pulleiaceus
czarny bez - ebulum n, ebulus m
czas - tempus n
czasownik - verbum n
czasownik ułomny - verbum defectivum n
czaszka - calva f
czciciel - cultor m
Czechy - Czechia f, Tzechia
Czeczenia - Tsetsenia
czernica - rubus m
czerwiec - Iunius
czerwone jagody - fragum n, fraga
czerwonobrzuchy - rubriventris
cześć - honor, salve, ave
część - pars f
część mowy - pars orationis
czeski - cechicus, czechicus, bohemicus
często - saepe
częstoskurcz - tachycardia f
częsty - frequens
czkawka - singultus
członek - penis m, sopio m, sopitio f, mentula f, cauda f, coda f, membrum virile n
człowieczy - humanus
człowiek - homo m
człowiek człowiekowi wilkiem - homo homini lupus est
człowiek neandertalski - Homo neanderthalensis, Homo sapiens neanderthalensis
czopek - suppositorium
czorny - ater, cacabatus, caccabatus, furvus, fuscus, morulus, niger, nigrans, nigricolor, piceus, picinus, pulleiaceus
czwartek - dies jovis
czy - an, num, -ne, utrum... an..., aut, vel
czyhunka - thorium n
czyrak gromadny - carbunculus m
czyrak mnogi - carbunculus m
czyrwiec - Iunius
czyrwień - Iunius
czyściec - purgatorium n
czysty - mundus
czytać - legere
D - genitivus
dąb - Quercus m, quercus m
dąb korkowy - suber n
dach - tectum n
Dafne - Daphne f
Dagestan - Daghestania
daktyl - dactylus m
dalekowzroczność - hyperopia f
Dalmacja - Dalmatia
dalmatyka - dalmatica f
dama - regina f
Dania - Dania f
darmsztadt - darmstadtium n
dawca - dator m
decyzja - decisio
de facto - de facto
definicja - definitio
deflacja - deflatio f
Deimos - Dimos
deklamować - declamare
dekret - decretum
dekspantenol - Dexpanthenolum
delfin - delphinus m, delphin m, Delphinus m
Delfin - Delphinus m
demografia - demographia f
demokracja - democratia
deportować - deporto
dereń - Cornus m, cornus m
destrukcyjny - destructivus, calamitosus, damnosus, exitiabilis, exitialis, exitiosus, fatifer, funestus, internecivus, mortifer, pemeptorius, perniciabilis, pernicialis, perniciosus, pestifer
deszcz - pluvia f
deżdż - pluvia f
diadem - diadema
diagnoza - diagnosis f
diakon - diaconus m
diakoni - diaconus m
Diana - Diana
dieta - diaeta f
dihydralazyna - dihydralazinum n
Dike - Dice, Dike
dioda - diodus m
Diogenes - Diogenes m, Diogenes m (Cynicus, Sinopensis)
Dionizos - Bacchus m
dla - pro, ob
długo - longe, diu
dłuto - caelum n
dmuchać - futuere
DNA - DNA, ADN
Dniepr - Danapris m, Borysthenēs m
dno - fundus
dobranoc - bonam noctem
dobry - bonus
dobry wieczór - bonum vesperum
Dodekanez - Dodecanesus
do greckich kalend - ad Kalendas Graecas
dojrzewanie - adolescentia
dokonany - perfectum
doktor - medicus m
dokuczliwy - ater, atrox, niger, spinosus
dołek - fossa
dom - domus f, gens f
domagać się - postulo
domowy - domesticus
dom publiczny - lupanar n
dopełniacz - genitivus
dopełnienie - obiectus
dopóki - dum
doradca - consiliarius m
doś - quot
doskonałość - perfectio f, summum n, praeclaritas f
do szczęta - funditus
doszczętnie - funditus
do widzenia - ave, vale
dowódca - ductor m, dux m
do zobaczenia - ave, vale
dratewka - sutor m
drewniany - līgnĕŏlŭs, līgnĕŭs
droga - iter n, via f
Droga Mleczna - Via lactea
dromader - dromas m
druga wojna światowa - Bellum Orbis Terrarum II
drwina - dicterium n
drzewo - arbor f
dubn - dubnium n
duchowość - spiritalitas f
Duch Święty - Spiritus Sanctus m
dudlać - lacrimo, bibo
dudy - pulmo m
dukat - ducatus
Dunaj - Danubius
dunajski - danubialis
dupa - culus, podex
dupek - culus m
dusza - anima f
dutek - pecunia f
duży - magnus, altus
dwoinka zapalenie zapalenia płuc - streptococcus pneumoniae
dwutlenek węgla - carbonii dioxidum, dioxidum carbonis, dioxydum carbonis
dychawica oskrzelowa - asthma bronchiale
dychawica sercowa - asthma cardialis
dycht - plane, omnino
Dydak - Didacus m
dydaktyczny - didascalicum
dygestia - digestio f
dyktator - dictator m
dymbcok - Quercus m, quercus m
dymić - fumare
dynia - cucurbita f
dyplom - diploma n
dysfagia - dysphagia f
dysfonia - dysphonia f
dysk - discus m
dysproz - dysprosium n
dysputacja - controversia
dywagacja - divagatio f
dywan - tapes m, tapete n
dziabka - sarculum n, sarculus m
dziadek - avus m
działać - gerere
dzieciobójstwo - infanticidium n
dzięcioł - picus, picumnus
dzięcioły - Picinae
dziela - pro, ob
dzielić - dividere
dzieło - opus
dzień - dies, lux f
dziennikarstwo - diurnalismus m
dziesięciolecie - decennium n
dziewa - virgō f
dziewica - virgō f
dziewierz - levir m
dzik - aper
dziób - rostrum m
dziś - hodie
dzisiaj - hodie
dżuma - pestis f
dżungla - silva tropica f
dźwięk - sonus
edyficjum - diaeta f
Edyta - Editha
Egina - Aegina f
Egipt - Aegyptus m
egzoksiężyc - exoluna f
einstein - einsteinium n
-ek - lus
ekologia - oecologia
ekologio - oecologia
ekonazol - econasolum n
ekskomunika - anathema
ekskomunikować - excommunicare
ekstremalny - extremus
ekstremum - extremum
ekwipunek - vas n
elefant - elephantus m, barrus m, elephas m
Eliasz - Elias m
Eligiusz - Eligius m
Elza - Elisabetha f, Elisabeth f
Elżbieta - Elisabetha f, Elisabeth f
Emili - Aemilia
Emilia - Aemilia
encyklopedia - encyclopaedia
Endymion - Endymion m
Eolia - Aeolia, Aeolis
Eos - Eos f, Aurora f
epistoła - epistola
epitafium - epitaphium
Erato - Erato f
erb - erbium n
Eris - Eris
Eryda - Eris
Erydan - Eridanus m
eskalator - scalae versatiles
eskulap - medicus m
Eskulap - Aesculapius m
esperanto - Esperanto
Estonia - Estonia f
etamsylat - etamsylatum, ethamsylatum n
etan - ethanum n
eten - ethenum n, ethylenum n
Eter - Aether
etin - ethinum n, aethinum n
Etiopia - Aethiopia f
Etolia - Aetolia f
etopozyd - ethoposidum, etoposidum n
Etruria - Etruria f, Hetruria f
etruski - Etruscus, Hetruscus
etylen - ethenum n, ethylenum n
etymologia - etymologia f
etyn - ethinum n, aethinum n
Eugeniusz - Eugenius m
Eunika - Eunice f
europ - europium n
Europa - Europa
Euros - Eurus m, Vulturnus m
Eurus - Vulturnus m, Eurus m
Euterpe - Euterpe f
ewangelia - evangelium n
ewangeliarz - evangeliarium m
Ewaryst - Evaristus m
ewokacja - evocatio
ewokować - evocare
Ezdrasz - Esdra, Esdras, Esra
Ezop - Aesopus m
facet - vir, -i m
facetka - femina, -ae, mulier, -is
facjata - facies f
-fagia - -phagia
fajek - sigarellum, fistula nicotiana
fajerwer - sigarellum, fistula nicotiana
fajfus - penis m, sopio m, sopitio f, mentula f, cauda f, coda f, membrum virile n
fajka - sigarellum, fistula nicotiana
falerno - Falernum n, Falernus m
fallus - phallus
familio - familia f
famotydyna - famotidinum
famuła - familia f
faryna - saccharum
fasola - phaseolus
Fawoniusz - Favonius m
fazan - Phasianus colchicus
Feliks - Felix
fenek - vulpes zerda, fennecus zerda
fenestracja - fenestratio f
ferm - fermium n
fezeła - apis f
Fidelis - Fidelis m
figa - ficus
figowiec - ficus
figowy - ficulnus
fikus - ficus
filip - lepus
Filip - Philippus m
Filoktet - Philoctetes m
filozof - philosophus
filozofia - philosophia f
finalizować - finire
Finlandia - Finnia
fioł - Viola, viola
fiołek - Viola, viola
fizjologia - physiologia
fizjologiczny - physiologicus
fiżon - phaseolus
flerow - flerovium n
Florencja - Florentia
Florian - Florianus m
fluor - fluor
Fobos - Phobus m
Focjusz - Photius m
fojerman - vigil ignis
foka - phōcā f
folga - requies f
formoterol - formoterolum
fort - castellum
fortuna - fortuna f
forum - forum
Francja - Gallia
frans - francium n
fregata białobrzucha - Fregata andrewsi
fregata mała - Fregata ariel
fregata orla - Fregata aquila f
fregata średnia - Fregata minor
fregata wielka - Fregata magnificens
fryzjer - tonsor m, tosor m
fryzjerka - tonstrix f
funkcja - functio f
furosemid - Furosemidum n
g - g
gad - reptile n
gadolin - gadolinium
Gaja - Gaea f
gal - gallium n
gała - oculus m, corvus m, cornix f
galarypa - Brassica oleracea var. gongyloides, caulorapa
gałąź - termes m
Galia - Gallia f
Galilea - Galilaea f, Galileia f
ganc - plane, omnino
gapa - corvus m, cornix f
gara - somnus
garb - gibba f, gibber n, gibbus m
gasa - via, vicus
Gdańsk - Gedania f, Dantiscum
gdy kota nie ma, myszy harcują - audacem reddit felis absentia murem
gdyż - quia, quod, quoniam, cum, propter
gdzie - ubi, ubinam
gdziekolwiek - ubicumque, alicubi, quacumque, sicubi
gędźba - musica f
genialny - ingeniosus
Genowefa - Genovefa f
gentamycyna - gentamicinum n
Genua - Genua
geografia - geographia
geologia - geologia
german - germanium n
Germania - Germania f
gest - gestus m, motus m
ginekomastia - gynecomastia f
gitara - cithara
glacok - calvus
gladiator - gladiator m
gładkość - levitas f
glajza - thorium n
glapa - cornix f
gleba - terra f
glin - aluminium
Gliwice - Glivitium
głód - esuries f, esuritio f, inedia f, ieiunium n, fames f
Głogów - Glogovia
głos - sonus m
głosowy - vocalis
główka - ultimum supplicium
Głuchołazy - Capricolum
głuchota - surditas f
gnat - os, talus m, tessera f
Gniezno - Gnesna
gnój - fimum n, fimus m
gnu - connochaetes
godać - dico
godka - lingua f
godność - dignitas f
godoć - dico
gołąb - columba f, columbus m
golarz - tonsor m, tosor m
gołębi - columbinus
gołębnik - columbarium
goleń - crus
golibroda - tonsor m, tosor m
golić - tondeo
goły - nudus
gongil - destillatio f, catarrhus m, rheuma f
goniec - cursor m, nuntius
góra - mons m
górą - mons m
Górny Śląsk - Silesia Superior f
gorycz - amaritas f
gówno - merda
graba - manus m
gracz - lusor m
gramofon - discophonum
grawiton - graviton n
Grek - Graecus m
Grób Pański - Sanctum Sepulchrum
gromada - grex, divisio, classis
gromadzić - cumulo, grego, adgrego, aggrego, congrego
grudzień - December m
grula - brutus
grusza - pirus f
gruszka - pirum n
gruszyczka - Pyrola f, pyrola f
gruźlica - tuberculosis
gryf - gryps m, gryphus m, grypus m
Gryfice - Griphemberch
grzbiet - dorsum n, spina f
grzech - peccatum n
Grzegorz - Gregorius m
grzeszyć - pecco
grzmot - tonitrus m, tonitruum n
guli - quia, quod, quoniam, cum, propter
Gustlik - Augustinus m
gwiazda - stella f, astrum n, Myriostoma
gwiazdarz - astronomus m, astrologus m
gwiazdozbiór - constellatio
gwiaździarz - astronomus m, astrologus m
gżegżółka - cuculus m, meretrix f
gzub - venter m
haczka - sarculum n, sarculus m
hafn - hafnium n
hajtok - culter m
halucynacja - hallucinatio f
Hamilkar - Hamilcar m, Amilcar m
Hana - Hanakia
hańba - infamia f
has - hassium n
haś - purgamen, purgamentum
Hazdrubal - Hasdrubal m, Asdrubal m
Hefajstos - Hephaestus m
Hekata - Hecate f
Hekate - Hecate f
hel - helium n
Helios - Sol m, Helius m
hełm - cassida f, cassis f
heparyna - heparinum n
Hera - Hera f
herb - sigillum n
herbarz - herbarium
heretycki - haereticus
Herod - Herodes m
hetman - regina f
hiacynt - hyacinthus m, hyacinthos m
Hiacynt - Hyacinthus m
Hieronim - Hieronymus
Hilaria - Hilaria f
Hilary - Hilarius m
Himalia - Himalia
hinduizm - hinduismus
hipokorystyk - hypokorisma f
hipomagnezemia - hypomagnesaemia f
hipopotam - hippopotamus m
historia - historia
historyk - Rerum gestarum scriptor
Hiszpania - Hispania f
hiszpanka - Morbus Hispanicus
hodologia - hodologia f
holajza - caelum n
holm - holmium
homar - locusta f
homeopatia - homeopathia f
Hongkong - Hongcongum
Horacy - Horatius m
Horeb - Horeb m
Horus - Horus
humerał - amictus m
humorystyczny - facetus
Hun - Hunnus m
hybryda - hibrida f, hybrida f, ibrida f
Hydra - hydra f, excetra f
Hyperion - Hyperion
Hypnos - Somnus m
i - et, at, atque, -que
ibis - ībis m
idarubicyna - idarubicinum n
ideologia - ideologia
idy - idus
igła - acus
II wojna światowa - Bellum Orbis Terrarum II
ile - quot
imbir - zingiber
imię - nomen n
imiesłów - participium n
imikwimod - imiquimodum n
imipenem - imipenemum n
imperium - imperium n
ind - indium
inercja - inertia
infekcja - infectio
infekcyjne zapalenie stawów - arthritis infectiosa
Inflanty - Livonia
influenca - influentia
informacja - informatio
ingrediencja - ingredientia
inkomodować - incommodare
inkszy - alius
inny - alius
ino - solum, solummode
insularny - insularis
insurekcja - insurectio
inteligencja - intelligentia
intencja - intentio
intensywny - amplus
interwencja - interventio
interwenient - interventio
interweniować - interventio
introspekcyjny - introspectus
inundacyja - diluvium n, inundatio f
inwencja - inventio
inwentaryzacja - inventarium
inwentarz - inventarium
inwokacja - invocatio
iny - alius
iperyt - yperitum n
iperyt siarkowy - yperitum n
Irena - Irena
Iris - Iris f
ironia - ironia f
iryd - iridium n
Iryda - Iris f
iść - eo, ire, itum
iskra - scintilla f
Islandia - Islandia
istnieć - sum
Itaka - Ithaca
itd. - etc.
iterb - ytterbium n
itr - yttrium n
izba - pax f, cella
ja - ego
jabłko - malum, -i n
jabłko Adama - pomum Adami
Jaćwież - Sudovia f, Jatvesonia f
jadłospis - diaeta f
Jadwiga - Hedvigis f
Jahwe - Iehova m, Iehovah m
jajko - ovum n
jajo - ovum n
jaki - qui
jakkolwiek - utut, ut ut
jak Kuba Bogu, tak Bóg Kubie - qui dicit que vult, audit que non vult
jakmiarz - plane, omnino
Jakub - Iacobus, Iacomus
jałmużna - elemosina f
jałowiec - iunipirus f, iuniperus f, cedrus f
jama bębenkowa - cavum tympani n, cavitas tympani f
jama ustna - cavum oris
Jan - Ioannes
jantar - glaesum n, glesum n, electrum n, sucinum n
japa - cavum oris
Japonia - Iaponia f
jarecka - mater
jarzyna - olus n, holus n
jaskółka - hirundo f, irundo f
jaśmin - jasminum
Jasna Góra - Clarus Mons, Mons Clara
jasny - clarus
jaszczurka - lacerta f, lacertus m
jebać - futuere
jebadło - cubiculum n, cubile n, lectus m
jęczmień - Hordeum n, hordeum n, ordeum n, hordeolus m
jeden za wszystkich, wszyscy za jednego - unus pro omnibus, omnes pro uno
jedlina - abies f
jednooki - luscus, unoculus
jednorożec - rhinoceros m
jedność - unitas f
jej - sua
jelonek - Lucanidae
jelonek rogacz - Lucanus cervus m
jemioła - viscum n
Jeruzalem - Hierusalem
Jerzy - Georgius m
jesion - ornus f
jesiotr - acipenser m, acipenseris m, acupenser m, acupenseris m
jeśli - si
jest - esse, adesse
jeż - erinacaeus m
jeżeli - si
jezioro - lacus
Jezus - Iesus m
Jezus Chrystus - Iesus Christus
język - lingua f
jeżyna - rubus m
jidysz - lingua iudaeogermanica
jod - iodium n
jodła - abies f
jodłowy - abiegineus, abiegneus, abiegnus
Jokasta - Iocasta f
Jowisz - Iuppiter
józefinizm - Iosephinismus m
judaszowy pocałunek - milliarium
Judea - Iudaea f
juliański - Iulianus
juny - iuvenis m, f
Jupiter - Iuppiter
Jur - Georgius m
jutro - cras
Jutrzenka - Eos f, Aurora f
juwenalia - Iuvenalia n
kaban - porcus m, sus f
kabergolina - cabergolinum n
kac - crapula
Kacper - Caspar m
kadm - cadmium n
kadubek - Sagina f
kaduceusz - caduceus m
kadzidło - incensum n
Kafarnaum - Capharnaum
Kair - Cairus
kaj - ubi, ubinam
kakao - anus m
kąkol - lolium, Agrostemma
kalafa - facies f
kalarepa - Brassica oleracea var. gongyloides, caulorapa
kalectwo - debilitas f
kalejdoskop - calidoscopium
kalendarz - kalendarium
kalendy - Kalendae, Calendae
kalfas - venter m
kaliforn - californium n
kalifornijski - californicus
Kaliopa - Calliope f
Kalisz Pomorski - Nova Calisia
kalumnia - calumnia
kam - ubi, ubinam
kamasz - calceus m
Kamil - Camillus m
kamyczek - calculus
Kanada - Canada f
kandydat - candidatus m, petitor m
kangur - macropus m
kania - milvus m, miluus m
kaniła - cucullus m
Kapitol - Capitolium m
Kaplica Sykstyńska - Sacellum Sixtinum m
kapować - intelligere, intellegere, sapere
kapryfolium - caprifolium n
kaptur - cucullus m
kapusta - pecunia f
karaba - felis
karabin maszynowy - polybolum
karacena - corazina, coratina, coratium
kara śmierci - ultimum supplicium
karbunkuł - carbunculus m
kardamon - cardamomum
kardiolog - cardiologus
kark - collum n
karmnik - Sagina f
karygodny - culpabilis
Kasandra - Cassandra f
Kasjopea - Cassiopea, Cassiopeia
Kasjopeja - Cassiopea, Cassiopeia
Kassandra - Cassandra f
Kastor - Castor m
kastrat - castratus m
kaszleć - tussio
Katalonia - Catalonia
kataloński - catalana
katana - crapula
katar - destillatio f, catarrhus m, rheuma f
katarakta - cataracta
Katarzyna - Catharina f
katastrofa - calamitas
katechizm - catechismus m
katechumen - catechumenus
katoda - Cathodus m, Kathodus m
kaucja - cautio
kawa arabska - Coffea arabica
kawa wesoła - lupanar n
kawka - monacha f
kaznodzieja - praedicator m
kciuk - pollex, digitus primus
kędy - ubi, ubinam
kędzierzawy - crispus
kejter - canis m
Kenia - Kenia
kenotaf - cenotaphium n
kenotafium - cenotaphium n
kiełbaska - hilla f
Kielce - Civitas Kielcensis
kimeryjskie ciemności - Cimmeriae tenebrae
kimono - somnus
kiszka - lactus
kiur - curium n
kłąb - cucula f, thenar
kłącze - rhizoma
klajdać - vesto
kłamca - mendax, falsus, falsidicus
kłamczuch - mendax, falsus, falsidicus
kłapaczka - os n
klara - sol m
kłaść - pono
klatka - thorax
klatka piersiowa - thorax
Klaudia - Claudia f
kłębek - glomus n
klej - gluten n
klejnot - gemma f
klęska - malum n
Klio - Clio f
klon - acer n
klucz - clavis f
kminek - cumīnum n
kmin rzymski - Cuminum cyminum
kniądz - princeps m, dux m
knipa - liber m
kobalt - cobaltum n
kobiecy - femineus, femininus
kobieta - femina, -ae, mulier, -is
koc - tapes m, tapete n
kochać - amare
kochan - amator m, adulter m
kochanek - amator m, adulter m
kociamber - felis
kociokwik - crapula
kocioł - cortina f
Kocyt - Cocytus m
kodeina - codeinum n
koja - cubile n, lectus m
kojo - cubile n, lectus m
Kokytos - Cocytus m
kolano - genu n
kolba - spadix
kołczan - corytos m, gorytos m, gorytus m, pharetra f
kolczasty - spineus, spinosus
kolegium - collegium m
kolekcjonować - colligere
kolendra - coriandrum
koleś - vir, -i m
Kolonia - Colonia Agrippina, CCAA
kolor - color m
Kolumb - Columbus m
kolumna - columna f
komar - culex m
komnata - cubiculum n
komórka - cellula f
komp - computatrum n, ordinatrum n
komputer - computatrum n, ordinatrum n
koń - equus m, Equus caballus, penis m, sopio m, sopitio f, mentula f, cauda f, coda f, membrum virile n
kóń - equus m, Equus caballus
kończyć - finire
kończyna - membrum n
konfraternia - confraternitas
Konfucjusz - Confucius m
koniczyna - trifolium n
koniec - finis, exitus
koniuszy - praefectus stabuli m
konklawe - conclave n
Konkordia - Concordia f
konsens - consensus
konsensus - consensus
konstelacja - constellatio
kontrreformacja - Contrareformatio f
konwent - conventus
Kopenhaga - Hafnia
koper - anethum n, anetum n
kopernik - copernicium n
Kopernik - Copernicus m
koper włoski - Foeniculum vulgare
kopruch - culex m
kora - cortex
Koran - Alcoranus m
korbol - cucurbita f
korek - cortex, suber n
korona - Fritillaria
Korona Południowa - Corona Australis
korzeń - radix f
kos - merula f
Kos - Cos
kosa - culter m
kość - os, talus m, tessera f
Kościerzyna - Costerina f
Kościół - ecclesia f
kości zostały rzucone - alea iacta est
kość krzyżowa - os sacrum n
koślawy - valgus
kosteczki słuchowe - ossicula auditoria
kostka - talus m
kot - felis
kowadło - incus
kowalno - incus
Koziorożec - Capricornus m
kraj - civitas f
Kraj Sudetów - Sudetia f
Krak - Cracus m
Kraków - Cracovia f
krasikoń - trifolium n
krasula - vacca f
kręgosłup - columna vertebralis f, spina f
kreować - creo
kret - talpa f
krew - sanguis
Krista - Christina f
krogulec - accipiter m
krok - gressus m, itus m
Krokos - Crocus
krokus - Crocus m, crocus m
Krokus - Crocus
król - rex m
królestwo - regnum n
królewski - basilicus
królik - lepus m
królowa - regina f
królówka koroniasta - Onychorhynchus coronatus
kropla - gutta f, stilla f, guttae
krople - guttae, gutta f, stilla f
krótki - brevis
krowa - vacca f
krtań - larynx
krucjata - expeditio sacra
krucyfiks - crucifixus
kruk - corvus m
kruk krukowi oka nie wykole - cornix cornici numquam confodit ocellum
krwiomocz - haematuria f
krybuny - crux, -cis f
krypton - krypton, crypton
Kryspin - Crispus m, Crispinus m
Krystyna - Christina f
krytyk - existimator m
krzeczek - cricetus m
krzem - silicium n
Krzysztof - Christophorus m
krzywonogi - valgus
krzyż - crux, -cis f
ksenon - xenon
książę - princeps m, dux m
książka - liber m
Księga Rodzaju - Liber Genesis
Księga Zachariasza - Prophetia Zachariae f
księżyc - luna f
Księżyc - Luna f
księżycowy - lunaris
ksylometazolina - xylometazolinum n
kto - qui
kto chce żyć z swojej pracy, dolegać nie trzeba - aurora habet aurum in ore
kto ma ręce do pracy, ten się naje kołaczy - sine labore non est panis in ore / sine labore non erit panis in ore
kto pod kim dołki kopie, sam w nie wpada - incidit in foveam qui primus fecerat illam
kto rano wstaje, temu Pan Bóg daje - aurora habet aurum in ore
który - qui
kto szuka, ten znajdzie - Qui quaerit, invenit
któż - qui
kto z przyrodzenia głupi, i w Paryżu sobie rozumu nie kupi - quod natura non dat, Salmantica non praestat
Kubuś Puchatek - Winnie ille Pu
kucać - tussio
kucharz - coquus m
kukułka - cuculus m, meretrix f
kulawy - claudus
kulinarny - culinarius
kult - cultus
kultura - cultura
kupować - emere
kuraż - fortitūdō f, virtus f, audentia f
kuropatwa - perdix m, f
kurulny - curulis
kusik - basium n, osculum n
kuśka - penis m, sopio m, sopitio f, mentula f, cauda f, coda f, membrum virile n
kwadryga - quadriga f
kwant - quantum
kwantowy - quanticus
kwas mlekowy - acidum lacticum
kwas mrówkowy - acidum formicum n
kwas węglowy - acidum carbonicum n
kwestor - quaestor
kwiat - flos m
kwiecień - Aprilis m
kwietniowy - Aprilis
Łaba - Albis
łabęć - cycnus m, olor m
łabędź - cycnus m, olor m
Łabędź - Cygnus
łabędzi - olorinus, cycneus
labirynt - labyrinthus m
laboratorium - laboratorium
Lacedemon - Lacedaemon
łacina - lingua Latina, latīnus m, latina f, latinum n
łaciński - latinus
Lacjum - Latium
łacny - facilis
lacz - penis m, sopio m, sopitio f, mentula f, cauda f, coda f, membrum virile n
ląd - terra f
Ładysław - Ladislaus
łagodzić - effeminare, moveo
Lajstrygon - Laestrygon m
lak - lacca f
lala - pupa f
lalka - pupa f
lampart - pardus m, panthera f
land - rus, pagus
lantan - lanthanum n
laparoskopia - abdominoscopia
las - silva f
laseczka - bacillus
łasica - mustela f
łaska - gratia f
Laszczyzna - Lachia f
lat - m annus
lata - m annus
latarnia morska - pharus f
lato - aestas
Latona - Latona
łatwy - facilis
latynista - latinista
lawenda - lavandula
le - autem, sed
lebioda - Chenopodium album
lebiodka pospolita - Origanum vulgare
łechtaczka - clitoris
lecz - autem, sed, curare
leczyć - curare
Leda - Leda f
legia - legio f
legion - legio f
lękać się - timere
lekarz - medicus m
lękliwy - timidus
leksykon - lexicon n
len - linum n
leń jeziorowy - Sarcocheilichthys lacustris
leopard - pardus m, panthera f
lepszy - melior
lepszy wróbel w garści niż gołąb na dachu - est avis in dextra melior, quam quattuor extra, sola avis in cavea melior, quam mille volantes
lesisty - silvestris, silvester, silvosus
leśny - silvestris, silvester
Leto - Latona f, Leto f
leukocytoza - leucocytosis f
lew - leo m, Leo m
Lew - Leo m
łgarz - mendax, falsus, falsidicus
licencja poetycka - licentia poetica f
lichwiarski - faenebris
liczba mnoga - pluralis
liczny - multus
lilak - syringa
lipa - tilia f
lipid - lipidum n
lipiec - Iulius m
Lipsk - Lipsia f
Lira - Lyra
lis - vulpes f
liść - folium n
lis polarny - Alopex lagopus
listopad - November m
list żelazny - salvus conductus
lit - lithium n
litera - littera f, litera f
literatura - litterae
literówka - lapsus calami
liturgiczny - liturgicus
liwermor - livermorium n
liza - lysis f
Lizbona - Lisbonum
łodyga - caulis m
łódź - cumba, linter, alveus, cymba, paro, navis f, navigium n, puppis f
lokatiwus - locativus
łokciowy - cubitalis
łokieć - cubitus m, cubitum n
Londyn - Londinium n
łono - sinus
loratadyna - loratadinum n
lorens - lawrencium n
łoś - Alces alces m, alces m
losowy - fortuitus
lotos - lotus n
lotus - lotus n
łowca - venator m
łoże - cubile n, lectus m
łóżko - cubile n, lectus m
lub - aut, seu, vel
łubin - Lupinus, lupinus
lucerna - cytisus, cytisum n
Łucja - Lucia f
łucznik - sagittarius m
łudzikwiat - Aprilis m
ludzki - humanus
ludzkość - humanitas, mundus
łuk - arcus m
łuk aorty - arcus aortae
lukrecja - Glycyrrhiza f, Liquiritia f, glycyrrhiza f, liquiritia f
luksus - luxus m
lulka - sigarellum, fistula nicotiana
luna - luna f
luńt - canis m
lustro - speculum
łuszczyca - psoriasis unguium
lutet - lutetium n
Lutnia - Lyra
luty - Februarius
lwi - leonis
lwia część - pars leonina
lwica - lea f
Lwów - Leopolis
łysy - calvus
łzawnica - Coix, coix
mać - mater
machać - moveo
Maciej - Matthias m
maciek - venter m
mączkować - molo
mącznica - Arctostaphylos, arctostaphylos
mądrej głowie dość dwie słowie - sapienti sat, dictum sapienti sat (est)
mądrość - sapientia f
magiczny - magicus
magister - ductor m, dux m
magnez - magnesium n
magnolia - magnolia
magnoliowate - Magnoliaceae
maj - Maius
majestatyczny - augustus
mak - papaver
mąka - farina f
Makary - Macarius m
makrela - lacerta f, lacertus m
Mała Niedźwiedzica - Ursa Minor
malarstwo - pictura f
malarz - pictor m
Malezja - Malaesia
mało - parum
Małopolska - Polonia Minor
małpa - simia f, simius m
Malta - Melitta f
mały - parvus
mały palec - digitus minimus m
małżeństwo - matrimonium n
małżonka - uxor f
mam - habere
mangan - manganum n
mango - Mangifera
Marcin - Martinus m
Marek - Marcus
marmur - marmor n, marmur n
marność - vanitas f
Mars - Mars m
marskość - cirrhosis
martwy - mortuus
Martyna - Martina f
Maryja Panna - Virgo Maria f
marzana - rubia
marzec - Martius
marzenie senne - somnus
marzyć - somniare
masa - massa f, materia f, materies f, multitudo f
masara - musca f
maska - facies f
maszyna - machina f
matczyny - maternus, maternalis
matematyka - mathematica f
Matiasz - Matthias m
matka - mater
Matka Boska - Mater Dei, Dei Genitrix
matka chrzestna - commater f
mazak - facies f
Mazowsze - Mazovia
mdłość - debilitas f
mecenas - advocatus m
mechloretamina - chlormethinum n
męczennik - martyr m
męczyć - desudo, sudo
Medard - Medardus m
Mediolan - Mediolanum
medycyna - medicina f
medyk - medicus m
Medziugorie - Mesoropolis
meitner - meitnerium n
Meksyk - Mexicum
melać - molo
melatonina - melatoninum
Melchior - Melchior m
melić - molo
melodyjny - dulcis
Melpomena - Melpomene f
Memfis - Memphis
mendelew - mendelevium n
menel - potor m
menstruacja - menses
Merkury - Mercurius
meskalina - mescalinum n
męski - masculinus, audax, genus masculinum
męstwo - fortitudo
metan - methanum n
metempsychoza - metempsychosis
Metody - Methodius m
metr kwadratowy - metrum quadratum
metronidazol - metronidasolum, metronidazolum
mężczyzna - vir, -i m
mgła - nebula f
Miami - Miamia
mianownik - nominativus
miasto - urbs f
miasto stołeczne - caput n
miażdżyca - atheromatosis, atherosclerosis
miceński - Mycenaeus, Mycensis
Michał - Michaelus m
mieć - habere
miecz - gladius m
miedź - cuprum n
miedźwiedź - ursus
między młotem a kowadłem - inter malleum et incudem
Międzyrzec Podlaski - Meserici
Międzyrzecz - Mederecensis
miejscownik - locativus
mielcuch - cervisia, cerevisia
mieli - habere
mielić - molo
miesiąc - mensis m, luna f
miesiączek - luna f
miesiączka - menses
miesięczny - lunaris
mięsień - musculus
mięsień krawiecki - musculus sartorius m
mięśniak - myoma
mięsopustnik - Februarius
mięsożerca - carnivora f
mieszkać - habito
mieszkaniec - civis m
mięta - mentha f
migotanie przedsionków - fibrillatio atriorum f
Mila - Aemilia
miłość - amor
miłosierdzie - misericordia f
Minerwa - Minerva f
minister prowincjalny - minister provincialis
ministra - ministra f
Minos - Minos m
miód - mel n
miotła - scopa f
Miranda - Miranda f
miscellanea - silva rerum
miseczka - catillus
miska - catinus m
mit - mythus
mitra - mitra f
mleć - molo
mleko - lactus
młodość - iuventus f
młody - iuvenis m, f
mnich - monachus m
mnogdy - saepe
mnogość - multitudo
moc - fortitudo
móc - possum
Modena - Mutina
modlić się - orare
modliszka - mantis
modlitwa - preces f, precatio f
modrakowy - caeruleus
modraszka - Cyanistes caeruleus, Parus caeruleus
modry - caeruleus
modrzew - larix
modrzewnica - andromeda
mój - meus
Mojżesz - Moyses
mokry - udus, uvidus, madidus, umidulus, humidulus, umidus, humidus, umifer, humifer, umorosus, uvens, uvidulus, aquosus
molibden - molybdenum n
mól książkowy - helluo librorum
monstrancja - ostensorium
moralność - moralitas
mord - parricidium n
morderstwo - parricidium n
morwa - Morus, morus
morze - mare n, pelagus n, pontus m, fretum n, fretus m, salum n, altum n
Morze Bałtyckie - Mare Balticum
Morze Egejskie - Mare Aegaeum n
Morze Śródziemne - Mare Mediterraneum
mosiądz - orichalcum n
most - pons m
moszna - scrotum n
motyka - sarculum n, sarculus m
motyl - papilio m
Mount Everest - Mons Everestis
mowa - lingua f
mówić - dico
moździerz - pila f
może - possum
mózgoczaszka - cranium, neurocranium
mrówka - formīca f
mrównik - Orycteropus afer, Tubulidentata
Ms - locativus
msza - missa f
mucha - musca f
muchomor - amanita
muchomór - amanita
mućka - vacca f
muraszka - formīca f
mużyk - vir, -i m
muzyka - musica f
my - nos
mydło - sapo
mykeński - Mycenaeus, Mycensis
Mykeny - Mycena f, Mycenae
mykita - vulpes f
mykoplazma - mycoplasma
myśleć - cogito
myśliwiec - venator m
myśliwy - venator m
mysz - Mus, mus
myszy tańcują, gdy kota nie czują - audacem reddit felis absentia murem
myt - mythus
N - instrumentalis
naczyniak - angioma
naczyniak krwionośny - haemangioma, hemangioma n
naczynie - vās n
naczyniowy - vascularis
nadarzyciel - dator m
nadbrzusze - epigastrium n
nadciśnienie płucne - hypertensio pulmonalis f, hypertonia pulmonalis f
nadwrażliwość - sensibilisatio f
nadwzroczność - hyperopia f
naga prawda - nuda veritas
nagi - nudus
nagietek - caltha f, calta f
nagły - subitus
Nahum - Nahum m
Najświętsza Maryja Panna - Beata Virgo Maria f
najwyższy czas - summum tempus
nalewka - tinctura f
napar - infusio
napisać - scribere
napletek - praeputium
napotny - diaphoreticus
naprany - ebrius, udus, uvidus, madidus, crapulatus, deebriatus, ebriacus, mattus, matus, merulentus, potus, temulentus, vinolentus, vinulentus, vinosus, potor
naproksen - naproxenum n
na przykład - ad exemplum, exempli gratia
Narcyz - Narcissus m
nard - nardum n, nardus, oleum nardinum n
nardowy - nardinus
narzędnik - instrumentalis
nastojka - tinctura f
na świętego Dygdy - ad Kalendas Graecas
na święty nigdy - ad Kalendas Graecas
nasz - noster
naszyjnik - monile n
natura - natura
natychmiast - actutum
natychmiastowo - actutum
nauczać - doceo, erudio, disco, studeo
nauczyciel - magister m
nauka - scientia
nazwa własna - nomen proprium
nazywać - appellare, dicere
neandertalczyk - Homo neanderthalensis, Homo sapiens neanderthalensis
Neapol - Neapolis
negować - nego
Nemezis - Nemesis
Nemezys - Nemesis
neodym - neodymium n
neon - neon, Paracheirodon
neptun - neptunium n
Neptun - Neptunus m
ni - nu, nec, non
nic - nihilum n, nil n, nihil n
nić - filum n
Nicea - Nicaea f
nicergolina - nicergolinum n
nie - non
niebieski - caeruleus
niebiosa - coelum
niebo - coelum
niechętny - iniquus
niech żyje - viva!
niedobiałczenie - hypoproteinaemia
niedokonany - imperfectum
niedokrwistość - anaemia
niedokrwistość Addisona-Biermera - anaemia perniciosa
niedokrwistość tarczowatokrwinkowa - thalassaemia
niedokrwistość złośliwa - anaemia perniciosa
niedoskonałość - imperfectio f
nie dospać trzeba, kto chce dostać chleba - aurora habet aurum in ore
nieduch - aegritudo
niedziela - dies Solis, dies Dominica
niedźwiedź - ursus
niedźwiedzica - ursa f
niedźwiedź polarny - ursus maritimus
niełupka - achaenium
niemal - fere
Niemcy - Germania
nie mieć - non, habere
niemy - mutus
nie od razu Kraków zbudowano - Roma non uno die aedificata est
niepodległość - libertas f
niepokalane poczęcie - immaculata conceptio
niepokoić - turbo
nieprzyjazny - infestus, inimicus
nierówność - inaequalitas f
nierządnica - meretrix f
nieśmiało - timide
niewdzięczny - ingratus
niewiasta - femina, -ae, mulier, -is
niewiedza - ignorantia f
niewolniczy - servus
niewolnik - famulus m
nie wszystko złoto, co się świeci - non omne quod nitet aurum est
niewybaczalny - inveniabilis
niewydolność - insufficientia
niewystarczający - incompetens
nieżonaty - agamus
niezwyciężony - invictus
nieżyt - catarrhus
nigdzie - nusquam
nikaj - nusquam
nikczemny - abiectus, contemptus, vilis
nikiel - niccolum n
Nikodem - Nicodemus
nikt - nemo
nim - is
niob - niobium n, columbium n
nitka - filum n
niż - quam
no - sic
nobel - nobelium n
noc - nox, noctis
nornica - clethrionomys
Nortumbria - Northumbria f, Regnum Northanhymbrorum n
nosorożec - rhinoceros m
Notos - Notus m, Auster m
Notus - Auster, Notus
nów - interlunium n
Nowa Fundlandia - Terra Nova
Nowa Zelandia - Nova Zelanda
nowicjat - novitiatus m
nowicjusz - novitius m
nowotwór - neoplasma n
nowotworowy - neoplasmaticus
nowy - novus
Nowy Testament - Novum Testamentum n
nóż - culter m
np. - e.g.
nudelzupa - ius n
numer - numerus m
numerować - numerare
nuncjusz - nuncius (nuntius)
ny - nu
nyga - culex m
obiecadło - alphabetum n, abecedarium n
obłok - nubes
obraz - pictura f
obrazki - Arum n
obrona - defensio
obrzezanie - circumcisio
obserwator - speculator
obwiniać - condemno, damno
ocean - Oceanus m
Ocean - Oceanus m
ochlapać - conspergere, spargere, se spargere (aqua)
ociec - pater, patris
ociężały - brutus
oczodół - orbita f
od - a, ab
odbyt - anus m
odcisk palca - digiti signum
od czubka głowy do pięt - a capite ad calcem
oddział - ordo m
ode - a, ab
odkupiciel - redemptor
odpadek - purgamen, purgamentum
odpoczynek - requies f
odpowiedzialność - auctoritas
Odra - Viadrus
od stóp do głów - a pedibus usque ad caput
odtąd - inde
odwaga - fortitūdō f, virtus f, audentia f
ofiara - anathema
ofiarny - sacrificālis
ogień - ignis m
ognie świętego Elma - corpus sanctum n
ogon - cauda f, coda f
ogórek - cucumis m
ojciec - pater, patris
ojczenasz - paternoster m
Ojcze nasz - Pater noster m
ojczyc - filius m
ojczyzna - patria f
Ojgen - Eugenius m
ok. - ca.
Okeanos - Oceanus m
okienko - fenestra rotunda, fenestra cochleae, fenestra ovalis, fenestra vestibuli
okno - fenestra f
oko - oculus m
oko za oko, ząb za ząb - oculum pro oculo, dentem pro dente
określenie - significatio
okręt podwodny - navis submarina
okrytonasienne - Magnoliophyta
okupacja - occupatio f
olejek eteryczny - oleum aethereum n, oleum aetherium n
olejek nardowy - nardum n, nardus, oleum nardinum n
Olimpia - Olympia
ołów - plumbum n
ołtarz - altaria, ara f
omdlenie - syncope f, humilitas f
omieszkać - non
omocznia - allantois
on - is
ona - ea
ontologia - ontologia
onycholiza - onycholysis
opal - opalus
opłakać - doleo, collacrimo, lacrimo, deploro, lamentor, delamentor, plango, ploro, deplango, eiulo
opłakiwać - doleo, collacrimo, lacrimo, deploro, lamentor, delamentor, plango, ploro, deplango, eiulo
opłatek - oblata f
oprócz - extra
optymalny - optimus (bonus)
opuszka - bulbus m
oraz - et, at, atque, -que
orbita - orbita f, gyrus m
orgazm - orgasmus m
Orion - Orion
ornat - casula, planeta
orzeł - aquila
Orzeł - Aquila
Osaka - Osaca
osierdzie - pericardium n, saccus pericardiacus m
osierdziowy - pericardiacus, pericardialis
osioł - asinus, asellus
osm - osmium n
osoba - persona f
Osobłoga - Ossoblavia f, Ossoplavia f
ostateczny - peremptorius, peremtorius, ultimus
osteomalacja - osteomalacia f
Ostia - Ostia
ostrężyna - rubus m
ostrożny - cautus
ostrze - lamina f
oszczep - sparus m
oszczerstwo - calumnia f
oszust - fraudator m
oszustwo - fraud
ouberiba - Brassica oleracea var. gongyloides, caulorapa
owacja - ovatio
owca - ovis n
o wilku mowa - lupus in fabula
o wilku mowa, a wilk tu - lupus in fabula
o wilku mowa, a wilk tuż - lupus in fabula
owoc - fructus
owulacja - ovulatio f
ożarty - ebrius, udus, uvidus, madidus, crapulatus, deebriatus, ebriacus, mattus, matus, merulentus, potus, temulentus, vinolentus, vinulentus, vinosus, potor
ożyna - rubus m
ożyrok - potor m
pachwina - inguen
paciuk - mus, rattus, Rattus norvegicus
pacyfikacja - pacificatio
Pad - Padus
padać - cado, dico
pająk - aranea f
pajęcznik - September, October, November m
pajęczyna - aranea f, araneum n
pajucina - aranea f, araneum n
pakli - si
pała - penis m, sopio m, sopitio f, mentula f, cauda f, coda f, membrum virile n
pale - penis m, sopio m, sopitio f, mentula f, cauda f, coda f, membrum virile n
palec wskazujący - digitus index m
pałeczka - coccobacillus, Tulostoma
Palermo - Panormus m
palimpsest - palimpsestus m
pallad - palladium n
pan - dominus m, erus m
Pan - Dominus m, Pan m, Faunus m
Pan Bóg - Dominus m, Pan m, Faunus m
pani - domina f, dea f
Pankracy - Pancratius m
Panna - Virgo f
państwo - civitas f
pantera - pardus m, panthera f
papieros - sigarellum, fistula nicotiana
papież - papa m, pater m
paproć - filix f, filex f
papuć - calceus m
papuga - psittacus m
Parys - Paris
Paryż - Parisium, Lutetia
pasierb - prīvignus m
pasierbica - prīvigna f
pasożyt - parasitus m
pasterski - pastoralis
pasza - cibaria, cibus m, pabulum n, pastus m, caballatio f, capitum n, capetum n
patria - patria f
patrzeć - spectare, specere
patrzyć - spectare, specere
Paulek - Paulus m
paw - Pavo m, pavo m
Paweł - Paulus m
pawęża - scutus m, scutum n
październik - October
paździerzeń - October
paznokieć - unguis
pazura - manus m
pchła - pulex m, pulix m
pęcherz - vesicam
pefloksacyna - pefloxacinum n
Pegaz - Pegasus
pekator - penis m, sopio m, sopitio f, mentula f, cauda f, coda f, membrum virile n
Pekin - Pechinum n, Pecinum n
Pelagia - Pelagia f
Pelagiusz - Pelagius m
Pełczyce - Arcto-Lithanus
pelikan - pelecanus
Pelops - Pelops m
penis - penis m, sopio m, sopitio f, mentula f, cauda f, coda f, membrum virile n
pentan - pentanum n
pępek - umbilicus m
per capita - per capita
perła - margarita f
Perseusz - Perseus m
Persja - Persia f
persona - persona f
perswadować - persuadere
petronelka - coccinella f
pewność - certitudo
piana - cervisia, cerevisia
piątek - dies Veneris
pić - bibo
pidżama - paiama
pieczarka - Agaricus campestris
pieczęć - signaculum, sigillum
piekielny - inferus
piękny - bellus
pień - truncus m
pieniądz - pecunia f
pieniądze nie śmierdzą - pecunia non olet
pieprzyć - futuere
pieprzyca siewna - Lepidium sativum L.
pierdolić - futuere
pierścień - anulus m
pierwiastek chemiczny - elementum n
pierwiosnek lekarski - Primula veris
pierwotniak - protozoon n
pierwsze wrażenie - primae impressionis
pies - canis m
piesiec - Alopex lagopus
pieśń - carmen n
Pieśń nad Pieśniami - Canticum Canticorum n
pijak - potor m
pijanica - potor m
pijany - ebrius, udus, uvidus, madidus, crapulatus, deebriatus, ebriacus, mattus, matus, merulentus, potus, temulentus, vinolentus, vinulentus, vinosus, potor
pijawka - sanguisuga f, hirudo f
piołun - apsinthium n, absinthius m
piosenkarz - cantor
Piotra - Petra f
piracki - piraticus
pirat - pirata m
piro- - pyr-
pisać - scribere
pismo - alphabetum n, abecedarium n
Pittsburgh - Pittsburgum
piwo - cervisia, cerevisia
piżama - paiama
Pizydia - Pisidia
pizza - placenta compressa f, placentula f
płakać - lacrimo
planeta - planeta f
planetarium - theatrum planetarium
plansza - abacus
pląsawica - chorea
płaskostopie - pes planus
platfus - pes planus
Platon - Plato
platyna - platinum n
plebiscyt - plebiscitum n
płeć - sexus m
plożyć - servo, do
płuco - pulmo m
plurale tantum - plurale tantum n
pluton - plutonium n
Pluton - Pluto m
płyn - lĭquŏr m
płynny - liquidus
płyta główna - tabula materna
p.n.e. - AC
pocałunek - basium n, osculum n
pocałunek Judasza - milliarium
pochwa - vagina
pocić się - desudo, sudo
pociecha - solacium n, consolatio f, solamen n, alloquium n
pocieszyciel - consolator m
pocisk - tēlum n, sagitta f
poczwarka - pupa
podchodzić - accedo
poddany - civis
podeszwa - solea f, planta f
Podlasie - Podlachia
podniebienie - palatum
poduszka - pulvinus
podwładny - servus, satelles m
pojazd - vehiculus m
pojedynczy - simplex
póki - dum
pokój - pax f, cella
pokrzewka - Sylvia
pokrzywa - urtica f
polecenie - nutus m
poleku - lente
Polihymnia - Polyhymnia f
polityka - politica
Polluks - Pollux m
północny - boreus
polon - polonium n
połowa - dimidium n
półowa - dimidium n
położnica - puerpera f
półsercowy - semicordatus
Polska - Polonia
polski - polonicus, polonice
południe - meridies, auster
południk - meridianus
półwysep - paeninsula f
Półwysep Iberyjski - Hiberia f
Półwysep Pirenejski - Hiberia f
pomieszczenie - diaeta f
pomoc - auxilium
Pompa - Antlia f
poniedziałek - odmiana klasyczna dies Lunæ, dies lunae, odmiana ludowa lunæ dies, odmiana kościelna secunda feria
ponieważ - quia, quod, quoniam, cum, propter
ponton - ponto m
ponury - ater, atrox, furvus, niger, nigrans
pornografia - pornographia f
poronienie - abortus m
port - portus m
portu - portus m
Portugalia - Lusitania f
portyk - porticus m
porzeczka - ribes f
posiłek - cena f
pospolity - vulgaris
post - ieiunium n
postać literacka - homo fictus m
postęp - progressio
potas - kalium n
potaż - potassa f
potępiać - condemno
potępienie - damnatio f
potka - commater f
potomstwo - progenies f
potop - eluvies f, eluvio f
potwierdzenie - affirmatio f
potwierdzić - affirmare
potwór z Loch Ness - Nessitera rhombopteryx
powabnica - Hedychrum nobile
powabnica piaskowa - Hedychrum nobile
powątpiewać - dubitare, haesitare, ambigere
powielacz - copiatrum
powiestka - invocatio, nomen n
powieszenie - suspensio
powietrze - aer
powodować - inducere, inferre
powódź - diluvium n, inundatio f
powoli - lente
powstrzymywać - prohibeo
powszedni - cotidianus
powtarzać - repetere, iterare
powtarzanie jest matką wiedzy - repetitio est mater studiorum
poza - extra
poziomka - fragum n, fraga
Poznań - Posnania
pozorny - mendax
pozostały - reliquus, caeterus
praca - labor m
prącie - penis m, sopio m, sopitio f, mentula f, cauda f, coda f, membrum virile n
Praga - Praga f
prawa ręka - manus m
prawda - veritas
prawdziwych przyjaciół poznaje się w biedzie - amicus certus in re incerta cernitur
prawnik - curialis
prawo - lex f, ius n
prawo jest po to, aby je omijać - inventa lege, inventa fraude
prawo międzynarodowe - ius gentium
prawo pierwszej nocy - ius primae noctis
prawo publiczne - ius publicum n
prawowity - iustus
prazeodym - praseodymium n
pręcik - stamen n
prewencja - praeventio
prezydent - praesidens, praeses
prócz - extra
progres - progressio
proletariusz - proletarius m
prom - ponto m
promet - promethium
propan - propanum n
propen - propenum n
propylen - propylenum n
propyn - propinum n, methylacetylenum n
prorok - propheta m, vaticinator m, haruspex
prosić - rogare
prosię ziemne - Orycteropus afer, Tubulidentata
prosto - simpliciter
protaktyn - protactinium n
proweniencja - proveniens, provenientis
prowokator - provocator
prowokować - provocare
Prusy - Borussia, Prutenia, Prussia
prym - primus
prymaria - primaria
prymas - primaria
pryskać - aspergo, conspergo, contingo, exspergo, respergo, spargo
przać - amare
przebój - carmen populare n
przeciwciało - anticorpus
przeciwnie - a contrario
przeczos - excoriatio
przedsiębiorca - redemptor m
przegroda nosowa - septum nasi n
przemówienie - oratio
przemożność - fortitudo
przeorysza - abbatissa f
przepaska - cincticulus
przepaska biodrowa - cincticulus
przepiórka - coturnix coturnix
przepowiednia - viticino f, oraculum n
przesądny - superstitiosus
przestraszyć - terrere, perterrere, horrificare, exanimare, exterrere, consternare
przestrzeń - spatium n, locus m
przestrzeń kosmiczna - spatium
przeszczep - transplantatum n
przeważność - fortitūdō f, virtus f, audentia f
przewlekły - chronicus
przewodnik - ductor m, dux m
przewrotka - Disciseda
przez - trans, ab, causā + Gen., ob, per
przeze - trans, ab, causā + Gen., ob, per
przoć - amare
przodek - abavus m
przy - apud
przybity - fractus, demissus
przychodzić - adventus
przydział - cibaria
przyimek - prepositio f
przyjacielski - amicus
przyjaciółka - amica f
przyjemność - voluptas f
przykład - exemplum n
przymiotnik - adiectivus
przypadek - casus m
przypominać - in memoriam revocare, similem esse
przyroda - natura f
przysadka mózgowa - hypophysis, glandula pituitaris
przysłówek - adverbium n
przysłowie - adagium n
przystępować - accedo
przytcza - exemplum n, casus m
przywództwo - auctoritas f
Psia Gwiazda - Sirius m
psisko - canis m
psowate - Canidae
pszczoła - apis f
pszenica - triticum n
Ptah - Phthas
ptak - avis f, penis m, sopio m, sopitio f, mentula f, cauda f, coda f, membrum virile n
ptaszę - avis f, penis m, sopio m, sopitio f, mentula f, cauda f, coda f, membrum virile n
publiczny - publicus
puchar - culullus
puls - pulsus
pulyr - potor m
puma - puma concolor
purpurowy - purpureus
puste - vacuus, inanis, vanus, vastus
pustelnia - hermitagium
pusty - vacuus, inanis, vanus, vastus
puszka - cervisia, cerevisia
pyta - penis m, sopio m, sopitio f, mentula f, cauda f, coda f, membrum virile n
r. - AD, AUC
rachatłukum - lucumium n
raciądz - eques m
rączka - manubrium n
rad - radium
Radamantys - Rhadamanthus m
radon - radon
radzić - consilior, consulo
Rafał - Raphael m
Rajch - Germania
Rak - Cancer m
rak krtani - carcinoma laryngis n
ramię - umerus m, humerus m
razdziawa - corvus m, cornix f
razem - simitu
rdest - Polygonum
rdest żyworodny - Bistorta vivipara
recytowanie - recitatio f
ręcznik - mantele n
ręgulec - fraud
ręka - manus m
rekin - squalus
Remigiusz - Remigius
ren - rhenium n
Ren - Rhenus m
renowacja - renovatio
reprymenda - reprehensio f
Republika Czeska - Res publica Cecha
Republika Federalna Niemiec - Respublica Foederalis Germanica
rewerencja - reverentia f
rewokować - revoco
rezerwa - subsidiis
Robert - Rupertus m, Robertus m
robić - facio, ago
robić z igły widły - elephantum ex musca facere
robić z muchy słonia - elephantum ex musca facere
rod - rhodium n
rodzaj męski - genus masculinum n
rodzaj nijaki - genus neutrum n
rodzaj żeński - genus femininum n
rodzić - gigno, creo, nascor
rodzina - familia f
rodzinny - familiaris
roentgen - roentgenium n
róg Amaltei - cornu copiae
róg obfitości - cornu copiae
rok - m annus
rokitnik - hippophae
rok przestępny - annus bissextus
Roland - Rolandus m, Rowlandus m, Rohelendus m
ropień - abscessus m
ropowica - phlegmone
ropucha - bufo m
rosiczka - Drosera f, drosera f
roślina zielna - herba f
rotunda - tholus m
rouza - rosa f
równanie - eaquatio
również - quoque
równość - aequalitas
róża - rosa f
rozdepka dunajska - Theodoxus danubialis m
rozdrażnienie - irritatio
rozdzielać - dividere
rozmaryn - Rosmarinus m, rosmarinus m
rozmarynowiec - hippophae
rozmyślać - reputare
różowy - roseus
rozsądek - sensus
rozumieć - intelligere, intellegere, sapere
rozumny - sapiens
rozwaga - considerantia f
rozwielitka - Daphnia f
rtęć - hydrargyrum n
rubid - rubidium n
ruch - motus m
ruchome schody - scalae versatiles
ruchomy - mobilis
Rudolf - Rudolphus
rufa - puppis f
rusałka admirał - Vanessa atalanta
ruta - ruta f
ruten - ruthenium n
rutherford - rutherfordium n
ryba - piscis m
rybak - piscator m
Ryby - Pisces
rycerz - eques m
ryma - destillatio f, catarrhus m, rheuma f
rynek - emporium n, mercatus m
ryś - lynx
rytualny - ritualis
rywal - rivalis m, adversarius m
rząd - ordo
rzadki - rarus
rzadko - raro
rzadny - foedus, turpis
rządzić - regere, regnare
rzecz - rēs f
rzeczny - fluviālis
rzeczownik - nomen
rzeczownik odczasownikowy - gerundium
rzeczownik własny - nomen proprium
rzeczywistość - realitas
rzekłem - dixi
rzesza - turba f
Rzeszów - Resovia
rzeszowski - resoviensis
rzeżucha - Cardamine L., Lepidium sativum L.
rzić - culus, podex
rzykać - orare
Rzym - Roma
Sabaudia - Sapandia f
Sabina - Sabina
salina - salina f
samar - samarium
sandał - crepida f
sanktuarium - sanctuarium n
Sardynia - Sardinia
sarkoidoza - sarcoidosis f
sarkopenia - sarcopaenia f
sarnapa - giraffa f, camelopardalis f
Saturn - Saturnus
satyra - satura f
schody ruchome - scalae versatiles
schodzić - descendo
schyłek - finis, exitus, terminus
Scylla - Scylla f
seaborg - seaborgium n
sękaty - geniculosus, geniculatus, nodabilis, nodosus
sekret - secretum, arcanum
seks oralny - coitus oralis
seksualność - sexualitas f
Sekwana - Sequana f
selen - selenium
Selene - Luna f, Selene f
seler - apium
seminarium - seminarium n
sen - somnus
senator - senator
senność - somnus n
sepulka - sepulca f
sepulkowate - Sepulcidae
serdeczny - cordialis
serdeczny palec - digitus anularis m
serio - sēriō
seroka - pica f
serwatka - serum n
Sewilla - Hispalis
si - hic
siano - foenum n, pratum n
siarka - sulfur n, sulphur n, sulpur n
sieć - rete n, tenus n, aranea f, casses m
sieczeń - Februarius
siedem grzechów głównych - SALIGIA f, septem peccata mortalia, septem peccata capitalia
Siedmiogród - Transsilvania f
siedzieć - sedeo
sierpiec - Bucephala islandica
sierpień - Augustus m
sierpik - drepanium
siestrzan - sororis filius m
siestrzeniec - sororis filius m
sikać - meio
sikora - parus
sikora czarnogłowa - Poecile montanus
sikora modra - Cyanistes caeruleus, Parus caeruleus
siła - fortitudo
siła wyższa - vis maior
Singapur - Singapura f
siniak - lapsus m
sioło - rus, pagus
siostra - soror
siostra cioteczna - matruelis f
siostra stryjeczna - patruelis f
siostrzan - sororis filius m
siostrzanek - sororis filius m
siostrzenica - sororis filia f
siostrzeniec - sororis filius m
sirpień - Augustus m
siurać - meio
Skałosz - Petrus m
skand - scandium n
skarb - thesaurus
skończony - finire
skop - vervex m
Skop - Aries m
skóra - corium
skorpion - scorpio m
Skorpion - Scorpius
skorupiak - crustaceum n, Crustacea
skot - taurus
skowronek - alauda f
skra - scintilla f
skrobia - amylum
skroń - tempus n, tempora
skunks - mephitis
słabość - debilitas f
ślabrać - inquino
Śląsk - Silesia f
śledź - clupea harengus
śledziona - lien m
ślepiec - caecus
śleptać - lacrimo
ślepy - caecus
ślimak - gastropus n, coclea f, cochlea f
ślina - salīva f
slipy - parvum subligaculum n
śliwa - prunus f
śliwka - prunum n
słoń - elephantus m, barrus m, elephas m
słońce - sol m
Słońce - sol m
słonecznik - Helianthus f
słoneczny - solaris, apricus
słowa - vocabulum n, verbum n
słowacki - slovachus
Słowianin - Slavus m
słowik - Luscinia f, luscinia f
słowik rdzawy - Luscinia megarhynchos
słownik - dictionarium
słowo - vocabulum n, verbum n
sługa - minister m, servus m
Słupsk - Stolpe
słuszność - aequitas f
służący - famulus m
służyć - servo, do
śmiałym szczęście sprzyja - audaces fortuna iuvat
śmieć - purgamen, purgamentum
śmierć - mors f
śmierdziel - mephitis
śmiertelny - mortifer, mortalis
śmigać - currere
Smilaks - Smilax
smok - draco m
smrodyla - ribes nigrum
smutniak - panis m, pane m
smutny - ater, atratus, niger
śnieg - nix f
śnieżka - Montifringilla nivalis
sobaka - canis m
sobota - dies Saturni
socjologia - sociologia f
socjusz - socius
soczewica - lens
sód - natrium n, sodium n
soda - soda f
sodalicja mariańska - congregatio mariana
sok - sucus
sokół - falco
sokolnik - falconarius m
Sol - Sol m
Solon - Solon m
Somalia - Somalia
specjał - cuppedium n
sperma - semen n
śpiący - somniosus, veternosus
śpiesz się powoli - festina lente
śpiew - cantus m
śpiewać - canere, cantare
śpiewak - cantor m
spisek - coniuratio f
spokojny - inturbidus, quietus, humanus, lentus, sedatus, abstinens
spór - controversia
sprawiedliwość - iustitia f
sprawiedlność - iustitia f
sprzedawać - vendere
sprzedawca - venditor m
srebrna - argenteus
srebrny - argenteus
srebro - argentum
średnio - peraeque, circiter, mediocriter
Sri Lanka - Sri Lanca
środa - dies Mercurii
śródręcze - metacarpus
sroka - pica f
stąd - inde
stadion - stadium
stado - armentum n, pecus n, grex
stal - chalybs m, adamas m
stalować się - imitor
stamtąd - inde
Stanisław - Stanislaus m
Stany - Respublicae Unitae, Respublicae Unitae Americae
Stany Zjednoczone - Respublicae Unitae, Respublicae Unitae Americae
Stany Zjednoczone Ameryki - Respublicae Unitae, Respublicae Unitae Americae
starek - avus m
stare miasto - antiquus, vetus, urbs f
Stargard Szczeciński - Stargardia
starosek - avus m
staroszek - avus m
starożytny - antiquus
starszy - pater, patris
staruszka - anus f
stary - antiquus, vetus
starzec - senex m
starzeć się - senesco
starzyk - avus m
statki - vās n
statory - vās n
statua - statua f
staw kowadełkowo-młoteczkowy - articulatio incudomallearis
staw krzyżowo-biodrowy - articulatio sacroiliaca
staw łokciowy - cubitum n
staw skroniowo-żuchwowy - articulatio temporomandibularis
Stefan - Stephanus
stół - mensa f
stolica - caput n
Stolica Apostolska - sedes apostolica f
Stolica Piotrowa - sedes apostolica f
stopa - pes m
stopień najwyższy - superlativus
stopień wyższy - comparativus
stosunek - actus sexuales
stosunek płciowy - actus sexuales
stosunek przerywany - coitus interruptus
strach - terriculum avium
strach na wróble - terriculum avium
strąpacz - Februarius
straszny - ater, atrox, furvus, niger, nigrans
strażak - vigil ignis
streszczać - abbreviare
strona - pagina f, pars f
strona bierna - passivum n
strona czynna - activum
stront - strontium n
struktur - structura
struktura - structura
struna głosowa - plica vocalis f
strzała - sagitta f
strzelec - sagittarius m
Strzelec - Sagittarius m
strzemiączko - stapes
stulejka - phimosis f
stwardnienie rozsiane - sclerosis multiplex
stwórca - creator m
styczeń - mensis Ianuarius, Ianuarius
subkontynent - subcontinens
subwencja - subventio
sudecki - sudeticum
suka - canicula f
sum - silurus m
sumienność - religio f
sutek - papilla f
swastyka - crux gammata f, svastica f
świat - mundus m
światło - lux f, lumen n
światłowstręt - photophobia f
świątynia - templum n
świerk - picea f
świerzb - scabies f
świetny - splendidus, praeclarus
świnia - porcus m, sus f
świstak - marmota f
swój - suus
swoje - suus
syfilis - syphilis, lues
symbol - omen n, signum n
Symferopol - Sympheropolis
syn - filius m
synowektomia - synovectomia f
synowiec - fratris filius m
sypialnia - cubiculum n
Syrinks - Syrinx
Syriusz - Sirius m
szabas - sabbatum n
szabat - sabbatum n
szafka - cista f
szafran - Crocus m, crocus m
szajs - merda
szampon - capitilavium n
szarańcza - locusta f
szczaw - rumex
Szczecin - Stetinum, Scecinum
Szczecinek - Nova Stetin
szczęka - maxilla f
szczęśliwego Nowy Nowego Roku - felix sit annus novus
szczęśliwy - felix
szczewik - calceus m
szczur - mus, rattus, Rattus norvegicus
szczyt - orgasmus m
szept - susurrus m
szerokość geograficzna - latitudo
szerszeń - crabro m
szew - sutura
szewc - sutor m
szkielet - skeleton
szklistka - corpus vitreum
szkliwo - enamelum
szkło - hyalus m, vitrum n
szkoła - schola f, collegium n, ludus m
szlachetny - nobilis
Szląsk - Silesia f
szlauch - serpens m, f, anguis m, coluber m, colubra f
szlug - sigarellum, fistula nicotiana
szmer sercowy - strepitus cordis m
szmucha - fraud
szneka - facies f
szop - procyon
szpik - medulla ossium
szpinak - Spinacia, spinacia
szpuk - columba f, columbus m
szron - pruina f
sztajmes - potor m
sztuka - ars
szukam człowieka - hominem quaero
Szwabia - Suēbĭa f
Szwajcaria - Helvetia f
Szwecja - Suecia f
Szwecyjo - Suecia f
szwestera - soror
Szydłowiec - Shidloviecz
szyja - collum n
szyjka macicy - cervix uteri
szynszyla - chinchilla f
szynszyla mała - Chinchilla lanigera f
ta - ea
tablica rejestracyjna - nota autocineti
tachykardia - tachycardia f
tacik - pater, patris, avus m
tafa - phascogale tapoatafa
tajemnica - secretum, arcanum
tak - sic
także - quoque
tal - thallium n
talasemia - thalassaemia
talerz - catinus m
Talia - Thalia f, Thalea f
Talos - Talus m
Talus - Talus m
tamilski - tamulicus
tamtędy - eadem
taniec świętego Wita - chorea
tantal - tantalum
Tantal - Tantalus
tarcza - scutus m, scutum n, facies f
tarcza krystaliczna - scutus m, scutum n
tarcza strzelecka - scutus m, scutum n, facies f
tarcza szkolna - scutus m, scutum n
taśka - theca
tchawica - trachea
te - hic
teatr - theatrum n
technet - technetium n
tej - tu
Tekla - Thecla
tekst - scriptum
Telesfor - Telesphorus
tellur - tellurium n
Temida - Themis
ten - hic
tenże - hic, ea, id
Teofan - Theophanes
teofania - theophania f
Teofania - Theophania f
teologia - theologia
terb - terbium n
Tercjusz - Tertius m
teren - humus
termometr - thermometrum
Termopile - Thermopylae
Terpsychora - Terpsichore f
testament - testamentum
tętnica - arteria
tętnica szczękowa - arteria maxillaris
tętniczy - arterialis
tetrakozaktyd - tetracosactidum n
też - quoque
tj. - ie. (= id est)
tkanka - textum n, tela f
tkanka tłuszczowa - textus adiposus
tlen - oxygenium
tlenek węgla - monoxidum carbonii, monoxidum carbonis
tłum - turba f
tłuszczak - lipoma, Steatornis caripensis
to - id
tobie - tu
Tomasz - Thomas m
Tomisław - Tomislaus m
tonsura - tonsura f
topaz - chrysolithos m
tor - thorium n
Tora - Tora f
torebka - theca
tors - thorax
Toruń - Thorunia, Torunium
tory - thorium n
trąbka - tuba auditiva f, tuba Eustachii f
trąbka słuchowa - tuba auditiva f, tuba Eustachii f
trąd - lepra f
traf - casus m
tramadol - tramadoli hydrochloridum
transsubstancjacja - transsubstantiatio
traszka górska - Ichthyosaura alpestris
trebusz - tripantium n
triumf - triumphus
trójząb - fuscina f
tron - thronus m, sedes f
trunek - tēmētum n
truskawka - fragaria f
tryb łączący - coniunctivus m
tryb orzekający - indicativus m
tryb oznajmujący - indicativus m
tryb przypuszczający - conditionalis m
tryktrak - nerdiludium m
trzaszczka - culmus
Trzebiatów - Treptow
trzeźwy - sobrius
trzoda - armentum n, pecus n, grex
trzonek - stilus m
tu - hic
tuberkuloza - tuberculosis
tudzież - et, at, atque, -que
tukan tęczodzioby - Ramphastos sulfuratus
tukej - hic
tul - thulium n
tulipan - tulipa f
tulp - tulipa f
tuńczyk - thynnus m, thunnus m
Tunezja - Tunesia
tunfisz - thynnus m, thunnus m
tungsten - wolframium n
turkusowy - callainus
Turyn - Taurinum
tutaj - hic
tuż - paene, fere
twardziel - duramen, scleroma
twarz - facies f
twarzoczaszka - viscerocranium
twój - tuus
twórca - effector m
ty - tu
Tyber - Tiberis m
tygr - tigris m
tygrys - tigris m
tył - puppis f
tylko - solum, solummode
tymianek - thymum n
Tymon - Timon
typografia - typographia
tyranka królewska - Onychorhynchus coronatus
Tyrteusz - Tyrtaeus m
tytan - titanium n
Tytus - Titus
ubierać - vesto
ubiór - vestimenta
ucho - auricula f, auris f
ucho środkowe - auris media
ucho wewnętrzne - auris interna f
uciążliwy - molestus
uczta - cena f
uczyć - doceo, erudio, disco, studeo
udawać - imitor
udziec - crur
układ okresowy pierwiastków - periodicum systema elementorum chemicorum
ulica - via, vicus
ułomność - debilitas f
umarł król, niech żyje król - Augustus mortuus est, habemus novum Augustum!
umierać - mori
umowa - contractus m
Unia Europejska - Unio Europæa
ununbium - ununbium n
ununhexium - ununhexium n
ununquadium - ununquadium n
unununium - unununium n
uón - is
upadać - cado, dilabor
upierdliwy - molestus
upór - obstinatio f
uprawa - cultivatio f
uran - uranium n
Uran - Uranus, Caelus
Urania - Urania f
Uranos - Uranus, Caelus
uraz - vulnus
Urban - Urbanus m
urępny - bellus
Ursyn - Ursus m
uskrzydlony - pennatus
uśmiechać się - subridere
usta - os n
ustny - oralis
uwolnić - libero
uzasadniać - iustificare
w - w, in
wacha - pluvia f, mare n, pelagus n, pontus m, fretum n, fretus m, salum n, altum n, aqua f
waga - statera f
Waga - Libra
wajco - ovum n
walczyć - bellare
walec - cylindrus m
wałek - fraud
Walenty - Valentinus m
wanad - vanadium
wapń - calcium n
waran - varanus m
Warszawa - Varsovia
warszawski - Varsoviensis
warunek konieczny - conditio sine qua non
warzywo - olus n, holus n
wasz - vobis
wątpić - dubitare, haesitare, ambigere
wątpliwość - dubium, dubitatio, dubietas
wątroba - iecur n
Watykan - Civitas Vaticana f, Mons Vaticanus m
Wawrzyniec - Laurentius m
wąż - serpens m, f, anguis m, coluber m, colubra f
wchodzić - venire, ascendo
wczoraj - heri, here
wdowa - vidua, ae f
wdowula - vidua, ae f
we - w, in
Wega - Vega
węgiel - carbonium
węgorzyca - Zoarces viviparus
wehikuł - vehiculum
wełna - lana f
wena - vena
Wenezuela - Venetiola f
wentroba - iecur n
Weronika - Veronica f
Wesołych Świąt - felix dies Nativitatis, Natale hilare, Lorem Nativitatis
Westa - Vesta f
weto - veto
węzeł chłonny - nodus lymphaticus
Wężownik - Ophiuchus m
Wezuwiusz - Vesuvius
wezwanie - invocatio, nomen n
wiatr - ventus m
Wichta - Victoria f
wiciokrzew przewiercień - caprifolium n
widz - spectator
widzieć - videre
wieczność - aeternitas f
Wiedeń - Vindobona f
wiedzieć - scio
wiela - quot, qui
wielbłąd - Camelus m (jako rodzaj), camelus m (jako przedstawiciel)
Wielka Brytania - Britannia f
Wielka Niedźwiedzica - Ursa Maior
Wielkanoc - Pascha f, Festa Paschalia
wielki - magnus
Wielki Tydzień - Hebdomas Sancta, Hebdomas Maior
Wielkopolska - Polonia Maior
wielooczny - multiocular
Wieloryb - Cetus
wierność - fidelitas
wierzba śląska - Salix silesiaca f
wierzyciel - creditor
wieś - rus, pagus
wietrzny - ventosus
wieża - turris
wieża Eiffla - turris Eiffelia f, turris Eiffeliana f
wikariusz - vicarius m
Wikipedia - Vicipaedia
Wikisłownik - Victionarium
Wikiźródła - Vicifons
wiktoria - Victoria f, victoria f
Wiktoria - Victoria f
wilczyca - lupa f
wilgotność - humiditas f
wilgotny - udus, uvidus
wilk - lupus m
wilk w owczej skórze - lupi in vestimentum ovium m
Wilno - Vilna
wina - culpa f
Wincenty - Vincentius
winien - culpabilis, culpatus
winny - culpabilis, culpatus
wino - vinum n, vinus m
winobranie - Vinalia
winograd - vinum n, vinus m
wioska - rus, pagus
wioślarz - remex m
wiosło - remigium n, remus m, tonsa f, palmula f
wirusologia - virologia f
Wisła - Vistula f
wiśnia - cerasus f
Wit - Vitus m
wizjer - dativus
władca - erus m, regnator m
Władysław - Wladislaus
Władysława - Wladislava
władza - auctoritas, dicio
właściwość - proprietas
Włochy - Italia f
Włocławek - Vladislavia
Włodzimiera - Wladimira
Włodzimierz - Wladimirus
włos - capillus
w międzyczasie - interibi
wnęk - nepos m
wnęka - neptis f
wnuczka - neptis f
wnuk - nepos m
woda - aqua f
Wodnik - Aquarius m
wodór - hydrogenium n
wodospad - aquae cadentes, deiectus aquae, deiectus
Wojciech - Adalbertus
wojenny - bellicus
województwo - palatinatus
wojna - bellum n
wojskowy - militaris, miles m
wokabularz - dictionarium
wokanda - vocanda
wół - bos n
wołacz - vocativus
Wolfgang - Wolfgangus
wolfram - wolframium n
woreczek łzowy - sacullus lacrimalis
worek sercowy - pericardium n, saccus pericardiacus m
wosk - cera f
wrażenie - pulsus
Wrocław - Wratislavia f, Vratislavia f
wrodzony - nativus, genetivus
wróg - hostis m, inimicus m
wrogi - ater, atrox, inimicus, iniquus, niger
wrona - cornix f
wrzeć - inferveo, invervesco
wrzesień - September
wrzód - ulcus n
wschód - oriens m
wschodni - orientalis
wschodzić - oriri
wścieklizna - rabies
wspaniały - magnificus
wspinać - ascendo
wspólnie - simitu
wszystkie drogi prowadzą do Rzymu - omnes viae Romam ducunt
wszystko - omnis
wtorek - dies Martis
w tym - w, in, id
Wulkan - Vulcanus m
Wulturnus - Vulturnus m, Eurus m
wy - vos
wybrzeże - maritimus, litus, ora
wydziedziczyć - exheredo
wygrywać - vincere
wyjaśnienie - explanatio
wyjść - exire
wykałaczka - dentiscalpium n, lentiscus f, lentiscum f, spina f, spicna f, spica f, spinus f, frondea cuspis f
wynalazek - inventio f
wyrak - Tarsius
wyraz - vocabulum n, verbum n
wyrazistość - claritas
wyrostek robaczkowy - appendix vermiformis
wyrostek soczewkowaty kowadełka - processus lenticularis
wyściółczak - ependymoma n
wysoki - altus, arduus
wysokość - altitudo f
wyspa - insula f
Wyspa Świętego Wyspy Świętego Tomasza i Wyspa Książęca - Insulae Sancti Thomae et Principis
wyssać z mlekiem matki - in lacte matris praebibere
wytrzeszcz - exophthalmus
wyża - altitudo f
wzdręga grecka - Scardinius graecus
z - cum
ząb - dens m
żabiru - Jabiru, Ephippiorhynchus, jabiru, ephippiorhynchus
zabójczyni - interfectrix f
zabójstwo - parricidium n
zabraniać - prohibeo
Zachariasz - Zaccharias m
zachód - occidens m, occasus m
zachodni - occidentalis
zachód słońca - occidens m
zaćma - cataracta
zaćmienie - eclipsis m
żądać - postulo
żądło - aculeus m
Żagań - Saganum
zagraniczny - exter
zaimek - pronomen
zając - lepus
zakażenie - infectio f
zakaźny - infectiosus
żakinada - Iuvenalia n
żako - Psittacus erithacus m
zakonnica - monacha f
zakonnik - monachus m
żal - luctus m
załącznik - additamentum
zalany - ebrius, udus, uvidus, madidus, crapulatus, deebriatus, ebriacus, mattus, matus, merulentus, potus, temulentus, vinolentus, vinulentus, vinosus, potor
żałobny - ater, atratus, niger
założyciel - conditor m
zamek - castellum n, castrum n
zamojski - Zamoscensis
Zamość - Zamoscia f
zapad - occidens m, occasus m
zapalenie mięśnia sercowego - myocarditis f
zapalenie oskrzeli - bronchitis f
zapalenie płuc - pneumonia
zapalenie skóry - dermatitis f
zapowiedź - nuntius m
zaproszenie - invitatio f, invitatus m
żarłoczny - edax
żartować - iocor, ioculor
zasłonak - Cortinarius, cortinarius m
zatrucie - intoxicatio f
zawiły - spinosus
zawrzeć - inferveo, invervesco
zazdrośnik - zelotes m
zazula - cuculus m, meretrix f
zazulka - coccinella f
zbiór - grex
zbliżać - accedo
zbliżenie - actus sexuales
zbrodnia - facinus, scelus
z całego serca - ex toto corde
zdolny - potens, ingeniosus
zdrowie - salus f
zdrzadło - speculum
źdźbło - culmus
ze - cum
żebrak - mendicabulum, mendicus, aeruscator
żeby - ut
żeby mieć kołaczy, trzeba użyć pracy - sine labore non est panis in ore / sine labore non erit panis in ore
Zefir - Zephyrus m, Favonius m, Zephyrinus m
Zefiryn - Zephyrinus m
Zefiryna - Zephyrina f
Zegar - Horologium n
zegar słoneczny - horologium solarium n, solarium n
żeglarz - nauta
żegleń - carbonium
żel - catinus m
żelazo - ferrum n, chalybs m
zelżywość - infamia f
zemrzeć - mori
żeńczyna - femina, -ae, mulier, -is
Zenobia - Zenobia
Zenobiusz - Zenobius
Zenon - Zeno
żeński - genus femininum n
zespół kanał kanału nadgarstka - syndroma isthmi canalis carpi n
zespół Sjögrena - syndroma Sjögreni n, syndroma Sjögren n
zewsząd - undique
zez - cum
ziele - herba f
zielnik - herbarium
ziemia - terra
Ziemia - Terra
Ziemia Święta - Terra Sancta f
zieziulka - cuculus m, meretrix f
zima - hiems f
zimno - algor m
zimorodek - alcedo f, alcyon f, halcyon f
zioło - herba f
złe oko - malus oculus
złośliwy - ater, atrox, niger
złoto - aurum n, chrysos m
złoty środek - aurea mediocritas f
zmiana - cambiatio f
zmieniać - mutare
żmija - vipera f, aspis f
znajdować - adesse
znany - notus, cognitus
Zofia - Sophia f
żołądek - stomachus m
żółć - bilis f, flavus
żółty - flavus
żółw - testudo
żółw lamparci - Psammobates pardalis
żona - uxor f
żongler - ventilator m
zorza - aurora f
zorza polarna - aurora borealis, aurora australis
zozula - cuculus m, meretrix f
Zozym - Zosimus
zręczny - habilis
źrenica - pupilla f, oculus m
źródlany - fontanus
źródło - fons, radix
zrozumiały - expositus, iustus
zrywać - tondeo
żubr - urus m, m
żul - potor m
zupa - ius n
zupełny - integer
Zurych - Turicum n
zwać - appellare, dicere
zwiadowca - speculator m
zwierciadło - speculum
zwierzak - animal n, bestia f
zwierzę - animal n, bestia f
zwycięski - victoriosus
zwyciężać - vincere
zwycięzca - victor m
z wyjątkiem - extra
z wyłączeniem - extra
żyć - vivere
życie - vita f
Zyga - Sigismundo m
Zygfryd - Sigfridus
Zygmunt - Sigismundo m
żyła - vena
żylak - varix
żyła udowa - vena femoralis f
żylistek - deutzia
zyprazydon - ziprasidonum n
żyrafa - giraffa f, camelopardalis f
zysk - faenus n, fenus n
Zyta - Zita
żywe srebro - hydrargyrum n
żywina - armentum n, pecus n, grex
żyzność - ubertas f
