abdykować - abdicirati, odreći se
abfal - anomalija f
Adam - Адам m
Afganistan - Afganistan, Avganistan
aktyn - aktinij m
Albania - Albanija
alergiczny - alergičan
Algieria - Alžir
aluminium - aluminij m
ameryk - americij m
anglikanin - anglikanac m
aniżeli - него / nego
anomalia - anomalija f
anonimowy - anoniman
Arabia Saudyjska - Saudijska Arabija
arfa - harfa f
argon - argon m
astat - astat m
autobana - autostrada f
autostrada - autostrada f
Azerbejdżan - Azerbejdžan
bąk - bumbar m
bar - barij m
Benin - Benin
berkel - berkelij m
beryl - berilijum m, berilij m
biocybernetyka - biokibernetika f
biseksualizm - biseksualnost f
bizmut - bizmut m
bluza - bluza f
bor - bor m
Brazylia - Brazil m
brydż - bridž / бриџ m
ciało - telo n, tijelo n
ciśnienie - tlak
cybernetyka - kibernetika f
cyga - bumbar m
cypresz - čempres m
cyprys - čempres m
Czarnogóra - Crna Gora f
czarodziej - čarobnjak m, čarobnik m
czasownik - глагол / glagol m
dezinformacja - dezinformacija f
dobranoc - лаку ноћ, laku noć
dobrobyt - prosperitet m
dogmat - dogma f
doktryna - doktrina f
doradca - savjetnik/саветник m
dramatyczny - dramski, dramatičan
dyktator - diktator m
emigracja - emigracija f
epitafium - epitaf m
eskalator - eskalator m
film - филм / film m
Finlandia - Finska
genetyczny - genetički
glin - aluminij m
groźba - prijetnja f, pretnja f
harfa - harfa f
harmonijny - složan, harmoničan
histeria - histerija f
homilia - homilija f
hydrologia - hidrologija f
i - i / и
ił - ilovača
jajo - јаје n
jednooki - jednook
jugonostalgia - jugonostalgija
jupa - bluza f
Kafarnaum - Kapernaum
kałasznikow - kalašnjìkov m
kanibalizm - kanibalizam m
kaplica - kapela f
kaznodzieja - propovjednik m, propovednik m
kołacz - колач m, kolač m
konspiracja - zavera f, zavjera f
krokus - barbička
krtań - grkljan
kwarantanna - karantena f
lateks - lateks m
leksykon - leksikon m
lojalność - lojalnost f
lub - или / ili
luksus - luksus m, luksuz m
męczennik - mučenik m
meczet - mošeja f
metafizyka - metafizika f
meteor - meteor
minaret - minaret m, munara f
modlitewnik - молитвеник (molitvenik) m
Mostar - Mostar
neutralność - neutralnost f
neutralny - neutralan
nieodwracalny - ireverzibilan
niepodległość - nezavisnost / независност f
nieposłuszny - neposlušan
nieprzewidywalny - nepredvidljiv
nierealny - irealan, nestvaran
nierówność - nejednakost f
nieskuteczny - neefikasan
nie wywołuj wilka z lasu - ne diraj lava dok spava
niezwyciężony - nepobjediv, nepobediv
niż - него / nego
obraz - филм / film m
Ocean Spokojny - Tihi okean m
okręt podwodny - podmornica f
oraz - i / и
orgazm - orgazam m
Pacyfik - Tihi okean m
pątnik - hodočasnik m
perfumy - parfem
pielgrzym - hodočasnik m
pocestny - putnik m
podróżnik - putnik m
poduszkowiec - hoverkraft m, aerogliser m, lebdelica f, lebdjelica f
poezja - pjesništvo n, poezija f
Polska - Poljska
pornograficzny - pornografski
poruta - skandal m
pożyczka - zajam, posudba
prawdopodobny - verojatan, vjerojatan
przejaw - pokazatelj m
przesądny - praznovjeran, sujevjeran
rasizm - rasizam m
realizm - realizam m
równoważny - ekvivalentan
różnorodność - diverzitet m, raznolikost f
ruchome schody - eskalator m
rytuał - ritual m, obred m
sałatka - salata f
schody ruchome - eskalator m
siano - seno n
Singapur - Singapur m
skandal - skandal m
slawistyka - славистика f, slavistika f
smerf - Štrumpf, Štrumpfovi
sojusznik - saveznik m
staw łokciowy - lakat
syfilis - sifilis m
synteza - sinteza f
szafran - barbička
szaman - šaman m
szczyt - orgazam m
szept - šapat / шапат m
szukam człowieka - tražim čoveka
tetum - tetumski jezik
trend - trend m
trzmiel - bumbar m
tudzież - i / и
Tunezja - Tunis
twardość - tvrdina f, tvrdoća f
tyrania - tiranija f
wacha - voda
wieczność - vječnost f, večnost f
Wikiźródła - Wikiteka
woda - voda
wolnomyślicielstwo - slobodoumlje, slobodnoumnost, slobodna misao
Wyspa Bożego Narodzenia - Božićni otok m
założyciel - osnivač m
zapominalski - zaboravan
zawistny - zavidljiv
zbieg okoliczności - koincidencija f
zdecydować - opredijeliti
złoto - zlato n
żongler - žongler m
