Aaron - Áron
abat - opát m
abażur - tienidlo
abdominalny - abdominálny
abdykacja - abdikácia f
abdykacyjny - abdikačný
abecadlnik - šlabikár m, abecedár m
abecadlny - abecedný
abecadło - abeceda
abecadłowo - abecedne
abecadłowy - abecedný
Abidżan - Abidjan m
abiecadło - abeceda
abiotyczny - abiotický
abiturient - abiturient m
abiturientka - abiturientka f
ablegierek - dieťa n
abonament - poplatok
abonent - abonent m
abonentka - abonentka f
aborcja - potrat
Abraham - Abrahám
ABS - ABS
absolutorium - absolutórium n
absolwent - absolvent m
absolwentka - absolventka f
absorpcja - absorpcia f
abstrahować - abstrahovať
abstynencja - abstinencia f
abstynent - abstinent m
absurdalny - absurdný
abulia - abúlia f
acefalia - acefália
aceton - acetón m
acetylen - acetylén m
Achilles - Achilles m
Achillesowy - Achillov
achromat - achromát
Adam - Adam m
Adamowy - Adamov
Addis Abeba - Addis Abeba f
adept - adept m
adeptka - adeptka f
Adonis - Adonis
adopcyjny - adopčný
adoptować - adoptovať
adrenalina - adrenalín m
adres - adresa
adresat - adresát
adresować - adresovať
Adriana - Adriána f
adwent - advent m
adwentnik - december m
adwentowy - adventný
adwokat - advokát m
adwokat diabła - diablov advokát m
aerobik - aerobik
aeroplan - lietadlo m
afa - opica f
afazja - afázia f
afelzina - pomaranč m
afera - aféra
Afgańczyk - Afganec m
afganiec - Afganec m
Afganistan - Afganistan m
Afganka - Afganka f
afgański - afganský
aforyzm - aforizmus m
Afrodyta - Afrodita f
Afryka - Afrika f
Afrykańczyk - Afričan m
Afrykanin - Afričan m
Afrykanka - Afričanka f
afrykański - africký
agat - achát m
Agata - Agáta f
agawa - agáva f
Aggeusz - Aggeus m
agitacja - agitácia f
agitator - agitátor m
agitka - agitka f
agitować - agitovať
agnostycyzm - agnosticizmus m
agnostyk - agnostik m
agonia - agónia f
agrafia - dysgrafia f
agrest - egreš
agronom - agronóm m
agronomia - agronómia f
agronomiczny - agronomický
agronomka - agronómka f
agroturystyka - agroturistika
ajmer - vedro n
akcja - akcia f
akord - akord m
akordeon - akordeón m
akordeonista - akordeonista m
akordeonistka - akordeonistka f
akrobata - akrobat m
akrobatka - akrobatka f
akronim - akronym m
akropol - akropola f
akrostych - akrostich m, akrostichon n
aksamit - zamat
aksjomat - axióma f
akt - akt m, dejstvo n
aktor - herec m
aktówka - aktovka f
aktualizacja - aktualizácia f
aktyn - aktínium n
aktyntasza - aktovka f
aktywista - aktivista m
aktywistka - aktivistka f
aktywnie - aktívne
akumulator - akumulátor m
akupunktura - akupunktúra
akuzatyw - akuzatív m
akwarela - akvarel m
akwarelista - akvarelista m
akwariowy - akváriový
akwarium - akvárium m
akwedukt - akvadukt m
Akwitania - Akvitánsko n
alabaster - alabaster m
alabastrowy - alabastrový
Alaska - Aljaška f
Albańczyk - Albánec m
Albania - Albánsko n
Albanka - Albánka f
albański - albánsky
albatros - albatros m
Alberta - Alberta
Albin - Albín
alchemia - alchýmia f
alchemik - alchymista m
Aldebaran - Aldebaran m
aldehyd - aldehyd m
ale - ale
alegoria - alegória f
alegoryczny - alegorický
Aleksander - Alexander m
Aleksandra - Alexandra f
Aleksandria - Alexandria f
alergen - alergén m
alergia - alergia
alergiczny - alergický
alfabet - abeceda
alfabetu - abeceda
alfabetycznie - abecedne
alfabetyczny - abecedný
alfa i omega - alfa a omega
Alfred - Alfréd
algebra - algebra
algebraiczny - algebraický
Algier - Alžír m
Algieria - Alžírsko
algorytm - algoritmus m
alibi - alibi
Alicja - Alica
aligator - aligátor m
alkaloid - alkaloid m
alkohol - alkohol m, lieh m
alkoholiczka - alkoholička f
alkoholik - alkoholik
alkoholizm - alkoholizmus m
Allach - Alah m
Allah - Alah m
alleluja - aleluja
almanach - almanach m, kalendár m
Alojz - Alojz
Alojzy - Alojz
alpejski - alpský
alpinista - alpinista m
alpinistka - alpinistka f
alpinizm - horolezectvo n
Alpy - Alpy
altówka - viola
altruista - altruista m
altruistka - altruistka f
altruistyczny - altruistický
altruizm - altruizmus m
aluminium - hliník m
aluwium - holocén
Alzacja - Alsasko n
Amadeusz - Amadej
Amalia - Amália f
amator - amatér m
Amazonka - Amazonka f
ambirz - zázvor m, ďumbier m
ambrozja - ambrózia f
Ambrożowy - Ambrózov
Ambroży - Ambróz m
amen - amen
ameryk - amerícium n
Ameryka - Amerika f
Amerykanin - Američan
amerykanizacja - amerikanizácia f
Amerykanka - Američanka f
amerykański - americký
Ameryka Północna - Severná Amerika f
ametyst - ametyst
ametystowy - ametystový
amfiteatr - amfiteáter m
amfora - amfora f
Amman - Ammán
ammańczyk - Ammánčan m
ammanka - Ammánčanka f
amnestia - amnestia f
amnestyja - amnestia f
amnezja - amnézia f
amoniak - amoniak m
amper - ampér
amputacja - amputácia f
Amsterdam - Amsterdam m
amsterdamczyk - Amsterdamčan m
Amu-daria - Amudarja
amulet - amulet m
Amur - Amur
analfabeta - analfabet m
analfabetyzm - analfabetizmus m
analityk - analytik m
analizować - analyzovať
ananas - ananás
anarchistyczny - anarchistický
anarchizm - anarchizmus m
Anastazja - Anastázia
anatom - anatóm m
anatomiczny - anatomický
Andaluzja - Andalúzia f
andezyt - andezit m
Andora - Andorra
Andrea - Andrea
androgen - androgén m
andromeda - andromeda f, androméda f, andromédka f
Andromeda - Andromeda f, Androméda f
Andrzej - Andrej m, Ondrej m
Andrzeja - Andrea f
Andrzejowy - Andrejov, Ondrejov
Andy - Andy
anegdota - anekdota
anekdota - anekdota
aneksja - anexia f
anemik - anemik m
anemo- - anemo-
anestezjolog - anestéziológ
Angelika - Angelika
angielski - anglický
angina - angína
angiologia - angiológia f
Anglia - Anglicko
anglicyzm - anglicizmus m
Anglija - Anglicko
angol - anglický
Angola - Angola f
Angolczyk - Angolčan m
Angolijczyk - Angolčan m
Angolijka - Angolčanka f
Angolka - Angolčanka f
angryst - egreš
anhydryt - anhydrit
ani - ani
Aniela - Angela f
anioł - anjel m
Anioł Pański - Anjel Pána m
Anioł Stróż - anjel strážca m
Anita - Anita
aniżeli - ako
anjoł - anjel m
Ankara - Ankara f
ankieterka - anketárka f
Anna - Anna f
Annamaria - Annamária f
anonim - anonym
anonimowość - anonymnosť f
anonimowy - anonymný
Antananarywa - Antananarivo
Antares - Antares
Antarktyda - Antarktída f
antena - anténa f
antidotum - protijed m
Antigua i Barbuda - Antigua a Barbuda
antologia - antológia f
antologie - antológia f
Antoni - Anton m
Antonia - Antónia f
antonim - antonymum n
antracyt - antracit m
antropo- - antropo-
antropologia - antropológia f
antropomorfizm - antropomorfizmus m
Antwerpia - Antverpy
antybiotyk - antibiotikum n
antyczny - antický
antyfona - antifóna f
antygen - antigén m
antyklerykalizm - antiklerikalizmus m
antykomunistyczny - antikomunistický
antykomunizm - antikomunizmus
antykoncepcja - antikoncepcia f
antykoncepcyjny - antikoncepčný
Antyle Holenderskie - Holandské Antily
antylopa - antilopa f
antymon - antimón m
antypatia - antipatia f
antypatyczny - antipatický
antysemita - antisemita m
antysemitka - antisemitka f
antysemityzm - antisemitizmus m
antywojenny - protivojnový
Anubis - Anubis m, Anup m
anyż gwiazdkowy - badián m, čínsky aníz m, hviezdicový aníz m
anyż gwiaździsty - badián m, čínsky aníz m, hviezdicový aníz m
aorta - srdcovnica f, aorta f
apelować - apelovať
Apeniny - Apeniny
aperitif - aperitív m
apetyt - chuť
aplikacja - aplikácia f
apluzyna - pomaranč m
apokryf - apokryf m
Apollo - Apolón m
apologia - apológia f
aportować - aportovať
apostata - apostata m
apostrof - apostrof m
apoteoza - apoteóza f
aprobata - uznanie
apryl - apríl m
aptek - lekáreň
apteka - lekáreň
ar - ár m
arab - arab m
Arab - Arab m
arabeska - arabeska f
Arabia Saudyjska - Saudská Arábia
arabista - arabista m
Arabka - Arabka f
arabski - arabský
arabus - Arab m
arachnologia - arachnológia f
Aragonia - Aragónsko n
aragoński - aragónsky
Ararat - Ararat m
archanioł - archanjel m
archeologia - archeológia
archimandryta - archimandrita m, archimandrit m
Archimedes - Archimedes m
architekt - architekt m
architektka - architektka f
architektoniczny - architektonický
architektonika - architektonika f, architektúra f
architektoński - architektonický
architektura - architektúra f
arcybiskup - arcibiskup m
areografia - areografia f
Argentyna - Argentína
Argentyńczyk - Argentínčan m, Argentínec m
argentyński - argentínsky
argon - argón m
argumentacja - argumentácia f
aria - ária f
arkada - arkáda f
arkoza - arkóza f
Arktur - Arktúr m
arktyczny - arktický
Arktyka - Arktída f
arkusz - hárok
Armeńczyk - Armén m
Armenia - Arménsko
Armenka - Arménka f
Armida - Armida f
arogancja - arogancia f
aromat - aróma f
arsen - arzén m
arsenał - arzenál m
artefakt - artefakt m
Artemida - Artemida f, Artemis f
Artemis - Artemis f, Artemida f
arteria - artéria f, tepna f
arteterapia - arteterapia f
artykuł - článok
artysta - umelec
artystyczny - umelecký
Aruba - Aruba f
arystokracja - aristokracia f
arystokrata - aristokrat m
arystokratka - aristokratka f
arytmetyczny - aritmetický
arytmetyk - aritmetik m
arytmetyka - aritmetika f
arytmia - arytmia f
-arz - -ár
asceta - askéta m
ascetyczny - asketický
asceza - askéza f
aseksualizm - asexualita
aseksualny - asexuálny
asfalt - asfalt
asfaltować - asfaltovať
Asmara - Asmara
aspiryna - aspirín m
Astana - Astana
astenosfera - astenosféra f
asteroida - asteroid m
astma - astma, záduch
astmatyczka - astmatička f
astmatyk - astmatik
astro- - astro-
astrofizyczka - astrofyzička f
astrofizyk - astrofyzik m
astrofizyka - astrofyzika f
astrolog - astrológ m
astrologia - astrológia f
astrologiczny - astrologický
astrologio - astrológia f
astrolożka - astrologička f
astronauta - astronaut m
astronautka - astronautka f
astronom - astronóm m
astronomia - astronómia
astronomiczny - astronomický
astronomio - astronómia
astronomka - astronómka f, hvezdárka f
asygnata - bankovka
asymetryczny - asymetrický
Asyria - Asýria
Asyryjczyk - Asýrčan m
asyryjski - asýrsky
asystent - asistent m
asza - popol
Aszchabad - Ašchabad
atak - útok, záchvat
atandzić - klopať
ateista - ateista m
ateistka - ateistka f
ateizm - ateizmus
Atena - Aténa f
Ateny - Atény
ateusz - ateista m
atlantycki - atlantický
Atlantyda - Atlantída f
Atlantyk - Atlantický oceán m
atlas - atlas, atlas m
Atlas - Atlas m
atłas - atlas
atmosfera - atmosféra f
atmosferyczny - atmosférický
atol - atol m
atom - atóm
atomowy - atómový
atrament - atrament m
atrapa - atrapa f
atrofia - atrofia f
Augiasz - Augeias m, Augiáš m
aukcja - aukcia
Aurelia - Aurélia f
Aurora - Auróra f
Australijczyk - Austrálčan m
australijski - austrálsky
Austria - Rakúsko n
austriacki - rakúsky
Austriaczka - Rakúšanka f
Austriak - Rakúšan m
Austro-Węgry - Rakúsko-Uhorsko n
auto - auto n
autobana - diaľnica f, autostráda f
autobiografia - autobiografia f
autobus - autobus
autobusowy - autobusový
autograf - autogram m, autograf m
autokar - autokar m
automat - automat m, samopal m
automatyczny - automatický
autoportret - autoportrét m
autostop - autostop m
autostopowicz - autostopár m
autostopowiczka - autostopárka f
autostrada - diaľnica f, autostráda f
Awentyn - Aventín m, Aventin m
awersja - averzia f
awiacja - letectvo n
azbest - azbest m
Azerbejdżan - Azerbajdžan
Azja - Ázia f
azjatycki - ázijský
Azory - Azory
azot - dusík
azyl - azyl
azylant - azylant m
B - akuzatív m
Baba Jaga - Jaga baba f
babcia - stará mama
Babia Góra - Babia hora
babie lato - babie leto n
babiogórski - babohorský
babka - skorocel m, stará mama
babskie gadanie - babské reči, babské klebety
baca - bača
bachraty - hruby
bać się jak diabeł święconej wody - báť sa ako čert svätenej vody, báť sa ako čert kríža
bać się o swoją skórę - báť sa o svoju kožu
Badenia-Wirtembergia - Bádensko-Württembersko
badian właściwy - badián m, čínsky aníz m, hviezdicový aníz m
badminton - bedminton m
bagaż - batožina f
Bagdad - Bagdad m
bagienny - bahenný
bagietka - bageta
bagno - bahno
Bahamczyk - Bahamčan m
Bahamka - Bahamčanka f
Bahamy - Bahamy
Bahrajn - Bahrajn
bajer - lož, klamstvo, cigánstvo
Bajkał - Bajkal m
bajtel - dieťa n
bajura - blato n
bajzel - verejný dom m, nevestinec m, bordel m
bak - nádrž
bąk - čmeľ m
bakałarz - učiteľ m
bakłażan - baklažán
bakłażanowy - baklažánový
bakteria - baktéria
bakteriolog - bakteriológ m
bakteriologia - bakteriológia f
Baku - Baku
bal - ples
Balaton - Balaton m
Baleary - Baleáry
balet - balet m
baletnica - baletka f
Bali - Bali n
Balijczyk - Balijčan m
bałkański - balkánsky
balkon - balkón m
ballada - balada f
balsam - balzam
bałtycki - baltský, baltický
Bałtyk - Baltik m, Baltské more n
bałwan - snehuliak
bambus - bambus m
bambusowy - bambusový
bana - vlak m
banan - banán
banana - banán
bananowiec - banánovník m
Banat - Banát m
banda - banda f
bandaż - obväz
bandzioch - brucho
Bangkok - Bangkok m
Bangladesz - Bangladéš
bania - hlava
baniaczek - klobúk m
baniak - hlava
bank - banka
banknot - bankovka
bankomat - bankomat m
bankowy - bankový
Bańska Bystrzyca - Banská Bystrica f
baobab - baobab m
bar - bar, bárium n
barabola - zemiak
baran - baran m
Baran - Baran m
Baranek Boży - Baránok Boží m
baraż - baráž
Barbados - Barbados
Barbara - Barbora f
Barcelona - Barcelona f
barman - barman m
barmanka - barmanka f
Barnaba - Barnabáš m
barok - barok m
barokowy - barokový
barometr - barometer
baron - barón m
Bartłomiej - Bartolomej m
Bartłomiejek - Bartolomejko m
Bartłomiejowy - Bartolomejov
baryton - barytón m
barzoł - bahno
bas - bas m, brucho
basen - bazén
basista - basista m
Bask - Bask m
baskijski - baskický
bateria - batéria
Batumi - Batumi n
batuta - taktovka f
Bawarczyk - Bavor m
Bawaria - Bavorsko n
bawarski - bavorský
bazalt - bazalt m, čadič m
bazaltowy - bazaltový
bażant - bažant m
Bazylea - Bazilej m
bazylia - bazalka f
bazylika - bazilika f
Beatrycze - Beatrica f
bebech - brucho
bęben - bubon, brucho
beczka - sud
bedki - huba f
befsztyk - biftek m
Bejrut - Bejrút m
Belfast - Belfast m
belfer - učiteľ m
Belgia - Belgicko
Belgijka - Belgičanka f
belgijski - belgický
Belgrad - Belehrad m
Belize - Belize
Belizeńczyk - Belizan m
Belizenka - Belizanka f
Belmopan - Belmopan m
Benin - Benin m
Benińczyk - Beninčan m
Beninka - Beninčanka f
benzyna - benzín
berbela - vodka f
Berenika - Berenika f
berga - kameň
berkel - berkélium n
Berlin - Berlín
Berlin Zachodni - Západný Berlín
berło - žezlo n
Bermudy - Bermudy
Berno - Bern m
beryl - berýlium m, beryl m
Beskidy - Beskydy
Beskidy Zachodnie - Západné Beskydy m
beszamel - bešamel m
Betlejem - Betlehem m
beton - betón
betoniarz - betonár m
bez - bez, orgován m
bezalkoholowy - nealkoholický
beze - bez, orgován m
bezkrwawy - bezkrvný
bezleśny - bezlesný
bezlistny - bezlistý
beznadziejny - beznádejný
beznogi - beznohý
beżowy - béžový
bezpiecznik - poistka
bezpłatny - bezplatný
bez pracy nie ma kołaczy - bez práce nie sú koláče
bez pracy nie ma płacy - bez práce nie sú koláče
bezprawnie - bezprávne
bezprecedensowy - bezprecedentný
bezrobocie - nezamestnanosť
bezrobotny - nezamestnaný
bezsenność - bezsennosť f
bezsenny - bezsenný
bezwarunkowy - bezpodmienečný
Bhutan - Bhután
Bhutańczyk - Bhutánčan m
biała magia - biela mágia
białko - bielok m
Białoruś - Bielorusko n
Białorusin - Bielorus m
Białorusinka - Bieloruska f
białoruski - bieloruský
białość - belosť f
biały - biely
Biały Dom - Biely dom
biały jak śnieg - biely ako sneh
biatlon - biatlon m
biatlonista - biatlonista m
biatlonistka - biatlonistka
biber - klobúk m
Bibiana - Bibiána f
biblia - biblia f
Biblia - Biblia f
biblijny - biblický
biblio- - biblio-
bibliofil - bibliofil m
bibliografia - bibliografia f
biblioteka - knižnica f
bić - biť
bida - bieda f, chudoba f, nedostatok m
bidet - bidet m
bieda - bieda f, chudoba f, nedostatok m
biedny jak mysz kościelna - chudobný ako kostolná myš
biegun - pól m
biegunka - hnačka
biegus - pobrežník m
biegus zmienny - pobrežník čiernozobý m
bielaczek - potápač malý
bielizna - prádlo n
bieliźniarka - bielizník m
bierne palenie - pasívne fajčenie
biernik - akuzatív m
bierzmować - birmovať
bierzmowanie - birmovanie n, birmovka f
bigamia - bigamia f
bikorn - bizón m
bilard - biliard m
bilardowy - biliardový
bilet - lístok m
bileter - biletár m
bileterka - biletárka f
binder - kravata f
bindka - kravata f, obväz
biochemia - biochémia
biolog - biológ m
biologia - biológia f
biologiczny - biologický
biotechnologia - biotechnológia f
biseksualizm - bisexualita
biseksualny - bisexuálny
bishalter - podprsenka f
biskup - biskup m
biskupi - biskupský
Biszkek - Biškek
biurko - písací stôl
biust - poprsie
biusthalter - podprsenka f
biustonosz - podprsenka f
biwak - bivak
bizmut - bizmut m
biznesmen - biznismen m
bizon - bizón m
blacha - plech
blady - bledý
blady jak kreda - bledý ako krieda
blady jak płótno - bledý ako plátno
blady jak ściana - bledý ako stena
blady jak śmierć - bledý ako smrť
blady jak trup - bledý ako mŕtvola
blaga - lož, klamstvo, cigánstvo
blaszany - plechový
blaza - duša
Błażej - Blažej m
błecha - blcha f
błękitna planeta - modrá planéta f
błękitnawy - beláskavý, belaskavý
błękitny - belasý, nebový, azúrový, blankytný
bliski - blízky
blisko - blízko
blizna - jazva
Bliźniak - Blíženec m
Bliźnięta - Blíženci, Blíženci m, Blíženec m
blondyn - blondín
blondynka - blondína
błoto - blato n
blumkol - karfiol
bluszcz - brečtan m
bluzka - blúzka
błyskawica - blesk
bo - lebo
bocian - bocian
bociani - bocianí
bocianica - bocianica f
bóg - boh m
Bóg - Boh m
Bogarodzica - Bohorodička f
Bogarodzicielka - Božia Matka f, Matka Božia f
bogaty - bohatý
Bóg dał, Bóg wziął - Pán Boh dal, Pán Boh vzal
Bogota - Bogota f
Bogumił - Bohumil
Bogurodzica - Bohorodička f
Bogusław - Bohuslav m
bohater - hrdina m
Bohemia - Bohemia, Česko n, Čechy
bohemistka - bohemistka f
bohemizm - bohemizmus m
bohr - bohrium
boisko - ihrisko
bojkot - bojkot m
bojtel - výbežok m
Boliwia - Bolívia f
Boliwijczyk - Bolívijčan m
Boliwijka - Bolívijčanka f
Bolonia - Bologna f
bolszewicki - boľševický
bolszewik - boľševik m
bomba - bomba
bomba atomowa - atómová bomba f
Bombaj - Bombaj
bombastyczny - bombastický
bombel - dieťa n
bómbón - cukrík
Bonifacy - Bonifác m
bordo - bordó n, bordeaux, bordový
bordowy - bordový
boreasz - boreas m
Boreasz - Boreas m
Borneo - Borneo
borowik szlachetny - hríb smrekový m
borówka - čučoriedka obyčajná, facka f
Bosfor - Bospor m
boski - božský
Bośnia i Hercegowina - Bosna a Hercegovina
Boston - Boston m
botanik - botanik m
botanika - botanika f
Botswana - Botswana f
Botswańczyk - Botswančan m
Botswanka - Botswančanka f
Boża Rodzicielka - Božia Matka f, Matka Božia f
Boże Narodzenie - Vianoce
bożonarodzeniowy - vianočný
boży - boží
Boży Grób - Boží hrob m
br. - t.r.
brachol - brat
bracieniec - brat
brak - nedostatok m
brakować - chýbať
brat - brat
brat mniejszy - brat menšie
Bratysława - Bratislava f, Prešporok m, Prešporek m, Blava f
bratysławianin - Bratislavčan
bratysławianka - Bratislavčanka
bratysławski - bratislavský
brązowawy - hnedavý, hnedastý
brązowozłoty - hnedozlatý
brązowy - hnedý
Brazylia - Brazília f
brazyliana - káva
Brazylijczyk - Brazílčan m
Brazylijka - Brazílčanka f
brazylijski - brazílsky
brele - okuliare
Brema - Brémy
brifkastla - poštová schránka f
Brno - Brno n
broda - brada
brom - bróm
broń - zbraň
broszka - brošňa
browar - pivovar, pivo
brucski - bruselský
brudny - špinavý
Bruksela - Brusel m
brukselski - bruselský
Brunei - Brunej
Brunejczyk - Brunejčan m
Brunejka - Brunejčanka f
brydż - bridž m
bryg - briga
bryka - automobil m, auto n
brylant - briliant
bryle - okuliare
bryna - denaturát m
bryndza - bryndza f
Brytyjczyk - Brit m
Brytyjka - Britka f
brzegówka - brehuľa hnedá f
brzmienie - zvuk m
brzoza - breza
brzozowy - brezový
brzuch - brucho
brzuszek piwny - pivné brucho n, pivný mozoľ m
brzydki - bridký
brzydkie kaczątko - škaredé káčatko n
brzydki jak noc - škaredý ako noc
brzytwa - britva
buc - kokot, chuj
buda - škola f
Budapeszt - Budapešť
buddyjski - budhistický
buddyzm - budhizmus
budyń - puding
budzik - budík
Budziszyn - Budyšín m
Bukareszt - Bukurešť f
bukiet - kytica
buła - žemľa, sval m
bulba - zemiak
Bułgaria - Bulharsko
bułgarski - bulharský
bulimia - bulímia f
bułka - žemľa, sval m
bulwa - zemiak
Bur - Búr m
burak - repa
Burgundia - Burgundsko n
Burkina Faso - Burkina, Burkina Faso
bursztyn - jantár m
bursztynowy - jantárový
Burundi - Burundi n
burza - búrka
burza w szklance wody - búrka v pohári vody f
burzowiny - pena f, pivo
but - topánka f
butelkowy - fľaškový, fľašový
butik - butik
być - byť
być sto lat za Murzynami - byť sto rokov za opicami
być w siódmym niebie - byť v siedmom nebi
Bydgoszcz - Bydgoszcz m
byk - býk
Byk - Býk m
Była Jugosłowiańska Republika Macedonii - Bývalá Juhoslovanská Republika Macedónsko
C - datív
całki - celý
całość - celok
cały - celý
cały boży dzień - celý boží deň
cap - cap
car - cár m
Caracas - Caracas
Cefeusz - Kefeus m, Cefeus m
cegielnia - tehelňa
cegła - tehla
ceglany - tehlový
ceglastobrązowy - tehlovohnedý
ceglastoczerwony - tehlovočervený
ceglasty - tehlový
celestyn - celestín m
Celestyn - Celestín m
celnik - colník
celny - presný, colný
celownik - datív
celtycki - keltský
cement - cement m
cementowy - cementový
cena - cena f
cep - cep
cera - dcéra
cerber - cerberus m
Cerber - Kerberos m, Cerberus m
Cerera - Ceres f
Ceres - Ceres f
cerusyt - ceruzit
cesarski - cisársky
cesarz - cisár
cetyna - čečina
cez - cézium n
chabaj - mäsiar
chabrowy - nevädzový
chalcedon - chalcedón
charakterystyka - charakteristika f
charczeć - chrápať
Charków - Charkov
chart - chrt
chemia - chémia f
chemia biologiczna - biochémia
chemiczny - chemický
chemik - chemik m
Chile - Čile
Chilijczyk - Čiľan m
Chilijka - Čiľanka f
Chinka - Číňanka f
chipowy - čipový
chira - vodka f
chirurg - chirurg
chirurgia - chirurgia
chleb - chlieb m
chłód - chlad
chłodny - chladný
Chłopek - Chlapík
chłop jak dąb - chlap ako hora, chlap ako buk
chlor - chlór m
Chloris - Chlóris f, Chloris f
chlorofil - chlorofyl m
chlorofilowy - chlorofylový
chmiel - chmeľ m, pivo
choćby - napríklad
chodnik - chodník, chodba
chodzić - chodiť
choinka - vianočný stromček m
chójk - vianočný stromček m
cholera - cholera f
cholesterol - cholesterol
chomik - škrečok m
chore - chorý
choreograf - choreograf m
choroba - choroba f, nemoc f
chorowity - chorľavý
Chorwacja - Chorvátsko f
chorwacki - chorvátsky
Chorwat - Chorvát m
Chorwatka - Chorvátka f
chory - chorý
chrapać - chrápať
chromosfera - chromosféra f
chromosom - chromozóm
chronologiczny - chronologický
chruścik - potočník
chrystianizm - kresťanstvo
chrystologia - christológia f, kristológia f
Chrystus - Kristus m
Chrystus Pan - Kristus Pán m
chryzantema - chryzantéma
chrzan - chren
chrześcijanin - kresťan
chrześcijanka - kresťanka
chrześcijański - kresťanský
chrześcijaństwo - kresťanstvo
chrzest - krst
chudoba - bieda f, chudoba f, nedostatok m
chuj - kokot, chuj
chyża - stodola f
ciągnik - traktor
ciało - telo n
ciało szkliste - sklovec
ciapryka - blato n
ciasto - cesto
cicha woda brzegi rwie - tichá voda brehy myje, tichá voda brehy podmýva
cicho - ticho
cicho jak w grobie - ticho ako v hrobe
cichy - tichý
ciebie - ty
cielęcina - teľacina
ciemnobłękitny - tmavobelasý
ciemnobrązowy - tmavohnedý
ciemnobursztynowy - tmavojantárový
ciemnoczekoladowy - tmavočokoládový
ciemnoczerwony - tmavočervený
ciemnofioletowy - tmavofialový
ciemnokasztanowy - tmavogaštanový
ciemnoniebieski - tmavomodrý, temnomodrý
ciemnopomarańczowy - tmavooranžový, tmavopomarančový
ciemnoróżowy - tmavoružový
ciemnoszary - tmavošedý, tmavosivý
ciemnowłosy - tmavovlasý
ciemnozielony - tmavozelený
ciemnożółty - tmavožltý
cień - tieň m
cienki - tenký
ciepło - teplo n
ciepły - teplý
cierpiarz - taxikár
cierpieć - trpieť
cierpki - trpký
cieść - svokor m, nevesta f
cietrzew - tetrov
ciężki - ťažký
ciga - koza f
cipka - sliepka, kura
Cisa - Tisa f
ciśnienie - tlak
ciupa - väzenie n
ciurma - väzenie n
ciżma - topánka f
cka - doska
cło - clo
ćmaga - vodka f
cmentarz - cintorín
ćmić - fajčiť
ćmik - cigareta f
codzienny - každodenný
cołki - celý
córa - dcéra
córczysko - dcéra
córeczka - dcérka
córka - dcéra
coroczny - každoročný
córunia - dcérka
córuś - dcérka
ćpać - jesť
cudzić - čistiť
cudzokrain - cudzinec
cudzoziemiec - cudzinec
cug - vlak m
cukier - cukor
cukierek - cukrík
cukiernia - cukráreň
cukrowiec lekarski - cukrová trstina f
cukrzyca - cukrovka
cumel - cumeľ m, cumlík m
cumelek - cumeľ m, cumlík m
ćwiczenia - cvičenie n
ćwiczenie - cvičenie n
cybernetyk - kybernetik m
cycek - cecok m, cicík m
cychalter - podprsenka f
cyferblat - tvár f, obličaj
cyfra - cifra f
cyga - čmeľ m
Cygan - Cigán m
cygański - cigánsky, cigánčina
cygareta - cigareta f
cygaretka - cigareta f
cyklotymia - cyklotýmia f
cynamon - škorica f
cynamonowy - škoricový
cyngiel - okuliare
cynk - zinok
cynowy - cínový
cypel - výbežok m
Cypr - Cyprus
Cyprian - Cyprián m
Cypryjczyk - Cyperčan m
Cypryjka - Cyperčanka f
cyrk - cirkus
cyrkiel - kružidlo
Cyryl - Cyril m
cyrylijski - cyrilský
cyrylo-metodejski - cyrilo-metodovský, cyrilo-metodský
cyrylo-metodiański - cyrilo-metodovský, cyrilo-metodský
cyrylo-metodyjski - cyrilo-metodovský, cyrilo-metodský
cysorz - cisár
cytat - citát
czad - oxid uhoľnatý
Czad - Čad
czajnik - čajník, hlava
czapla - volavka f
czarna dziura - čierna diera
czarna jagoda - čučoriedka obyčajná
czarna magia - čierna mágia
czarna skrzynka - čierna skrinka f
czarnawy - černavý, černastý
czarne złoto - čierne zlato n, tekuté zlato n
czarniawy - černavý, černastý
czarnobrązowy - čiernohnedý
czarnogłówka zwyczajna - sýkorka čiernohlavá f
Czarnogóra - Čierna Hora f
czarny - čierny
czarodziej - bosorák m
czart - čert m
czas - čas m
czasopismo - časopis
czasownik - sloveso n
cząsteczka - častica
czas to pieniądz - čas sú peniaze
czaszka - lebka
czciciel - ctiteľ m
Czech - Čech m
czechizm - bohemizmus m
Czechosłowacja - Československo n, Česko-Slovensko n
Czecho-Słowacja - Československo n, Česko-Slovensko n
czechosłowacki - československý
Czechosłowaczka - Čechoslováčka f
Czechosłowak - Čechoslovák m
czechosłowakizm - čechoslovakizmus m
Czechy - Česko n, Čechy
Czeczenia - Čečensko n
czędo - dieťa n
czekolada - čokoláda
czekoladowy - čokoládový
czernica - čučoriedka obyčajná
czerwcowy - júnový
czerwiec - jún m
czerwonobrązowy - červenohnedý
czerwonopomarańczowy - červenooranžový
czerwony - červený, komunista
czeski - český, čeština
często - často
częstoskurcz - tachykardia f
Czeszka - Češka f
czeszki - cvička f
czipowy - čipový
członek - člen
człowieczy - ľudský
człowiek - človek m
czołg - tank
czoło - čelo
czorny - čierny, špinavý
czosnek - cesnak
czterdziestolatek - štyridsiatnik m
czterocyfrowy - štvorciferný
czterodniowy - štvordenný
czterokrotnie - štvornásobne
czteroletni - štvorročný
czteronogi - štvornohý
czteronożny - štvornohý
czujność - bedlivosť f
Czukotka - Čukotka f
czwartek - štvrtok m
czwartorzęd - kvartér
czworonogi - štvornohý
czworonożny - štvornohý
czyhunka - thorium
czyli - čiže
czynność - činnosť f
czyrwiec - jún m
czyrwień - jún m
czyścić - čistiť
czyście - pekne
czyściec - očistec
czysło - číslo
czysty - čistý
czytelnik - čitateľ
D - genitív m
dąb - dub
dąb korkowy - dub korkový m
Dąbrówka - Dúbravka f
dach - strecha f
dach nad głową - strecha nad hlavou f
dadaistyczny - dadaistický
Dafne - Dafné f
Dagestan - Dagestan
Dagmara - Dagmara f
dalekowzroczność - ďalekozrakosť f
Dalmacja - Dalmácia f
damski - dámsky
data - dátum m
debata - diskusia
Debreczyn - Debrecín
decybel - decibel
defekacja - defekácia f
Deimos - Deimos
deista - deista m
dekiel - hlava
deklamować - deklamovat
delfin - delfín
demagog - demagóg m
dementi - dementi n
Demeter - Demeter f
Demetra - Demeter f
demograf - demograf m
demografia - demografia f
demografka - demografka f
demokracja - demokracia
demokrata - demokrat
Demokratyczna Republika Konga - Konžská demokratická republika f
Demokratyczna Republika Wyspy Świętego Tomasza i Wysp Świętego Tomasza i Książęcej - Demokratická republika Svätého Tomáša a Princovho ostrova
demontaż - demontáž m
denaturat - denaturát m
dereń - drieň m
dereniówka - drienkovica f
derkacz - chrapkač m
deska - doska
deszcz - dážď
detektyw - detektív
dętka - duša
detonator - detonátor m
deżdż - dážď
dezinformacja - dezinformácia f
diabeł nie śpi - čert nikdy nespí
diabeł wie - čert vie, čert ho vie
diagnoza - diagnóza f
dialekt - nárečie
diament - diamant m
diamentowy - diamantový
Diana - Diana f
diecezja - diecéza f
dietetyczny - diétny
Dike - Diké f, Dike f
dinar - dinár m
Diogenes - Diogenes m, Diogenes m (zo Sinópy, Cynik)
Dionizos - Dionýzos m
dla - pre
dłoń - dlaň
dług - dlh
długi - dlhý
długo - dlho
dłużnik - dlžník
Dniepr - Dneper m
Dniestr - Dnester
dno - dno n
dobranoc - dobrú noc
dobro - dobro
Dobromiła - Dobromila f
dobry - dobrý
dobry wieczór - dobrý večer
dobrze - dobre
dochtór - doktor m
dodatek - prídavok
dogmat - dogma f
dogmatyzm - dogmatizmus m
doktor - doktor m, lekár m
doktryna - doktrína f
dół - jama
dolar - dolár
dolegliwość - ochorenie n
dołek - jamka
dolmen - dolmen
dolnośląski - dolnosliezsky
dom - dom
Dominika - Dominika f
domino - domino
domowy - domáci
dom publiczny - verejný dom m, nevestinec m, bordel m
Don - Don
dopełniacz - genitív m
doradca - poradca m
Dorota - Dorota f
dorsz - treska
dosłowny - doslovný
dostać - dostať
dostojnik - hodnostár m
dostojny - dôstojný
do widzenia - zbohom, do videnia
do zobaczenia - zbohom, do videnia
dozorca - dozorca m
drabina - rebrík
drabka - rebrík
drach - drak m, šarkan m
dracheta - drak m, šarkan m
dramat - dráma
dramaturg - dramaturg
drań - lajdák, nedbanlivec
drapacz chmur - mrakodrap
drapieżnik - dravec
drapieżny - dravý
drewniany - drevený
Drezno - Drážďany
drób - hydina
drobnowidz - mikroskop m
droga - cesta f
Droga Mleczna - Mliečna dráha, Mliečna cesta
drogi - drahý
drogowy - cestný
dromader - dromedár m
drozd - drozd m
drożdże - kvasinka, droždie
droździk - drozd červenkavý
drukarka - tlačiareň
drukarski - tlačiarenský
drukarz - tlačiar
dryndziorz - taxikár
drzemać - driemať
drzewo - strom m
drzwi - dvere
Dublin - Dublin m
duch - fantóm, duch, duša
Dunaj - Dunaj
Dunajec - Dunajec m
Duńczyk - Dán m
Dunka - Dánka
Dunkierka - Dunkerque
duński - dánsky, dánčina
dupek - buzerant
dupoliz - vlezdoprdelista m
dusza - fantóm, duch, duša
dwucyfrowy - dvojciferný
dwukropek - dvojbodka
dwuszereg - dvojrad m
dwuuchy - dvojuchý
dwuwiosłowy - dvojveslový
dychawica - astma, záduch
dyktator - diktátor m
dym - dym
dymbcok - dub
dymić - dymiť
dymisja - demisia
dyniowy - dyňový
dynks - denaturát m
dyplomata - diplomat
dyr - riaditeľ
dyrcio - riaditeľ
dyrektor - riaditeľ
dyro - riaditeľ
dyrygent - dirigent
dyrygować - dirigovať
dysgrafia - dysgrafia f
dyskryminować - diskriminovať
dyskusja - diskusia
dyskutować - diskutovať
dysleksja - dyslexia
dysmorfofobia - dysmorfofóbia f
dywan - koberec m
dzban - džbán m
dżem - džem
Dzeus - Zeus m
dziadek - dedo m, dedko m, starý otec m
dziąsło - ďasno
Dżibuti - Džibutsko n, Džibuti n
Dzieciątko - Jezuliatko n, Ježiško m, ježiško m, jezuliatko n
dziecięcy - detský
dziecinny - detský
dzięcioł - ďateľ
dzięcioł białogrzbiety - ďateľ bielochrbtý m
dzięcioł czarny - tesár čierny m, ďateľ čierny m
dzięcioł duży - ďateľ veľký
dzięciołek - ďateľ malý
dzięcioł pstry duży - ďateľ veľký
dzięcioł trójpalczasty - ďubník trojprstý m
dzięcioł zielony - žlna zelená
dzieciszczko - dieťa n
dziecko - dieťa n
dziękówa - ďakujem, ďakovať
dziękować - ďakovať
dziękówka - ďakujem, ďakovať
dziękuję - ďakujem, ďakovať
dziela - pre
dzień - deň
dzień dobry - dobrý deň, dobré ráno
dziennikarstwo - žurnalistika f, novinárstvo n
dziennikarz - žurnalista m
dzierzba - strakoš m
dziewa - panna f
dziewica - panna f
dzika róża - ruža šípová f, psia ruža, divý šíp, šípka f
Dziki Zachód - Divoký západ
dżinsy - džínsy
dziób - zobák
dziobak - vtákopysk
dziś - dnes
dzisiaj - dnes
dziura - jaskyňa
dziurawy - deravý
dziurka - dierka
dziurkacz - dierovačka kancelárska f
dziurkacz biurowy - dierovačka kancelárska f
dżungla - džungľa f
dźwięk - zvuk
dzwon - zvon m
EBOiR - EBOR
EBOR - EBOR
Edmund - Edmund
Edyta - Edita
edytor tekstu - textový procesor
Egipcjanin - Egypťan m
egipski - egyptský
egipskie ciemności - egyptská tma f
Egipt - Egypt m
egiptologia - egyptológia f
egoista - egoista m
egoistka - egoistka f
egoizm - egoizmus m
egzamin - skúška
egzaminować - skúšať
egzoksiężyc - exomesiac m
eka - banda f
ekierka - trojuholník m
ekolog - ekológ m
ekologia - ekológia f
ekologiczny - ekologický
ekologio - ekológia f
Ekwador - Ekvádor
Ekwadorczyk - Ekvádorčan m
Ekwadorka - Ekvádorčanka f
ekwiwalent - ekvivalent m
Elbrus - Elbrus, Eľbrus
elefant - slon
elegancki - elegantný
elektroliza - elektrolýza f
elektroniczny - elektronický
elektronika - elektronika
elektrownia - elektráreň
elektryczny - elektrický
elementarz - šlabikár m, abecedár m
Eleonora - Eleonóra f
elf - elf m
Eliasz - Eliáš m
Eligiusz - Elígius m
elipsa - elipsa f
elita - elita f
emigrant - emigrant m
emigrantka - emigrantka f
Emili - Emília
Emilia - Emília
endogenny - endogénny
Endymion - Endymión m
energia - energia
entomologia - entomológia f
entropia - entropia f
Eolia - Aiolia
eoliczny - eolický
Eos - Eos f
epidemia - epidémia
epidemio - epidémia
epopeja - epopeja f
Erato - Erato f
erb - erbium
Eris - Eris f
Eros - Eros m
Eryda - Eris f
Eryka - Erika f
Erytrea - Eritrea
Erywań - Jerevan m
eschatologia - eschatológia f
esej - esej
eskalator - eskalátor m, pohyblivé schody
eskulap - lekár m
esperanto - esperanto
esperantysta - esperantista
Estonia - Estónsko
estoński - estónsky
estrogen - estrogén m
etanol - etanol
eternit - eternit m, azbestová krytina f
Etiopczyk - Etiópčan m
Etiopia - Etiópia
etno- - etno-
Etolia - Aitólia f, Ajtólia f
Etrusk - Etrusk m
etylen - etylén m
etymologia - etymológia f
Eufrat - Eufrat m
euro - euro
euro- - euro-
Europa - Európa f
Europa Wschodnia - Východná Európa f
Europejczyk - Európan m
europejski - európsky
Euterpe - Euterpé f
Ewa - Eva f
ewangeliarz - evanjeliár m
ewangelistarz - evanjelistár m
Ewaryst - Evarist m
eż - že
Ezop - Ezop m
fabryka - továreň f, fabrika f
facet - muž m
facetka - žena f, učiteľka f
facjata - tvár f, obličaj
fagocista - fagotista m
fagot - fagot m
fajek - cigareta f
fajer - sviatok m
fajera - volant, sviatok m
fajerwer - cigareta f
fajka - fajka, cigareta f
faktura - faktúra f
fala - vlna f
fałat - bankovka
falochron - vlnolam m
fana - vlajka f
farad - farad m
faraon - faraón m
farba - farba
farmaceutka - farmaceutka f
faryna - cukor
fasola - fazuľa
faszystowski - fašistický
fatwa - fatva f
faul - faul m
fazan - bažant m
federacja - federácia f
Federacja Rosyjska - Ruská federácia f
fedra - pružina f
fedrować - pracovať
felieton - fejtón m
felinologiczny - felinologický
feministka - feministka f
feminizm - feminizmus m
fenol - fenol m
fezeła - včela f
filharmonia - filharmónia f
Filip - Filip m
Filipińczyk - Filipínec m
Filipiny - Filipíny
filiżanka - šálka
film - film m
filmoteka - filmotéka f
filozof - filozof m
filozofia - filozofia
filozoficzny - filozofický
filozofka - filozofka f
Fin - Fín m
finał - finále
finalista - finalista m
finalistka - finalistka f
finansowy - finančný
Finka - Fínka f
Finlandia - Fínsko
finlandzki - fínsky, fínčina
fiński - fínsky, fínčina
fioł - fialka
fiołek - fialka
fioletowy - fialový, violetový
fiord - fjord
firanka - záclona
fiut - kokot, chuj
fiza - fyzika f
fiżon - fazuľa
fizyka - fyzika f
flag - vlajka f
flaga - vlajka f
flerow - flerovium n
flet - flauta, kokot, chuj
fletnia Pana - Panova flauta f, syrinx
fliger - lietadlo m
flora - flóra f
Florencja - Florencia
Florian - Florián m
Florianowy - Floriánov
Floryda - Florida f
flota - loďstvo
fluor - fluór
-fobia - -fóbia
Fobos - Fobos m
fojerman - hasič m
foka - tuleň
fonetyka - fonetika f
fontanna - fontána
forteca - pevnosť
forteklapa - klavír
fortepian - klavír
foryster - cudzinec
fosfor - fosfor m
fotka - fotka f
fotograf - fotograf m
fotografia - fotografia, snímka
fotograficzny - fotografický
fotografie - fotografia, snímka
fotokopia - fotokópia
fotomodelka - fotomodelka
frajer - frajer
Francja - Francúzsko n
francuski - francúzsky, francúzština
Francuz - Francúz
Francuzka - Francúzka
frazeologiczny - frazeologický
frutarianizm - frutariánstvo n
fryc - Nemec m
Fryc - Nemec m
fundusz - fond
fura - automobil m, auto n
furdygarnia - väzenie n
furt - zasa
fusekla - ponožka f
futro - kožuch
futrować - kŕmiť
futurolog - futurológ m
futurologiczny - futurologický
fuzekle - ponožka f
Gabon - Gabon m
Gabończyk - Gabončan m
Gabonka - Gabončanka f
Gabriela - Gabriela f
gad - plaz
gagatowy - gagátový
gała - oko n, krkavec m, vrana f
galancie - pekne
galarypa - kaleráb
Galicja - Halič
galicyjski - haličský
galicyzm - galicizmus m
Galilea - Galilea f
gamaja - gymnázium
Gambia - Gambia f
Gambijka - Gambijčanka f
Ganges - Ganga f
gapa - krkavec m, vrana f
gar - hrniec
gara - spánok m
garaż - garáž
garb - hrb
garbaty - hrbatý
gardinka - záclona
gardło - hrdlo n
Garłuch - Gerlachovský štít, Gerlachovka
garncarstwo - hrnčiarstvo n
garncarz - hrnčiar m
garnek - hrniec
gasa - ulica f
gąsienica - húsenica
Gaskonia - Gaskonsko n
gaz - plyn m
gaza - gáza f
gazo - gáza f
gazociąg - plynovod
gdakać - kotkodákať
gdzie - kde
gdzie drwa rąbią, tam wióry lecą - keď sa rúbe les, lietajú triesky
gdzie dwóch bić się bije, tam trzeci korzysta - kde sa dvaja bijú, tam tretí víťazí
gejzer - gejzír
generał - generál
genetyczny - genetický
geneza - genéza f
genialny - geniálny
geniusz - génius m
genueński - janovský
geograf - zemepisec m, geograf m
geografia - zemepis, geografia
geologia - geológia
geologiczny - geologický
geometria - geometria f
gepard - gepard
geriatria - geriatria f
Gerlach - Gerlachovský štít, Gerlachovka
gerlachowski - gerlachovský
germanizm - germanizmus m
germański - nemecký, nemčina
Gertruda - Gertrúda f
gęś - hus
gęś krótkodzioba - hus krátkozobá f
gęsty - hustý
gestykulować - gestikulovať
getto - geto n
Ghana - Ghana f
gibki - rýchly
Gibraltar - Gibraltár m
giełd - burza f
giełda - burza f
Gierlach - Gerlachovský štít, Gerlachovka
gierlachowski - gerlachovský
giez - vel'ká moucha
gigant - gigant m
gilotyna - gilotína
gimnazjum - gymnázium
ginekolog - gynekológ
gips - sadrovec m
gira - noha f
gitara - gitara
gładki - hladký
głagolica - hlaholika f
glajda - blato n
glajza - thorium
glancować - čistiť
glapa - vrana f
głęboki - hlboký
głębokość - hĺbka
glin - hliník m
glina - hlina f
glista - hlísta f
glizda - hlísta f
globus - glóbus m, hlava
głodny - hladový
głóg - hloh
głowa - hlava
głowa rodziny - hlava rodiny f
główny - hlavný
głuchota - hluchota f
głuchy - hluchý
głuchy jak pień - hluchý ako peň
głupi - hlúpy
głupi jak but - hlúpy ako peň
gnat - kosť f
gnejs - rula
gniazdo - hniezdo
gnój - hnoj m
gnot - dieťa n
godać - hovoriť
godka - jazyk m
godoć - hovoriť
godzina - hodina f
godzinnik - hodiny f
gol - gól
gołąb - holub
golf - golf
Golgota - Golgota f
gołoledź - poľadovica
goły - nahý
gondola - gondola f
gora - oheň m, požiar m
góra - hora f
górą - hora f
gorący - horúci
gorączka - horúčka
górnictwo - baníctvo n
górnik - baník m
górnośląski - hornosliezsky
Górnoślązaczka - Hornoslezanka f
Górnoślązak - Hornoslezan m
Górny Śląsk - Horné Sliezsko n
górski - horský
gorszy - horší
gorzała - alkohol m, lieh m
gorzałka - vodka f
gorzki - horký
gorzoła - vodka f
gościnny - pohostinný
gospodarka - hospodárstvo n, ekonomika f
gospodarstwo - gazdovstvo n
gotówka - hotovosť
gotowy - pripravený
graba - ruka, dlaň
grabić - hrabať
grabie - hrable
grać na nerwach - hrať na nervy
grać pierwsze skrzypce - hrať prvé husle
grać w otwarte karty - hrať s otvorenými kartami
gracz - prehrávač m
gram - gram m
gramatyka - gramatika
granat - granát
granatowoczarny - modročierny
granatowy - tmavomodrý, temnomodrý
granica - hranica f
granit - granit m, žula f
granitowy - granitový
grant - grant m
gratulacja - blahoželanie n
Grecja - Grécko
grecki - grécky, gréčtina
Greczynka - Grékyňa f
gregoriański - gregoriánsky
Grek - Grék m
greka - grécky, gréčtina
Grenada - Grenada f, Granada f
Grenlandia - Grónsko
grób - hrob
grobowa cisza - hrobové ticho n
grobowiec - hrobka, klavír
groch - hrach
gromnica - hromničná svieca f, hromnička f, hromnica f
gronostaj - hranostaj m
gruba - baňa f
grubiański - hrubý
gruby - hruby
grudzień - december m
gruszka - hruška
gruziński - gruzínsky
Gruzja - Gruzínsko
grycha - žemľa
grypa - chrípka
grzanka - hrianka
grzebień - hrebeň
grzech - hriech
grzechotnik - štrkáč
Grzegorz - Gregor m
Grześ - Lúčna f
grzesznica - hriešnica f
grzesznik - hriešnik
grzyb - huba f
grzybiarka - hríbarka f
grzybiarz - hríbar m
grzywka - ofina
Guam - Guam
guano - guáno n
Gujańczyk - Guyanec m, Guyančan m
Gujanka - Guyanka f, Guyančanka f
guła - moriak, morka
gularz - moriak
guma - prezervatív m
gumka - prezervatív m
gust - vkus
Gwatemala - Guatemala f
Gwatemalczyk - Guatemalčan m
Gwatemalka - Guatemalčanka f
gwatemalski - guatemalský
gwiazda - hviezda f
Gwiazda Poranna - Zornička f
gwiazdarz - astronóm m, astrológ m
Gwiazda Wieczorna - Večernica f
gwiazdka - Štedrý deň
gwiazdozbiór - súhvezdie
gwiaździarz - astronóm m, astrológ m
Gwinea Równikowa - Rovníková Guinea f
gwóźdź - klinec
gzub - dieťa n, brucho
habit - habit m
haczka - motyka f
Hades - Hádes m, hádes m
Haiti - Haiti
Hajfa - Haifa f, Hajfa f
hajtok - nôž
hałas - hluk
hałaśliwy - hluèný
halit - halit m
Hamburg - Hamburg m
hamować - brzdiť
hamulec - brzda
Hana - Haná f
handel - obchod
Hanna - Hana f
Hanoi - Hanoj m
hara - vodka f
Harare - Harare n
harmonogram - harmonogram
haszysz - hašiš
hau - haf, hau
haw - tam
hawajski - havajský
Hawana - Havana f
Heba - Hebe f
hebdow - hodváb
Hebe - Hebe f
hedonista - hedonista m
hedonistyczny - hedonistický
hedonizm - hedonizmus m
Hefajstos - Hefaistos m
hegemon - hegemón m
Hekata - Hekata f, Hekaté f, Hekate f
Hekate - Hekata f, Hekaté f, Hekate f
hektar - hektár
hektolitr - hektoliter m
Helena - Helena f, Helene f
heligonka - heligónka f
helikopter - helikoptéra f, vrtuľník m
helio- - helio-
heliograf - heliograf m
Helios - Helios m
Hellada - Grécko
Helsinki - Helsinki
hemisfera - hemisféra f
Henryka - Henrieta f
heparyna - heparín
Hera - Héra f
herbaciany - čajový
herbaciarnia - čajovňa
herbarz - herbár
herc - hertz m
Hermes - Hermes m
Herod - Herodes m
heroina - heroín
herpeto- - herpeto-
herpetologia - herpetológia f
Hestia - Hestia f
Hiada - Hyáda f
Hiady - Hyády
hierarchiczny - hierarchický
hieroglif - hieroglyf m
Higieja - Hygieia f
Hilaria - Hilária f
Hilary - Hilár m
Himalia - Himalia f
hinduista - hinduista m
Hindus - Ind
Hinduska - Indka
hiperonim - hyperonymum n
hipo- - hypo-
hipochondryk - hypochonder
hipomania - hypománia f
hiponim - hyponymum n
hipopotam - hroch
hipotetyczny - hypotetický
Hiroszima - Hirošima f
histeria - hystéria f
histo- - histo-
historyczka - historička f
historyk - historik m
Hiszpan - Španiel m
hiszpański - španielsky
hokeista - hokejista
hokej - hokej m
holenderski - holandský
holocen - holocén
homeopatia - homeopatia f
homeopatyczny - homeopatický
Homer - Homér m
homilia - homília f
homoseksualistka - homosexuálka f
homoseksualny - homosexuálny
Honduras - Honduras
Hongkong - Hongkong
Honolulu - Honolulu
honorarium - honorár
horoskop - horoskop m
hotel - hotel m
hulajnoga - kolobežka
humanitarny - humánny
hungaryzm - hungarizmus m
huśtawka - hojdačka
huta - huta
Hydra - Hydra f
hydrant - hydrant
hydrologia - hydrológia f
hymenopterologia - hymenopterológia f
hymn - hymna
Hypnos - Hypnos m
i - a
ibis - ibis m
ich - ich
ichtio- - ichtyo-
ichtiologiczny - ichtiologický
idea - idea f
ideologia - ideológia f
idiotka - idiotka f
idiotyczność - idiotstvo n
igła - ihla
iglasty - ihličnatý
Ignacy - Ignác
ił - íl
iloczas - kvantita f
imbir - zázvor m, ďumbier m
imbirowy - ďumbierový, zázvorový
imię - meno
imieniny - meniny
imiennik - menovec
imigrant - imigrant m
implementacja - implementácia f
impresario - impresário m
impresor - tlačiar
i na żagiel, i na parę - bisexuálny
Indie - India
indochiński - indočínsky
Indochiny - Indočína f
Indonezyjczyk - Indonézan m
Indonezyjka - Indonézanka f
Indus - Indus
indyczka - morka
indyczy - morčací
Indygirka - Indigirka
indygowy - indigový
indyk - moriak
infant - infant m
informatyczny - informatický
informatyka - informatika
inkaust - atrament m
inkszy - iný
inny - iný
ino - len, iba
insekt - hmyz
inspektor - inšpektor
instynkt - inštinkt m
insulina - inzulín
integracja - intergrácia
intelektualny - intelektuálny
inteligencja - inteligencia f
internetowy - internetový
interpunkcja - interpunkcia f
inundacyja - povodeň f
iny - iný
inżynier - inžinier
Io - Io
iracki - iracký
Irak - Irak m
Irakijczyk - Iračan m
Irakijka - Iračanka f
Iran - Irán
Irańczyk - Iránec m
iranistyka - iránistika f
Iranka - Iránka f
Iris - Íris f, Iris f
Irkuck - Irkutsk m
Irlandczyk - Ír m
Irlandka - Írka f
irlandzki - írsky
ironia - irónia
iryd - irídium
Iryda - Íris f, Iris f
iść po trupach - ísť cez mŕtvoly
iskierka - iskierka f, iskrička f
iskra - iskra f
islam - islam
Islandczyk - Islanďan m
Islandka - Islanďanka f
islandzki - islandský, islandčina f
italianizm - talianizmus m
Italok - Talian m
italski - taliansky, taliančina f
itd. - atď.
iż - že
izba - izba
ize - že
izotop - izotop m
Izrael - Izrael
Izraelczyk - Izraelčan m
Izraelka - Izraelčanka f
izraelski - izraelský
Izydor - Izidor m
ja - ja
jabłko - jablko n
jabłko Adama - Adamovo jablko n
jabłoń - jabloň
jabłonka - jablonka f
jadać - jesť
jadowity - jedovatý
Jadwiga - Hedviga f
jagoda - čučoriedka obyčajná, facka f
jagodzianka na kościach - denaturát m
jajecznica - praženica
jajko - vajce n
jajnik - vaječník
jajo - vajce n
jajówa - praženica
jaka praca, taka płaca - aká práca, taká pláca
jak grom z jasnego nieba - ako blesk z jasného neba, ako hrom z jasného neba
jakie drzewo, taki klin, jaki ojciec, taki syn - aký otec, taký syn
jakikolwiek - akýkoľvek
jaki ojciec, taki syn - aký otec, taký syn
jaki pan, taki kram - aký pán, taký krám
Jakuck - Jakutsk m
Jamajczyk - Jamajčan m
Jamajka - Jamajka
jamnik - jazvečík
Jan - Ján m
jangryst - egreš
Janina - Jana f
jantar - jantár m
japa - jaskyňa
Japończyk - Japonec m
japonizm - japonizmus m
Japonka - Japonka f
japoński - japonský
jara - svokra, svekruša f
jarecka - matka, mať, mama, mamka, mamička f
Jaromir - Jaromír m
jarosz - vegetarián m
jarząbek - jariabok
jarzyna - zelenina f
jaskinia - jaskyňa
jasne jak słońce - jasné ako facka
jasnobłękitny - svetlobelasý
jasnobrązowy - svetlohnedý
jasnoczerwony - svetločervený
jasnofioletowy - svetlofialový
jasnokasztanowy - svetlogaštanový
jasnoniebieski - svetlomodrý
jasnopomarańczowy - svetlooranžový, svetlopomarančový
jasnoróżowy - svetloružový
jasnoszary - svetlošedý, svetlosivý
jasnozielony - svetlozelený
jasnożółty - svetložltý
jasny jak słońce - jasné ako facka
jaspis - jaspis m
jastrząb - jastrab
jastrzębi - jastrabí
jaszczurka - jašterica f
jaworzyna - javorina f
jazda - jazda f
jeansy - džínsy
jebadło - spálňa f, posteľ, lôžko n
jęczmień - jačmeň m
jęczmienny - jačmenný
jeden za wszystkich, wszyscy za jednego - jeden za všetkých, všetci za jedného
jedlina - jedľa
jedna jaskółka nie czyni wiosny - jedna lastovička nerobí leto
jedna jaskółka wiosny nie czyni - jedna lastovička nerobí leto
jednokierunkowy - jednosmerný
jednooki - jednooký
jednorazowy - jednorazový
jednorożec - jednorožec, nosorožec m
jednożeństwo - monogamia f
Jędrzej - Ondrej m, Andrej m
jedwab - hodváb
jedwabny - hodvábny
jedyny - jediný
jego - jeho
jej - jej
jeleń - jeleň
jelito - črevo
Jemen - Jemen
Jemeńczyk - Jemenčan m
Jemenka - Jemenčanka f
jemioła - imelo
jemiołuszka - chochláč
jen - jen m
jeniec - zajatec
Jenisej - Jenisej
Jerozolima - Jeruzalem m
jerozolimka - Jeruzalemčanka f
Jerycho - Jericho
Jerzy - Juraj m, Jur m
jeść - jesť
jesień - jeseň
jesienny - jesenný
jesień życia - jeseň života f
jesion - jaseň m
jeśli - ako
jest - byť
jeszcze - ešte
jeż - jež
jezdnia - vozovka
jeźdźczyni - jazdkyňa f
jeżeli - ako
jezioro - jazero n
jezuicki - jezuitský
Jezus - Ježiš m
Jezus Chrystus - Ježiš Kristus
język - jazyk m
język ojczysty - materinský jazyk
językowy - jazykový
jidysz - jidiš
jodła - jedľa
joga - joga f
jogurt - jogurt
Jokasta - Iokasté f, Iokasta f, Iocaste f
jon - ión m
Jordańczyk - Jordánec m, Jordánčan m
Jordanka - Jordánka f, Jordánčanka f
Jowisz - Jupiter m
Józef - Jozef m
Józefowy - Jozefov
jubiler - klenotník m, šperkár m
jubilerka - klenotníčka f, šperkárka f
jubilerski - klenotnícky
Juda - Júda m
judaizm - judaizmus
Judasz - Judáš m
judofob - antisemita m
Judyta - Judita f
Jugosławia - Juhoslávia
juny - mladý
Jupiter - Jupiter m
Jur - Jur m, Juraj m
jura - jura f
Juraszczyk - Juraščik
jurgielt - žold m
jurta - jurta f
jutro - zajtra
Jutrzenka - Zornička f, Eos f, Auróra f
już - už
-ka - -ka
kabaret - kabaret m
kabel - kábel
kabriolet - kabriolet m
kabza - vrecko
Kacper - Gašpar m
kadłub - trup m
kafej - kaviareň f
kaffa - káva
kaflarz - kachliar m
kaj - kde
kajak - kajak m
kajakarka - kajakárka f
kakadu - kakadu m
kakao - kakao
kakaowy - kakaový
Kalabria - Kalábria f
kalafa - nos, alkoholik, tvár f, obličaj
kalafior - karfiol
kałamarz - kalamár m
kalapitra - hlava
kalarepa - kaleráb
kalcyt - kalcit
kalendarz - kalendár m
kalfas - brucho
Kalifornia - Kalifornia f
Kalifornijczyk - Kalifornčan m
Kalifornijka - Kalifornčanka f
kaligrafia - kaligrafia f
Kaliopa - Kalliope f
kalkulator - kalkulačka
Kalkuta - Kalkata
kaloria - kalória f
Kalwaria - Kalvárie f
kam - kde
kamasz - topánka f
kambr - kambrium
Kamczatka - Kamčatka
kameleon - chameleón m
kamera - kamera
Kamerun - Kamerun m
Kameruńczyk - Kamerunčan m
kamfora - gáfor
kamień - kameň
kamizelka - vesta
Kampala - Kampala f
kamuflaż - kamufláž
Kanada - Kanada
kanadyjski - kanadský
kanał - kanál m
kanalizacja - kanalizácia
kangur - kengura f, kenguru m, klokan m
kanonizacja - kanonizácia f
Kanton - Kanton
kapać - kvapkať
kapcylinder - klobúk m
kapeluch - klobúk m
kapelusz - klobúk m
kąpiel wodna - vodný kúpeľ m
kąpiółka - kúpelňa f
kapitalista - kapitalista m
kapitan - kapitán
Kapitol - Kapitol m
kaplica - kaplnka
kaprys - vrtoch m
kapusta - kapusta
karaba - mačka
karate - karate n
karbon - Karbón
karbowaniec - karbovanec m
karczoch - artičok
kardio- - kardio-, kardi-
kardiologia - kardiológia
kardiologiczny - kardiologický
kardynał - kardinál m
Karelia - Karélia f
karelski - karelský
Karmel - Karmel
karmelowy - karamelový
karmić - kŕmiť
karminowy - karmínový
karnawał - fašiangy, mäsopust m, fašiang m, fašianok m, karneval m
karo - káro
karoseria - karoséria f
karp - kapor
Karpaty - Karpaty
karta pocztowa - pohľadnica
kartel - kartel m
kartka - pohľadnica
kartofel - zemiak
kartograf - kartograf m
kartografia - kartografia f
kartografka - kartografka f
Karwat - Chorvát m
karykatura - karikatúra f
kasa - pokladnica
Kasandra - Kassandra f
Kasjopea - Kasiopeja f
Kasjopeja - Kasiopeja f
kask - prilba
kaskada - kaskáda f
Kassandra - Kassandra f
Kastor - Kastor m
kastoreum - kastoreum
kastrować - kastrovať
kaszel - kašeľ
kaszmirski - kašmírsky
kasztan - gaštan m, marón m, pagaštan m
kasztan jadalny - gaštan jedlý m
kasztanowiec - pagaštan m
kasztanowordzawy - gaštanovohrdzavý
kasztanowy - gaštanový
kat - kat
katalog - katalóg
Katalonia - Katalánsko
Katalonka - Katalánka f
Katar - Katar
Katarczyk - Katarčan m
Katarka - Katarčanka f
Katarzyna - Katarína f
katecheza - katechéza f
katoda - katóda f
katolicki - katolícky
katolicyzm - katolicizmus
katolik - katolík
kaucja - kaucia
kawa - káva
kawa wesoła - verejný dom m, nevestinec m, bordel m
kawiarnia - kaviareň f
kawowiec - kávovník m
kawowy - kávový
Kazach - Kazach
Kazachstan - Kazachstan m
kazanie - kázeň
Kazaszka - Kazaška
każdy - každý
kazeina - kazeín m
kazeinowy - kazeínový
kaznodzieja - kazateľ m
kciuk - palec m
kebab - kebab
keczup - kečup m
kędy - kde
kefir - kefír
kejter - pes
kejza - syr
kelner - čašník m
kelnerka - čašníčka
kemping - kemping m, camping {{m]}
Kenia - Keňa f
Kenijczyk - Keňan m
Kenijka - Keňanka f
kenozoik - kenozoikum
kichać - kýchať
kicz - gýč m
kiejda - vrecko
kiełbasa - klobása f
kiepeła - hlava
kierowca - vodič m
kierownica - volant
kierownik - vedúci
kierunek - smer m
kierunkowskaz - smerovka f
kieszeń - vrecko
kieszonkowe - vreckové
kijanka - žubrienka
kilo - kilo n
kilogram - kilogram
kilometr - kilometer
kilometrowy - kilometrový
kimono - spánok m
kinol - nos, alkoholik
kira - vodka f
kirchóf - cintorín
Kiribati - Kiribati
kis - štrk
kiszka - črevo, mlieko n, duša
kit - lož, klamstvo, cigánstvo
klakson - klaksón m
klamot - kameň
kłamstwem daleko się nie zajdzie - lož má krátke nohy
kłamstwo - lož, klamstvo, cigánstvo
kłamstwo ma krótkie nogi - lož má krátke nohy
kłapaczka - ústa
klara - Slnko n
klarnet - klarinet m
klasztor - kláštor
klatka - hrudník m
klatka piersiowa - hrudník m
Klaudia - Klaudia f
klaustrofobia - klaustrofóbia
klawiatura - klávesnica f
klęczeć - kľačať
klękać - kľačať
klekotun - bocian
Kleopatra - Kleopatra f
kliber - nos, alkoholik
klient - klient m
klientela - klientela f
klientka - klientka f
klika - klika
klimat - podnebie, klíma
Klio - Kleio f, Klio f
klon - javor
kłos - klas
kluber - nos, alkoholik
klucz - kľúč
kluka - nos
klupać - klopať, biť
kłusownik - pytliak
kluza - väzenie n
knipa - kniha f
kobalt - kobalt
kobaltowy - kobaltový
kobieta - žena f
kobieta lekkich obyczajów - žena ľahkých mravov f
kobra - kobra f
kochać - milovať, ľúbiť
kociamber - mačka
kocioł - kotol m
kocioł parowy - parný kotol
kod kreskowy - čiarový kód m
kohorta - kohorta f
koja - posteľ, lôžko n
kojo - posteľ, lôžko n
kokon - kokón m
kokosz - sliepka, kura
kokoszka - sliepka, kura
koks - koks m
kolacja - večera
kołacz - koláč m
kolano - koleno
kolarski - cyklistický
kolarz - cyklista
kołchoz - kolchoz
kołdra - paplón
kolęda - koleda f
kolędnik - betlehemec m
kolejowy - železničný
kolektywizacja - kolektivizácia f
kolendra - koriander m
koleś - muž m
koliber - kolibrík
kołnierz - golier
koło - bicykel m
kołodziej - kolár m
Kolonia - Kolín nad Rýnom
kolonizator - kolonizátor m
kolorowy - farebný
koloryt - kolorit m
kolosalny - kolosálny
Kolumbia - Kolumbia
Kolumbijczyk - Kolumbijčan m, Kolumbijec m
Kolumbijka - Kolumbijčanka f, Kolumbijka f
koma - koma f, čiarka f
komar - komár m
komat - koma f, čiarka f
komentator - komentátor
komentować - komentovať
kometa - kométa
komiczny - komický
komiks - komiks m
komin - komín
kominiarz - kominár m
Komory - Komory
komp - počítač m
kompas - kompas
Kompas - Kompas m
kompot - kompót m
komputer - počítač m
komputerowy - počítačový
komuch - komunista
komunista - komunista
komunistyczny - komunistický
komunizm - komunizmus
koń - kôň
kóń - kôň
koncert - koncert m
kondom - prezervatív m
kondor - kondor m
konfesjonał - spovednica f
konformista - konformista m
Kongo - Kongo n
koniec - koniec m
Konkordia - Konkordia f
konopny - konopný
konstelacja - súhvezdie
kontrabasista - kontrabasista m
kontrreformacja - protireformácia f
kontynent - kontinent m, pevnina f, svetadiel m
kopa - kopa
kopalnia - baňa f
kopciuszek - žltochvost domáci
kopernik - kopernikium m
Kopernik - Kopernik m
koper włoski - fenikel obyčajný
kopica - kopa
kopiejka - kopejka f
koprolit - koprolit
kopruch - komár m
kopyto - kopyto n
koralowy - koralový
Koran - Korán m
kordła - paplón
Kornelia - Kornélia f
korona - koruna f
korona z głowy nie spadnie - koruna z hlavy nespadne
korpulentny - korpulentný
Korsyka - Korzika f
korund - korund m
korzeń - koreň m
kos - drozd čierny m, kosa f
Kos - Kos
kosa - kosa f, nôž
kość - kosť f
Kościoły - Kostoly
kosmita - mimozemšťan m, ufón m, vesmirčan m
kosmitka - mimozemšťanka f
kosodrzewina - kosodrevina
Kostarykanka - Kostaričanka f
kosz - basketbal
kosztowny - drahý
Koszyce - Košice
koszykarka - basketbalistka f
koszykarz - basketbalista
koszykówka - basketbal
kot - mačka
kotlina - kotlina f
kot perski - perzská mačka f
kot syjamski - siamská mačka f
kowal - kováč m
kowalik - brhlík
koza - koza f
kozica - kamzík m
kozioł ofiarny - obetný baránok m
Koziorożec - Kozorožec m
koźlak - kozák m
koźlarz - kozák m
koźlarz babka - kozák brezový m
krab - krab m
kradzież - krádež f
kragel - golier
kraj - kraj, štát
krajobraz - krajina f, geografická krajina f
krajopis - zemepisec m, geograf m
Kraj Sudetów - Sudety
Kraków - Krakov
krakowski - krakovský
krakwa - kačica chripľavka
krasula - krava f
krawat - kravata f
krawatka - kravata f
kręgielnia - kolkáreň f
kręgowiec - stavovec m
kret - krt m
Kreta - Kréta f
krew - krv f
krogulec - krahulec m
krokus spiski - šafran spišský m
królewicz - kráľovič m
królik - králik m
królikarnia - králikáreň f
królowa - kráľovná f
królowa nauk - kráľovná vied f
kroplomierz - kvapkadlo n
krótki - krátky
krowa - krava f
krtań - hrtan
krucjata - križiacka výprava
kruczy - havraní
kruk - krkavec m
krukowate - krkavcovité
krwawnik - rebríček m
krwistoczerwony - krvavočervený
Krym - Krym m
kryminał - kriminálka f, väzenie n
krypton - kripton m
krzeczek - škrečok m
krzesełko - kresielko n
krzesło - stolička
krzest - krst
Krzysztof - Krištof m
krzywica - krivica f
krzyżodziób świerkowy - krivonos smrekový m
Ksenia - Xénia f
kseno- - xeno-
książka - kniha f
księgozbiór - knižnica f
księżyc - mesiac m, luna f, mesiačik m
Księżyc - Mesiac m
księżycowy - mesačný
kształt - tvar f
kto - kto
kto chce żyć z swojej pracy, dolegać nie trzeba - komu sa nelení, tomu sa zelení
kto ma ręce do pracy, ten się naje kołaczy - bez práce nie sú koláče
kto mieczem wojuje, (ten) od miecza ginie - kto mečom bojuje, mečom zahynie
kto rano wstaje, temu Pan Bóg daje - komu sa nelení, tomu sa zelení
któż - kto
Kuba - Kuba
kukurydza - kukurica f
kula - noha f
kulos - noha f
kumulacja - kumulácia f
kuna - kuna f
kup - kúpiť
kupić - kúpiť
kupidło - cena f
kupować - kupovať
kupować kota w worku - kupovať mačku vo vreci
kupryt - kuprit
kura - sliepka, kura
kurka - sliepka, kura
kurki - sliepka, kura
kurkuma - kurkuma f
kurwa - kurva
kurwacik - kravata f
kutafon - kokot, chuj
kutas - kokot, chuj
Kuwejtczyk - Kuvajťan m
Kuwejtka - Kuvajťanka f
kuzaj - bratanec m
kuzyn - bratanec m
kuzynka - sesternica f
kwadrat - štvorec m
kwakać - tákať
kwark - kvark m
kwas akrylowy - kyselina akrylová
kwas hialuronowy - hyaluronan m, kyselina hyalurónová f
kwiat - kvet
Kwiatosław - Kvetoslav m
Kwiatosława - Kvetoslava f
kwiecień - apríl m
kwietniowy - aprílový
kwietno niedziela - Kvetná nedeľa f, Palmová nedeľa f
Kwietosław - Kvetoslav m
Kwietosława - Kvetoslava f
Łaba - Labe f
łabęć - labuť f
łabędź - labuť f
Łabędź - Labuť f
łabędź krzykliwy - labuť spevavá f
laborant - laborant m
laborantka - laborantka f
lacz - hlava
łączka - lúčka f
ładnie - pekne
lahar - lahár
lajbik - podprsenka f
lampa - lampa f
lampart - leopard
lampeczka - lampička f
lampka - lampka f
land - dedina f, vidiek m
lantan - lantán m
lany poniedziałek - polievací pondelok
Laos - Laos
Laotańczyk - Laosan m
Laotanka - Laosanka f
Laponia - Laponsko n
larmo - hluk
larwa - larva f
las - les m
laski - lašský
Laszczyzna - Lašsko n
lat - rok m
lata - rok m
latawiec - drak m, šarkan m
lato - leto n
latynizm - latinizmus m
lawenda - levanduľa f
lawendowy - levanduľový
łazienka - kúpelňa f
le - ale
łechtaczka - dráždec m
lecieć - leteť
lecz - ale
Leda - Léda f, Leda f
legendarny - legendárny
lekarz - lekár m
lekarz choroby chorób kobiecych - gynekológ
leksykologia - lexikológia f
Leningrad - Petrohrad
leopard - leopard
lepak - zasa
łepetyna - hlava
lepidopterologia - lepidopterológia f
lepszy wróbel w garści niż gołąb na dachu - lepší vrabec v hrsti ako holub na streche, lepší vrabec v hrsti ako zajac v chrasti
lesbijka - lesbička f
Lesotho - Lesotho n
Lesotyjczyk - Lesothčan m
Lesotyjka - Lesothčanka f
lesotyjski - lesothský
Leto - Léto f, Lato f, Latona f, Leto f
lew - lev
Lew - Lev m
leworęczny - ľavák
lewszun - ľavák
Lhasa - Lhasa
liana - liana f
Liban - Libanon m
Libańczyk - Libanončan m
Libanka - Libanončanka f
Liberia - Libéria f
Libia - Líbya f
licho nie śpi - čert nikdy nespí
licho wie - čert vie, čert ho vie
liczba - číslo
liczba atomowa - atómové číslo n, protónové číslo n
liczba mnoga - množné číslo n, plurál m
liczba pierwsza - prvočíslo
liczebnik - číslovka f
Ligia - Lýgia f
lila - ľaliový, lila, orgovánový
lilak - orgován m
liliowy - ľaliový, lila, orgovánový
Lima - Lima f
lina - lano n
lipa - lipa f, lipa obyčajná f
lipiec - júl
Lipsk - Lipsko n
Lira - Lýra f
list - list m
listopad - november m
litera - písmeno
litografia - litografia f
litr - liter
litra - liter
liturgiczny - liturgický
Litwa - Litva f
liwermor - livermorium n
Lizbona - Lisabon
Lobamba - Lobamba
lodowiec - ľadovec m
Łódź - Lodž f
-logia - -lógia
logiczny - logický
lokatiwus - lokál
łokieć - lakeť m
lolek - frajer
Lombardia - Lombardsko
Londyn - Londýn m
łososiowy - lososí, lososový
lot - let m
Lotaryngia - Lotrinsko n
łotewski - lotyšský
lotnictwo - letectvo n
Łotwa - Lotyšsko n
Lozanna - Lausanne
łoże - posteľ, lôžko n
łóżko - posteľ, lôžko n
lub - alebo
Lublana - Ľubľana
Łucja - Lucia f
łucznictwo - lukostreľba f, lukostrelectvo n
łucznik - lukostrelec m
Ludmiła - Ľudmila f
ludożerstwo - ľudojedstvo n, ľudožrútstvo n
łudzikwiat - apríl m
ludzki - ľudský
Luizjana - Louisiana f
Łukasz - Lukáš m
Luksemburg - Luxembursko n, Luxemburg
lulka - fajka, cigareta f
luna - luna f, mesiac m, mesiačik m
Luna - Luna f
lunatyk - lunatik m, námesačník m, somnambul m
luńt - lajdák, nedbanlivec, pes
lupa - lupa f
lutnia - lutna f
Lutnia - Lýra f
lutnik - husliar m
lutować - biť
luty - február m
lwię - levíča n
łydka - lýtko n
łyk - hlt
Lyon - Lyon
łyżka - lyžica f
łza - slza
łża - lož, klamstvo, cigánstvo
mać - matka, mať, mama, mamka, mamička f
Maciej - Matej m
Maciejowy - Matejov
maciek - brucho
maczek - máčik m
Madagaskar - Madagaskar m
mądry - múdry
Madryt - Madrid m
madziaryzm - hungarizmus m
Magdalena - Magdaléna f
magma - magma f
magnetofon kasetowy - kazetový magnetofón m, kazeťák m
magnetyt - magnetit m
magnez - horčík m, magnézium m
magnolia - magnólia f
mahonia - mahónia f
maj - máj m
majonez - majonéza f
Majorka - Malorka f
mak - mak m
makrela - makrela
Malachiasz - Malachiáš m
malachitowy - malachitový
Mała Niedźwiedzica - Malá medvedica f
malaria - malária f
Malawi - Malawi
Malezja - Malajzia f
Małgorzata - Margaréta f, Margita f
Mali - Mali
malin - malina
malina - malina
malować - maľovať
malowidło - farba
małpa - opica f
Malta - Malta
Mały Lew - Malý lev m
mały palec - malíček m
małżonek - muž m
małżonka - žena
mam - mama, mamka, mamička f
mama - mama, mamka, mamička f, svokra, svekruša f
mandżurski - mandžuský
manekin - figurína f
mangan - mangán m
Manila - Manila f
mańkut - ľavák
manufaktura - manufaktúra f
mapa - mapa f
maras - blato n
maraton - maratón m
maratończyk - maratónec m
marchew - mrkva f
marchewka - mrkva f
marchewkowy - mrkvový
Marcin - Martin m
Marcinowy - Martinov
Maria - Mária f
Marja - Mária f
marny - márny
Marokańczyk - Maročan m
Marokanka - Maročanka f
Maroko - Maroko n
Mars - Mars m
Marsjanin - Marťan m
Marsjanka - Marťanka f
martwy - mŕtvy
Martynika - Martinik
Maryja - Mária f
Maryjka - Mária f
maryjny - mariánsky
marzec - marec m
marzenie senne - spánok m
masakra - masakra f
masara - mucha
masaż - masáž f
maska - tvár f, obličaj
masło - maslo
masochistka - masochistka f
maszyna - stroj m
maszyna do szycia - šijací stroj m
mat - mat m
matematyk - matematik
matematyka - matematika
Matiasz - Matej m
matka - matka, mať, mama, mamka, mamička f
Matka Boża - Božia Matka f, Matka Božia f
Matka Matki Boskiej Gromnicznej - Obetovanie Pána n, Predstavenie Pána Ježiša n, Hromnice
mąż - muž m
mazak - tvár f, obličaj
mazojen - majonéza f
meander - meander m
mecenas - advokát m
mech - mach m
mechatronika - mechatronika f
meczet - mešita f
Medard - Medard m
Medardowy - Medardov
Mediolan - Miláno n
mediolańczyk - Milánčan m
mediolanka - Milánčanka f
medyk - lekár m
megaloman - megaloman m
Mekka - Mekka f
Mekong - Mekong
Meksyk - Mexiko
Meksykanin - Mexičan
Melchior - Melichar m
Melilla - Melilla
melizmat - melizma f
melki - cukrík
melodyjny - melodický
Melpomena - Melpomena f, Melpomene f
menadżer - vedúci
menora - menora f
Merkurianin - Merkúran m
Merkurianka - Merkúranka f
Merkury - Merkúr m
męski - pánsky, mužský, mužný, samčí
metafizyka - metafyzika f
metafora - metafora
metal - kov
metan - metán m
metempsychiczny - metempsychický
metempsychoza - metempsychóza f
meteor - meteor
meteoryt - meteorit
meteorytyka - meteoritika
metoda - cesta
Metody - Metod m
metodyjski - metodovský, metodský
metro - metro n
mężczyzna - muž m
mezozoik - mezozoikum
mgła - hmla f
mgr - Mgr.
Miami - Miami
mianownik - nominatív m, prvý pád m, menovateľ m
miasto - mesto n
miasto stołeczne - hlavné mesto n
miau - mňau
Michał - Michal m
Michałowy - Michalov
mieć anielską cierpliwość - mať anjelskú trpezlivosť
mieć pustą kieszeń - mať prázdne vrecko
mieć puste kieszenie - mať prázdne vrecko
mieć w mały małym palcu - mať v malíčku, mať všetko v malíčku
miecz - meč m
miejsce - miesto n
miejscownik - lokál
miejski - mestský
miękki - mäkký
mielcuch - pivovar, pivo
mieśćce - miesto n
mieśce - miesto n
miesiąc - mesiac m, luna f, mesiačik m
miesiączek - mesiac m, luna f, mesiačik m
miesięczny - mesačný
mięsień - sval m
mięsopust - fašiangy, mäsopust m, fašiang m, fašianok m, karneval m
mięsopustnik - február m
mieszkanie - byt
mieszkaniec - obyvateľ m
mięta - mäta
miętki - mäkký
migdałowy - mandľový
Mikołaj - Mikuláš m
Mikołów - Mikulov
mikrobus - mikrobus m
Mikronezyjczyk - Mikronézan m
Mikronezyjka - Mikronézanka f
mikronezyjski - mikronézsky
mikroskop - mikroskop m
Mila - Emília
miligram - miligram m
milimetr - milimeter m
milimetrowy - milimetrový
miłość - láska
miłość jest ślepa - láska je slepá
mim - mím m
mimo - vedľa
minaret - minaret m
Minerwa - Minerva f
Minos - Minos m, Minós m
Mińsk - Minsk m
miocen - miocén
miód - med m
miodownik - medovník m, medunica f, medovnikár m
miodowy - medový
miód pitny - medovina f
miotła - metla f
Miranda - Miranda f
misa - misa f
misjonarz - misionár m
mitologia - mytológia f, bájoslovie n
mleko - mlieko n
młody - mladý
młodzie - kvasinka, droždie
młodziec - dojča
młodzież - mládež f
młyn - mlyn
młynarz - mlynár
mnogdy - často
modlitwa - modlitba f
modrakowy - modrý
modry - modrý
modrzewnica - andromeda f, androméda f, andromédka f
Mogadiszu - Mogadišo n
mój - môj
Mojmir - Mojmír m
Mojżesz - Mojžiš
mokry - mokrý
mól - moľa f
Mołdawia - Moldavsko
molekuła - molekula f
Monako - Monako
Mongolia - Mongolsko n
monogamia - monogamia f
monogamiczny - monogamický, monogamný
monopol - monopol m
monstrancja - monštrancia, ostenzórium
Montevideo - Montevideo n
mora - fantóm, duch, duša
Morawa - Morava f
morawski - moravský
Morawy - Morava
Morfeusz - Morfeus m
morkwa - mrkva f
mors - mrož
morski - morský, námorný
Morskie Oko - Morské oko n
morze - more n
Morze Adriatyckie - Jadranské more
Morze Bałtyckie - Baltské more n
Morze Martwe - Mŕtve more
Morze Norweskie - Nórske more
Morze Śródziemne - Stredozemné more
mosiądz - mosadz f
Moskwa - Moskva
most - most m
Mostar - Mostar
moszna - miešok m
motyka - motyka f
Mount Everest - Mount Everest
mowa - jazyk m
mówić - hovoriť
mozaika - mozaika f
Mozambijczyk - Mozambičan m
Mozambijka - Mozambičanka f
Mozambik - Mozambik m
może - možno
mózg - mozog m
możliwość - možnosť f
możliwy - možný
mróz - mráz m
Ms - lokál
mucha - mucha
mućka - krava f
mulica - mulica f
muskowit - muskovit m
musztarda - horčica
muza - Múza f, múza f
muzeum - múzeum n
mużyk - muž m
my - my
mydło - mydlo
myjna - ofina
myrmeko- - myrmeko-
myrmekologia - myrmekológia f
mysz - myš
Myszka Miki - Miki Miška m
N - inštrumentál
naczynie - riad
naczyniowy - cievne
naddunajski - podunajský
nadir - nadir m, podnožník m
nadwzroczność - ďalekozrakosť f
nadziany - bohatý
nadzieja - nádej
Nadzieja - Nadežda
nagi - nahý
nagietek - nechtík m
nagietkowy - nechtíkový
Nahum - Nahum m
Nairobi - Nairobi
naleśnik - palacinka
Namibia - Namíbia f
napletek - predkožka f
napój - nápoj
na przykład - napríklad
narba - jazva
narkotyk - droga f
narzędnik - inštrumentál
nasz - náš
naturalny satelita - prirodzená družica f
nauczyciel - učiteľ m
nauczycielka - učiteľka f
Nauru - Nauru
Nawarra - Navarra f
Nazaret - Nazaret m
na zdrowie - na zdravie
nazywać - volať sa
Ndżamena - N'Djamena
Neapol - Neapol m
neapolitański - neapolský
neogen - neogén
neoliberalizm - neoliberalizmus m
neon - neón
Nepal - Nepál
neptun - neptúnium n
Neptun - Neptún m
nerka - oblička
nestorianizm - nestoriánstvo n, nestorianizmus m
neutralny - neutrálny
neutron - neutrón m
ni - ani, nie
nic - nič
nić Ariadny - Ariadnina niť f
nie - nie
niebieski - modrý
niebieskofioletowy - modrofialový
niebiosa - nebo
niebo - nebo
nieboskłon - nebosklon m, nebasklon m
nieć - bratanec m
niedaleko pada jabłko od jabłoni - jablko nepadá ďaleko od stromu
nie dospać trzeba, kto chce dostać chleba - komu sa nelení, tomu sa zelení
niedostatek - nedostatok m
nieduch - choroba f, nemoc f
niedziela - nedeľa f
Niedziela Palmowa - Kvetná nedeľa f, Palmová nedeľa f
niełatwy - ťažký
Niemcy - Nemecko n
Niemiec - Nemec m
nie mieć - nie
Niemiecka Republika Demokratyczna - Nemecká Demokratická Republika
niemiecki - nemecký, nemčina
Niemka - Nemka f
niemowlę - dojča
nienawistnie - nenávistne
niepamięć - amnézia f
niepełnoletni - neplnoletý
niepodległość - nezávislosť f
niepotrzebny - zbytočný
nieściora - sesternica f
niestały - nestály
niestety - bohužiaľ
niewiarygodny - neuveriteľný
niewiasta - žena f
niewiastka - nevesta f
niezapominajka - nezábudka f
niezmiennie - stále
nieżyczliwy - zlomyseľný
nigdy - nikdy
nigdzie - nikde
Niger - Niger
Nigeria - Nigéria
nihilistyczny - nihilistický
nihilizm - nihilizmus m
nikaj - nikde
Nikaragua - Nikaragua f
nikczemny - podlý
nikiel - nikel
nikotyna - nikotín m
nim - on, ono
Nina - Nina f
Niniwa - Ninive
ni pies, ni wydra - ani ryba, ani rak
ni rak, ni ryba - ani ryba, ani rak
Nix - Nix
niż - ako
ni z pierza, ni z mięsa - ani ryba, ani rak
NLPZ - NSA
no - áno
noc - noc f
noga - noha f
nonsens - protireèenie
Normandia - Normandia f
Norweg - Nór m
Norwegia - Nórsko
nos - nos, alkoholik
nosorożec - nosorožec m
nów - nov m
Nowak - Novák m
nowicjat - noviciát
nowogrecki - novogréčtina f, nová gréčtina f
nowojorski - newyorský
noworoczny - novoročný
nowotestamentowy - novozákonný
Nowozelandczyk - Novozélanďan m
nowy - nový
Nowy Rok - Nový rok
nóż - nôž
nóż do masła - nôž na maslo m
nożyce - nožnice f
nożyczki - nožnice f
Nubia - Núbia f
nuda - nuda f
nudelzupa - polievka f
nudno - nudne, nudno
nudny - nudný
numer - číslo
nupel - cumeľ m, cumlík m
nur - potáplica f
nurek - potápač m
nyga - komár m
Nyks - Nyx f
nylon - nylon, nylón, nylonky
nylonowy - nylonový, nylónový
nyny - spanie n
oaza - oáza f
Ob - Ob
obcokrajowiec - cudzinec
obelisk - obelisk m
oberżyna - baklažán
oberżynowy - baklažánový
obiad - obed m
obiecać - sľúbiť
obiecadło - abeceda
obiecny - jednoduchý
obiekt - objekt m
obierać - biť
obły - oblý
obój - hoboj m
obok - vedľa
obolewiec - ľavák
obraz - film m
obrus - obrus m
obywatel - občan m
Ocean Atlantycki - Atlantický oceán m
Ocean Spokojny - Tichý oceán m
ociec - otec, tato, tatko, tatíčko, foter m
oczywiście - samozrejme
od - z, od
od A do Z - od a do z, od a po z
od a do zet - od a do z, od a po z
od czasu do czasu - z času na čas
ode - z, od
odpływ - odliv m
odtrutka - protijed m
odwet - odplata f, odveta f
Ofelia - Ofélia f
Ofiarowanie Pańskie - Obetovanie Pána n, Predstavenie Pána Ježiša n, Hromnice
ogień - oheň m
ognie świętego Elma - Eliášov oheň m, oheň svätého Eliáša m
ogólniak - gympel m
ogórek - uhorka f
ogród - záhrada f
ogrodniczka - záhradníčka f
ogrodnik - záhradník m
ogrodowy - záhradný
ogrodzenie - ohrada f
ogród zoologiczny - zoologická záhrada f
ojciec - otec, tato, tatko, tatíčko, foter m
ojciec święty - Svätý Otec m
ojczyc - syn
ojczym - otčím m, nevlastný otec m
ojla - sova f
okno - okno
oko - oko n
okoń - ostriež m
okręt podwodny - ponorka f
okrutny - hnusný
oksymoron - oxymoron m
oksza - sekera f
okulary - okuliare
okultystyczny - okultistický
okultyzm - okultizmus m
okupant - okupant m
olcha - jelša f
olej - olej m
olej słonecznikowy - slnečnicový olej m
oligocen - oligocén m
Olimp - Olymp
oliwka - oliva f
Ołomuniec - Olomouc m
ołówek - ceruzka f, ceruza f, tužka f
ołtarz - oltár
Ołtarz - Oltár m
oma - stará mama
Oman - Omán
omen - omen n
omieszkać - nie
omlet - omeleta f
on - on
ona - ona
oni - oni
ono - ono
ONZ - OSN
oologia - oológia f
opal - opál m
opat - opát m
opera - opera f
opero - opera f
opiąć - zasa
opięć - zasa
opłata - poplatok m
opłatek - oblátka f
Orawa - Orava f
Orawianin - Oravec m, Oravčan m
Orawianka - Oravka f, Oravčanka f
orawski - oravský
oraz - a
orbita - orbita f
ordowik - ordovik m
orgazm - orgazmus m
orientalistyka - orientalistika f
Orion - Orión m
orlab - dovolenka
Orla Perć - Orlia prť f
Ormianin - Armén m
Ormianka - Arménka f
ornitolog - ornitológ m
ornitologia - ornitológia f
ornitologiczny - ornitologický
orogeneza - orogenéza f
ortografia - pravopis m, ortografia f
ortograficzny - pravopisný
oryginalność - originálnosť f
orzeł - orol m
Orzeł - Orol m
osa - osa f
Osaka - Osaka f
-ość - -osť
Oslo - Oslo n
ośmiotysięcznik - osemtisícovka f
osoba - osoba f
Osobłoga - Osoblaha f, Petrovický potok m (do zbiegu ze strumieniem Muszlow)
osobłoski - osoblažský
ostatki - fašiangy
osteo- - osteo-
ostiepok - oštiepok m
Ostrawa - Ostrava f
ostrokrzew - cezmína f
ostrokrzew kolczasty - cezmína ostrolistá f
Oświęcim - Osvienčim
ouberiba - kaleráb
-owa - -ová
owad - hmyz
owadoznawstwo - entomológia f
owca - ovca
owulacja - ovulácia f
owulacyjny - ovulačný
ozimina - ozimina f
ozon - ozón
pachniarz - nos
paciuk - potkan, krysa
pacjent - pacient
pacjentka - pacientka f
Pacyfik - Tichý oceán m
Pad - Pád m
padać - hovoriť
padać jak muchy - padať ako muchy
Padwa - Padova f
pająk - pavúk m
pajęcznik - september m, október m, november m
Pakistan - Pakistan
Pakistanka - Pakistanka
pakli - ako
pała - hlava
pałacowy - palácový
palacz - vodič m
Palau - Palau
pale - hlava
palec - prst m
paleo- - paleo-, pale-, pal-
paleogen - paleogén
paleoproterozoik - Paleoproterozoikum
paleozoik - paleozoikum
palić - fajčiť
paliowy - svetložltý
pamflet - pamflet m
pan - pán m
Pan - Pán m
Panacea - Panakeia f
Panama - Panama f
panamerykański - panamerický
Pan Bóg - Pán m
Pankracy - Pankrác m
panna - slečna f
Panna - Panna f
panorama - panoráma
pantera - leopard
pantograf - pantograf m
papier - papier
papieros - cigareta f
papież - pápež m
papryka - paprika f
Papua-Nowa Gwinea - Papua-Nová Guinea f
papuć - topánka f
parabola - parabola f
Paragwaj - Paraguaj
parasol - dáždnik m, slnečník m
park - park m
park krajobrazowy - chránená krajinná oblasť f
park narodowy - národný park m
parówka - párok
partykuła - častica f
Parys - Paris m
Paryż - Paríž m
pasat - pasát m
pasażer - pasažier m
pasażerka - pasažierka f
pasjans - pasians m
pasta - pasta f
pasywny - pasívny, nečinný
pasz - nedostatok m
paszport - cestovný pas
pat - pat m
Patagonia - Patagónia
Patria - Patria f
patriotyzm - patriotizmus
patrzałki - okuliare
patrzeć przez różowe okulary - pozerať cez ružové okuliare
Paulek - Pavol m
paw - páv
Paweł - Pavol m
październik - október m
paździerzeń - október m
pazura - ruka
pchła - blcha f
pedagogika - pedagogika
pedant - pedant m
pedantka - pedantka f
pedo- - pedo-, ped-
pedofil - pedofil m
pędzel - štetec m
Pegaz - Pegas m
peja - voš f
pelargonia - pelargónia f
pełen - plný
pełny - plný
pentagon - päťuholník m
Pepik - Čech m
Peregryn - Peregrin
perka - zemiak
perkoz dwuczuby - potápka chochlatá f
perkozek - potápka malá
perła - biser m, perla f
perliczka - perlička f
perm - perm
Perseusz - Perseus m, Perzeus m
persona - osoba f
Peru - Peru
Peruwianka - Peruánka f
Petersburg - Petrohrad
piać - kikiríkať
piana - pena f, pivo
pianista - klavirista m, pianista m
pianistka - klaviristka f, pianistka f
piano - kikiríkať, pena f
piasek - piesok
piaskowiec - pieskovec
piaskownica - pieskovisko n
piątek - piatok m
piąte koło u wozu - piate koleso na voze n
piec - pec f, piecť
pięciocyfrowy - päťciferný
pięciokąt - päťuholník m
pięciokątny - päťuholníkový
pieczara - jaskyňa
pieczarka - pečiarka, šampiňón
piekło - peklo
pięknie - pekne
piękny - pekný
Piemont - Piemont m
pieniński - pieninský
Pieniny - Pieniny
pierdnięcie - prd m
pies - pes
pieski - psí
pięta Achillesa - Achillova päta f
pięta achillesowa - Achillova päta f
Pietropawłowsk Kamczacki - Petropavlovsk-Kamčatskij
pietruszka - petržlen
pietruziel - petržlen
pijacki - pijacký
pijaczka - pijačka f
pijany jak bela - opitý ako snop
pijawa - dúha f
pijawka - pijavica f
pikawa - srdce n
piłkarzyki - stolný futbal m
Pilzno - Plzeň f
pióro - pero
piorun - blesk m
piosenka - pieseň f, pesnička f
Piotr - Peter m
Piotra - Petra f
piramida - pyramída f
Pireneje - Pyreneje
Pireus - Pireus m
pirydoksyna - pyridoxín m
piryt - pyrit m
pismo - písmo n, abeceda
pisuar - pisoár m
pitny - pitný
Pittsburgh - Pittsburgh
piwo - pivo
pizgać - biť
pizza - pizza f
pl. - nám.
plac - námestie
plagiator - plagiátor m
planeta - planéta f
planetarium - planetárium n
planetoida - asteroid m
planta - rastlina f
platan - platan m
plaża - pláž m
plebiscyt - hlasovanie n
Plejada - Plejáda f
Plejady - Plejády
plejstocen - pleistocén
pliocen - pliocén
pliszka górska - trasochvost horský
płk - plk.
płomień - plameň m
płomyk - plameň m
płótno - plátno n
Pluton - Pluto m, Plutón m
płynny - likvidní, plynný, tekutý
pływacki - plavecký
pływalnia - bazén m
pocestny - cestovateľ m
pochmurny - zamračený
pociąg - vlak m
poczta - pošta
pocztówka - pohľadnica
pod gołym niebem - pod holým nebom
Podgorica - Podgorica
podkarpacki - podkarpatský
podkoszulek - tielko n
podkoszulka - tielko n
podłoga - podlaha f
Podole - Podolie
podpis - podpis m
podróżnik - cestovateľ m
podstawówka - základná škola f
podstawowy - základný
podtlenek - suboxid m
poduszka - poduška f, káro
poduszkowiec - vznášadlo n
poeta - básnik m
poezja - poézia f
poganin - pohan m
poganka - pohanka f
pogoda - počasie n
poker - poker m
pokląskwa - pŕhľaviar červenkavý
pokój - izba
pokrzywowy - žihľavový, pŕhľavový
poleku - pomaly
policzek - facka f
Polihymnia - Polymnia f
politolog - politológ m
polityk - politik m
polityka - politika
Polka - Poľka f
półkula - hemisféra f
półlitrówka - pollitrovka f
półlitrowy - pollitrový
północ - polnoc, sever
północnoamerykański - severoamerický
północno-zachodni - severozápadný
połóg - pôrod
polon - polonium
połonina - polonina f
polonizm - polonizmus m
położenie - umiestnenie n
Polska - Poľsko
Polska Rzeczpospolita Ludowa - Poľská ľudová republika
polski - poľský, poľština f
półudenyk - obed m
południe - poludnie n, juh m
Południe - juh m
południk - poludník
półwysep - polostrov m
Półwysep Apeniński - Apeninský polostrov m
Półwysep Iberyjski - Iberský polostrov
Półwysep Pirenejski - Iberský polostrov
pomarańcza - pomaranč m
pomarańczowobrązowy - oranžovohnedý
pomarańczowoczerwony - oranžovočervený, pomarančovočervený
pomarańczowożółty - oranžovožltý
pomarańczowy - pomarančový, oranžový
pomidorowy - paradajkový, rajčinový
pomoc - pomoc f
pończocha - pančucha f
poniedziałek - pondelok m
ponor - ponor m
ponownie - zasa
ponuro - ponuro
pop - pop m
Popielec - Popolcová streda f, Popolečná streda f, Popolec m, Škaredá streda f, Popolná streda f, Krivá streda f, Prvopôstna streda f
popiół - popol
Poprad - Poprad m
por. - por.
porno- - porno-
pornografia - pornografia f
pornograficzny - pornografický
poród - pôrod
Portoryko - Portoriko
porucznik - nàdporóčnik
poruta - škandál m
Posejdon - Poseidón m
posiadać - mať
posłać do diabła - poslať do čerta
posłać do wszystkich diabłów - poslať do čerta
posłanka - poslankyňa f
posowa - strop m
postawić wszystko na jedną kartę - postaviť všetko na jednu kartu
postęp - pokrok
pot - pot m
potas - draslík
powiestka - meno
powietrze - vzduch m
powódź - povodeň f
powoli - pomaly
powolny - pomalý
pożar - oheň m, požiar m
pozaziemski - mimozemský
Poznań - Poznaň
pożyczka - pôžička f
pracować - pracovať
praczka - práčka f
prawak - hríb smrekový m
prawa ręka - pravý, ruka
prawa zwierząt - práva zvierat
prawda - pravda
prawdziwek - hríb smrekový m
prawie - takmer
prawnuczka - pravnučka f
prawy - pravý
premier - premiér m
Preszów - Prešov m
prezerwatywa - prezervatív m
proca - prak m
prochownia - pracháreň f
progres - pokrok
projektantka - projektantka f
prom - kompa
propan - propán m
prorok - prorok m
prosiak - prasa
prosię - prasa
prostota - prostota f
prosty - priamy, rovný, ľahký, obyčajný
proszczok - prasa
proszę - prosím
protein - bielok m
proteina - bielok m
proton - protón m
prowansalski - Occitánsky
Prowansja - Provensalsko
prowitamina - provitamín m
Prusy - Prusko
prymatologiczny - primatologický
przać - milovať, ľúbiť
przebaczenie - odpustenie
przebytek - byt
przecinek - čiarka f
przedmieście - predmestie
przedsiębiorca - podnikateľ m
przedszkole - materská škola f, škôlka f
przekształcać - premeniť, pretvoriť, transformovať
Przełęcz pod Chłopkiem - Mengusovské sedlo m
przełyk - pažerák m
przenośnia - metafora
przepraszam - prepáčiť
przewlekły - vleklý
przez - cez
przeze - cez
przoć - milovať, ľúbiť
przyimek - predložka
przyjaciółka - priateľka f
przykład - príklad
przylądek - mys m
przyroda - príroda f
przyrodni - nevlastný
przyrodniczy - prírodný
przyrostek - prípona f
przysłówek - príslovka f
przytcza - príklad
przytulić - objať
przyzapuście - fašiangy, mäsopust m, fašiang m, fašianok m, karneval m
psi - psí
Psia Gwiazda - Sírius m
psisko - pes
psychopata - psychopat m
psychopatka - psychopatka f
Psy Gończe - Poľovné psy
pszczelarski - včelársky
pszczelarstwo - včelárstvo n
pszczelarz - včelár m
pszczeli - včelí
pszczoła - včela f
ptak - vták m
ptaszę - vták m
puchacz - výr
puchar - pohár
pudło - škatuľa f
pukać - klopať
puklaty - hrbatý
pultok - moriak
punkt - bod m
purpurowy - purpurový, nachový
pusty - hlúpy
puszka - väzenie n, pivo
puter - moriak
putnia - vedro n
Pyjter - Peter m
pypka - cumeľ m, cumlík m
pyra - zemiak
rabat - rabat m
Rabat - Rabat m
rabin - rabín m
Rachela - Ráchel f
raciądz - rytier m
rad - rádium n
Radamantys - Radamantys m
radar - radar m, rádiolokátor m
radon - radon
rafinować - rafinovať
raj - raj m
Rajch - Nemecko n
rak - rakovina
Rak - Rak m
rakieta - raketa f
rakuski - rakúsky
ranny ptaszek - ranostaj m
rap - rap m
rasa - rasa f
rasista - rasista m
rasistka - rasistka f
rasizm - rasizmus m
ratusz - radnica f
Rawenna - Ravenna
razdziawa - krkavec m, vrana f
raz na ruski rok - raz za uhorský rok
rdest ptasi - stavikrv vtáčí, truskavec
rdzawobrązowy - hrdzavohnedý
rdzawoczerwony - hrdzavočervený
ręka - ruka
rękaw - rukáv m
rekin - žralok m
rekordowy - rekordný, rekordový
religia - náboženstvo
religijny - náboženský, nábožný
ren - rénium
republika - republika
republika bananowa - banánová republika f
Republika Czeska - Česká republika f
Republika Federalna Niemiec - Nemecká spolková republika
Republika Karelia - Karelská republika
Republika Słowacka - Slovenská republika
Republika Zielony Zielonego Przylądka - Kapverdy
responsorium - responzórium
restauracja - reštaurácia f
reumatyczny - reumatický
reumatyzm - reumatizmus m
rewolucjonistka - revolucionárka f
reżyser - režisér m
Rijad - Rijád m
ring - ring m
RNA - RNK f
robaczywy - červivý
robić - robiť, pripraviť
robot - robot m
rod - ródium
Rodan - Rhôna
rodzic - rodič m
rodzić - rodiť
rodzicielski - rodičovský
róg Amaltei - roh hojnosti m
rogaty - rohatý
róg obfitości - roh hojnosti m
rok - rok m
Roksana - Roxana f
rolmops - zavináč m
rolnictwo - poľnohospodárstvo n
Rom - Róm m
Roman - Roman
romanizm - romanizmus m
romski - rómsky, rómčina
ropa - hnis m
rosa - rosa f
rosarium - rozárium n
Rosja - Rusko n
roślina - rastlina f
roso - rosa f
rouza - ruža f
Rouza - Ružena f
rower - bicykel m
rowerowy - bicyklový
równanie - rovnica
równanie stanu - stavová rovnica
również - tiež
róża - ruža f
Róża - Ružena f
róża dzika - ruža šípová f, psia ruža, divý šíp, šípka f
róża herbaciana - čajová ruža, čajovka
róża herbatnia - čajová ruža, čajovka
różaniec - ruženec m
rozdroże - rázcestie n, krížne cesty f, križovatka f
rozdział - kapitola f
rozkaz - rozkaz m
rozliczny - rozličný
roztwór - roztok m
rozum - rozum m
rozumny - rozumný
rtęć - ortuť f, živé striebro n
rubid - rubidium
rubryka - rubrika f
ruchome schody - eskalátor m, pohyblivé schody
ruda - ruda f
rudny - červený, komunista
rudy - hrdzavý, ryšavý, rysavý
rugby - ragby f
rum - rum m
rumianek - rumanček m
rumiankowy - rumančekový
Rumun - Rumun m
Rumunia - Rumunsko
Rumunka - Rumunka f
ruten - ruténium
rutyl - rutil
Rwanda - Rwanda f
ryba - ryba
Ryba - Ryba f
Ryby - Ryby, Ryby f, Ryba f
rycerz - rytier m
rycina - rytina f
Ryga - Riga f
ryma - chrípka
rynek - trh
rynka - hrniec
ryś - rys
rywal - súper m
ryż - ryža f
rzadny - bridký
rzemiosło - remeslo n
Rzeszów - Rešov
rzeźnik - mäsiar
Rzym - Rím m
Rzymianin - Riman m
Rzymianka - Rimanka f
Sabaudia - Savojsko n
Sachalin - Sachalin
saczek - blúzka
sad - sad m
sadu - sad m
sadzielnik - kominár m
sagan - hlava, čajník
Sahara - Sahara
Sahara Zachodnia - Západná Sahara f
saharyjski - saharský
sakralny - sakrálny
sałaciarz - taxikár
salmiak - salmiak m
Salomon - Šalamún m
samar - samarium
samba - samba f
samica - samica f
Samoa - Samoa
samobójczy - samovražedný
samobójstwo - samovražda f, suicídium n
samochód - automobil m, auto n
samochód osobowy - osobný automobil, osobné motorové vozidlo, osobné auto
samochodowy - automobilový
samodzielny - samostatný
samolot - lietadlo m
sanajka - Sanáčanka f
sandacz - zubáč m
sanskrycki - sanskritský
Sardynia - Sardínia
sarnapa - žirafa f
sąsiad - sused
Saturn - Saturn m
sauna - sauna f
schizofreniczny - schizofrenický
schizofrenik - schizofrenik m
schody - schody, schodisko
schody ruchome - eskalátor m, pohyblivé schody
ściana - stena f
ściany mają uszy - steny majú uši
seaborg - seaborgium
sejf - trezor m, sejf m
sekunda - sekunda f
Sekwana - Seina f
selen - selén
Selena - Selena f
Selene - Selene f, Seléna f
Selenita - Mesiačan m
Selenitka - Mesiačanka f
seleno- - seleno-
selenografia - selenografia f
seler - zeler m
semicki - semitský
sen - spánok m
Senegal - Senegal m
sen zimowy - zimný spánok m
separatysta - separatista m
separatystyczny - separatistický
sepsa - sépsá f
ser - syr
Serbia - Srbsko
Serbka - Srbka f
serce - srdce n
serdce - srdce n
sernik - kazeín m
seroka - straka f
serowy - surový
serwatka - srvátka f
Seszele - Seychely
sezamowy - sezamový
siano - seno n
siarkowodór - monosulfán, sírovodík, sulfán
siatkarka - volejbalistka
siatkarski - volejbalový
siatkarz - volejbalista
się - sa
sieczeń - február m
siedem grzechów głównych - sedem hlavných hriechov
siedmioramienny - sedemramenný
siekiera - sekera f
Siena - Siena f
sierpień - august m
Sierra Leone - Sierra Leone
sierść - srsť f
sierżant - seržant m
siewka złota - kulík zlatý m
sikora - sýkorka f
sikora czarnogłowa - sýkorka čiernohlavá f
Singapur - Singapur m
sioło - dedina f, vidiek m
siostra - sestra
sirpień - august m
sitwa - klika
skalpel - skalpel
skand - skandium
skandal - škandál m
skansen - skanzen
skarpeta - ponožka f
skarpetka - ponožka f
skiba - krádež f
skład - obchod m, predajňa f, strop m
sklep - obchod m, predajňa f, strop m
skok - skok m
skok o tyczce - skok o žrdi
Skop - Baran m
Skopje - Skopje n
Skorpion - Škorpión m
skowronek - škovránok m
skra - iskra f
skrobia - škrob m
skromność - skromnosť f
skroń - spánok m
skrótowiec - akronym m
skrzydlaty - okrídlený
skrzynka pocztowa - poštová schránka f
ślad - stopa f
sładnie - pekne
Śląsk - Sliezsko n
śląski - sliezsky
slawistyczny - slavistický
slawistyka - slavistika f
slawizm - slavizmus m
śleboda - sloboda, voľnosť
śledź - kravata f
śledziona - slezina
ślepota - slepota f
ślepucha - sliepka, kura
ślicznie - pekne
ślimak - slimák m
ślips - kravata f
słodki - sladký
słomiana wdowa - slamená vdova
słomiany - slamený
słomiany wdowiec - slamený vdovec m
słomkowy - slamený
słoń - slon
słońce - slnko n
Słońce - Slnko n
słowa - slovo n
Słowacja - Slovensko n
Słowaczka - Slovenka f
Słowak - Slovák m
Słowenia - Slovinsko n
Słoweniec - Slovinec m
Słowenka - Slovinka f
słoweński - slovinský
Słowianin - Slovan m
Słowianka - Slovanka f
słowiański - slovanský
słownik - slovník m
słowo - slovo n
ślub - svadba f
słuch - sluch
słuchać - počúvať
słuchacz - poslucháč m
słuchaczka - poslucháčka m
slup - šalupa
smacznego - dobrú chuť
smażonka - praženica
smerf - Šmolko, Šmolkovia
śmierć - smrť f
śmigus - oblievačka f, polievačka f
śmigus-dyngus - oblievačka f, polievačka f, polievací pondelok
smoczek - cumeľ m, cumlík m
smok - drak m
Smok - Drak m
smutniak - chlieb m
smutny - smutný
smysł - rozum m
snecha - nevesta f
śnieg - sneh m
śnieżnobiały - snehobiely
snob - snob m
snobka - snobka f
snop - snop m
sobaczy - psí
sobaka - pes
sobota - sobota f
socjaldemokracja - sociálna demokracia f
socjalizm - socializmus m
soczewica - šošovica f
soczysty - šťavnatý
sód - sodík
Sofia - Sofia f
sójka syberyjska - škriekavec zlovestný m
sójka złowroga - škriekavec zlovestný m
sokół - sokol
Sokrates - Sokrates m
Sol - Sol m
solarium - solárium n
solidarnie - solidárne
solidny - solídny
Solon - Solón m
Somalia - Somálsko n
Somaliland - Soomaaliland
somsiad - sused
sopel - cencúľ m, ciageľ m
sopranista - sopranista m
sos - omáčka
sosyska - párok
sowa - sova f
spać jak zając - spať ako myš, spať ako myš na vreci
spać snem sprawiedliwego - spať spánkom spravodlivých
spanie - spanie n
spektakularny - spektakulárny
śpiący - ospalý, pohostinný
śpiewać - spievať
śpioch - spachtoš
spis rzeczy - abecedár m
spis treści - abecedár m
śpiwór - spací vak
spójnik - spojka f
sposób - spôsob m
spowiednia - spovednica f
spowiedź - spoveď
spragniony - smädný
sprężyna - pružina f
sprzedawać - predávať
sprzęgło - spojka f
sp. z o.o. - s.r.o.
srać - srať
srebro - striebro n
srebrzysty - striebristý
średniowiecze - stredovek n
Sri Lanka - Srí Lanka
środa - streda f
środa popielcowa - Popolcová streda f, Popolečná streda f, Popolec m, Škaredá streda f, Popolná streda f, Krivá streda f, Prvopôstna streda f
Środa Popielcowa - Popolcová streda f, Popolečná streda f, Popolec m, Škaredá streda f, Popolná streda f, Krivá streda f, Prvopôstna streda f
sroka - straka f
śruba - skrutka f
śrubokręt - skrutkovač m
ssak - cicavec m
stacja - stanica f
stacja kolejowa - železničná stanica f, nádražie n
stado - črieda f
stalagmit - stalagmit m
stalagnat - stalagnát m
stalaktyt - stalaktit m
Stambuł - Istanbul
stan - stav m, štát m
stanik - podprsenka f
stara panna - stará panna f
starek - dedo m, dedko m, starý otec m
stare miasto - starý, mesto n
starka - stará mama
starosek - dedo m, dedko m, starý otec m
staroszek - dedo m, dedko m, starý otec m
starotestamentowy - starozákonný
starożytność - starovek m
starszy - otec, tato, tatko, tatíčko, foter m
stary - starý
starzyk - dedo m, dedko m, starý otec m
statki - riad
statory - riad
staw łokciowy - lakťový kĺb
Stefan - Stefan
stegnisko - stopa f
Stela - Stela f
Stella - Stella f
stodoła - stodola f
stół - stôl m
stolica - hlavné mesto n
stomatologia - stomatológia f
stonka - pásavka f
stopa - chodidlo n, stopa f
strąpacz - február m
strata - strata f
strażak - hasič m
stres - stres m
struna - struna f
struś - pštros
strzała - šíp
strzec jak oka w głowie - chrániť ako oko v hlave
strzec jak źrenicy oka - chranit́ áko oko v hlave
Strzelec - Strelec m
studnia - studňa
stuletni - storočný
styczeń - január m
subiektywny - subjektívny
suchy - suchý
Sudan - Sudán
Sudańczyk - Sudánec m
Sudanka - Sudánka f
sudeckoniemiecki - sudetonemecký
Sudety - Sudety, Krkonošsko-jesenická subprovincia
sufit - strop m
suka - suka f
Sumatra - Sumatra
Surinam - Surinam
surowy - surový
surrealizm - surrealizmus m, nadrealizmus m
suwerenny - suverénny
świat - svet m
świątek - sviatok m
świekier - svokor m
świekra - svokra, svekruša f
świerk - smrek m
świerzb - svrab
świeść - svokra, svekruša f
Świetlana - Svetlana f
święto - sviatok m
świętojański - svätojánsky
święty lej - oblievačka f, polievačka f
święty Marcin - svätý Martin m
święty mikołaj - Mikuláš m
święty Mikołaj - svätý Mikuláš m
Święty Mikołaj - svätý Mikuláš m
Świnica - Svinica f
świń z tobą nie pasałem - ja som s tebou svine nepásol, ja som s tebou kravy nepásol, ja som s tebou husi nepásol
świostka - svokra, svekruša f
świstun - kačica hvizdárka
świstunka - kolibiarik
świt - svit, úsvit, svitanie
świtanie - svit, úsvit, svitanie
Sycylia - Sicília
syjam - siamská mačka f
Syjon - Sion m
syjonistyczny - sionistický
sylaba - slabika f
sylur - silúr
sylwek - Silvester m
sylwester - Silvester m
Sylwester - Silvester m
sylwestrowy - silvestrovský
symbol - symbol
symetria - symetria f
symulant - simulant m
syn - syn
synkretyczny - synkretický
synkretyzm - synkretizmus m
syn marnotrawny - márnotratný syn m
synowa - nevesta f
sypialnia - spálňa f
syra - noha f
Syriusz - Sírius m
syty - sýty
szach - šach
szachownica - šachovnica
szachy - šach
szafonierka - bielizník m
szafranowy - šafranový
szal - šál
szampan - šampanské
szara strefa - siva ekonomija
Szczecin - Štetín
szczerk - štrk
szczewik - topánka f
szczoteczka do zębów - zubná kefka f
szczur - potkan, krysa
szczyt - orgazmus m
szept - šepot m
szermierz - šermiar
szeroki - široký
sześciocyfrowy - šesťciferný
sześciokąt - šesťuholník m
szkarłatny - šarlátový
szkielet - kostra
szkita - noha f
szklistka - sklovec
Szkocja - Škótsko
szkoda - škoda f
szkoła - škola f
szkoła podstawowa - základná škola f
szkoła powszechna - základná škola f
szkolnictwo - školstvo n
szkop - Nemec m
Szląsk - Sliezsko n
szlauch - had m
szlips - kravata f
szlug - cigareta f
szluk - hlt
szmaja - ľavák
szmania - ľavák
szneka - tvár f, obličaj
szogun - šógun m
szolka - šálka
szowinista - šovinista m
szowinistka - šovinistka f
szpak - škorec
szpiegostwo - špionáž f
szpinak - špenát
szprycer - fet'ak
szpuk - holub
Sztokholm - Štokholm m
sztuka - umenie, kus, exemplár, hra
szuja - lajdák, nedbanlivec
szukać igły w stogu siana - hľadať ihlu v kope sena
szulak - jastrab
szwab - Nemec m
szwaja - noha f
Szwajcaria - Švajčiarsko
Szwajcarka - Švajčiarka f
Szwecja - Švédsko
Szwecyjo - Švédsko
szwestera - sestra
szybki - rýchly
szyć - šiť
Szydłowiec - Šydlovéc
szykowny - elegantný
szynal - klinec
szynka - šunka
szypszyna - ruža šípová f, psia ruža, divý šíp, šípka f
szyszynka - šuškovité teliesko n
tachykardia - tachykardia f
tacik - otec, tato, tatko, tatíčko, foter m, dedo m, dedko m, starý otec m
Tadżykistan - Tadžikistan
tajga - tajga f
Tajlandia - Thajsko
Tajwan - Taiwan
tajwański - taiwanský
tak - áno
taksówkarz - taxikár
także - tiež
tal - thallium
Talia - Tália f
Tallinn - Tallinn m
tam - tam
Tamara - Tamara
tamdotąd - tam
tamten - tamten
tango - tango n
taniec świętego Wita - tanec svätého Víta
tank - tank
tantal - tantal
Tanzania - Tanzánia f
tapeta - tapeta f
tarcza - tvár f, obličaj
tarcza strzelecka - tvár f, obličaj
tarczyca - štítna žľaza f
Tasmania - Tasmánia f
taternictwo - horolezectvo n
tatrzański - tatranský
Tbilisi - Tbilisi n
teatr - divadlo n
teatralny - divadelný
technet - technécium
technolog - technológ m
technologia - technológia f
tęcza - dúha f
tej - ty
teksasy - džínsy
tekst - text m
Tel Awiw - Tel Aviv m
telefonista - telefonista m
teleskop - teleskop, ďalekohľad
tellur - telúr
temat - tému
tenis - tenis
tenisista - tenista m
tenisistka - tenistka
tenisowy - tenisový
Teodor - Teodor m
teofania - teofánia f
teolog - teológ m
tępak - tupec, sprosták
tępy - tupý
teraz - teraz
terb - terbium
teriologiczny - teriologický
Termopile - Termopyly
Terpsychora - Terpsichora f
Tesalia - Tesália f
teść - svokor m
teściowa - svokra, svekruša f
tęsknota - túha, túžba
tętnica - artéria f, tepna f
tetum - tetumčina
też - tiež
Timor - Timor
Tirana - Tirana
tisztuch - obrus m
tkactwo - tkáčstvo n
tkanina - tkanina f
tlen - kyslík
tlenek węgla - oxid uhoľnatý
tłusty czwartek - tučný štvrtok m
tobie - ty
Togo - Togo n
tokijski - tokijský
Tokio - Tokio
tokoferol - tokoferol m
toksyczność - toxicita f
tona - tona f
Tonga - Tonga
tor - thorium
torf - rašelina f
torfowy - rašelinový
torpeda - torpédo n
tors - hrudník m
tort - torta f
tory - thorium
totalitarny - totalitárny
towar - tkanina f
towarzysz - kompán, spoločník m, súdruh m
tracz - potápač
trądzik - akné f
tragikomedia - tragikomédia f
traktor - traktor
transcendentalizm - transcendentalizmus m
trąt - trúd m
trawa - tráva f
Trenczyn - Trenčín m
trias - trias m
Trnawa - Trnava f
trójnóg - trojnožka f
trolejbus - trolejbus
tron - trón m
trudny - ťažký
trumniarz - truhlár m
trup - mŕtvola
truskawka - jahoda f
truteń - trúd m
Trynidad i Tobago - Trinidad a Tobago
trzcina cukrowa - cukrová trstina f
trzeciorzęd - terciér
trzmiel - čmeľ m
trzycyfrowy - trojciferný
trzymać język za zębami - držať jazyk za zubami
tubylec - domorodec m
tudzież - a
Tukan - Tukan m
tulipan - tulipán m
tułów - trup
tulp - tulipán m
tundra - tundra f
tunel - tunel m
Tunezja - Tunisko
tunezyjski - tuniský
Turcja - Turecko
turcyzm - turcizmus m
Turek - Turek m
turkusowy - tyrkysový
turmalinowy - turmalínový
Turyn - Turín
turysta - turista m
turystka - turistka f
turystyczny - turistický
turystyka - turistika f
Tuvalu - Tuvalu
twardy - tvrdý, drsný, tvrdošijný
twarz - tvár f, obličaj
twierdza - tvrdza f
twój - tvoj
ty - ty
Tybetanka - Tibeťanka f
Tyche - Tyché f
tydzień - týždeň m
tygr - tiger
tygrys - tiger
Tyjuś - Teodor m
tylko - len, iba
typografia - typografia f
tyroksyna - tyroxín m
tytanida - Titanka
tzn. - t. j.
tzw. - tzv.
ubiór - odev
udo - stehno n
udziec - kotleta
ufnal - klinec
Uganda - Uganda
układ nerwowy - nervová sústava f
Układ Słoneczny - slnečná sústava f
Ukrainiec - Ukrajinec m
Ukrainka - Ukrajinka f
ulica - ulica f
umywalka - umývadlo n
Unia Europejska - Európska únia f
uniwerek - univerzita
uniwersytet - univerzita
uón - on
upiór - upír m
Ural - Ural
uran - urán m
Uran - Urán m, Uranos m
Uranos - Uranos m
Urban - Urban m
urbanista - urbanista m
Urbanowy - Urbanov
urępny - pekný
urlop - dovolenka
urodzajność - úrodnosť f
Urugwaj - Uruguaj
uskrzydlony - okrídlený
usta - ústa
uszatka - sova ušatá
utęsknienie - túha, túžba
uzasadniać - zdôvodniť
Uzbek - Uzbek m
Uzbekistan - Uzbekistan
uzupełniać - dopĺňať
V4 - V4
wacha - benzín, dážď, more n, voda
wadliwy - chybný
Waga - Váhy, Váha f
wagon - vagón m
wajco - vajce n
Walburga - Valburga f
walcowaty - valcovitý
Walenty - Valentín m
Walia - Wales
wandal - vandal m
Wandal - Vandal m
wandalizm - vandalstvo n, vandalizmus m
wapień - vápenec
wapniak - rodič m
wardawy - ľavák
warga - pera
Warkocz Bereniki - Vlasy Bereniky m
Warszawa - Varšava f
warszawski - varšavský
warunek - podmienka f
warzęcha - lyžičiar m
warzywo - zelenina f
wata - vata f
Watykan - Vatikán
Wawrzyńcowy - Vavrincov
Wawrzyniec - Vavrinec m
wąż - had m
wczoraj - včera
wdowa - vdova f
wdowiec - vdovec m
wdowula - vdova f
węborek - vedro n
Wega - Vega f
wegetarianin - vegetarián m
węgiel - uhlík m, uhlie n
Węgier - Maďar m
Węgierka - Maďarka f
węgierski - maďarský
węglowodan - karbohydrát m
Węgry - Maďarsko n, Uhorsko n
Wełtawa - Vltava f
Wenecja - Benátky
wenecjanin - Benátčan m
wenecjanka - Benátčanka f
wenecki - benátsky
Wenera - Venuša f
wenerologia - venerológia f
Wenezuela - Venezuela
Wenezuelczyk - Venezuelčan m
Wenus - Venuša f
Wenusjanin - Venušan m
Wenusjanka - Venušanka f
wereta - plátno n
Weronika - Veronika f
weselny - svadobný
Wesna - Vesna f
wesoło - veselo
Wesołych Świąt - veselé Vianoce
westa - vesta
Westa - Vesta f
wesz - voš f
węszyć - čuchať
weterynaria - veterinárna medicína, veterinárne lekárstvo, veterinárstvo, zverolekárstvo
węzeł chłonny - lymfatická uzlina
Wężownik - Hadonos m
Wezuwiusz - Vezuv
wezwanie - meno
wiadro - vedro n
wiadukt - viadukt m
Wiara - Viera f
wiatr - vietor m
Wichta - Viktória f
widelec do porcjowania - vidliĉka na porciovanie f
wideo - video n
widzieć - vidieť
widzieć białe myszki - vidieť biele myšky
wieczera - večera
wieczerza - večera
Wieczne Miasto - Večné mesto n
wieczór - večer m
Wiedeń - Viedeň f
wiedzieć - vedieť
większy - väčší
wielbłąd - ťava f
wielbłądzi - ťaví
Wielka Niedźwiedzica - Veľká medvedica
Wielkanoc - Veľká noc f
wielkanocny - veľkonočný
Wielka Sobota - Veľká sobota f, Biela sobota f
wielki - ťažký
Wielki Piątek - Veľký piatok m
Wielki Tydzień - Svätý týždeň m, Veľký týždeň m
wielkopiątkowy - veľkopiatkový
wielokropek - tri bodky
Wielopole - Veľopolie
Wieloryb - Veľryba f
wieniec adwentowy - adventný veniec m
wieniec laurowy - laur m, vavrín m, vavrínový veniec m
wierzba - vŕba f
wieś - dedina f, vidiek m
Wietnam - Vietnam
Wietnamczyk - Vietnamec m
Wietnamka - Vietnamka f
wietnamski - vietnamský
wiewiórka - veverica f
wieża - veža
więzienie - väzenie n
wigilia - vigília f
Wigilia - Štedrý deň
wikariusz - vikár m
wikary - farský vikár
Wikipedia - Wikipédia
Wikisłownik - Wikislovník, vikcionár m
Wikiźródła - Wikizdroj
Wiktoria - Viktória f
wilczy - vlčí
wilgotność - vlhkosť f
wilia - vigília f
wilija - vigília f
wilk - vlk m
wilk morski - morský vlk m
willa - vila f
Wilno - Vilnius m
winiarstwo - vinárstvo n
wino - víno
winograd - víno
winogrodnictwo - vinohradníctvo n
winogrodniczka - vinohradníčka f
winogrodnik - vinohradník m
wiosenny - jarný
wioska - dedina f, vidiek m
wiosło - veslo n
wiosłowanie - veslovanie n
wiosna - jar f, vesna f
Wirakocza - Viracocha m
wirus - vírus m
Wisła - Visla
wista - vesta
Wisznu - Višnu m
Wit - Vít m
wizjer - datív
w każdym razie - v každom prípade
Władywostok - Vladivostok
włamywacz - vlamač m
Włoch - Talian m
Włochy - Taliansko
Włodzimierz - Vladimír
włoski - taliansky, taliančina f
Włoszka - Talianka f
wnęk - vnuk m
wnęka - vnučka f
wnuczka - vnučka f
wnuk - vnuk m
woda - voda
wóda - vodka f
woda mineralna - minerálna voda f
wódka - vodka f
Wodnik - Vodnár m
wodór - vodík
wodospad - vodopád
wojak - vojak m
Wojciech - Vojtech
województwo - vojvodstvo, kraj
wojna - vojna
wojna trojańska - trójska vojna
wojskowy - vojak m
wokabularz - slovník m
wołacz - vokatív
Wolarz - Pastier m
wolność - sloboda, voľnosť
woniączka - vodka f
worek - výbežok m
wóz - voz
wpaść z deszczu pod rynnę - dostať sa z dážďa pod odkvap
wróbel - vrabec
wrona - vrana f
wrotycz - vratič m
wrzesień - september m
wrzód - vred
wrzos - vres m
wschód - východ
współlas - spoloèník m, komplic m
wspólnik - spoloèník m, komplic m
Wstępna Środa - Popolcová streda f, Popolečná streda f, Popolec m, Škaredá streda f, Popolná streda f, Krivá streda f, Prvopôstna streda f
wszędy - všade
wszędzie - všade
wszystkie drogi prowadzą do Rzymu - všetky cesty vedú do Ríma
wtorek - utorok m
wulkan - sopka f, vulkán m
Wulkan - Vulkán m
wuszt - klobása f
wy - vy
Wybrzeże kość Kości Słoniowej - Pobrežie Slonoviny n
wybuchnąć - vybuchnúť
wydra - vydra
wyjątek - výnimka f
wyjście - východ
wykrywacz kłamstw - detektor lži m
wykrzyknik - výkričník m, citoslovce n
wykusz - arkier
wyraz - slovo n
wysoki - vysoký
wyspa - ostrov m
Wyspa Bożego Narodzenia - Vianočný ostrov m
Wyspa Świętego Wyspy Świętego Tomasza i Wyspa Książęca - Svätý Tomáš a Princov ostrov
wyspiarz - ostrovan m
Wyspy Kanaryjskie - Kanárske ostrovy
wystarczający - dostatočný
wyszehradzki - vyšehradský
wzdłuż i wszerz - všade
wzrok - zrak
żaba - žaba
zabaczyć - zabudnúť
zabawka - hračka
żabie oczko - nezábudka f
zabijać czas - zabíjať čas
zabijanie - zabíjanie n
zabłądzić - zablúdiť
zabójczyni - vrahyňa f
zabyły - hlúpy
Zachariasz - Zachariáš m
zachłanny - chamtivý
zachód - západ m
zachodniosłowiański - západoslovanský
zachód słońca - západ slnka m
zaćmienie - zatmenie n
zaganiacz - sedmohlások obyčajný m
zaimek - zámeno
zajebisty - jebucký
zakarpacki - zakarpatský
zakaz - zákaz m
zakład karny - väzenie n
zakładnik - rukojemník m
Zakopane - Zakopané
Zakopiec - Zakopané
żal - smútok
zaliczka - preddavok
założyciel - zakladateľ m
zamach - atentát m
zamachowiec - atentátnik m
Zambia - Zambia f
Zambijczyk - Zambijčan m
Zambijka - Zambijčanka f
zamówienie - objednávka f
zapad - západ m
zapalenie płuc - zápal pľúc
zapiziany - chorľavý
zapominać - zabúdať
zapomnieć - zabudnúť
zapusty - fašiangy
zaraza - epidémia
zarodek - embryo n
zaś - zasa
zaskroniec - užovka f
zasługa - hodnota f
Zatoka Biskajska - Biskajský záliv
Zatoka Botnicka - Botnický záliv
Zatoka Fińska - Fínsky záliv
Zatoka Meksykańska - Mexický záliv
Zatoka Sueska - Suezský záliv
Zatoka Tajlandzka - Thajský záliv
zawistny - závistlivý
zdalasiały - unavený
zdjęcie - fotografia, snímka
zdrowie - zdravie n
zdrowy - zdravý
zdun - kachliar m
że - že
zebra - zebra
żebro - rebro
żebro Adama - Adamovo rebro n
żeby mieć kołaczy, trzeba użyć pracy - bez práce nie sú koláče
żec - fajčiť
zefir - zefyr m, zefír m
Zefir - Zefyros m
zegar - hodiny f
zegarek - hodinky
zegarmistrz - hodinár m
zegar słoneczny - slnečné hodiny
żegleń - uhlík m, uhlie n
żelatyna - želatína f
żelazo - železo n
żeliwo - liatina f
zelter - minerálna voda f
żeńczyna - žena f
zenit - zenit m, nadhlavník m
żentyca - žinčica f
żętyca - žinčica f
Zeus - Zeus m
ziarnko do ziarnka, a zebrać zbierze się miarka - babka k babce, budú kapce
ziarno - zrno n
zięć - zať
zielarstwo - bylinkárstvo n
ziele angielskie - nové korenie n
zielnik - herbár
zielonkawobrązowy - zelenkavohnedý, zelenkastohnedý
zielonkawożółty - zelenkavožltý, zelenkastožltý
zielononiebieski - zelenomodrý
zielonooki - zelenooký
zielony - zelený
Ziemia - Zem f
Ziemianin - Pozemšťan m, pozemšťan m, zemšťan m
Ziemianka - Pozemšťanka f, pozemšťanka f, zemšťanka f
ziemniak - zemiak
zima - zima f
Zimbabwe - Zimbabwe n
zimnica - horúčka
zimno - zima f, chlad m, chladno
zimny prysznic - studená sprcha f
zimorodek - rybárik m
ziobro - rebro
ziołolecznictwo - fytoterapia f
ziomkostwo - krajanské združenie n, landsmanšaft m
zista - skorocel m, stará mama
Zjednoczone Emiraty Arabskie - Spojené arabské emiráty
złamanie - zlomenina
złe nie śpi - čert nikdy nespí
zlepieniec - zlepenec
złodziej - zlodej
złotniczka - zlatníčka f
złotnik - zlatník m
złoto - zlato n
złotówa - taxikár
zmarszczka - vráska f
zmęczony - unavený
znachor - mastičkár m
znachorka - mastičkárka f
znajdować - nachádzať, nachádzať sa
znak astronomiczny - astronomický symbol m
znak zodiaku - znamenie zvieratníka n, znamenie zverokruhu n
żniwiarz - žnec m
znów - zasa
znowu - zasa
zodiak - zvieratník m, zverokruh m, zodiak m
Zofia - Žofia f
zol - podlaha f
zola - podlaha f
żółć - žltý
żołd - žold m
żołnierka - vojenčina f, vojna f, vojačka f
żołnierz - vojak m
żółtawy - žltastý, žltkastý, žltavý, žltkavý
żółty - žltý
żona - žena
zoo- - zoo-
zoolog - zoologická záhrada f
zoologia - zoológia f
zoologiczny - zoologický
zooplankton - zooplankton m
Zora - Zora f
zorza - žiara f
z reguły - spravidla
źrenica - zrenica f, pupila f, zrak, oko n
zupa - polievka f
żurnal - časopis
żurnalista - žurnalista m
Zuzanna - Zuzana
zwać - volať sa
Związek Socjalistycznych Republik Radzieckich - Zväz Sovietskych Socialistických Republik
zwierzak - živočích m, zviera n
zwierzę - živočích m, zviera n
żwir - štrk
zwolenniczka - prívrženkyňa f, stúpenkyňa f
zwyczajny - jednoduchý
żybura - žinčica f
życiorys - životopis
żydożerstwo - antisemitizmus m
żyletka - žiletka f
Żylina - Žilina f
zymft - horčica
żymła - žemľa
żyniaczka - svadba f
zyntyca - žinčica f
żyrafa - žirafa f
żywe srebro - živé striebro n, ortuť f
żywić - jesť
żywokost - kostihoj m
żywokostowy - kostihojový
żywy trup - živá mŕtvola f
