AA - AA, AA-liike (Anonyymit Alkoholistit)
Aaron - Aaron
abak - abakus, helmitaulu
abakus - abakus, helmitaulu
abandon - hylkääminen
abażur - lampunvarjostin
ABC - aakkoset
Abchazja - Abhasia
abecadlnik - aapinen
abecadło - aakkoset, kirjaimisto
abfal - jäte, uskaltaa, anomalia
Abidżan - Abidjan
abiecadło - aakkoset, kirjaimisto
abiturient - abiturientti
ablatyw - ablatiivi
ablegierek - lapsi
aborcja - abortti
ABS - ABS
absolut - absoluutti
abstrakcyjny - abstrakti
abstynent - absolutisti, raitis
Adam - Aadam
Adelajda - Adelaide
administrator - kuraattori, selvitysmies
admirał - amiraali
Adonis - Adonis
adres - osoite
adwentnik - joulukuu
adwokat - asianajaja
aeracja - ilmastus
aerodrom - lentoasema
aerodynamika - aerodynamiikka
aeroplan - lentokone
afelzina - appelsiini, appelsiinipuu
Afganistan - Afganistan
afro - afro, afrokampaus
Afrodyzja - Afrodisias
Afryka - Afrikka
afrykanerski - afrikaans
afrykański - afrikkalainen
AGD - kodinkone
agrafka - hakaneula
agrest - karviainen
akacja - akaasia
akademik - asuntola
akademus - asuntola
akcent - paino
akcja - osake
akolita - akoluutti
akordeon - harmonikka
akrolit - akroliitti
aktor - näyttelijä
aktyn - aktinium
akumulator - akku
akupunktura - akupunktio
akwedukt - akvedukti
Akwitania - Akvitania
Aladyn - Aladdin
Albania - Albania
albański - albanialainen, albania
Alberta - Alberta
Albin - Alpo
alczyk - pikkuruokki
ale - mutta
Aleksander - Aleksanteri
Aleuty - Aleutit
alfabet - aakkoset, kirjaimisto
alfabetu - aakkoset, kirjaimisto
Alfred - Alfred
algebra - algebra
algebraiczny - algebrallinen
algida - prostituoitu
Algieria - Algeria
algorytm - algoritmi
Alicja - Aliisa
Alina - Alina
alka - ruokki
alka olbrzymia - siivetönruokki
alka zwyczajna - ruokki
alkohol - alkoholi, alkoholijuoma
alkoholizm - alkoholismi
Allach - Allah
Allah - Allah
alleluja - halleluja
almanach - kalenteri
alokacja - jako, jakaminen, allokointi
Alpy - Alpit
ałsztojer - myötäjäiset
altannik - lavastaja
aluminium - alumiini
Amanda - Amanda
ambicja - kunnianhimo
ambirz - inkivääri
ambus - alasin
ameba - amebat
ameryk - amerikium
Ameryka - Amerikka
Amerykanin - amerikkalainen
Amerykanka - amerikkalainen
amerykański - amerikkalainen
Ameryka Południowa - Etelä-Amerikka
Amman - Amman
amoniak - ammoniakki
amputacja - amputaatio
amsterdamczyk - amsterdamilainen
Amu-daria - Amudarja
anadromiczny - anadrominen
anarchista - anarkisti
Anatolia - Anatolia
anatomia - anatomia
anatomiczny - anatominen
ancug - puku
Andaluzja - Andalusia
andrologia - andrologia
Andromeda - Andromeda
Andrzej - Antero
Andy - Andit
Aneta - Anette
angielski - englantilainen, englanti
Anglia - Englanti
anglicyzm - anglismi
Anglija - Englanti
angol - englantilainen, englanti
angryst - karviainen
animista - animisti
anioł - enkeli
Anioł Stróż - suojelusenkeli
anion - anioni
aniżeli - kuin
anjoł - enkeli
anoda - anodi
anomalia - anomalia
anonimowy - anonyymi
Antananarywa - Antananarivo
Antares - Antares
Antarktyda - Etelämanner
antena - antenni
Antoni - Anton
antrejka - käytävä, eteiskäytävä
antropofagia - antropofagia
antropologia - antropologia
antryj - käytävä
antybakteryjny - antibakteerinen
antykomunizm - antikommunismi
Antyle Holenderskie - Alankomaiden Antillit
antyoksydacyjny - antioksidanttinen
Anzelm - Anselmi, Anssi
apartament - asunto
Apeniny - Apenniinit
apluzyna - appelsiini, appelsiinipuu
Apollo - Apollon
aprykoza - aprikoosi
apryl - huhtikuu
apsik - ätsii!, ätsiih!
a psik - ätsii!, ätsiih!
aptek - apteekki
apteka - apteekki
Arab - arabi, arabialainen
Arabia Saudyjska - Saudi-Arabia
arabika - arabiankahvi
arabski - arabia, arabialainen
arabus - arabi, arabialainen
Aragonia - Aragonia
arbuz - vesimeloni, arbuusi
Archangielsk - Arkangeli
archipelag - saaristo
arfa - harppu
Argentyna - Argentiina
argon - argon
arka - arkki
armia - maavoimat, armeija
armijo - maavoimat, armeija
arogancja - arroganssi
arsen - arseeni
artykuły gospodarstwa domowego - kodinkone
as - ässä
asafetyda - hajupihka, pirunpihka
asceza - askeesi
aseksualizm - aseksuaalisuus
aspiryna - aspiriini
astat - astaatti, astatiini
astrofizyka - astrofysiikka
astronomia - tähtitiede
astronomio - tähtitiede
Asyria - Assyria
aszynbecher - tuhkakuppi
atak serca - sydäninfarkti
Ateny - Ateena
Atlantyk - Atlantin valtameri
atlas - kartasto
Augiasz - Augeias
ausgus - tiskiallas
ausgust - tiskiallas
Austria - Itävalta
austriacki - itävaltalainen
Austriak - itävaltalainen
Austro-Węgry - Itävalta-Unkari
autobana - moottoritie
autobus - bussi, linja-auto
autoklaw - autoklaavi
autonomia - autonomia
autonomiczny - autonominen
autostrada - moottoritie
azbest - asbesti
Azerbejdżan - Azerbaidžan
Azja - Aasia
Azja Mniejsza - Vähä-Aasia
azjatycki - aasialainen
baba - akka
Babilon - Babylon
Badenia-Wirtembergia - Baden-Württemberg
bagietka - patonki
bagno - suo
bajer - valehtelu
bajerować - valehdella
bajt - tavu
bajtel - lapsi
bajura - kura n
bąk - kimalainen
bakałarz - opettaja
bakelit - bakeliitti
bakłażan - munakoiso
bakteria - bakteeri
balet - baletti
baletnica - balettitanssijatar
balkon - parveke
bałtycki - balttilainen
Bałtyk - Itämeri
bałwan - lumiukko
bana - juna, raitiotievaunu, ratikka
banan - banaani
banana - banaani
bandzioch - maha
bania - kurpitsa, pää, nuppi, hamara
baniak - pää, nuppi, hamara
bank - pankki
banka - raitiotievaunu, ratikka
baptyzm - baptismi
bar - baari, barium
barabola - peruna
Baran - Oinas
baranek - taivaanvuohi
Baranek Boży - Jumalan Karitsa
baranina - lampaanliha
Barbados - Barbados
barglik - vilistäjä
barszcz - borssi
barwa - väri
barzoł - suo
bas - basso, maha
basen - allas
baskijski - baskilainen, baski
batuta - tahtipuikko, pinna
bażant - fasaani
bazylia - basilika
beatyfikacja - beatifikaatio
bebech - maha, vatsa
bęben - maha
bębenek - tärykalvo
beczeć - itkeä, parkua, vollottaa
befsztyk - pihvi
bejm - raha
bekasik - jänkäkurppa
bekaśnica - kotilokurki
bele kaj - missä tahansa
belfer - opettaja
Belg - belgialainen
Belgia - Belgia
Belgijka - belgialainen
belgijski - belgialainen
belgradzki - belgradilainen
belona - nokkakala
bemol - alennettu
Benin - Benin
berać - kertoa
beret - baskeri
beretka - baskeri
berga - kivi
Bergamo - Bergamo
berkel - berkelium
berlińczyk - berliiniläinen
Berlin Zachodni - Länsi Berliini
bernikla białolica - valkoposkihanhi
bernikla obrożna - sepelhanhi
bernikla rdzawoszyja - punakaulahanhi
beryl - beryllium
Betlejem - Betlehem
beton - betoni
bety - pyjama, yöpuku
bezchmurny - pilvetön
bezdomny - koditon
bezlistny - lehdetön
beznadzieja - epätoivo
bezosobowy - persoonaton
beżowy - beige, beesi
bezpłetwiec - puuhanhi
bezradność - avuttomuus
bezręki - kädetön
bezrobotny - työtön
bezsenność - unettomuus
Białoruś - Valko-Venäjä
białoruski - valkovenäläinen, valkovenäjä
białorzytka - kivitasku
białozór - tunturihaukka
biały - valkoinen, valkea
Biblia - Raamattu
bibliografia - bibliografia
biblioteka - kirjasto
bibliotekarz - kirjastonhoitaja
biedny - köyhä
bieg płotkarski - aitajuoksu
bieg przez płotki - aitajuoksu
biegunka - kura
biegus - sirri
biegus mały - lapinsirri
biegus rdzawy - isosirri
biegus zmienny - suosirri
bielaczek - uivelo
bielik - merikotka
bierne palenie - passiivinen tupakointi
biglosko - silitysrauta
bilbil - bulbuli
bilet - lippu
bimba - raitiotievaunu, ratikka
bindał - lannevaate
binder - solmio, kravatti
bindka - solmio, kravatti
biografia - elämäkerta
biograficzny - biografinen, elämäkerrallinen
biolog - biologi
biologia - biologia
bioniczny - bioninen
bioróżnorodność - biodiversiteetti
birginiak - allihaahka
biseksualizm - biseksuaalisuus
bishalter - rintaliivit
biskup - piispa
biurko - kirjoituspöytä
biusthalter - rintaliivit
biustonosz - rintaliivit
bizmut - vismutti
błąd poznawczy - kognitiivinen vääristymä
bladź - prostituoitu
blaga - valehtelu
blaszkodziobe - sorsalinnut
błędne koło - noidankehä
blisko - läheinen
blizna - arpi
Bliźnięta - Kaksoset
błogosławieństwo - siunaus
błona bębenkowa - tärykalvo
błotniak - suohaukka
błoto - kura n
blumkol - kukkakaali
blumsztynder - kukkapenkki
bluszcz - muratti
błyskawica - salama
bo - koska, sillä, siksi
bób - härkäpapu
boba - hattu
bóbr - majava
bocian - haikara
bocian czarny - mustahaikara
bóg - jumala
Bóg - Jumala
bogatka - talitiainen
Bohemia - Tšekki, Böömi
bohr - bohrium
bójka - tappelu
bojler - boileri
boks - nyrkkeily
Boliwia - Bolivia
bomba atomowa - ydinpommi
bombel - lapsi
bor - boori
borówka - marja, mustikka
borówka bagienna - juolukka
borsuk - mäyrä
Bośnia i Hercegowina - Bosnia ja Hertsegovina
botanik - kasvitieteilijä
boźdór - poika, poikaystävä
Boże Narodzenie - joulu
brachol - veli
bracieniec - veli
brat - veli
bratanek - veljenpoika m
brązowy - ruskea
Brazylia - Brasilia
brazyliana - kahvi
briftreger - postinkantaja
bród - kahlaamo, kahluupaikka
broda - parta
brodaty - partainen
brodziec pławny - lampiviklo
brodziec śniady - mustaviklo
broń - ase
broń biologiczna - biologinen ase
browar - panimo, olut, kalja, kotikalja, mallasjuoma
brudny - likainen
Bruksela - Bryssel
brukselka - brysselinkaali
brunatny - ruskea
brutto - brutto
brydż - bridge
brylant - briljantti
Brytyjczyk - brittiläinen
Brytyjka - brittiläinen
brytyjski - brittiläinen
brzask - aamunkoitto
brzęczka - ruokosirkkalintu
brzegówka - törmäpääsky
brzmienie - ääni
brzoskwinia - persikka
brzoza - koivu
brzuch - maha
brzydki - ruma
brzydota - rumuus
brzytwa - partaveitsi
brzytwodziób - saksinokka
buc - kyrpä
buda - koulu
buddyzm - buddhalaisuus
budynek - rakennus
buk - pyökki
bulba - peruna
buldożer - puskutraktori, raivaustraktori
Bułgar - bulgarialainen
Bułgaria - Bulgaria
Bułgarka - bulgarialainen
bułgarski - bulgarialainen, bulgarian kieli
bulić - maksaa
bulwa - peruna
burak - juurikas
burdel - ilotalo, bordelli
Burkina Faso - Burkina Faso
bursztyn - meripihka
burunduk - siperianmaaorava
burza - ukkonen, ukkosmyrsky
burza w szklance wody - myrsky vesilasissa
burzowiny - olut, kalja, kotikalja, mallasjuoma
być - olla
Byk - Härkä
Była Jugosłowiańska Republika Macedonii - Entisen Jugoslavian Tasavalta Makedonia
bzybzać - varastaa
całkiem - aika, melko
camper - leiriytyjä
cebula - sipuli, laukka
cegła - tiili
celtycki - kelttiläinen
cel uświęca środki - tarkoitus pyhittää keinot
cena - hinta
centrum - keskusta
cepeen - bensiiniasema, bensa-asema
cepelin - ilmalaiva, zeppeliini
cera - tytär
chabaj - teurastaja
chabanina - liha
Chabarowsk - Habarovsk
chabas - liha
chabić - varastaa
chachoł - niska
chamera - pilvi
Chanty-Mansyjsk - Hanti-Mansijsk
charkowski - harkovalainen
chart - vinttikoira
chata - maja
chemiczny - kemiallinen
chemik - kemisti
chętny - hanakka, kärkäs
chiński - kiinalainen
Chiny - Kiina
chitozan - kitosaani
chlać - juoda
chleb - leipä
chłopak - poika, poikaystävä
chlor - kloori
chmiel - humala, olut, kalja, kotikalja, mallasjuoma
chmura - pilvi
choćby - esimerkiksi
choinka - joulukuusi
chójk - joulukuusi
choroba - sairaus
choroba von Willebranda - von Willebrandin tauti
Chorwacja - Kroatia
chorwacki - kroatialainen, kroatia
chów wsobny - sisäsiittoisuus
chrobak - mato, aivomato
chrom - kromi
chromosfera - kromosfääri
chruścik - vesiperhonen
chrystadelfiański - kristadelfialainen
Chrystus - Kristus
chryzopraz - krysopraasi
chrząszcz - kovakuoriainen
chuj - kyrpä
chuśle - viulu
chyc - helle
ciało - keho, ruumis
ciało szkliste - lasiainen
ciapryka - kura n
ciebie - sinä (język pisany), sä (język mówiony), Te
ciemnia - pimiö
ciemnia fotograficzna - pimiö
cień - varjo
cierpienie - kärsimys
cietrzew - teeri
ciężarny - raskaana
ciężarówa - kuorma-auto
ciężarówka - kuorma-auto
ciężki - painava, raskas, hankala, ankea
ciga - vuohi
ciocia - täti
ciota - poljin, hinttari
cipa - pillu, vittu
cipka - keltavahvero, liejukana, kana
cis - lehtikuusi
ciśnienie - paine, verenpaine
ciupa - vankila
ciurma - vankila
ciut - vähän, hiukan
ćma - yöperhonen, prostituoitu
ćmić - polttaa
cnotliwy - hyveellinen
co - mikä
córa - tytär
córczysko - tytär
córka - tytär
cos - cos
co z oczu, to z serca - poissa silmistä, poissa mielestä
ćpać - syödä
ctg - cot
cudzokrain - ulkomaalainen
cudzoziemiec - ulkomaalainen
cug - juna
cukier - sokeri
cukier puder - tomusokeri
curig - takaisin
cwel - poljin, hinttari
ćwiczenie czyni mistrza - harjoitus tekee mestarin
ćwierć - neljännestunti
ćwierćfinał - quartierfinal
ćwierćnuta - neljäsosanuotti
cyber- - kyber-
cybernetyka - kybernetiikka
cychalter - rintaliivit
cyferblat - kasvot
cyfra - numero
cyga - kimalainen
cyklista - pyöräilijä
cynamon - kaneli
cynk - sinkki
Cypr - Kypros
cyraneczka - tavi
cyranka - heinätavi
cyranka syberyjska - siperiantavi
cyrkiel - harppi
Cyrkiel - Harppi
cytryna - sitruuna
cytrynat - sitruuna
cytrynowożółty - sitruunankeltainen
czad - hiilimonoksidi, hiilioksidi
czaj - tee
czajka - töyhtöhyyppä
czajnik - pää, nuppi, hamara
czapka - hattu
czarna dziura - musta aukko
czarna jagoda - mustikka
czarnogłówka zwyczajna - hömötiainen
Czarnogóra - Montenegro
czarny - musta
czas - aika, hetki, aikamuoto
czasopismo - aikakauslehti
czasownik - verbi
czas to pieniądz - aika on rahaa
czaszka - pääkallo, kallo
Czechosłowacja - Tšekkoslovakia
Czecho-Słowacja - Tšekkoslovakia
Czechy - Tšekki, Böömi
Czeczenia - Tšetšenia
czeczotka - urpiainen
czeczotka tundrowa - tundraurpiainen
czędo - lapsi
czekista - tšekisti
czekolada - suklaa
Czelabińsk - Tšeljabinsk
czepiga - hiiro
czereśnia - kirsikkapuu, kirsikka
czernica - mustikka
czerwiec - kesäkuu
czerwone jagody - ahomansikka, metsämansikka
Czerwony Krzyż - Punainen Risti
czesać - kammata
cześć - terve, moi, hei
czeski - tšekkiläinen, böömiläinen, tšekki
cześnia - kirsikkapuu, kirsikka
częstoskurcz - takykardia
czkawka - hikka
człowiek - ihminen
czoło - otsa
czołoczub - harjalepinkäinen
czorny - musta, likainen
czosnek - valkosipuli
czubatka - töyhtötiainen
czujny - valpas
Czukocki Okręg Autonomiczny - Tšuktšien autonominen piirikunta
czwartek - torstai
czwartorzęd - Kvartäärikausi
czyhunka - torium
czynsz - vuokra
czyrwiec - kesäkuu
czyrwień - kesäkuu
czysło - luku, lukumäärä
czyż - vihervarpunen
czyżyk - vihervarpunen
dać - antaa
dach - katto
dała - antaa
dalekowzroczność - kaukotaittoisuus, kaukonäköisyys
dama - kuningatar f
dana - antaa
Dania - Tanska
dany - antaa
darowanemu koniowi w zęby się nie zagląda - lahjahevosen suuhun ei saa katsoa
defenestracja - defenestraatio
deizm - deismi
dekiel - pää, nuppi, hamara
dekoracja - koriste
dekoracyjny - koristeellinen
demiurg - demiurgi
demografia - väestötiede, demografia
demokracja - demokratia, kansavalta
demokrata - demokraatti
Demokratyczna Republika Wyspy Świętego Tomasza i Wysp Świętego Tomasza i Książęcej - São Tomén ja Príncipen demokraattinen tasavalta
demokratyczny - demokraattinen
dentysta - hammaslääkäri
deskorolka - rullalauta
deszczowy - sateinen
dezelować - tuhota, hävittää
dezinformacja - disinformaatio
diabelski młyn - maailmanpyörä
diabeł tkwi w szczegółach - piru asuu yksityiskohdissa
diagnoza - diagnoosi
dialekt - murre, aluemurre
diament - timantti
difalia - difallia
dioda - diodi
Diogenes - Diogenes, Diogenes (Sinopelainen)
diplodok - diplodocus
diuna - dyyni
dłoń - käsi
długopis - kynä
długoszpon - jassana
dłuto - taltta
dmuchnąć - varastaa
Dniepr - Dnepr
dno - pohja, alapää
dobranoc - hyvää yötä
dobry wieczór - hyvää iltaa
docent - dosentti
doić - lypsää
doktor - lääkäri, tohtori, lekuri
dolar - dollari
dolina - laakso
dolmen - dolmen
dom - talo, koti
dom dziecka - lastenkoti
Dominika - Dominica
doradca - neuvonantaja
doskonałość - eksellenssi
dostęp - pääsy
dostojnik - arvohenkilö, merkkihenkilö
do trzech razy sztuka - kolmas kerta toden sanoo
dotykać - koskea
do widzenia - näkemiin, hyvästi, jäähyväiset
do zobaczenia - näkemiin, hyvästi, jäähyväiset
dramat - draama
dramatyczny - dramaattinen
drętki - hapan
drewno - puu
droga ekspresowa - moottoriliikennetie
Droga Mleczna - Linnunrata
drozd - rastas
drożdże - hiiva
droździk - punakylkirastas
druga wojna światowa - toinen maailmansota
drugdy - muualla (z innego miejsca muualta), toisaalla, muualle, toisaalle
druh - ystävä
drukarka - tulostin
drzazga - säle
drzemlik - ampuhaukka
drzewo - puu
drzewo iglaste - havupuu
drzwi - ovi
drzym - laiskuri
dubelt - heinäkurppa
duch - sielu, henki
dudek - harjalintu
dudlać - itkeä, parkua, vollottaa, juoda
dudy - keuhko
dufać - toivoa
dumnie - ylpeästi
Duńczyk - tanskalainen
Dunka - tanskalainen
duński - tanskalainen, tanska
dupa - perse
durnica - juolukka
dusza - sielu, henki
dutek - raha
dwucyfrowy - kaksinumeroinen
dwujęzyczny - kaksikielinen
dwujęzykowy - kaksikielinen
dwukropek - kaksoispiste
dwulicowy - kaksinaamainen
dycht - aika, melko
dycki - aina
dyktator - diktaattori
dym - savu
dymić - savuta
dynastia - dynastia
dynia - kurpitsa
dyplom - diplomi, päättötodistus, päästötodistus
dyplomata - diplomaatti
dysfagia - dysfagia
dysk twardy - kovalevy
dysleksja - lukivaikeus, lukihäiriö, dysleksia
dywan - matto
dżez - jatsi
dziabka - kuokka
dziadek - isoisä
dzięcioł - tikka
dzięcioł białogrzbiety - valkoselkätikka
dzięcioł czarny - palokärki
dzięcioł duży - käpytikka
dzięciołek - pikkutikka
dzięcioł pstry duży - käpytikka
dzięcioł średni - tammitikka
dzięcioł trójpalczasty - pohjantikka
dzięcioł zielonosiwy - harmaapäätikka
dzięcioł zielony - vihertikka
dzieciszczko - lapsi
dziecko - lapsi
dziedzina - ala
dziękówa - kiitos
dziękówka - kiitos
dziękuję - kiitos
dzielić - jakaa, jakautua
dzień - päivä
dzień dobry - hyvää huomenta, huomenta
dziennikarstwo - journalismi
dziennikarz - toimittaja, lehtimies, journalisti
dzierzba - lepinkäinen
dżihadysta - jihadisti
dziób - nokka
dziobak - vesinokkaeläin
dzioborożec - sarvinokka
dziś - tänään
dzisiaj - tänään
dziura - luola
dziurkacz - lävistäjä
dziurkacz biurowy - lävistäjä
dziwonia - punavarpunen
dżuma - rutto
dżungla - viidakko
dźwięk - ääni
dzwonek - kello
dzwoniec - viherpeippo
echolalia - kaikupuhe
edredon - haahka
edredon okazały - kyhmyhaahka
edredon okularowy - silmälasihaahka
edyficjum - rakennus
efekt uboczny - sivuvaikutus
Egina - Aígina
Egipt - Egypti
egzamin - tentti
ejber - poika, poikaystävä
eka - sarvi
ekologia - ekologia
ekologio - ekologia
ekosystem - ekosysteemi
ekstrapolacja - ekstrapolaatio
Ekwador - Ecuador
elefant - elefantti, norsu
elektrolit - elektrolyytti
elektroliza - elektrolyysi
elektroniczny - elektroninen
elementarz - aapinen
emigracja - maastamuutto
Emili - Emilia, Milja, Milla
Emilia - Emilia, Milja, Milla
empatyczny - empaattinen
encyklopedia - tietosanakirja
energia - energia
epitafium - epitafi, hautakirjoitus
epruwetka - koeputki
Erytrea - Eritrea
eskalator - rullaportaat, liukuportaat
eskulap - lääkäri, tohtori, lekuri
Estera - Esteri
Estonia - Viro, Eesti
estoński - virolainen, viro
Etiopia - Etiopia
etymologia - etymologia
euforia - euforia
euro - euro
eurocent - sentti
Europa - Eurooppa
Europa Środkowa - Keski-Eurooppa
Europa Zachodnia - Länsi-Eurooppa
Europejczyk - eurooppalainen
Europejka - eurooppalainen
europejski - eurooppalainen
everyman - jokamies
Ewa - Eeva
eż - että
Ezdrasz - Esra
Ezop - Aisopos
fabryka - tehdas
facet - mies
facetka - nainen
facjata - kasvot
fagocista - fagotisti
fajans - fajanssi
fajer - juhla
fajera - juhla
faks - faksi
fakt - tosiasia
fałszywy przyjaciel - väärä ystävä
familio - perhe, heimo
famuła - perhe, heimo
fanatyzm - fanaattisuus, fanatismi
fandzolić - valehdella
fara - pappila
farerski - färsaarelainen, fääri
faryna - sokeri
faryzeusz - fariseus
fasola - papu
fazan - fasaani
Federacja Rosyjska - Venäjän federaatio
fefer - pippuri
Fenicja - Foinikia
ferska - persikka
fezeła - mehiläinen
Fidżi - Fidži
filiżanka - kuppi
film - elokuva
filmować - filmata
filok - kynä
filologia - filologia
filozof - filosofi
filozofia dziejów - historianfilosofia
filozofia historii - historianfilosofia
filozoficzny - filosofinen
Fin - suomalainen
finansowy - taloudellinen
finka - puukko
Finlandia - Suomi
finlandzki - suomalainen, suomi
fiński - suomalainen, suomi
fioł - orvokki
fiołek - orvokki
fioletowy - violetti
fiord - vuono
fiut - kyrpä
fiza - fysiikka
fizjologia - fysiologia
fizjoterapeuta - fysioterapeutti
fiżon - papu
fizyczny - fysikaalinen, fyysinen
fizyka - fysiikka
flet - kyrpä
fliger - lentokone
Florencja - Firenze
fluor - fluori
fojerman - palomies
fonetyka - fonetiikka
fort - linnoitus
forteklapa - flyygeli
fortepian - flyygeli
foryster - ulkomaalainen
fosfor - fosfori
fotel - nojatuoli
foton - fotoni
fotorealizm - fotorealismi
frajda - hupi
franciszkanin - fransiskaani
Francja - Ranska
francuski - ranskalainen
fresk - fresko
frutarianizm - fruitarismi
fryc - saksalainen
Fryc - saksalainen
fulać - valehdella
furdygarnia - vankila
furosemid - furosemidi
fusbal - jalkapallo
futbol - jalkapallo
gad - matelija
gadałka - keijukainen, keiju
gadożer - käärmekotka
gągoł - telkkä
gągołek - pikkutelkkä
gajer - puku
gała - silmä, jalkapallo, korppi, varis
Galilea - Galilea
galoty - housut
gama - sävelasteikko
ganc - aika, melko
gangol - puku
gapa - korppi, varis
gar - ruukku
gara - uni, unennäkö
gardło - kurkku
garnek - ruukku
garnitur - puku
gasa - katu
gatunkowizm - spesismi
gaz cieplarniany - kasvihuonekaasu
gaz musztardowy - sinappikaasu
gaz szklarniowy - kasvihuonekaasu
gdy kota nie ma, myszy harcują - kun kissa on poissa, hiiret hyppivät pöydällä
gdyż - koska, sillä, siksi
gdzie - jossa, missä
gdzie drwa rąbią, tam wióry lecą - munakasta ei voi tehdä rikkomatta munia
gdzie indziej - muualla (z innego miejsca muualta), toisaalla, muualle, toisaalle
gdziekolwiek - missä tahansa
gędźba - musiikki
gęgawa - merihanhi
genetyczny - geneettinen
geografia - maantiede, maantieto, geotiede
geologia - geologia
geriatria - geriatria
germański - saksalainen, saksa
gęś - hanhi
gęś białoczelna - tundrahanhi
gęś krótkodzioba - lyhytnokkahanhi
gęś mała - kiljuhanhi
gest - ele
gęś zbożowa - metsähanhi
gibki - nopea
gierada - myötäjäiset
giez - paarma
gil - punatulkku
ginekolog - gynekologi
ginekologia - gynekologia
gira - jalka
gitara - kitara
glacok - kalju
glajda - kura n
glajza - kisko, torium
glapa - varis
glin - alumiini
globus - karttapallo, pää, nuppi, hamara
głód - nälkä
głowa - pää, nuppi, hamara
głowienka - punasotka
głównie - erityisesti, varsinkin
głuchota - kuurous
głuchy - kuuro
głupota - älyttömyys
głuptak - suula
głuszec - metso
gmina - kunta
gnat - luu, noppa, arpakuutio
gniew - kiukku
gnój - lanta
gnot - lapsi
gnu - gnuu
gnuśny - laiska
godka - kieli
godność - arvokkuus
Godzilla - Godzilla
godzina - kello
godzinnik - kello
gołąb - kyyhky
gołębnik - kyyhkyslakka
góra - vuori
górą - vuori
góra lodowa - jäävuori
górniczek - tunturikiuru
górnik - kaivosmies
gorzała - alkoholi, alkoholijuoma
gorzyk - tanssija
göteborski - göteborgilainen
gówniany - paska
gówno - paska
goździk - neilikka
gra - peli, leikki, kisa
graba - käsi
gracz - pelaaja
gramatyka - kielioppi
granatowy - tummansininen
granit - graniitti
grążyca - sotka
Grecja - Kreikka
grejpfrut - greippi
grobowiec - flyygeli
grochówka - hernekeitto
groźba - uhka, uhkakuva
groźny - julma, raivokas, raivopäinen
gruba - kaivos
grubodziób - nokkavarpunen
gruchacz - kyssäkurki
gruczoł - rauhanen
grudzień - joulukuu
grusza - päärynäpuu
gruszka - päärynä
gruziński - georgia, georgialainen
gryf - aarnikotka
grypa - flunssa, influenssa
gryzoń - jyrsijä
grzebień - kampa, harja
grzech - synti
Grzegorz - Reijo
grzywa - harja
guli - koska, sillä, siksi
guma - kumi, kondomi
gumka - kumi, kondomi
gwałciciel - raiskaaja
gwałtowny - raju
gwiazda - tähti
gwiazdka - jouluaatto
Gwinea Równikowa - Päiväntasaajan Guinea
gzub - lapsi, maha
haczka - kuokka
hadron - hadroni
Haiti - Haiti
hajstra - mustahaikara
hajtok - veitsi
hałas - melu
hamak - riippumatto
Hamburg - Hampuri
hańba - häpeä
handlarz - kauppias
handszuły - käsine
harfa - harppu
haś - jäte, uskaltaa
haszysz - hasis
hau - hau, vuh, rauf
haubica - haupitsi
hawajski - havaijilainen, havaiji
hę - mikä
hedonizm - hedonismi
hel - helium
Hellada - Kreikka
hellenista - hellenisti
Helsinki - Helsinki
helsiński - helsinkiläinen
hemoliza - hemolyysi
heparyna - hepariini
herbarz - kasvikokoelma
herbata - tee
Herod - Herodes
Hestia - Hestia
hetman - kuningatar f
hiacynt - hyasintti
hica - helle
hidżab - hijab
hiena - hyeena
hierarchia - hierarkia
hierarchiczny - hierarkkinen
hipergrafia - hypergrafia
hipopotam - virtahepo
hipotetyczny - hypoteettinen
hirsutyzm - hirsutismi
histeria - hysteria
historiozofia - historianfilosofia
historyk - historioitsija
Hiszpania - Espanja
hiszpański - espanjalainen, espanja
holajza - taltta
Holandia - Hollanti, Alankomaat
Holandyja - Hollanti, Alankomaat
holenderski - hollantilainen
homeopatia - homeopatia
homeostaza - homeostaasi
homiletyka - homiletiikka f
homo- - homo-, sama-, saman-
Hongkong - Hongkong
Horus - Horus
hotel - hotelli
hyca - helle
hydrologia - hydrologia
hydrostatyka - hydrostatiikka
i - ja
Ida - Iida
idea - idea
igrzyska olimpijskie - olympialaiset, olympiakisat
II wojna światowa - toinen maailmansota
imbir - inkivääri
imię - nimi, etunimi
imieniny - nimipäivä
indonezyjski - indonesialainen, indonesia
informatyka - tietotekniikka
infrastruktura - infrastruktuuri
instrument - soitin, instrumentti
intryga - juoni, juonittelu
inundacyja - tulva, ryöppy
inżynier - insinööri
Irak - Irak
Irlandia - Irlanti
iryd - iridium
iść na skibę - varastaa
Islandia - Islanti
islandzki - islantilainen, islanti
istnienie - olemassaolo
Italok - italialainen
italski - italialainen, italia
itd. - jne.
iż - että
izba - rauha, huone
ize - että
Izrael - Israel
ja - minä
jabłko - omena
jabłko Adama - aataminomena
jabłoń - omenapuu
jadać - syödä
jąderko - tumajyvänen
Jadwiga - Heta
Jadzia - Hetti
jagnię - karitsa
jagoda - marja, mustikka
Jahwe - Jahve
jajecznica - munakokkeli
jajko - muna
jajo - munasolu, muna
jajówa - munakokkeli
jak cię widzą, tak cię piszą - vaatteet tekevät miehen
jakmiarz - aika, melko
jakość - laatu
jak się masz? - mitä kuuluu?
Jakub - Jaakko
Jakucja - Jakutia
Jakuck - Jakutsk
Jamalsko-Nieniecki Okręg Autonomiczny - Jamalin nenetsien autonominen piirikunta
Jan - Jukka, Juhani, Jussi, Janne
jangryst - karviainen
Jan Kowalski - Matti Meikäläinen
jantar - meripihka
japa - luola
japoński - japanilainen, japani
jarecka - äiti
jarząbek - pyy
jaskinia - luola
jaskółka - pääsky
jaśmin - jasmiini
jaszczurka - lisko
jazda - ajo
jazz - jatsi
jebadło - makuuhuone, sänky
jedna jaskółka nie czyni wiosny - ei yksi pääsky kesää tee
jedna jaskółka wiosny nie czyni - ei yksi pääsky kesää tee
jednojęzyczny - yksikielinen
jednojęzykowy - yksikielinen
jednooki - yksisilmäinen
jednorożec - sarvikuono
jednosylabowy - yksitavuinen
Jędrzej - Antero
jedza - ruoka
jedzenie - ruoka
jeleń - hirvieläin
jemeński - jemeniläinen
jemioła - misteli
jemiołuszka - tilhi
jeniec - sotavanki
jer - järripeippo
Jerycho - Jeriko
jeść - syödä
jesień - syksy
jesienny - syksyinen
jesiotr - sampi
jeśli - jos
jeśli wejdziesz między wrony, musisz krakać jak i one - maassa maan tavalla
jest - olla
jeż - siili
jeżeli - jos
jezioro - järvi
Jezioro Aralskie - Araljärvi
Jezus - Jeesus
Jezus Chrystus - Jeesus Kristus
język - kieli
język migowy - viittomakieli
język obcy - vieras kieli
język ojczysty - äidinkieli
język programowania - ohjelmointikieli
jidysz - jiddiš
jogurt - jogurtti
Jordan - Jordanjoki
Jordania - Jordania
Jugosławia - Jugoslavia
juny - nuori
już - jo, ei enää
kaban - porsas, sika
kac - krapula
kaczeniec - rentukka
kaczka - ankka
kaczka dziennikarska - uutisankka, ankka
Kafarnaum - Kapernaum
kafej - kahvila
kaffa - kahvi
kaj - jossa, missä
kajman - kaimaani, krokotiili
kajuta - hytti
kajuto - hytti
kakadu - kakadu
kakao - kaakao
kalafa - kasvot
kalafior - kukkakaali
kalapitra - pää, nuppi, hamara
kalejdoskop - kaleidoskooppi
kalendarz - kalenteri
kalfas - maha
kalifat - kalifaatti
kam - jossa, missä
Kamczatka - Kamtšatka
Kamerun - Kamerun
kamfora - kamferi
kamień - kivi
kamieniuszka - virta-alli
kamień szlachetny - jalokivi
kamper - kämppäri, matkailuauto
kamusznik - karikukko
kanibalizm - kannibalismi
kaniuk - liitohaukka
kaolin - kaoliini
kąpiółka - kylpyhuone
kapusta - kaali, raha
kapusta kiszona - hapankaali
kara - rangaistus, kottikärryt
karaba - kissa
karabin maszynowy - konekivääri
karawana - karavaani
karczoch - artisokka
kardiolog - sydänlääkäri, kardiologi
kardiologia - kardiologia
kardynał - kardinaali, punakardinaali
Karelia - Karjala
karelski - karjalainen
karibu - poro, peura
kark - niska
karlus - komea
karo - ruutu
karta kredytowa - luottokortti
kartofel - peruna
kaszalot - kaskelotti
kaszel - yskä
katana - katana, krapula
Katarzyna - Kaarina f, Kaisa f, Katri f
katastrofa - onnettomuus
katedra - tuomiokirkko
katus - lehtopöllö
Kaukaz - Kaukasia n
kawa - kahvi
kawa arabska - arabiankahvi
kawaler - poikamies, vanhapoika
kawiarka - espressopannu, mokkapannu
kawiarnia - kahvila
kawka - naakka, nunna
kawon - vesimeloni, arbuusi
kazarka - ruostesorsa
każdy - kunkin
kaznodzieja - saarnaaja
kciuk - peukalo
kędy - jossa, missä
kefir - kefiiri
kejter - koira
kejza - juusto
Kenia - Kenia
kiecka - mekko, hame
kieł - kulmahammas
kiełbasa - makkara
kiepeła - pää, nuppi, hamara
kij - kerros
kijanka - nuijapää
Kijów - Kiova
kimono - uni, unennäkö
kino - elokuvateatteri
kintop - elokuvateatteri
Kirgistan - Kirgisia
kiść - ranne
kiszka - maito
kit - valehtelu
kitajski - kiinalainen
kłącze - maavarsi
kłamać - valehdella
kłamca - valehtelija
kłamczuch - valehtelija
klamot - kivi
kłamstwem daleko się nie zajdzie - valheella on lyhyet jäljet
kłamstwo - valehtelu
kłamstwo ma krótkie nogi - valheella on lyhyet jäljet
kłapaczka - suu
klara - Aurinko
klasy - ruutuhyppely
klaustrofobia - klaustrofobia, umpiokammo
klej - liima
klekotun - haikara
klimat - ilmasto
kłochtun - siperiantavi
kłódka miłości - lemmenlukko
klucz - avain, koodiavain
klupać - etsiä
kluza - vankila
kniądz - prinssi
knipa - kirja
koala - koala
kobalt - koboltti
kobiecy - naisellinen
kobieta - nainen
kobieta lekkich obyczajów - prostituoitu
kochać - rakastaa, rakastella
kochanie - kulta
kociamber - kissa
kociątko - kissanpentu
kocik - kissanpentu
kociokwik - krapula
kocioł - pata
kod kreskowy - viivakoodi
kogut - kukko
koja - sänky
kojo - sänky
kokosz - kana
kokoszka - kana, liejukana
kokot - kukko
kokota - prostituoitu
koks - koksi
kołchoz - kolhoosi
kolczyk - korvakoru
koleś - mies
koło - polkupyörä
kolonoskopia - kolonoskopia
koło podbiegunowe - napapiiri
kolor - väri
kolorowanka - värityskirja
koło sterowe - ruori
Kolumb - Kolumbus
Kolumbia - Kolumbia
koma - koma, pilkku
komar - hyttynen, sääski, moskiitto
komat - koma, pilkku
kometa - komeetta
komórka - komero, solu, kännykkä
komp - tietokone
kompas - kompassi
komputer - tietokone
komunizm - kommunismi
koń - hevonen
kóń - hevonen
koncert - konsertti
kończyna - raaja
kondensacja - kondensaatioreaktio
kondensator - kondensaattori
kondom - kondomi
kondygnacja - kerros
Konfucjusz - Kungfutse
kongijski - kinshasankongolainen
koniak - konjakki
koniunkturalność - opportunismi
konserwatywny - konservatiivi
konspiracja - konspiraatio
kontrabas - kontrabasso
kontynent - maanosa, manner, mantere
kopa - viisi tusinaa
kopalnia - kaivos
koparka - kaivinkone
Kopenhaga - Kööpenhamina
kopenhaski - kööpenhaminalainen
koper - tilli
kopernik - kopernikium
kopernikański - kopernikaaninen
koperta - kirjekuori
kopica - viisi tusinaa
kopruch - hyttynen, sääski, moskiitto
kopyto - kavio
kora - kaarna
Koran - Koraani
korbol - kurpitsa
koreański - korealainen, korea
korytarz - eteiskäytävä
kos - mustarastas
Kos - Kos
kosa - veitsi
kość - luu, noppa, arpakuutio
kościół - kirkko
kostka - nilkka, plektra
kot - kissa
kotek - kissanpentu
kotka - kissa
kotku - kissanpentu
kowadło - alasin
kowal - seppä
kowalik - pähkinänakkeli
kowalno - alasin
koza - vuohi
Kozak - kasakka
Koziorożec - Kauris
kradzież - varkaus
krajać - varastaa
krajacz do sera - juustohöylä
Kraj Krasnojarski - Krasnojarskin aluepiiri
Kraj Permski - Permin aluepiiri
Kraków - Krakova
krakwa - harmaasorsa
kraść - varastaa
Krasnojarsk - Krasnojarsk
krasula - lehmä
krawat - solmio, kravatti
krawatka - solmio, kravatti
krążownik - risteilijä
krepel - munkki, silmu
krew - veri
krogulec - varpushaukka
kroić - varastaa
krokodyl - krokotiili
krokodyle łzy - krokotiilinkyyneleet
król - kuningas
królestwo - kuningaskunta
królik - kaniini, kani
królowa - kuningatar f
krótki - lyhyt
krótkoszpon - käärmekotka
krowa - lehmä
krowa, która dużo ryczy, mało mleka daje - haukkuva koira ei pure
krtań - kurkunpää
krucjata - ristiretket
kruk - korppi
kruk krukowi oka nie wykole - ei korppi korpin silmää noki
krwawodziób - punajalkaviklo
krybuny - risti
krykiet - kriketti
kryminał - vankila
krzesło - tuoli
krzyż - risti
krzyżodziób - käpylintu
krzyżodziób świerkowy - pikkukäpylintu
krzyżówka - sinisorsa
książę - prinssi
książka - kirja
książka kucharska - keittokirja
księgozbiór - kirjasto
księżyc - kuu
Księżyc - Kuu
kszyk - taivaanvuohi
kto chce żyć z swojej pracy, dolegać nie trzeba - aikainen lintu madon nappaa
kto mieczem wojuje, (ten) od miecza ginie - joka miekkaan tarttuu, se miekkaan hukkuu
kto rano wstaje, temu Pan Bóg daje - aikainen lintu madon nappaa
ktoś - joku
Kuba - Kuuba
kubek - muki
kubizm - kubismi
Kubuś Puchatek - Nalle Puh
kuchnia - keittiö, kyökki
kucza - maja
kuć żelazo, póki gorące - takoa silloin kun rauta on kuuma
kukurydza - maissi
kula - jalka
kuloodporny - luodinkestävä
kulos - jalka
kultura - kulttuuri
kuper - takamus
kupidło - hinta
kupować - ostaa
kupować kota w worku - ostaa sika säkissä
kur - kukko
kura - kana
kurka - keltavahvero, liejukana, kana
kurka wodna - liejukana
kurki - keltavahvero, liejukana, kana
kuropatwa - peltopyy
kurs - kurssi
kurtyzana - prostituoitu
kurwa - huora, vittu
kurwacik - solmio, kravatti
kuskus - kuskus
Kusz - Kus, Kush
kutafon - kyrpä
kutas - kyrpä
kuzaj - serkku
kuzyn - serkku
kuzynka - serkku
kwadrat - neliö
kwarantanna - karanteeni
kwas - happo
kwas akrylowy - akryylihappo
kwas foliowy - foolihappo
kwas mlekowy - maitohappo
kwaśny - hapan
kwiat - kukka
kwiczoł - räkättirastas
kwiecień - huhtikuu
kwietnik - kukkapenkki
kwokacz - valkoviklo
kynologia - kynologia
łabęć - joutsen
łabędź - joutsen
łabędź krzykliwy - laulujoutsen
łabędź niemy - kyhmyjoutsen
łacina - latina
lacz - pää, nuppi, hamara
łącznik - kopula
ład - järjestys, siivous
laga - kerros
lajbik - rintaliivit
łąka - niitty
lakier do paznokci - kynsilakka
łańcuch pokarmowy - ravintoketju
land - kylä
Laponia - Lappi
larmo - melu
las - metsä
lat - vuosi
lata - vuosi, hame
latarnia morska - majakka
lateks - lateksi
lato - kesä
laur - laakeri
łazienka - kylpyhuone
le - mutta
lebera - maksamakkara
leberka - maksamakkara
łechtaczka - häpykieli
lecz - mutta
łęczak - liro
legalizacja - laillistaminen
lekarz - lääkäri, tohtori, lekuri
lekarz choroby chorób kobiecych - gynekologi
lekcja - oppitunti
lekka atletyka - yleisurheilu
lekkoatletyka - yleisurheilu
lekomania - lääkeaineriippuvuus
lemoniada - limonadi, limonaati, limsa, limu
leniwy - laiska
łepetyna - pää, nuppi, hamara
lepszy wróbel w garści niż gołąb na dachu - parempi pyy pivossa kuin kaksi oksalla
lerka - kangaskiuru
leszcz - lahna
letni - kesäinen, haalea
Lew - Leijona
lewy - vasen
łgać - valehdella
łgarz - valehtelija
liceum - lyseo, lyceum
liczba - luku, lukumäärä
liczba atomowa - järjestysluku, atomiluku
liczba mnoga - monikko
liczba pierwsza - alkuluku
liczba podwójna - kaksikko
likier - likööri
lin - suutari
linie lotnicze - ilmailuyhtiö
liniowiec - matkustajalaiva, linjalaiva
link - linkki
lipa - lehmus
lipiec - heinäkuu
lirogon - lyyrypyrstö
liść - lehti
lis polarny - naali
lista - lista
listonosz - postinkantaja
listopad - marraskuu
litera - aakkonen
litewski - liettualainen, liettua
Litwa - Liettua
lizać - nuolla
łochynia - juolukka
lód - jää
lodowaty - jääkylmä
lodowiec - jäätikkö
lodówka - jääkaappi, alli
łódź - vene
logarytm - logaritmi
logika - logiikka
logiko - logiikka
lojalność - lojaliteetti
lokator - asukas
łokieć - kyynärpää
lola - kerros
Londyn - Lontoo
londyński - lontoolainen
los - arpa
łoś - hirvi
łosoś - lohi
łosprawiać - kertoa
lot - lento, lentomatka
łotewski - latvialainen, latvia
lotnisko - lentoasema
lotniskowiec - lentotukialus
Łotwa - Latvia
łoże - sänky
łóżko - sänky
łozówka - luhtakerttunen
lub - tai
łucznictwo - jousiammuntaa
ludność - väestö
ludożerstwo - ihmissyönti
łudzikwiat - huhtikuu
łuk - jousi
luksus - luksus, ylellisyys
luna - kuu
luńt - koira
łupież - hilse
łuskowiec - taviokuurna
lustro - peili, kuvastin
luty - helmikuu
lwia część - leijonanosa
łydka - pohje
łyska - nokikana
łysy - kalju
łza - kyynel
łża - valehtelu
mać - äiti
Macedonia - Makedonia
Machaczkała - Mahatškala
maciek - maha
mączka - puuteri
madagaskarnik - kyyhkyrääkkä
Madera - Madeira
mądry - viisas
Maghreb - Maghreb
magnetofon - magnetofoni
magulanka - tappelu
maj - toukokuu
majeranek - meirami
mąka - jauho
makolągwa - hemppo
makrela - makrilli
mała czarna - pikkukahvi mustana, pikkumusta, pieni tummaverikkö
malin - vadelma
malina - vadelma
mało - vähän, hieman
Malta - Malta
maltański - maltalainen, malta
mały palec - pikkusormi
małżeństwo - avioliitto
małżonek - aviomies
małżonka - vaimo
mamka - imettäjä
manekin - malli
mapa - kartta
maras - kura n
Marcin - Martti
margaryna - margariini f
markaczka - mustalintu
martwy - kuollut
marzec - maaliskuu
marzenie - haave
marzenie senne - uni, unennäkö
marznący deszcz - jäätävä sade
marzyć - haaveilla, haaveksia
masakra - joukkomurha
masa krytyczna - kriittinen massa
maska - kasvot
maskonur - lunni
maskonur atlantycki - lunni
maskonur pacyficzny - isolunni
maskonur złotoczuby - töyhtölunni
maślanka - piimä
maszyna do pisania - kirjoituskone
maszyna do szycia - ompelukone
matematyka - matematiikka
matka - äiti
mąż - aviomies
mazak - kasvot
mazidło - linimentti
ME - EM
mecenas - asianajaja
mechaniczny - mekaaninen
mecz - ottelu, matsi
męczennik - marttyyri
meczet - moskeija
Med - meedialainen
mediana - mediaani
medyk - lääkäri, tohtori, lekuri
Merkury - Merkurius
metafizyka - metafysiikka
metafora - metafora
meteor - meteori
meteorologia - ilmatiede, meteorologia
meteoryt - meteoriitti
metr kwadratowy - neliömetri
metropolia - metropoli
mewa blada - isolokki
mewa mała - pikkulokki
mewa pospolita - kalalokki
mewa siodłata - merilokki
mewa srebrzysta - harmaalokki
mewa trójpalczasta - pikkukajava
mężczyzna - mies
Miami - Miami
miasto - kaupunki, kantakaupunki, keskusta
miasto stołeczne - pääkaupunki
miażdżyca - ateroskleroosi, valtimonrasvoittumistauti
micela - miselli
Michał - Mikael, Mikko
mieć nadzieję - toivoa
miedźwiedź - karhu
międzynarodowy - kansainvälinen
miejsce - paikka, tila
miękkopiór - haahka
miękkość - pehmeys
mielcuch - panimo, olut, kalja, kotikalja, mallasjuoma
mieśćce - paikka, tila
mieśce - paikka, tila
miesiąc - kuukausi, kuu
miesiąc miodowy - kuherruskuukausi
miesiączek - kuu
mięso - liha
mięso armatnie - tykinruoka
mięsopustnik - helmikuu
mięsożerca - lihansyöjä
mieszkać - asua
mieszkaniec - asukas
mięta - minttu
miętus - made
mikrobiologia - mikrobiologia
Mila - Emilia, Milja, Milla
miliarder - miljardööri
milioner - miljonääri
militarny - sotilaallinen
miliwolt - millivoltti
miłość - rakkaus, lempi
miłosierny - armelias, armollinen, armahtavainen, laupias, armoinen
minaret - minareetti
minerał - mineraali
minuta - minuutti
miód - hunaja, sima
miodojad - mesikko
miodowód - hunajaopas
miś - nalle
misiek - nalle
misjonarz - lähetyssaarnaaja
mistrz - mestari, nuoriherra, oppi-isä
mistyk - mystikko
miteser - finni
mitra - mitra
mleczarz - maitomies
mleko - maito
młode - pentu, poikanen
młody - nuori
młodzie - hiiva
młodzież - nuoriso
młyn - mylly
młynarz - mylläri
mocz - virtsa
modrakowy - sininen
modraszka - sinitiainen
modry - sininen
modrzew - lehtikuusi
mój - minun
Mojżesz - Mooses
mól książkowy - kirjatoukka
molo - laituri
Monachium - München
monarchista - monarkisti
moneta - kolikko
monocykl - yksipyöräinen
monopolowy - viinakauppa, alko, alkoholiliike, pitkäripainen
mops - mopsi
mora - sielu, henki
morda - turpa
morela - aprikoosi
morena - moreeni
mornel - keräkurmitsa
moroszka - hilla, lakka, muurain
morze - meri
Morze Bałtyckie - Itämeri
Morze Białe - Vienanmeri
Morze Czarne - Mustameri
Morze Północne - Pohjanmeri
Morze Śródziemne - Välimeri
morzyk - murri
morzyk japoński - töyhtömurri
morzyk marmurkowy - marmorimurri
morzyk sędziwy - mustakurkkumurri
mosiądz - kolikko
Moskwa - Moskova
most - silta
motyka - kuokka
motyl - perhonen
Mount Everest - Mount Everest
mowa - kieli
mowa jest srebrem, a milczenie złotem - puhuminen on hopeaa, mutta vaikeneminen kultaa
mózg - aivot
mrowisko - muurahaiskeko
mrównik - maasika
mróz - pakkanen
muchołówka szara - harmaasieppo
muchomor - kärpässieni
muchomór - kärpässieni
muchomor mglejarka - harmaakärpässieni
mućka - lehmä
mumia - muumio
Murmańsk - Murmansk
musztarda - sinappi
muzeum - museo
muzyk - muusikko
mużyk - mies
muzyka - musiikki
my - me
mycka - hattu
mydło - saippua
mysikrólik - hippiäinen
myśl - ajatus
mysz - hiiri
Myszka Miki - Mikki Hiiri
myszołów włochaty - piekana
myszy tańcują, gdy kota nie czują - kun kissa on poissa, hiiret hyppivät pöydällä
mżawka - tihkusade
nacjonalizm - nationalismi
nacjonalizować - kansansallistaa
naczyniak - angiooma
naczyniak krwionośny - hemangiooma, verisuoniluomi
nadgarstek - ranne
nadwzroczność - kaukotaittoisuus, kaukonäköisyys
nagrobek - hautakivi
nagroda - palkinto
Nairobi - Nairobi
najemnik - palkkasoturi, palkkasotilas
napój - juoma
naprany - humalassa
na przykład - esimerkiksi
narba - arpi
narcyz - narsissi
narodowy - kansallinen
narwal - sarvivalas
następny - seuraava
naszyjnik - kaulakoru
nauczyciel - opettaja
nauka - tiede
naukowy - tieteellinen
nawa - laiva
nazad - takaisin
na zdrowie - terveydeksi kippis
nazod - takaisin
nazwisko - sukunimi
nekrolog - kuolinilmoitus
nektarnik - medestäjä
neologizm - uudissana
neon - neon
Nepal - Nepal
nestorianin - nestorilainen
neutralność - neutraalisuus, neutraalius, neutraliteetti
neutralny - neutraali
ni - ei
Niderlandy - Hollanti, Alankomaat
nie - ei
niebawem - pian
niebiańskie pnie - taivaalliset rungot
niebieski - sininen
nieć - serkku
niedaleko pada jabłko od jabłoni - ei omena puusta kauas putoa
niedokrwistość tarczowatokrwinkowa - talassemia
nie dospać trzeba, kto chce dostać chleba - aikainen lintu madon nappaa
nieduch - sairaus
niedziela - sunnuntai
niedźwiedź - karhu
niedźwiedź polarny - jääkarhu
nieestetyczny - epäesteettinen
nieetyczny - epäeettinen
niełatwy - hankala, ankea
nie ma dymu bez ognia - ei savua ilman tulta
Niemcy - Saksa
Niemiec - saksalainen
nie mieć - ei
Niemiecka Republika Demokratyczna - Saksan Demokraattinen Tasavalta
niemiecki - saksalainen, saksa
Nieniecki Okręg Autonomiczny - Nenetsien autonominen piirikunta
nieodmienny - taipumaton
nie od razu Kraków zbudowano - Roomaa ei rakennettu yhdessä päivässä
niepodległość - riippumattomuus, itsenäisyys
niepokalane poczęcie - neitseestäsyntymisoppi, perisynnitön sikiäminen
nieposłuszny - tottelematon
nieprzyjazny - epäystävällinen
nierealny - epätodellinen
nierówność - epätasa-arvo
nieruchomość - kiinteistö
nieść - kantaa
nieściora - serkku
nieśmiertelność - kuolemattomuus
niestety - valitettavasti
nieszczęścia chodzą parami - kaikki on vastaan, vain saha puoltaa
nietoperz - lepakko
niewiasta - nainen
niewłaściwy - väärä
niewód - nuotta
niewolnictwo - orjuus
niewolnik - orja
nie wszystko złoto, co się świeci - kaikki ei ole kultaa mikä kiiltää
nie wywołuj wilka z lasu - älä herätä nukkuvaa karhua
niezdolność - kyvyttömyys, kykenemättömyys
nigdy - koskaan
nihilizm - nihilismi
nikczemny - kurja
nikiel - nikkeli
nim - hän
niski - matala
niszczyć - tuhota, hävittää
Nix - Nix
niż - kuin
niża - alanko
nizina - alanko
no - niin, kyllä
noc - yö
nocna zmiana - yövuoro
noga - jalka
nogal - isojalkakana
nogawice - housut
nonkonformista - toisinajattelija
nordycki - pohjoismainen
Norfolk - Norfolkinsaari
Norweg - norjalainen
Norwegia - Norja
norweski - norjalainen, norja
nosorożec - sarvikuono
nosówka - kissarutto
Nowa Holandia - Uudet-Alankomaat, Uusi Hollanti
Nowa Zelandia - Uusi-Seelanti
Nowa Ziemia - Novaja Zemlja
nowicjat - noviisi
nowotwór - kasvaimet
nowy - uusi
Nowy Rok - Uusivuosi
nóż - veitsi
nożyce - sakset
nożyczki - sakset
np. - esim.
nudelzupa - keitto
numer - numero
numerować - numeroida
Numidia - Numidia
nur - kuikka
nur białodzioby - jääkuikka
nur czarnoszyi - kuikka
nurek - sukeltaja, sarvikiisla
nurniczek - kiislanen
nurniczek ciemny - ulappakiislanen
nurniczek czubaty - töyhtökiislanen
nurniczek krasnodzioby - punanokkakiislanen
nurniczek malutki - pikkukiislanen
nurniczek wąsaty - hapsukiislanen
nurnik - riskilä
nurnik aleucki - tyynenmerenriskilä
nurnik ochocki - nokiriskilä
nurogęś - isokoskelo
nur pacyficzny - tundrakuikka
nur rdzawoszyi - kaakkuri
nurzec - myrskysukeltaja
nurzyk - kiisla
nurzyk polarny - pohjankiisla
nyga - hyttynen, sääski, moskiitto
obcokrajowiec - ulkomaalainen
obelisk - obeliski
oberżyna - munakoiso
obiecadło - aakkoset, kirjaimisto
obierać ogóra - runkata, vetää käteen
objaw - oire
oblężenie - piiritys
obłok - pilvi
obój - oboe
obraz - elokuva
obszar - ala
obwód murmański - Murmanskin alue
obywatel - kansalainen
obywatelstwo - kansalaisuus
ocean - valtameri
Ocean Atlantycki - Atlantin valtameri
Ocean Spokojny - Tyyni valtameri
ocet - etikka
ochrona - turva
ociec - isä
od - alkaen
odcisk palca - sormenjälki
oddzielnie - erikseen
ode - alkaen
odmieniec jaskiniowy - olmi
odmowa - epuu
odpadek - jäte, uskaltaa
odpowiedzialność - edesvastuu
odsyłacz - linkki
odwet - kostoisku
odwracalny - reversiibeli
ogień - tuli
ognisko - nuotio, valkea, polttopiste
ogórecznik lekarski - rohtopurasruoho, kurkkuyrtti
ogórek - kurkku
ogorzałka - lapasotka
ogród - puutarha
ojciec - isä
ojla - pöllö
okazały - kookas
okłamywać - valehdella
okno - ikkuna
oknówka - räystäspääsky
oko - silmä
okręt liniowy - linjalaiva
okręt podwodny - sukellusvene
okrutny - julma
okultyzm - okkultismi
olcha - leppä
olej - öljy
olej słonecznikowy - auringonkukkaöljy
Olimpia - Olympia
ołówek - lyijykynä
omieszkać - ei
on - hän
ona - hän
ONZ - YK
oologia - oologia
opal - opaali
opalenizna - rusketus
opium - oopiumi
oportunizm - opportunismi
opowiadać - kertoa
oraz - ja
ordnung - järjestys, siivous
organista - urkuri
organy - urut
orgazm - orgasmi
orlik krzykliwy - pikkukiljukotka
orzeł - kotka
oś - akseli
osa - ampiainen
osika - haapa
osioł - aasi
osłomuł - muuliaasi
osoba - henkilö
osobliwy - erikoinen, outo
osobno - erikseen
ostatni - viimeinen
Ostia - Ostia
ostrygojad - meriharakka
ostrze - terä
ostrzytko - kynänteroitin
oszustwo - petos
otwierać - avata
owies - kaura
o wilku mowa - siinä paha missä mainitaan
o wilku mowa, a wilk tu - siinä paha missä mainitaan
o wilku mowa, a wilk tuż - siinä paha missä mainitaan
owulacja - ovulaatio
ożarty - humalassa
pacha - kainalo
pachwina - nivunen
paciuk - rotta
Pacyfik - Tyynimeri, Tyyni valtameri
pączek - munkki, silmu
pagórek - kumpu
pająk - hämähäkki
pajęcznik - syyskuu, lokakuu, marraskuu
pakli - jos
pała - pää, nuppi, hamara
palacz - tupakoija
pale - pää, nuppi, hamara
palec - sormi (palec u ręki), varvas (palec u nogi)
palec wskazujący - etusormi
Palestyńczyk - palestiinalainen
pali - pali
palić - polttaa
palindrom - palindromi
pamięć - muisto
pancernik - vyötiäinen, panssarilaiva
pandeizm - pandeismi
panleukopenia - kissarutto
panna - neiti
Panna - Neitsyt
państwowość - osavaltioasema
panteon - pantheon tai pantheoni
pantoflarz - vihtori
papier - paperi, asiapaperi
papier śniadaniowy - voipaperi
papież - paavi
para - vesihöyry
paranoidalny - paranoidinen
parasol - sateenvarjo, auringonvarjo
pardwa górska - kiiruna
pardwa mszarna - riekko
park - puisto
park narodowy - kansallispuisto
partia polityczna - poliittinen puolue
Paryż - Pariisi
pas - vyö
pasek - vyö
pasożyt - loinen
pasta do zębów - hammastahna
pasywny - passiivinen
paszkot - kulorastas
paszport - passi
pasztet strasburski - hanhenmaksa
patelnia - paistinpannu
pątnik - pyhiinvaeltaja, toiviomatkalainen, toivioretkeläinen
patronimiczny - patronyymi
paw - riikinkukko
pawęża - kilpi
październik - lokakuu
paździerzeń - lokakuu
paznokieć - kynsi
pchnięcie kulą - kuulantyöntö
pedał - poljin, hinttari
pedryl - poljin, hinttari
pędzel - sivellin
Pentateuch - pentateukki
pępek - napa
perfumy - hajuvesi, parfyymi, hajuste
perka - peruna
perkołyska - uikkukana
perkoz - uikku
perkoz dwuczuby - silkkiuikku
perkozek - pikku-uikku
perkoz rdzawoszyi - härkälintu
perła - helmi
Perm - Perm
persona - henkilö
Peru - Peru
peruka - peruukki
piana - olut, kalja, kotikalja, mallasjuoma
piaskowiec - pulmussirri
piaskownica - hiekkalaatikko
piątek - perjantai
pić - juoda
piczka - pillu, vittu
pidżama - pyjama, yöpuku
piec - leipoa
piecuszek - pajulintu
pieczara - luola
pieczeń - paisti
piegża - hernekerttu
piekarz - leipuri
piekielny - helvetillinen
piękny - kaunis
pielgrzym - pyhiinvaeltaja, toiviomatkalainen, toivioretkeläinen
piemontyt - piemontiitti
pień - runko
pieniądz - raha
pieprz - pippuri
pieprzyca siewna - vihanneskrassi
pierdnięcie - pieru
pierścień - sormus
pierwsza pomoc - ensiapu
pies - koira
pięść - nyrkki
pięściarstwo - nyrkkeily
piesiec - naali
pieśń - laulu
pies obronny - suojelukoira
pies policyjny - poliisikoira
pies pracujący - käyttökoira
pies przewodnik - opaskoira
pies stróżujący - vahtikoira
pieszy - jalankulkija
piętro - kerros
Pietropawłowsk Kamczacki - Petropavlovsk-Kamtšatski
Pietrozawodsk - Petroskoi
pietruszka - persilja, juuripersilja
pietruziel - persilja, juuripersilja
pietuch - kukko
pijanica - juolukka
pijany - humalassa
pijawa - sateenkaari
pikawa - sydän
pikieta - piquet, piketti
piksel - pikseli
piłka nożna - jalkapallo
piłkarzyki - pöytäjalkapallo
piorun - salama
piosenka - laulu
piosenkarz - laulaja
Piotr - Petteri, Pekka
Piotra - Petra f
pipa - pillu, vittu
piromania - pyromania
pisać - kirjoittaa
pismo - kirjoitus, kirjoittaminen, aikakauslehti, aakkoset, kirjaimisto
pistolet maszynowy - konepistooli
Pitagoras - Pythagoras
Pittsburgh - Pittsburgh
piwo - olut, kalja, kotikalja, mallasjuoma
piżama - pyjama, yöpuku
pizda - pillu, vittu
piżmowół - myskihärkä
pizza - pitsa
plac - aukio
plac budowy - rakennustyömaa
płacić - maksaa
plagiator - plagioija
plajster - laastari
płakać - itkeä, parkua, vollottaa
planeta - planeetta
planetarium - planetaario
planta - kasvi
płaskonos - lapasorsa
plaster - laastari
plaża - ranta
plebania - pappila
plemię - heimo
pliszka górska - virtavästäräkki
pliszka siwa - västäräkki
płuco - keuhko
plurale tantum - plurale tantum
płynny - neste, sujuva, sulava
płyta główna - emolevy
pływak - uimari
pochwodziób - tuppinokka
pociąg - juna
pociąg pocztowy - postijuna
pocieszyciel - lohduttaja
poczucie humoru - huumorintaju
podatek kościelny - kirkollisvero
podatnik - veronmaksaja
podgatunek - alalaji
podomka - aamutakki
podpułkownik - everstiluutnantti
podrodzina - alaheimo
podróżniczek - sinirinta
podstawówka - peruskoulu
poduszka - tyyny, ruutu
poduszka powietrzna - turvatyyny
poeta - runoilija
poganin - pakana
pogaństwo - pakanuus
pogoda - ilma, sää
pogrzeb - hautajaiset
pohybel - hirsipuu
pojazd - kulkuneuvo, ajonuvo
pokładełko - munanasetin
pokląskwa - pensastasku
pokój - rauha, huone
pokrzewka - kerttu
pokrzewka piegża - hernekerttu
pokrzywa - nokkonen
Polak - puolalainen
polatucha - liito-orava
pole - pelto
polędwica - filee
poleku - hitaasti
poli- - moni-, poly-
policja - poliisi
poliptyk - polyptyykki
politeizm - polyteismi, monijumalisuus
politura - pulituuri
polityk - poliitikko
polityka - politiikka
półka - hylly
północ - puoliyö, pohjoinen
północnoamerykański - pohjoisamerikkalainen
północny wschód - koillinen
polon - polonium
położenie - sijainti
położnica - synnyttäjä
półsamogłoska - puolivokaali
Polska - Puola
polski - puolalainen, puola
polskość - puolalaisuus
polszczyzna - puola
półtora - puolitoista
półtorej - puolitoista
południowy zachód - lounas
Półwysep Arabski - Arabian niemimaa
pomarańcza - appelsiini, appelsiinipuu
pomarańczowy - oranssi
pomidor - tomaatti
pomoc - ohje, apu
poniedziałek - maanantai
ponieważ - koska, sillä, siksi
popielniczka - tuhkakuppi
populizm - populismi
pornografia - pornografia
pornograficzny - pornografinen, siveetön
port - satama
portier - talonmies
portki - housut
portu - satama
portugalski - portugalilainen, portugali
porucznik - luutnantti
porządek - järjestys, siivous
porzeczka - herukka, viinimarja
posag - myötäjäiset
posiadać - omata, omistaa
pośledni - viimeinen
posowa - katto, sisäkatto
postępowy - edistyksellinen
poświerka - lapinsirkku
poszukiwacz - etsijä
potas - kalium
potrzeba jest matką wynalazków - hätä keinon keksii
potrzebować - tarvita
potrzeszcz - harmaasirkku
potrzos - pajusirkku
powiadać - kertoa
powiestka - nimi, etunimi
powietrze - ilma
powódź - tulva, ryöppy
powoli - hitaasti
powstanie warszawskie - Varsovan kansannousu
poziomka - ahomansikka, metsämansikka
pozwalać - sallia, antaa, suoda
pożyczka - laina
pożyteczny idiota - hyödyllinen idiootti
pożywienie - ruoka
PP - PP
praca - työ
praca domowa - kotitehtävä, läksy
pralka - pesukone
prawda - totuus
prawdziwych przyjaciół poznaje się w biedzie - hädässä ystävä tunnetaan
prawko - ajokortti
prawo jazdy - ajokortti
prażyć - paistaa
prekariat - prekariaatti
premier - pääministeri
prezentacja - esitys, esitelmä
prezerwatywa - kondomi
prezydent - presidentti
probówka - koeputki
próbówka - koeputki
proca - ritsa
proch - ruuti
proch strzelniczy - ruuti
produkcja - valmistaminen, tuotanto, valmistus
prom - lautta
prosiak - porsas
prosię - porsas
prosię ziemne - maasika
prostytucja - prostituutio
prostytutka - prostituoitu
proszczok - porsas
proszę - olkaa hyvä
proton - protoni
prowansalski - oksitaani
Prusy - Preussi
pryszcz - finni
przać - rakastaa, rakastella
przebiśnieg - lumikello
przebój - hitti, menestys
przecinek - pilkku
przeciwwaga - vastapaino
przedchrześcijański - esikristillinen
przede wszystkim - erityisesti, varsinkin
przedmiot - esine
przedpokój - käytävä
przedsiębiorca - yrittäjä
przedstawiciel - edustaja
przenośnia - metafora
przepaska - lannevaate
przepaska biodrowa - lannevaate
przepiórnik - pyyjuoksija
przepowiednia - profetia
przesądny - taikauskoinen
prześcieradło - lakana
przesłanka - edellytys
przestępstwo - rikos
przestrzeń kosmiczna - ulkoavaruus
przeszkoda - este
przewodnik - johde
przewrotka - saksipotku
przoć - rakastaa, rakastella
przybity - masentunut
przydomek - lempinimi
przyjaciel - ystävä
przymiotnik - adjektiivi
przynęta - syötti
przyprawa - mauste
przysięga - vala f
przysięgać - vannoa
przysłówek - adverbi
przystanek - pysäkki
przystojny - komea
przywilej - etuoikeus
psiarnia - poliisi
psisko - koira
Psków - Pihkova
pstrąg - forelli
psychologia - psykologia
psy szczekają, karawana idzie dalej - koirat haukkuvat ja karavaani kulkee, karavaani kulkee, mutta koirat haukkuvat
pszczoła - mehiläinen
Ptah - Ptah
ptak - lintu
ptaszę - lintu
PTFE - PTFE
puchacz - huuhkaja
puder - puuteri, tomusokeri
punkt - piste
purpurowy - purppura
puste - tyhjä
pusty - tyhjä
pustynia - aavikko, autiomaa
puszczyk - lehtopöllö
puszczyk mszarny - lapinpöllö
puszczyk uralski - viirupöllö
puszka - vankila, olut, kalja, kotikalja, mallasjuoma
Pyjter - Petteri, Pekka
pyra - peruna
pytanie retoryczne - retorinen kysymys
rachatłukum - lokum, loukoum
raciądz - ritari
racjonalność - rationaliteetti
rączka - korva
radioaktywny - radioaktiivinen
radon - radon
Rafał - Rafael
Rajch - Saksa
Rak - Rapu
rakuski - itävaltalainen
rana - haava
raróg - aavikkohaukka
rasizm - rasismi
raszka - punarinta
raz - kerta
razdziawa - korppi, varis
realizm - realismi
ręce do góry - kädet ylös!
ręcznik - pyyhe
redyska - retiisi
redźka - retiisi
reformacja - uskonpuhdistus
regularnie - säännöllisesti
ręgulec - petos
reinkarnacja - jälleensyntyminen, sielunvaellus
rękawica - käsine
rękawiczka - käsine
rekin - hai
reklama - mainos, mainostus
rekomendować - suositella
rekrut - alokas
remiz - pussitiainen
ren - poro, peura
renifer - poro, peura
republika - tasavalta
republika bananowa - banaanitasavalta
Republika Czeska - Tšekin tasavalta
Republika Federalna Niemiec - Saksan Liittotasavalta
Republika Karelia - Karjalan tasavalta
Republika Komi - Komin tasavalta
Republika Słowacka - Slovakian Tasavalta
restauracja - ravintola
rewolucjonista - vallankumouksellinen
RNA - RNA
robak - mato, aivomato
Robert - Roope
robić z igły widły - tehdä kärpäsestä härkänen
rodzaj męski - maskuliini
rodzaj nijaki - neutri
rodzina - perhe, heimo
róg - sarvi
rok - vuosi, hame
rok przestępny - karkausvuosi
ropień - paise
ropucha - rupikonna, konna
rosa - kaste
Rosja - Venäjä
Rosjanin - venäläinen
roślina - kasvi
roślinożerca - kasvinsyöjä
roso - kaste
rosomak - ahma
rosyjski - venäläinen, venäjä
rouza - ruusu
rów - oja
rower - polkupyörä
rowerzysta - pyöräilijä
równanie - yhtälö
również - myös, -kin
równoważny - ekvivalentti, ekvivalenttinen, yhtäpitävä, samanarvoinen
róż - vaaleanpunainen
róża - ruusu
rozdzielać - jakaa
rożeniec - jouhisorsa
rozgrzeszenie - synninpäästö
rozgwiazda - meritähti
różnica - erotus
różnorodność - diversiteetti, monimuotoisuus, moninaisuus
różowy - vaaleanpunainen
rozsierdzie - kiukku
roztargniony - hajamielinen
rozum - järki
różyczka - vihurirokko
rtęć - elohopea
rubel - rupla
rubid - rubidium
ruchome schody - rullaportaat, liukuportaat
ruda darniowa - suomalmi
rudzik - punarinta
ruina - raunio
rum - rommi
rumianek - kamomilla
Rumun - romanialainen
rumuński - romanialainen, romania
rura - putki
ruten - rutenium
ryba - kala
rybak - kalastaja
rybik cukrowy - sokeritoukka
rybołów - sääksi
Ryby - Kalat
rycerz - ritari
Ryga - Riika
ryma - flunssa, influenssa
rynka - ruukku
ryś - ilves
rysować - piirtää
rysownik - piirtäjä
rywal - kilpailija
rywalizować - otella
ryż - riisi
rząd marionetkowy - nukkevaltio
rzadny - ruma
rzecz - esine
rzeczownik - substantiivi
rzeczywistość - todellisuus
rzeka - joki
rzepak - rapsi
rzepołuch - vuorihemppo
rzęsa - silmäripsi
rzeżączka - tippuri
rzeźnik - teurastaja
rzić - perse
rzodkiewka - retiisi
rzut młotem - moukarinheitto
rzut oszczepem - keihäänheitto
rzut rożny - kulmapotku
sabotaż - sabotaasi
sadło - silava
sadzić - istuttaa
sagan - pää, nuppi, hamara
sałata - taksi
sałatka - salaatti
salceson - aladobi
Salwador - El Salvador
samar - samarium
samiec - koiras
samobójca - itsemurhaaja
samobójstwo - itsemurha
samolot - lentokone
samotnik - metsäviklo
samotność - yksinäisyys
samowar - samovaari
sarkofag - sarkofagi
sarna - metsäkauris
sarnapa - kirahvi
sąsiad - naapuri f
satyra - satiiri
sauna - sauna
schody ruchome - rullaportaat, liukuportaat
ściany mają uszy - seinilläkin on korvat
ścięgno - jänne
ściemniać - valehdella
seaborg - seaborgium
seksualność - seksuaalisuus, seksualiteetti, sukupuolisuus
seksuologia - seksologia
selen - seleeni
seler - selleri
sen - uni, unennäkö
sęp - korppikotka
sepsa - verenmyrkytys, sepsis
ser - juusto
Serbia i Czarnogóra - Serbia ja Montenegro
serce - sydän
serdce - sydän
serdeczny palec - nimetön sormi
seroka - harakka
serwatka - hera
setka - satanen
si - tämä
siano - heinä
siarkowodór - rikkivety
siatkówka - lentopallo
sieczeń - helmikuu
siedem grzechów głównych - seitsemän kuolemansyntiä
siedzieć - istua
sierociniec - lastenkoti
sierpień - elokuu
sierpodudek - säihkyjä
siestrzan - sisarenpoika m
siestrzeniec - sisarenpoika m
siewka złota - kapustarinta
siewka złotawa - siperiankurmitsa
siewnica - tundrakurmitsa
sikać - pissata, pisauttaa
siki - virtsa
sikora - tiainen
sikora bogatka - talitiainen
sikora czarnogłowa - hömötiainen
sikora czubata - töyhtötiainen
sikora modra - sinitiainen
sikora północna - lapintiainen
silnia - kertoma
sin - sin
Singapur - Singapore
sinus - sini
siodło - satula
sioło - kylä
siostra - sisko
siostrzan - sisarenpoika m
siostrzanek - sisarenpoika m
siostrzeniec - sisarenpoika m
sirpień - elokuu
siurać - pissata, pisauttaa
siwerniak - vuorikirvinen
skąd - mistä
skała - kallio
skand - skandium
Skandynawia - Skandinavia n
skandynawski - skandinaavinen
skąpy - saita, niukka
skiba - varkaus
skibać - varastaa
skład - kauppa, katto, sisäkatto
sklep - kauppa, katto, sisäkatto
sklep monopolowy - viinakauppa, alko, alkoholiliike, pitkäripainen
skoczek - hevonen
skok o tyczce - seiväshyppy
skok wzwyż - korkeushyppy
Skop - Oinas
skopowina - lampaanliha
skóra - iho
skorpion - skorpioni
Skorpion - Skorpioni
skorupiak - äyriäinen
skowroda - paistinpannu
skowronek - kiuru
skroń - ohimo f
skrytka pocztowa - postilokero
skrzydłoszpon - romisko
skrzypce - viulu
skuteczność - efektiivisyys
skuter - skootteri lub (rzadko używane) potkulauta
ślad - jälki
slang - slangi
Śląsk - Sleesia
śleboda - vapaus
śledź - solmio, kravatti
śledziona - perna
śleptać - itkeä, parkua, vollottaa
ślepucha - kana
ślepy lelek - lepakko
ślimak - etana
ślips - solmio, kravatti
śliwa - luumupuu
śliwka - luumu
słodki - makea, imelä, suloinen, herttainen
słoń - elefantti, norsu
słońce - aurinko
Słońce - Aurinko
słonecznica - aurinkokurki
słonecznik - auringonkukka
słoneczny - auringon-, aurinko-, aurinkoinen
słonina - silava
słonka - lehtokurppa
słony - suolainen
słowa - sana
słowacki - slovakialainen, slovakki
Słowenia - Slovenia
Słowianin - slaavi
słowik - satakieli
słownik - sanakirja
słowo - sana
słup słoneczny - auringonpilari
smacznego - hyvää ruokahalua
smagły - tummaihoinen
smażonka - munakokkeli
smerf - Smurffi, Smurffit
smętny - haikea
śmieć - jäte, uskaltaa
śmierć - kuolema
śmieszka - naurulokki
śmietana - kerma
smutniak - leipä
smutny - haikea, ankea, surullinen
smysł - järki
śniadanie - aamiainen, aamupala
śnieg - lumi
śnieguła - pulmunen
sobaka - koira
sobota - lauantai
socjolog - sosiologi
socjologia - sosiologia
socynianin - socinialainen
socynista - socinialainen
socynjanin - socinialainen
soczewka - mykiö
Soczi - Sotši
soczysty - mehukas
sód - natrium
sójka - närhi
sójka syberyjska - kuukkeli
sójka złowroga - kuukkeli
sojusznik - liittolainen
sok - mehu
sokolnik - haukkametsästäjä
sól - suola
solniczka - suolasirotin
Somalia - Somalia
somsiad - naapuri f
sopel - jääpuikko
sos - kastike
sos sojowy - soijakastike
sowa - pöllö
sowa błotna - suopöllö
sowa jarzębata - hiiripöllö
sowa śnieżna - tunturipöllö
spadochroniarz - laskuvarjohyppääjä
spalanie - palaminen
spam - spämmi, roskaposti
śpiący - uninen
śpiewać - laulaa
śpiewak - laulaja
Spitsbergen - Huippuvuoret
śpiwór - makuupussi
spódnica - hame
spodnie - housut
sport - urheilu
sport narodowy - kansallispeli
spowiedź - rippi, tunnustaminen, tunnustus
spragniony - janoinen
sprzedawca - myyjä
sraka - takamus
srebrna - hopeainen
srebrny - hopeainen
srebro - hopea
średniowiecze - keskiaika
Sri Lanka - Sri Lanka
ŚRK - KMN
środa - keskiviikko
sroka - harakka
śruba - ruuvi, potkuri
ssak - nisäkäs
stacja benzynowa - bensiiniasema, bensa-asema
stadion - stadion
stanik - rintaliivit
Stany - Amerikan Yhdysvallat, Yhdysvallat
Stany Zjednoczone - Yhdysvallat
Stany Zjednoczone Ameryki - Amerikan Yhdysvallat, Yhdysvallat
stara panna - vanhapiika
starek - isoisä
stare miasto - vanha, kaupunki, kantakaupunki, keskusta
starorzecze - juolua
starosek - isoisä
staroszek - isoisä
starszy - isä
stary - vanha
starzeć się - vanheta
starzyk - isoisä
statek - laiva
staw - nivel
staw łokciowy - kyynärpää
stawonóg - niveljalkainen
Stefan - Stefanos
stefka - lentoemäntä
stegnisko - jälki
ster - peräsin
sterowiec - ilmalaiva, zeppeliini
stewardesa - lentoemäntä
stół - pöytä
stolica - pääkaupunki
stomatolog - hammaslääkäri
stopa - jalka
stopień wyższy - komparatiivi
strach - pelko, linnunpelätin, linnunpelätti, variksenpelätin
strach na wróble - pelko, linnunpelätin, linnunpelätti, variksenpelätin
strąpacz - helmikuu
strategia - strategia
strażak - palomies
strefa Złotowłosej - elinkelpoinen vyöhyke
stres - stressi
strój kąpielowy - uimapuku
struktur - rakennelma
struktura - rakennelma
strychnina - strykniini
strzała - nuoli
Strzelec - Jousimies
student - opiskelija
stulecie - ikä, vuosisata
styczeń - tammikuu
sufit - katto, sisäkatto
sukienka - mekko
sumienie - omatunto
surrealistyczny - surrealistinen
sutek - nänni
swastyka - hakaristi
świątek - juhla
świergotek - kirvinen
świergotek łąkowy - niittykirvinen
świergotek polny - nummikirvinen
świerk - kuusi
świeść - käly
święto - juhla
Święty Hufiec - pyhä joukko
święty mikołaj - joulupukki
Święty Zastęp - pyhä joukko
świnia - porsas, sika
świnka - sikotauti
świostka - käly
świstun - haapana
Syberia - Siperia
syczek - pöllönen, kyläpöllönen
syfilis - syfilis, kuppa, kuppatauti
sylaba - tavu
sylwek - uudenvuodenaatto, uusivuosi
sylwester - uudenvuodenaatto, uusivuosi
sympatia - sympatia
synapsa - synapsi
synergia - synergia
synowiec - veljenpoika m
synteza - synteesi
sypialnia - makuuhuone
syra - jalka
syrop klonowy - vaahterasiirappi
system operacyjny - käyttöjärjestelmä
szajs - paska
szampan - samppanja
szara strefa - harmaa talous
szarłat - revonhäntä
szary - harmaa
szczepionka - rokotus
szczęśliwego Nowy Nowego Roku - onnellista uutta vuotta, hyvää uutta vuotta
szczoteczka do zębów - hammasharja
szczotka - harja
szczudłak - pitkäjalka
szczupak - hauki
szczur - rotta
szczyt - orgasmi
szept - kuiskaus
szermierka - miekkailu
szeroki - laaja
sześcian - kuutio
szkita - jalka
szklarnia - kasvihuone
szklistka - lasiainen
Szkocja - Skotlanti
szkoła - koulu
szkoła podstawowa - peruskoulu
szkoła powszechna - peruskoulu
szkop - saksalainen
szlachar - tukkakoskelo
szlachetny - jalo
szlafrok - aamutakki
Szląsk - Sleesia
szlauch - käärme
szlips - solmio, kravatti
szminka - huulipuna
szmucha - petos
szneka - kasvot
sznur - nuora f
szolka - kuppi
szowinizm - sovinismi (chauvinismi, šovinismi)
szowinizm gatunkowy - spesismi
szpic fiński - suomenpystykorva
szpinak - pinaatti
szpital - sairaala
szpuk - kyyhky
Sztokholm - Tukholma
sztokholmski - tukholmalainen
sztrof - rangaistus
sztrofa - rangaistus, kottikärryt
sztuka - taide
szubienica - hirsipuu
szukać - etsiä
szwab - saksalainen
szwagierka - käly
szwaja - jalka
Szwajcaria - Sveitsi
szwajcarski - sveitsiläinen
Szwecja - Ruotsi
Szwecyjo - Ruotsi
szwedzki - ruotsalainen, ruotsi
szwestera - sisko
szybki - nopea
szyna - kisko
tabaka - tupakka
tabliczka - kertotaulu, kertomataulu, suklaapatukka
tabliczka czekolady - suklaapatukka
tabliczka mnożenia - kertotaulu, kertomataulu
tachykardia - takykardia
tacik - isä, isoisä
taczka - kottikärryt
Tadżykistan - Tadžikistan
Tajlandia - Thaimaa
tak - niin, kyllä
taksonomia - taksonomia
taksówka - taksi
także - myös, -kin
tak zwany - niin sanottu, niin kutsuttu
tal - tallium
talasemia - talassemia
tanksztela - bensiiniasema, bensa-asema
tantal - tantaali
Tanzania - Tansania
tapeta - tapetti
tarcza - kilpi, kasvot
tarcza krystaliczna - kilpi
tarcza strzelecka - kilpi, kasvot
tarcza szkolna - kilpi
tarczyca - kilpirauhanen
tarło - kutu
taśma perforowana - reikänauha
taśtać - kantaa
tatuaż - tatuointi
tchawica - henkitorvi
te - tämä
technet - technetium,
tęcza - sateenkaari
teista - teisti
tej - sinä (język pisany), sä (język mówiony), Te
tekst - teksti
telefon - puhelin
telefon komórkowy - kännykkä
teletekst - teksti-TV
tellur - telluuri
temat - aihe
temperówka - kynänteroitin
ten - tämä
ten śmiać się śmieje, kto śmiać się śmieje ostatni - joka viimeksi nauraa, se parhaiten nauraa
tenże - tämä
teolog - teologi
teologiczny - teologinen
terapeuta - terapeutti
terb - terbium
terekia - rantakurvi
terier brazylijski - brasilianterrieri
terier szkocki - skotlanninterrieri
termodynamika - termodynamiikka
Termopile - Thermopylai
terroryzm - terrorismi
terytorium - territorio, alue, reviiri (terytorium zwierząt:)
testament - testamentti
tetraplegia - neliraajahalvaus, kvadriplegia, tetraplegia
tetrapylon - tetrapylon
tetum - tetumin kieli
też - myös, -kin
tg - tan
Timor Wschodni - Itä-Timor
tiul - tylli
tkactwo - kutominen
tkanka - kudos
tkanka tłuszczowa - rasvakudos
tlen - happi
tlenek węgla - hiilimonoksidi, hiilioksidi
tłum - väkijoukko
tłumaczenie - käännös
tobie - sinä (język pisany), sä (język mówiony), Te
toksykologia - toksikologia
toksyna - toksiini
topografia - topografia
topola - poppeli
tor - torium
Tora - toora
tory - torium
totem - toteemi
towar - tavara
tracić - kadottaa
tracz - koskelo
tradycyjny - perinteinen
trajkotka - heinätavi
trambimba - raitiotievaunu, ratikka
tramwaj - raitiotievaunu, ratikka
tramwajka - raitiotievaunu, ratikka
transliteracja - translitterointi
transsubstancjacja - transsubstantiaatio
trichotillomania - trikotillomania
troć - forelli
trochę - vähän, hiukan
trójkąt - kolmio, triangeli
trójskok - kolmiloikka
truchło - ruumis
trudny - hankala, ankea
trujący - myrkyllinen
trybalizm - tribalismi
trzaszczka - korsi
trzewikodziób - kenkänokka
trzmiel - kimalainen
trznadel zwyczajny - keltasirkku
trzustka - haima
tudzież - ja
Tunezja - Tunisia
turecki - turkkilainen, turkki
Turkmenistan - Turkmenistan
tusz - tussi
tuż - lähes, melkein
tuzin - tusina
twardość - kovuus
twardziel - kovalevy
twarz - kasvot
twierdza - linnake
twój - sinun
ty - sinä (język pisany), sä (język mówiony), Te
Tybetańczyk - tiibetiläinen
tyczkarz - seiväshyppääjä
tydzień - viikko
tygr - tiikeri
tygrys - tiikeri
tyj - tee
tyłek - takamus
tylne światło - perävalo
typografia - typografia
tyrania - tyrannia, tyrannius
Tyrteusz - Tyrtaios
tytoń - tupakka
ubezpieczenie - vakuutus
ubezpieczenie na życie - henkivakuutus
ubikacja kucana - kyykkykäymälä
ubóstwo - köyhyys
ubranie - vaatetus
ucho - korva
Uchta - Uhta
uczuć - tunne
uczucie - tunne
udo - reisi
udziec - haara
uhla - pilkkasiipi
uhla pstrodzioba - pilkkaniska
ujgurski - uiguuri
ukaz - ukaasi
układ okresowy pierwiastków - jaksollinen järjestelmä, alkuaineiden jaksollinen järjestelmä
ukleja - salakka
Ukraina - Ukraina
ukraiński - ukrainalainen, ukraina
ulica - katu
umiak - umiakki
umywalka - pesuallas
Unia Europejska - Euroopan unioni
uón - hän
upał - helle
uparty - itsepäinen
upiec dwie pieczenie na jednym ogniu - tappaa kaksi kärpästä yhdellä iskulla
uprzedzenie - ennakkoluulo
urępny - kaunis
urna - uurna
urologia - virtsaelintautioppi, urologia
uryna - virtsa
uśmiech - hymy
uśmiechać się - hymyillä
usta - suu
uszatka - sarvipöllö
uwertura - alkusoitto
użyteczny idiota - hyödyllinen idiootti
używka - nautintoaine
wacha - raitamakrilli, meri, vesi
waga - vaaka
Waga - Vaaka
wajco - muna
wałach - ruuna, valakka
Waldemar - Valdemar
wałek - petos
Walia - Wales
walić konia - runkata, vetää käteen
wampir - vampyyri
wandal - vandaali
wandalizm - vandalismi
wanta - vantti
wapień - kalkkikivi
waran - varaani
warszawa - Varsova
Warszawa - Varsova
waruga - vasarapäähaikara
warzęcha - kapustahaikara
wąski - kapea
wata cukrowa - hattara
wątroba - maksa
wątrobianka - maksamakkara
Watykan - Vatikaan
wawrzyn - laakeri
wąż - käärme
wcześniactwo - ennenaikainen synnytys
wczoraj - eilinen, eilispäivä
wdzięczność - kiitollisuus
wedyjski - vedalainen
weganin - vegaani
weganizm - veganismi
wegański - vegaaninen
wegetarianizm - kasvissyönti, vegetarismi
węgiel - hiili
Węgier - unkarilainen
Węgierka - unkarilainen
węgierski - unkarilainen, unkari
węgierskojęzyczny - unkarinkielinen
węgorz - ankerias
Węgry - Unkari
wełna - villa
wena - haltioituminen, innoitus
wentroba - maksa
wesele - häät
Wesołych Świąt - hyvää joulua, hyvää pääsiäistä
węszyć - haistaa
weterynarz - eläinlääkäri
węzeł - solmu
wężówka - käärmekaula
wezwanie - nimi, etunimi
wiatr - tuuli
wichura - vihuri
widelec - haarukka
widelec do porcjowania - paistihaarukka
widołka - haarukka
widzieć - nähdä
więc - siksi
wieczność - iankaikkisuus
wieczny - ikuinen
wieczór - ilta
wiek - ikä, vuosisata
wiek emerytalny - eläkeikä
Wielka Brytania - Britannia
Wielkanoc - pääsiäinen
Wielki Piątek - Pitkäperjantai
wielokulturowość - monikulttuurisuus
wielokulturowy - monikulttuurinen
wiersz - runo
wieś - kylä
wietnamski - vietnamilainen, vietnam
wiewiór - tippuri
wiewiórka - orava
wieża ciśnień - vesitorni
więzień - vanki
więzienie - vankila
Wigilia - jouluaatto
Wikipedia - Wikipedia
Wikisłownik - Wikisanakirja
Wikiźródła - Wikiaineisto
wilga - kuhankeittäjä
wilgotny - humidi
wilk - susi, hukka
wilkołak - ihmissusi
wilk w owczej skórze - susi lampaan vaatteissa
willa - huvila
winien - syyllinen
winnica - viinitila
winny - syyllinen
wino - viini
winograd - viinitila, viinirypäle, viini
winogrono - viinirypäle
wioska - kylä
wiosło - airo
wiosna - kevät
Wirakocza - Viracocha
Wisła - Veiksel
wiśnia - hapankirsikka
wizytkarta - käyntikortti
wizytówka - käyntikortti
wkrótce - pian
wkurwiony - vihainen, ärsyyntynyt
Włoch - italialainen
włochatka - helmipöllö
włos - hius
włoski - italialainen, italia
wnęta - syötti
woda - vesi
woda mineralna - mineraalivesi
wodnik - luhtakana
Wodnik - Vesimies
wodny - vesi-, veden-
wodór - vety m
wodospad - koski
wójcik zielony - idänuunilintu
wojna - sota
wokabularz - sanakirja
wolnomularz - vapaamuurari
wolność - vapaus
wolność słowa - sananvapaus
Wołogda - Vologda
wołowina - raavaanliha
Workuta - Vorkuta
woskówka - vahanahka
wózek dziecięcy - lastenvaunut
wózek inwalidzki - pyörätuoli
wózek sklepowy - ostoskärryt
wróg - vihollinen
wrona - varis
wróżka - keijukainen, keiju
wrzesień - syyskuu
wrzód - haavauma
wrzos - kanerva
wschód - itä
wschodni - itä
wścieklizna - vesikauhu, raivotauti
współczucie - myötätunto
wszystek - kaikki
wszystkie drogi prowadzą do Rzymu - kaikki tiet vievät Roomaan
wtorek - tiistai
wulkan - tulivuori
wuszt - makkara
wybierać - valita
wybitny - erinomainen
wyborca - äänestäjä
wybory - vaalit
Wybrzeże kość Kości Słoniowej - Norsunluurannikko
wydma - dyyni
wydrzyk - kihu
wydrzyk ostrosterny - merikihu
wyjątek - poikkeus
wyjątkowy - erikoinen
wykusz - erkkeri
wylać dziecko z kąpielą - heittää lapsi pesuveden mukana
wymię - utare
wymowa - ääntäminen
wyprysk - finni
wyraz - sana
wyścig w workach - pussijuoksu, kenguruhyppely
wyspa - saari
Wyspa Bożego Narodzenia - Joulusaari
Wyspa Świętego Tomasza - São Tomé
Wyspa Świętego Wyspy Świętego Tomasza i Wyspa Książęca - São Tomé ja Príncipe
Wyspy Alandzkie - Ahvenanmaa
Wyspy Kanaryjskie - Kanariansaaret
Wyspy Owcze - Färsaaret
wywiad - haastattelu
wywielga - kuhankeittäjä
wyż - korkeapaine
wzajemny - keskinäinen
wzdręga grecka - kreikansorva
ząb - hammas
żaba - sammakko
zabawka - lelu, leikkikalu
ząbek czosnku - valkosipulinkynsi
zachód - auringonlasku, länsi, vaiva
zachód księżyca - kuun lasku
zachód słońca - auringonlasku
zaćmienie - pimennys
zadanie domowe - kotitehtävä, läksy
zagadka - arvoitus
zaganiacz - kultarinta
żagiel - purje
żaglówka - purjevene
zaimek dzierżawczy - ossessiivipronominit
zakład karny - vankila
zakonnica - nunna
zakrystia - sakasti, sakaristo
żal - suru
zalany - humalassa
żałoba narodowa - maansuru
założyciel - perustaja
zamach stanu - vallankaappaus
zamieć - tuisku, lumimyrsky
zamknąć - sulkea
zapad - auringonlasku, länsi, vaiva
zapalenie płuc - keuhkokuume
zarodek - sikiö
żart - vitsi, pila, kuje, kepponen
zaskroniec - rantakäärme
zastrużka - kynänteroitin
zatoka - lahti
Zatoka Botnicka - Pohjanlahti
Zatoka Fińska - Suomenlahti
zawilec - vuokko
zawór bezpieczeństwa - varoventtiili
zawsze - aina
zawżdy - aina
zazwyczaj - tavallinen
zbieg okoliczności - yhteensattuma
zbrodnia - rikos
zbroja - haarniska
zdrowie - terveys
zdrowy - hyvinvoipa, terve, terveellinen
zdrzadło - peili, kuvastin
źdźbło - korsi
ździebluchno - vähän, hiukan
że - että
zebra - seepra
żec - polttaa
zegar - kello
zegarek - kello
zegarmistrz - kelloseppä
zegar słoneczny - aurinkokello
żegleń - hiili
żelazko - silitysrauta
żelazo - rauta
żelazobeton - teräsbetoni
żelbet - teräsbetoni
żeliwo - valurauta
zelter - mineraalivesi
zelżywość - häpeä
żeńczyna - nainen
Zenon - Zenon
żeń-szeń - ginseng
zespół - ryhmä, yhtye, oireyhtymä
zespół kanał kanału nadgarstka - rannekanavaoireyhtymä
zespół napięcia przedmiesiączkowego - premenstruaalisyndrooma, kuukautisia edeltävä oireyhtymä
zespół Sjögrena - Sjögrenin oireyhtymä, Sjögrenin syndrooma
zez - karsastus
żgak - säle
żgok - säle
zicherka - hakaneula
zięba - peippo
zielarstwo - kasvilääkintä, herbalismi
ziele angielskie - maustepippuri
zielnik - kasvikokoelma
zielony - vihreä
zielony ludzik - pieni vihreä mies, pieni vihreä ukkeli
Ziemia Franciszka Józefa - Frans Joosefin maa
Ziemia Północna - Severnaja Zemlja
ziemniak - peruna
ziemnokraska - marhi
ziewnięcie - haukotus
żigolo - gigolo
zima - talvi
zimno - kylmä
zimorodek - kuningaskalastaja
ziołosiek - silpoja
zjeżdżalnia - liukumäki
zlew - tiskiallas
złodziej - varas
złoto - kulta
złoty środek - kultainen keskitie
zmęczenie - väsymys
żmija - kyy
zmywacz do paznokci - kynsilakanpoistoaine
znachor - puoskari
znaczenie - merkitys
znajomy - tuttu
znak drogowy - liikennemerkki
znak wodny - vesileima
znak zapytania - kysymysmerkki
żołądek - maha, vatsa
żółć - keltainen
żółtaczka - keltaisuus
żółtko - keltuainen
żółty - keltainen
żółw - kilpikonna
żołwica - käly
żółw lamparci - leopardikilpikonna
żona - vaimo
żongler - jonglööri
zoo - eläintarha
zoofilia - zoofilia
zoofobia - zoofobia
zoolatria - eläintenpalvonta, zoolatria
zoologia - eläintiede
zooplankton - eläinplankton
zorza polarna - revontulet
z powrotem - takaisin
źrenica - silmä
źródło - lähde
ZSRR - SNTL
zszywacz - nitoja
żubr - visentti
ZUM - VTI
zupa - keitto
żuraw biały - lumikurki
żurawina - amerikankarpalo, pensaskarpalo
żurnal - aikakauslehti
żurnalista - toimittaja, lehtimies, journalisti
Zurych - Zürich
Związek Socjalistycznych Republik Radzieckich - Sosialististen Neuvostotasavaltojen Liitto
zwierciadło - peili, kuvastin
zwierzak - eläin, elukka
zwierzę - eläin, elukka
zwierzę domowe - kotieläin
zwłoki - ruumis
zwycięski - voitollinen, voitokas, voittoisa
zymft - sinappi
żyrafa - kirahvi
żywe srebro - elohopea
żywić - syödä
