AA - США (Спільнота анонімних алкоголіків)
Aaron - Аарон
abat - абат m
abazja - абазія f
abażur - абажу́р m
abażurek - абажурчик m
abchaski - абхазький
Abchaz - абхаз m
Abchazja - Абхазія f
Abchazka - абхазка f
abecadlny - алфавітний
abecadło - азбука f, абетка f, алфавіт m
abecadłowy - алфавітний
Abel - Авель m
abfal - аномалія f
Abidżan - Абіджан m
abiecadło - азбука f, абетка f, алфавіт m
Abisynia - Абісинія f
Abisynka - ефіопка f
abisyński - абіссінський
abiturient - абітурієнт m, випускник m
ablegierek - дитина f
abo - або
abolicjonizm - аболіціонізм m
abonament - абонемент m
aborygen - абориген m
Abram - Абрам m
abrogacja - аброгація f
ABS - АБС
absolut - абсолют m
absolutny - абсолютний
absorbent - абсорбент m
absorber - абсорбер m
absorpcja - абсорбція f
abstrakt - абстракт m
Abwehra - Абвер
abwera - Абвер
aby - аби, щоб
aceton - ацетон m
acetylen - ацетилен m
ach - ах, ох
Achilles - Ахілл m
achromat - ахромат m
Ada - Ада f
Adam - Адам m
adamaszek - дамаск m
Addis Abeba - Аддис-Абеба f
Adelajda - Аделаїда f
adiabata - адіябата f
adipocyt - адипоцит
administracja - адміністрація f
administrator - адміністратор m
administrowanie - адміністрування n
admirał - адмірал m
Adolf - Адольф m
Adonis - Адоніс m
adrenalina - адреналін m
adres - адреса f
adresować - адресувати
Adrian - Адріан m
Adriana - Адріана f
Adriatyk - Адріатика f
adwentnik - грудень m
adwokat - адвокат m
aeracja - аерація f
aerobik - аеробіка f
aerodrom - аеродром m, летовище n
aerodynamiczny - аеродинамічний
aerometr - аерометр m
aeroplan - літак m
aerostat - аеростат m
afa - мавпа
afekt - афект m
afektacja - афектація f
afera - афера f
aferzysta - аферист m
aferzystka - аферистка f
Afgańczyk - афганець m
afgani - афгані
afganiec - афганець m
Afganistan - Афганістан m
Afganka - афганка f
afisz - афіша f
afiszować - афішувати, афішуватися
aforyzm - афоризм m
Afroamerykanin - афроамериканець m
Afrodyta - Афродіта f
afront - афронт m
Afryka - Африка f
Afrykańczyk - африканець m
Afrykanin - африканець m
Afrykanka - африканка f
afrykański - африканьский
agat - агат m
Agata - Агата f
agawa - агава f
AGD - битова техника
agentura - агентура f
agitator - агітатор m
agnostycyzm - агностицизм m
agnostyczny - агностичний
agnostyk - агностик m
agorafobia - агорафобія f
agrarny - аграрний, земельний
agregat - агрегат
agresja - агресія f
agresor - агресор m
agrest - аґрус m
agrestówka - аґрусівка f
agrestowy - аґрусовий
agronom - агроном m
agronomia - агрономія f
Agrypina - Агрипина f
ahistoryzm - антиісторизм m
ajatollah - аятола m
akacja - акація f
akalkulia - акалькулія f
akceptacja - акцептування n
akcjonariusz - акціонер m
akomodacja - акомодація f
akompaniament - акомпанемент m
akompaniator - акомпаніатор m
akompaniatorka - акомпаніаторка f
akonit - аконіт m
akord - акорд m
akordeon - акордеон m
akordeonista - акордеоніст m
akordeonistka - акордеоністка f
akr - акр m
Akra - Аккра f
akrobatka - акробатка f
aksjomat - аксіома f
akson - аксон m
akt - акт m
aktorka - актриса f
aktualizacja - актуалізація f
aktyn - актиній m
aktywność - активність f
aktywować - активувати
akumulator - акумулятор m
akupunktura - акупунктура f
akuszer - акушер m
akuszeria - акушерство n
akuszerka - акушерка f
akuzatyw - знахідний відмінок m
akwamaryn - аквамарин m
akwamaryna - аквамарин m
akwarium - акваріум m
akwedukt - акведук m
Akwizgran - Аахен m
Alabama - Алабама f
alabaster - алебастр m
Alaska - Аляска f
Albańczyk - албанець m
Albania - Албанія f
Albanka - албанка f
albański - албанський
albatros - альбатрос m
Albert - Альберт m
Alberta - Альберта f
albinizm - альбінізм m
albinos - альбінос m
albo - або
alchemia - алхімія
alegoryczny - алегоричний
aleja - алея f, проспект m
Aleksander - Олександр m
alergen - алерген m
alergia - алергія f
alergiczny - алергічний
alergologia - алергологія f
alfa - альфа f
alfabet - алфавіт m, абетка f
alfabetu - алфавіт m, абетка f
alfabetyczny - алфавітний
Alfons - Альфонс m
Alfred - Альфред m
algebra - алгебра f
algebraiczny - алгебраїчний
algida - проститутка f
Algier - Алжир m
algierczyk - алжірець m
Algierczyk - алжірець m
Algieria - Алжир m
algierka - алжірка f
Algierka - алжірка f
algierski - алжирський
Algol - алгол m
algorytm - алгоритм m
alibi - алібі n
aligator - алігатор m
Alina - Аліна f
aliteracja - алітерація f
Alkantara - Алькантара f
alkohol - алкоголь m
alkoholizm - алкоголізм m
Allach - Аллах m
Allah - Аллах m
allegretto - алеґрето n
alleluja - алілуя
almanach - календар m
aloesowy - алоевий
alpinista - альпініст m
alpinizm - альпінізм m
Alpy - Альпи
alt - альт m
Ałtaj - Алтай m
ałtajski - алтайський
altruizm - альтруїзм m
aluminium - алюміній m
Alzacja - Ельзас
amajza - мураха f
amant - аматор m
Amazonia - Амазонія f
amazonit - амазоніт
Amazonka - Амазонка f
ambasada - посольство n, амбасада f
ambirz - імбир m
ambona - амвон m
Ambroży - Амвросій m
ameba - амеба f
Ameryka - Америка f
Ameryka Łacińska - Латинська Америка f
Amerykanin - американець m
amerykanista - американіст m
amerykanizacja - американізація f
amerykanizm - американізм m
Amerykanka - американка f
amerykański - американський
Ameryka Północna - Північна Америка f
Ameryka Południowa - Південна Америка f
Ameryka Środkowa - Центральна Америка f
ametyst - аметист
ametystowy - аметистовий
amfibia - амфібія f
amfiteatr - амфітеатр m
amfora - амфора f
amikoszoneria - амікошонство n
aminokwas - амінокислота f
Amman - Амман m
amnestia - амністія f
amnestyja - амністія f
amoniak - амоніак m
amoralizm - аморалізм m
amorficzny - аморфний
Amos - Амос m
amper - ампер m
ampułka - ампула f
amputacja - ампутація f
Amsterdam - Амстердам m
amsterdamski - амстердамський
Amu-daria - Амудар'я
amulet - амулет m
Amur - Амур m
anachoreta - анахорет m
anachroniczny - анахронічний
anachronizm - анахронізм m
anakonda - анаконда f
analityczny - аналітичний
analizować - аналізувати
analogia - аналогія f
analogiczny - аналогічний
ananas - ананас m, ананас
anarchista - анархіст m
anarchizm - анархізм
Anastazja - Анастасія f
Anatol - Анатоль m
Anatolia - Анатолія f
anatom - анатом m
anatomiczny - анатомічний
Andaluzja - Андалузія f
Andora - Андорра f, Андора f
andrologia - андрологія
Andromeda - Андромеда
Andrychów - Андрихув
Andrzej - Андрій m
Andy - Анди
andyjski - андійський
aneksja - анексія f
anektować - анексувати
anemia - анемія f
anestetyk - анестетик m
anestezjolog - анестезіолог m
Angelika - Анжеліка f
Angielka - англійка f
angina - ангіна f
angiografia - ангіографія f
angiologia - ангіологія f
Anglia - Англія f
anglicyzm - англіцизм m
Anglija - Англія f
Anglik - англієць m
anglikanin - англіканець m (anglìkanecʹ)
anglomania - англоманія f
angol - англієць m
Angol - англієць m
Angola - Ангола f
Angolczyk - анголець m
Angolijczyk - анголець m
Angolijka - анголка f
angolijski - ангольський
Angolka - анголка f
angolski - ангольський
angryst - аґрус m
angstrem - ангстрем
anielski - ангельський
anilina - анілін m
animista - аніміст m
animizm - анімізм m
anioł - ангел m
Anioł Stróż - ангел-охоронець m
anion - аніон m
Anita - Аніта f
aniżeli - низький атмосферний тиск m, низовина f, ніж
anjoł - ангел m
Ankara - Анкара f
ankarski - анкарський
Anna - Анна f
Annopol - Аннополь
anoda - анод m
anomalia - аномалія f
anonim - анонім m, анонімка f
anonimowość - анонімність f
anonimowy - анонімний
antagonista - антагоніст m
antagonistka - антагоністка f
antagonistyczny - антагоністичний
antagonizm - антагонізм m
Antananarywa - Антананаріву n
Antares - Антарес
Antarktyda - Антарктида f
antena - антена f
Antigua i Barbuda - Антигуа і Барбуда f
antologia - антологія f
antologie - антологія f
antonim - антонім m
Antonina - Антоніна f
antrakt - антракт m
antrejka - ґанок m
antropofagia - антропофагія f
antropolog - антрополог m
antropologia - антропологія f
antropologiczny - антропологічний
antropomorfizm - антропоморфізм m
Antwerpia - Антверпен m
antybiotyk - антибіотик m
antyczny - античний
antydepresant - антидепресант m
antyfaszysta - антифашист m
antyfaszyzm - антифашизм m
antygen - антиген m
antyk - антик m
antykomunista - антикомуніст m
antykwariat - антикваріат m
antykwarnia - антикваріат m
Antyle Holenderskie - Антильські острови, Нідерландські Антильські острови
antylopa - антилопа f
antynomiczny - антиномічний
antypatia - антипатія f
antysemicki - антисемітський
antysemita - антисеміт m
antysemitka - антисемітка f
antysemityzm - антисемітизм m
anulować - анулювати
anyż - аніс m
anyżek - аніс m
aorta - аорта f
aparat - апарат m
apatia - апатія f
apeniński - апеннінський
Apeniny - Апенніни
apetyczny - апетитний
apetyt - апетит m
apetyt rośnie w miarę jedzenia - апетит приходить під час їжі, апетит з їдою прибуває
Apolinary - Аполлінарій m
Apollo - Аполлон m
Apolonia - Аполлонія f
apostoł - апостол m
apostrof - апостроф m
Appalachy - Аппалачі
aprobata - апробація f
aprykoza - абрикос m
apryl - квітень m
apryl-apryl - День сміху m, День усіх дурнів m
apsyda - апсида f
apteczka - аптечка f
aptek - аптека f
apteka - аптека f
aptekarz - аптекар m
ar - ар
Arab - араб m
Arabia - Аравія f
Arabia Saudyjska - Саудівська Аравія
arabski - арабський
arabus - араб m
arachnologia - арахнологія f
arakowy - араковий
Ararat - Арарат m
arbiter - арбітр m
arboretum - арборетум m
arbuz - кавун m
archaiczny - архаїчний
Archangielsk - Архангельськ m
archanioł - архангел m
archeologia - археологія f
archimandryta - архімандрит m
archipelag - архіпелаг m
architekt - архітектор m
architektoniczny - архітектурний, архітектонічний
architektonika - архітектоніка f, архітектура f
architektoński - архітектурний, архітектонічний
architektura - архітектура f
architraw - архітрав m
arcybiskup - архієпископ m
areał - ареал m
arena - арена f
areopag - ареопаг m
arfa - арфа f
Argentyna - Аргентина f
Argentyńczyk - аргентинець m
Argentynka - аргентинка f
argentyński - аргентинський
argon - аргон m
argumentacja - аргументація f
aria - арія f
Ariadna - Аріадна f
arkada - аркада f
arka Noego - Ноїв ковчег
Arktyka - Арктика f
arlekinada - арлекінада f
armada - армада f
Armenia - Вірменія
Arnold - Арнольд m
aromaterapia - ароматотерапія f
arsen - арсен m
arsenał - арсенал m
arteria - артерія f
arteterapia - арт-терапія f
Artur - Артур
artykuł - стаття f, артикул m, товар m, продукт m, параграф m
artykuły gospodarstwa domowego - битова техника
artyleria - артилерія f
artyleryjski - артилерійський
artysta - артист m, художник m, мистець m
artystyczny - артистичний, художній, мистецький
Aryjczyk - арієць m
aryjski - арійський
arystokrata - аристократ m
arystokratka - аристократка f
arytmetyka - арифметика f
as - ас m
asceta - аскет m
ascetyczny - аскетичний
asfalt - асфальт m
asfaltować - асфальтувати
asfaltowy - асфальтний, асфальтовий
Asmara - Асмара f
asortyment - асортимент m
aspekt - аспект m, вид m
aspiryna - аспірин m
Astana - Астана f
aster - айстра f
asteroida - астероїд m
astma - астма f
astma oskrzelowa - астма бронхіальна f
astmatyczka - астматичка f
astmatyk - астматик m
astralny - астральний
astrofizyka - астрофізика f
astrograf - астрограф m
astrolabium - астролябія f
astrolog - астролог m
astrologia - астрологія f
astrologiczny - астрологічний
astrologio - астрологія f
astronauta - астронавт m
astronautyka - астронавтика f
astronom - астроном m
astronomia - астрономія f
astronomiczny - астрономічний
astronomio - астрономія f
asygnata - асигнація f
asymetryczny - асиметричний
Asyria - Ассирія
atak - атака f, напад m, припадок m, приступ m, атака
atak serca - серцевий напад
atandzić - стріляти
atawistyczny - атавістичний
atawizm - атавізм m
ateista - атеїст m
ateistka - атеїстка f
ateistyczny - атеїстичний
ateizm - атеїзм m
atencja - увага f, примітка f, зауваження f
ateńczyk - афінянин m
atenka - афінянка f
ateński - афінський
Ateny - Афіни
ateusz - атеїст m
Atlantyk - Атлантичний океан m
atlas - атлас m
atłas - атлас m
atleta - атлет m
atletka - атлетка f
atleto - атлет m
atletyka - атлетика f
atmosfera - атмосфера f
atmosferyczny - атмосферний
atol - атол m
atom - атом m
atrium - атріум m
atrofia - атрофія f
attyka - аттик m
audiencja - аудієнція f
audytorium - аудиторія f
Augiasz - Авгій m
August - Август m
Augusta - Августа f
Augustyn - Августин m
aukcja - аукціон m
aura - аура f
Aurelia - Аврелія f
Aurora - Аврора f
Australia - Австралія f
Australijczyk - австралієць m
Australijka - австралійка f
australijski - австралійський
Austria - Австрія f
austriacki - австрійський
Austriaczka - австрійка f
Austriak - австрієць m
aut - аут m
autobana - автострада f
autobus - автобус (avtobus) m
autobusowy - автобусний
autokar - туристичний автобус m, автокар m
autoklaw - автоклав m
autokracja - автократія f
automobilista - автомобіліст m
autonomia - автономія f
autonomiczny - автономний, автономічний
autoportret - автопортрет m
autostrada - автострада f
awangardowy - авангардний
awatar - аватар m
awokado - авокадо n, алігаторова груша f, персея американська f
aż - аж, поки, поки не
Azerbejdżan - Азербайджан m
Azerbejdżanin - азербайджанець m
Azerbejdżanka - азербайджанка f
azerbejdżański - азербайджанський
Azja - Азія f
Azja Mniejsza - Мала Азія f
Azjata - азіат m, азієць m
Azjatka - азіатка f, азійка f
azjatycki - азіатський, азійський
Azory - Азорські острови
azot - азот m
Azow - Азов m
B - знахідний відмінок m
Baba Jaga - Баба-яга f
baba z wozu, koniom lżej - баба з воза, кобилі легше, баба з воза, коням легше, баба з воза, возові легше
babcia - бабуся f
babie lato - бабине літо n
Babilon - Вавилон m
babka - бабуся f
bać się - боятися
bać się jak diabeł święconej wody - боятися як чорт свяченої води, боятися як чорт ладану, боятися як дідько ладану
bać się jak ognia - боятися як вогню
bać się o swoją skórę - боятися за свою шкуру, дрижати за свою шкуру, тремтіти за свою шкуру
Badenia-Wirtembergia - Баден-Вюртемберг
bądź - або
bagażnik - багажник m
Bagdad - Багдад m
bagienny - багнистий, болотистий
bagietka - французький багет
bagno - багно n, болото n
Bahamy - Багамські Острови
Bahrajn - Бахрейн m
Bairiki - Баїрикі n
bajer - брехливість
bajka - казка, байка f
Bajkał - Байкал m
bajtel - дитина f
bajura - болото n, грязь f
bajzel - публічний дім m, публічний будинок m
bąk - джміль m
bakałarz - вчитель m
bakłażan - баклажан m
bakteriobójczy - бактерицидний
bakteriolog - бактеріолог m
bakteriologia - бактеріологія f
bakteryjny - бактерійний
Baku - Баку
bala - м'яч m
bałaguła - зануда m
balkon - балкон m
balneoterapia - бальнеотерапія f
balon - аеростат m
balsam - бальзам m
Bałtyk - Балтійське море
bałwan - сніговик m, снігова баба f, ідол, кумир m, бовдур m
Bamako - Бамако n
bambus - бамбук
bana - поїзд m, потяг m, трамвай
banan - банан m
banana - банан m
bandaż - бандаж m, бинт m, пов'язка f
banderowiec - бандерівець m
Bandżul - Банджул
Bangladesz - Бангладеш
bania - гарбуз m, голова
baniak - голова
banka - трамвай
bańka - бідон m, булька, банька f, пузир m
bankowy - банківський
bankructwo - банкрутство n, неплатоспроможність f
bankrut - банкрот
baptyzm - баптизм m
bar - барій m
barabola - картопля f
baran - баран m
Baran - Овен
baranina - баранина f
Barbados - Барбадос
barbadoski - барбадоський
bardyzana - алебарда f
bardzo - дуже, вельми, більш
barter - бартер
Bartłomiej - Варфоломій m
barwa - колір m, фарба f
barykada - барикада f
barzej - дуже, вельми, більш, багато
barzoł - багно n, болото n
basetla - басоля f
baśń - казка f
batki - труси
batłąch - пляшка f
batrachologia - батрахологія f
batymetria - батиметрія
bazar - ринок m
Bazylea - Базель
bebech - шлунок m
bęben - барабан m
beczeć - плакати
beczka - бочка f
bednarz - бондар m
bejm - гроші
bejrucki - бейрутський
Bejrut - Бейрут m
bekerel - беккерель m, Бк, Bq
belfer - вчитель m
Belg - бельгієць m
Belgia - Бельгія f
Belgijka - бельгійка f
belgijski - бельгійський
Belize - Беліз m
belizeński - белізійський
Belmopan - Бельмопан
Benin - Бенін
berbela - горілка f
berbelucha - самогон, сивуха, первак
berberys - барбарис
berga - камінь m
berkel - берклій m, беркелій m
Berlin - Берлін m
berlińczyk - берлінець m
berlinianka - берлінка f
berlinka - берлінка f
berliński - берлінський
Bermudy - Бермудські острови
beryl - берилій m, берил m
Beskidy - Бескиди
bezalkoholowy - безалкогольний
bezbożnik - атеїст m
bezdzietność - бездітність f
bezdzietny - бездітний
bezhołowie - безлад m, непорядок m, розгардіяш m
bezimienny - безіменний
bezinteresowny - безкорисливий
bezkrytyczny - некритичний
bezludny - безлюдний
bezmózgi - безмозкий
beznadziejny - безнадійний
bezokolicznik - інфінітив m
bezosobowy - безособовий, безлюдний
beżowy - бежевий
bezpośredni - безпосередній
bezpotomność - бездітність f
bezwstydny - безсоромний
bezzębny - беззубий
Bhutan - Бутан
białaczka - білокрів'я f
biała gorączka - біла гарячка f
biała herbata - білий чай
Białogród - Акерман m
Białoruś - Білорусь f
Białorusin - білорус m
Białorusinka - білоруска
białoruski - білоруський
biały - білий
Biblia - Біблія
biblioteka - бібліотека
bić się w piersi - бити себе в груди, битися в груди
bić w dzwony na trwogę - бити тривогу, бити на сполох, бити на ґвалт
biedronka - сонечко n
bieg - біг m, біг, хід m, течія f
biegunka - пронос m
biernik - знахідний відмінок m
bieszczadzki - вещадський
bilet - квиток (kwitok)
bilion - більйон
bilirubina - білірубін m
bimba - трамвай
bimber - самогон, сивуха, первак
bimbrowniczy - самогонний
binder - краватка f
bindka - краватка f, бандаж m, бинт m, пов'язка f
binia - дівчина f
biofilm - біоплівка f, біофільм m
biografia - біографія f
biograficzny - біографічний
biologia - біологія f
biologiczny - біологічний
Birma - Бірма f
birr - бир
biskup - єпископ m
Bissau - Бісау
Biszkek - Бішкек m
bita śmietana - збиті вершки
biurko - письмовий стіл m
biuro - о́фіс m
biurokracja - бюрократизм m, бюрократія f
biust - погруддя
bizmut - вісмут m
biznes - бізнес m
biznesmen - бізнесмен m
blady jak chusta - білий як хустка, блідий як хустка
blady jak śmierć - блідий як смерть
bladź - проститутка f
blaga - брехливість
błecha - блоха f
błękitny - голубий, блакитний
bliski - близький
Bliski Wschód - Близький Схід m
blisko - близько
blizna - рубець m, шрам m
Bliźnięta - Близнята
błona śluzowa - слизова оболонка f
błota - болото n
błotka - плітка f
błoto - болото n, грязь f
blumkol - цвітна капуста f
bluszcz - плющ m
bo - бо (bo), тому (tomu), тому що (tomu ščo), так як (tak jak), оскільки (oskil’ky), адже (adže), внаслідок (vnaslidok), унаслідок (unaslidok)
boba - марихуана f
bóbr - бобер m
bocian - лелека m
bóg - бог m
Bóg - Бог m
Bogarodzica - Богородица f
Bogota - Богота f
Bogurodzica - Богородица f
Bohemia - Чехія f, Богемія f
bohr - борій m
bojtel - мішок m, виступ m
ból - біль m
boleć - боліти
boliviano - болівіано
Boliwia - Болівія f
Boliwijczyk - болівієць m
Boliwijka - болівійка f
boliwijski - болівійський
bolszewicki - більшовицький
bolszewik - більшовик m
bomba atomowa - атомна бомба f
bombel - дитина f
bómbón - цукерка f
bonsai - бонсай m
bor - бор
bordo - бордовий
bordowy - бордовий
Bornholm - Борнгольм m
borowik szlachetny - білий гриб m
borowina - грязь, боровинка
borówka - чорниця f, щока f, ляпас m
borówka bagienna - буяхи, лохина f, пя́ниця f, голубиця f, гнобобель m
borsuk - борсук m
Borys - Борис
Bośnia - Боснія f
Bośnia i Hercegowina - Боснія і Герцеговина
bot - чобіт m
botanika - ботаніка f
botek - чобіт m
Botswana - Ботсвана f
boża krówka - сонечко n
Boże Narodzenie - Різдво n
brachol - брат m
bracieniec - брат m
brak - брак m, недостаток m
bramkarz - воротар m, голкіпер m
brat - брат m
bratobójstwo - братовбивство n
Bratysława - Братислава f
bratysławski - братиславський
brązowy - коричневий
Brazylia - Бразилія f
brazyliana - кавове дерево n, кава f
Brazylijczyk - бразилець m
Brazylijka - бразилійка f
brazylijski - бразильський
brele - окуляри
briftreger - листоноша (lystonoša)
bród - брід m
broda - борода f
broń - Зброя
broń atomowa - атомна зброя f
broń biała - холодна зброя f
broń biologiczna - біологічна зброя
Bronisław - Броніслав m
broń palna - вогнепальна зброя f
browar - пиво n
browarz - пивовар m
brud - бруд m
Bruksela - Брюссель
brukselka - брюссельська капуста f
Brunei - Бруней m
brunet - брюнет m
brutalność - жорстокість f
brydż - брідж m
bryka - автомобіль m
bryle - окуляри
bryndza - бринза f
brzmienie - звук
brzoskwinia - персик m
buc - хуй m
buchalter - бухгалтер m, бухгалтерський
buda - школа f
Budapeszt - Будапешт
buddysta - буддист m
buddystka - буддистка f
buddyzm - буддизм m
budować - будувати
Bug - Буг m, Західний Буг m
buk - бук m
bukinista - букініст m
buła - булка f, м'яз, мускул m
bułat - булат m
bulba - картопля f
Bułgar - болгарин m
Bułgaria - Болгарія f
Bułgarka - болгарка f
bułgarski - болгарський
bulimia - булімія f
bułka - булка f, м'яз, мускул m
bulwa - картопля f
buńczuk - бунчук
bundz - бундз m
bunt - бунт m
burak - буряк m
burdel - бордель m
burdynek - дуель f
Burgundia - Бургундія f
Burkina Faso - Буркіна-Фасо f
Burundi - Бурунді f
burundyjski - бурундійський
burza - буря f, гроза f, громовиця f
burzowiny - пиво n
but - чобіт m, черевик m
butelka - пляшка f
buzi - поцілунок m
Bużumbura - Бужумбура
być - бути
być solą w oku - бути сіллю в оці (кому)
być w siódmym niebie - бути на сьомому небі
Bydgoszcz - Бидгощ
bydło - худоба f
Byk - Телець
Była Jugosłowiańska Republika Macedonii - Колишня Югославська Республіка Македонія
bynajmniej - анітрохи, зовсім ні
C - приціл m, давальний відмінок m
cacanka - цяцянка f, цяцька f
cajtung - газета f
całus - поцілунок m
cdn. - далі буде
cebula - цибуля, цибулина f
cedi - седі
celownik - приціл m, давальний відмінок m
centurion - кентуріон m, центуріон m
centymetr - сантиметр m
cepeen - автозаправна станція, АЗС
cera - дочка f
ceremoniarz - церемоніарій m
cerkiew - церква f
cesarskie cięcie - кесарів розтин m
cewka moczowa - сечовипускний канал
cewnik - катетер m
cez - цезій
chabanina - м'ясо n
chabas - м'ясо n
chamera - хмара f
charczeć - хропіти
Charków - Харків m
chcieć - хотіти
Chełm - Холм
chemia - хімія f
chemiczny - хімічний
chemioterapia - хіміотерапія f
chemoterapia - хіміотерапія f
Chile - Чилі f
Chilijczyk - чилієць m
Chilijka - чилійка f
chilijski - чилійський
Chińczyk - китаєць m
Chinka - китаянка f
chiński - китайський
Chiny - Китай m
chira - горілка f
chiropterologia - хіроптерологія f
chlać - пити
chleb - хліб m
chlebak - речовий мішок m
chłód - холод m
chłodny - холодний
chłopiec - хлопець m
chłopomania - хлопома́нство
chłopyszek - хлопець m
chlor - хлор m
chlorofil - хлорофіл m
chmiel - хміль m, пиво n
chmura - хмара f
choćby - наприклад
chocieć - хотіти
chód - крок m
chodzić - ходити
choinka - ялинка
chójk - ялинка
chojna - сосна f
cholesterol - холестерин m
chomik - хом'як m
chór - хор m
choroba - хвороба
choroba morska - морська хвороба f
choroba Parkinsona - хвороба Паркінсона f
chorobotwórczość - патогенність f
Chorwacja - Хорватія
chorwacki - хорватський
Chorwat - хорват m
Chorwatka - хорватка f
chrapać - хропіти
chrom - хром m
chromosfera - хромосфера f
chromosom - хромосома f
chruścik - волохокрилець, джерельник
chrystianizacja - християнізація f
chrystianizm - християнство n
Chrystus - Христос m
chrząstka - хрящ m
chrześcijanin - християнин m
chrześcijanka - християнка f
chrześcijański - християнський
chrześcijaństwo - християнство n
chudy - худий
chuj - хуй m
chuśle - скрипка f
chwost - хвіст m
chyba - хіба
ciąg dalszy nastąpi - далі буде
ciało obce - сторонне тіло n, чужорідне тіло n
ciało szkliste - скловидне тіло n, склисте тіло n
ciapryka - болото n, грязь f
ciasnocha - сорочка f
ciasto - тісто n, пиріг m
ciąża - вагітність f
cicha woda brzegi rwie - тиха вода греблю рве
ciebie - ти, Ви
ciekawość - цікавість f
cień - тінь
ciepać - кидати
ciepło - теплота f
ciepły - теплий
ciga - коза f
cios - удар m
cios poniżej pasa - удар нижче пояса
ciotka - тітка f
cipka - курка f
cis - модрина f
ciśnienie - тиск
ciśnienie krwi - кров'яний тиск
cisza jak makiem zasiał - тихо, хоч мак сій
ciupa - в'язниця
ciupaga - бартка
ciurma - в'язниця
ciżma - чобіт m, черевик m
ćma - проститутка f
ćmaga - горілка f
cmentarz - кладовище n, цвинтар m
ćmić - палити, курити, топити
ćmik - сигарета f, цигарка f, папіроса f
co - що, кожний, кожен
cokolwiek - абищо
colon - колон m
córa - дочка f
córczysko - дочка f
córka - дочка f
cos - cos
ćpać - їсти, кидати
ctg - ctg
cudzokrain - іноземець m
cudzoziemiec - іноземець m
cug - поїзд m, потяг m
cukier - цукор
cukierek - цукерка f
cukinia - кабачок m
cukrowiec lekarski - цукрова тростина f, (cukróva trostýna)
cukrzyca - діабет m, цукрова хвороба
ćwierć - чверть
ćwierćfinał - чвертьфінал m
ćwikła - цвіклі
cyferblat - обличчя n, лице n
cyga - джміль m
Cygan - циган m
cygański - циганський
cygareta - сигарета f, цигарка f, папіроса f
cygaretka - сигарета f, цигарка f, папіроса f
cyklon - циклон m
cymes - цимес m
cyngiel - окуляри
cynizm - цинізм m
cynk - цинк m
cypel - виступ m
Cypr - Кіпр (Kipr)
Cypryjczyk - кіпріот m
Cypryjka - кіпріотка f
cypryjski - кіпріотський, кіпрський
cyrkiel - циркуль m
cyrkon - цирконій m
cytryna - лимон m, цитрина f
cytrynat - лимон m, цитрина f
Czad - Чад
czador - чадра f
czaj - чай m
czajnik - голова
czapla - чапля f
czarna dziura - чорна діра
czarna jagoda - чорниця f
czarna porzeczka - чорна смородина f
czarna skrzynka - чорна скринька f, чорний ящик m
Czarnogóra - Чорногорія f
czarny - чорний
czarny rynek - чорний ринок
czart - чорт m
czas - час m
czas niniejszy - теперішній час m
czasownik - дієслово n
czas przeszły - минулий час m
czas przyszły - майбутній час m
czas teraźniejszy - теперішній час m
czaszka - череп m
czciciel - шанувальник m
Czech - чех m
Czechosłowacja - Чехословаччина f
Czecho-Słowacja - Чехословаччина f
Czechy - Чехія f, Богемія f
czędo - дитина f
czekać - чекати, очікувати, вичікувати
czekolada - шоколад m
czeladź - челядь f
czemergies - самогон m, самогонка f
czemu - чому, навіщо
czereśnia - черешня f
czernica - чорниця f, ожина f
Czerniowce - Чернівці
czerwiec - червень m
czerwona kartka - червона картка f
czerwona porzeczka - червона смородина f
czerwony - червоний, комуніст m
cześć - привіт
część - частина, частка f
czeski - чеський
cześnia - черешня f
często - часто
częstoskurcz - тахікардія f
Czeszka - чешка f
człowiek - людина f
czoło - чоло n
czorny - чорний
czosnek - часник m
czuć - чути
czwartek - четвер m
czwartkowy - четверговий
czwartorzęd - Четвертинний період
czworo - четверо
czyhunka - торій m
czyli - або, чи
czyrwiec - червень m
czyrwień - червень m
czysło - число n
czytać - читати
czytelnik - чытач m
czytelny - читабельний
czyżyk - хлопець m
D - родовий відмінок m
dąb - дуб m
dach - дах m, покрівля f
dach nad głową - дах над головою m
dać po nosie - дати по носі
dać prztyczka w nos - дати щигля, дати носака
Dafne - Дафна f
Dagestan - Дагестан
daktyl - фінік m
dalasi - даласі
dalece - дуже, вельми, більш
Dalmacja - Далмація
Dania - Данія f
darowanemu koniowi w zęby się nie zagląda - дарованому коневі в зуби не дивляться
debil - дебіл m
debiut - дебют m
dedykacja - дедикація f
Dekan - Декан
dekiel - голова
deklamować - декламувати
dekolonizacja - деколонізація f
delfin - дельфін m
demografia - демографія f
demokracja - демократія f
Demokratyczna Republika Konga - Демократична Республіка Конго f
Demokratyczna Republika Wyspy Świętego Tomasza i Wysp Świętego Tomasza i Książęcej - Демократична Республіка Сан-Томе і Принсіпі
demokratyczny - демократичний
denar - денар m
dendrologia - дендрологія f
deportacja - депортація f
dereń - дерен, кизил
dermatolog - дерматолог m
dermatologa - дерматолог m
despota - деспот m
destabilizacja - розстабілізація f
deszcz - дощ m
deżdż - дощ m
dezinformacja - дезінформація f
diabeł wie - чорт його знає, дідько знає
diabetologia - діабетологія f
diagnoza - діагноз m
diament - алмаз m
diecezja - єпархія f, діоцез m
dietetyka - дієтологія f
difalia - дифалія f
dinar - динар m
dioda - діод
Diogenes - Діоген m, Діоген m (Синопський)
dla - для
dlaczego - чому, навіщо
długi - довгий
długo - довго
dłuto - долото n (doloto), стамеска (stameska) f
Dniepr - Дніпро n, Дніпр m
Dniestr - Дністер
doba - доба f
dobranoc - надобраніч, на добраніч, добраніч
dobry - добрий
dobry wieczór - добрий вечір
dobrze - добре
dogmatyzm - догматизм m
do góry nogami - вгору ногами, догори ногами
dokładność - акуратність f
doktor - лікар m
doktryna - доктрина f
doktryner - доктринер m
doktrynerski - доктринерський
doktrynerstwo - доктринерство n
dokument - документ m
dolar - долар m
dolarowy - доларовий
dolaryzacja - доларизація f
dolina - долина f
dolmen - дольмен
dom - дім m, будинок m
Dominika - Домініка f
Dominikana - Домінікана f
Dominikańczyk - домініканець m
Dominikanka - домініканка f
dominikański - домініканський
domowej roboty - домашній
dom publiczny - публічний дім m, публічний будинок m
domra - домра
Donieck - Донецьк m
dopełniacz - родовий відмінок m
doradca - радник m
doś - скільки, багато
dostać prztyczka w nos - отримати щигля по носу
dostojnik - сановник m
dostojny - достойний
do widzenia - до побачення
do zobaczenia - до побачення
dozorca - сторож m
dr - д-р
dram - драм
dramat - драма f
drapacz chmur - хмарочос, небосяг, хмародряп m
DRL - ДНР
droga - дорога f, шлях m
drogi - дорогий
Drohobycz - Дрогобич
drozd - дрізд m
druga wojna światowa - друга світова війна f
druh - друг m, приятель m, товариш m
drukarka - принтер
drwal - лісоруб m
drybling - дриблінг m
drzazga - тріска f
drzewo - дерево n
drzwi - двері
Dublin - Дублін
dubliński - дублінський
duch - дух m
dudlać - плакати, пити
Dunaj - Дунай
Duńczyk - датчанин m
Dunka - датчанка f
duński - датський
dureń - дурак m, дурень, глупак m, йолоп m
dureń do kwadratu - дурень у квадраті
durniacha - довірливий
durnica - буяхи, лохина f, пя́ниця f, голубиця f, гнобобель m
dusza - дух m
dutek - гроші
dużo - багато
dwoje - двоє
dwulicowość - дволичність f, двоєдушність f
dwulicowy - дволичний, двоєдушний, лицемірний
dychawica - астма f
dychawica oskrzelowa - астма бронхіальна f
dydaktyczny - дидактичний
dyktator - диктатор m
dymbcok - дуб m
dymisja - відставка f
dynamika - динаміка f
dynia - гарбуз m
dyplom - диплом m
dyplomata - дипломат m
dysfagia - дисфагія f
dysproz - диспрозій m
Dżakarta - Джакарта f
dziadek - дід, дідусь m
działo - га́убиця f, гарма́та f
dziąsło - ясна
Dżibuti - Джибуті
dżibutyjski - джибутійський
dzięcioł - дятел m
dzieciszczko - дитина f
dziecko - дитина f
dziegieć - дьоготь
Dzieje Apostolskie - Апостол m
dziękówa - дякую, спасибі
dziękówka - дякую, спасибі
dziękuję - дякую, спасибі
dziela - для
dzielić skórę na niedźwiedziu - ділити шкуру невбитого ведмедя
dzień - день m
dzień dobry - добридень, добрий день, доброго дня, доброго ранку
dziennikarstwo - журналістика f
dziennikarz - журналіст m
dziesięciolecie - десятиліття n
dziesięcioro - десятеро
dziewa - дівчина f
dziewczę - дівчина f
dziewczyna - дівчина f
dzik - кабан m
dzika karta - вайлд-кард m
dziób - ніс m
dziołcha - дівчина f
dziopa - дівчина f
dziś - сьогодні
dzisiaj - сьогодні
dżistać - пердіти
dziunia - дівчина f
dziura - печера f
dziurkacz - діркопробивач офісний m
dziurkacz biurowy - діркопробивач офісний m
dżungla - джунглі f
dzwonić na trwogę - бити тривогу, бити на сполох, бити на ґвалт
EBOiR - ЄБРР
EBOR - ЄБРР
Edirne - Едірне
efekt cieplarniany - парниковий ефект m
efektowny - ефектний
efekt szklarniowy - парниковий ефект m
Efialtes - Ефіальт m
Egipcjanin - єгиптянин m
Egipcjanka - єгиптянка f
egipski - єгипетський
egipskie ciemności - эгипетська тьма, эгипетська темінь, темно як у розі
Egipt - Єгипет m
egoizm - егоїзм m
egotyzm - самозакоханість f
egzamin - екзамен m
egzaminacyjny - екзаменаційний
egzaminować - екзаменувати
egzamin wstępny - вступний екзамен m
egzemplarz - зразок m
einstein - ейнштейній m
ejakulacja - еякуляція
ekistyka - екістика f
Eklezjastes - Екклезіаст m
ekologia - екологія f
ekologio - екологія f
ekosystem - екосистема
eksportować - експортувати
ekstaza - екстаз m
ekstrawagancki - екстравагантний
ekstremista - екстреміст m
ekstremistyczny - екстремістський
ekstremizm - екстремізм m
Ekwador - Еквадор m
Ekwadorczyk - еквадорець m
Ekwadorka - еквадорка f
ekwadorski - еквадорський
elastyczność - еластичність f, гнучкість f
elegancki - елегантний
elektroluks - пилосос m
elektryczność - електрика f
elektryczny - електричний
Emili - Емілія
Emilia - Емілія
emirat - емірат m
energia - енергія f
entomologia - ентомологія f
epidemia - епідемія f
epidemio - епідемія f
epoka - епоха f
era - ера f
erekcja - ерекція f
erotyka - еротика f
Erytrea - Еритрея f
Erywań - Єреван m
ESBC - ЄСЦБ
eschatologia - есхатологія f
eskalacja - ескалація f
eskalator - ескалатор m
eskimoski - ескімоський
eskulap - лікар m
estetyka - естетика f
Estończyk - естонець m
Estonia - Естонія f
Estonka - естонка f
estoński - естонський
etalon - еталон
Etiopczyk - ефіоп m
Etiopia - Ефіопія f
Etiopka - ефіопка f
etiopski - ефіопський
etologia - етологія f
etopozyd - етопозид m
etyka - етика f
etymologia - етимологія f
eufemizm - евфемізм m
Eurazja - Євразія f
euro - євро n
Europa - Європа f
Europejczyk - європеєць m
Europejka - європейка f
europejski - європейський
ewangelistarz - апракос
ewolucja - еволюція f
Ezop - Езоп m
fabryka - фабрика f
fabrykant - фабрикант m
facet - чоловік m
facetka - жінка f
fachowiec - фахівець m
facjata - обличчя n, лице n
fajans - дурень, глупак m, йолоп m
fajek - сигарета f, цигарка f, папіроса f
fajerwer - сигарета f, цигарка f, папіроса f
fajka - сигарета f, цигарка f, папіроса f
fajny - гарний
fakt - факт m
fanatyczny - фанатичний
fanatyk - фанатик m
fanatyzm - фанатизм m
fanfaron - фанфарон m
farad - фара́д m, Ф, F
farsa - фарс m
faryna - цукор
fasola - квасоля f
faszysta - фашист m
faszystowski - фашистський
faszyzm - фашизм m
fedrować - працювати
fefrać się - боятися
felinologia - фелінологія f
feministka - феміністка f
feministyczny - феміністичний
feminizm - фемінізм m
Fenicja - Фінікія f
Fenicjanin - фінікієць m, фінікіянин m
Fenicjanka - фінікійка f, фінікіянка f
ferska - персик m
fest - дуже, вельми, більш
festiwal - фестиваль m
fetor - сморід m
fezeła - бджола f
Fidżi - Фіджі
fidżyjski - фіджійський
filatelistka - філателістка f
filatelistyka - філателія f
filip - заєць m
Filipińczyk - філіппінець m
Filipinka - філіппінка f
filipiński - філіппінський
Filipiny - Філіппіни
filiżanka - ча́шка f
film - фільм m
filolog - філолог m
filozofia - філософія f
filozofia dziejów - філософія історії f
filozofia historii - філософія історії f
filozoficzny - філософський
Fin - фін m
finka - фінка f
Finka - фінка f
Finlandia - Фінляндія
finlandyzacja - фінляндизація f
finlandzki - фінський
fiński - фінський
fioletowy - фіолетовий, ліловий
fiut - хуй m
fizjolog - фізіолог m
fizjologia - фізіологія f
fizjologiczny - фізіологічний
fiżon - квасоля f
flanela - фланель f
flaszka - пляшка f
flecista - флейтист m
flecistka - флейтистка f
fleks - кутова шліфувальна машина
flep - документ m
flet - флейта f, хуй m
flet poprzeczny - поперечна флейта f
fliger - літак m
flirt - флірт m
fluor - фтор m
fogelka - атракціон m
fonetyka - фонетика f
fonologia - фонологія f
formuła - формула f
fort - фортеця (fortetsia) f
foryster - іноземець m
fosfor - фосфор m
franciszkanin - францисканець m
Francja - Франція f
francuski - французький
francuz - французький ключ m
Francuz - француз m
Francuzka - француженка f
frank - франк m
frans - францій m
frapujący - вражаючий
frazeologia - фразеологія f
frazeologiczny - фразеологічний
frazeologizm - фразеологізм m
frela - дівчина f
frutarianizm - фруктаріанство n
fryc - німець m
Fryc - німець m
fryzjer - перукар m
funkcja - функція f
funt - фунт m
fura - автомобіль m
furdygarnia - в'язниця
furosemid - фуросемід
furt - знову
fusbal - футбол m
futbol - футбол m
futbolista - футболіст m
fyrtel - кут m, куток m, точка зору
Gabon - Габон m
Gaborone - Габороне
gad - гад m
gadolin - гадоліній m
gal - галій m
gała - кулька f, головка f, ручка f, око, футбол m, крук m, ворон m, гайворон m, ворона, гава
galaktyka - галактика f
galancie - багато
Galia - Галлія f
Galicja - Галичина
Galilea - Галілея f
gałka - кулька f, головка f, ручка f
Gambia - Гамбія f
gambijski - гамбійський
gambit - гамбіт m
gameta - гамета
ganek - ґанок m
gapa - крук m, ворон m, гайворон m, ворона, гава
gara - сон m, сон, мрія f
garbaty - горбатий
gardło - горло n
gasa - вулиця f
gawron - гайворон m
gaz - газ m, педаль газу f, акселератор m
gazela - газель f
gazeta - газета f
gazociąg - газовід, газопровід, газотяг
Gdańsk - Ґданськ
gdyby - коли
Gdynia - Гдиня
gdyż - бо (bo), тому (tomu), тому що (tomu ščo), так як (tak jak), оскільки (oskil’ky), адже (adže), внаслідок (vnaslidok), унаслідок (unaslidok)
gdzie - де
gdzie diabeł nie może, tam babę pośle - де чорт не зможе, туди бабу пошле
gędźba - музика f
genetyczny - генетичний
genetyka - генетика f
Genewa - Женева f
genewczyk - женевець m
genewka - женевка f
genewski - женевський
geografia - географія f
geolog - геолог m
geologia - геологія
geologiczny - геологічний
geometria - геометрія f
geometryczny - геометричний
gepard - гепард m
geriatria - геріатрія f
german - германій m
germanizacja - германізація f
germański - німецький, німецький m
gęś - гуска f
getto - гетто n
Ghana - Гана f
gibki - швидкий
gibko - швидко
Gibraltar - Гібралтар m
giełd - біржа f
giełda - біржа f
giez - гедзь
giezło - сорочка f
ginekolog - гінеколог m
ginekologia - гінекологія f
gira - нога f
gitara - гітара f
gitarzysta - гітарист m
gitarzystka - гітаристка f
glajda - болото n, грязь f
glajza - торій m
glapa - гайворон m, ворона, гава
głaskać - гладити
glin - алюміній m
globalizacja - глобалізація f
globus - голова
głos - голос m
głowa - голова
glukometr - глюкометр m
głupi - дурний, безглуздий
głupiec - дурень, глупак m, йолоп m
głuszec - глухар m
gnat - кістка f
gniady - гнідий
gnot - дитина f
godać - говорити, казати
godka - промова f, язик m, мова f
godoć - говорити, казати
godz. - год.
Godzilla - Ґодзілла m
godzina - година f
godzinnik - годинник m
gołąb - голуб m
golarz - перукар m
golem - ґолем m, голем m
golibroda - перукар m
gołoledź - ожеледь f
gondola - гондола f
góra - гора f
górą - гора f
gorący - гарячий
góralek - даман
góra lodowa - айсберг m
górnik - шахтар
Górny Śląsk - Верхня Сілезія f
gorzała - алкоголь m
gorzałka - горілка f
gorzki - гіркий
gorzoła - горілка f
gość - гість m
gościna - гостина f
gościniec - гостинець m, готель m
gościnność - гостинність f
gościnny - гостинний
gotówka - готівка f
gotowy - готовий
gówno - гівно n
goździk - гвоздика f
graba - рука f
grać na nerwach - грати на нервах
grać pierwsze skrzypce - грати першу скрипку
grać w otwarte karty - грати з відкритими картами
gracz - гравець m
grad - град m
gram - грам m
gramatyka - граматика f
granatowy - темно-синій
grawiton - гравітон m
Grecja - Греція f
grecki - грецький
greckojęzyczny - грекомовний
Greczynka - гречанка f
Grek - грек m
greka - грецький
Grenada - Гренада f
grób - могила f
groch - горох m
grom - грім m
gronostaj - горностай m
grota - грот m
grubiański - грубий
grudzień - грудень m
gruszka - груша f
Gruzin - грузин m
Gruzinka - грузинка f
gruziński - грузинський
Gruzja - Грузія f
grycha - булка f
gryfny - гарний
gryka - гречка f
Grzegorz - Григорій m
grzesznica - грішниця f
grzeszny - грішний
Gujana - Гаяна f
guła - індик m
gularz - індик m
gulden - гульден
guli - бо (bo), тому (tomu), тому що (tomu ščo), так як (tak jak), оскільки (oskil’ky), адже (adže), внаслідок (vnaslidok), унаслідок (unaslidok)
Gustlik - Августин m
gwałt - насильство n, зґвалтування n, ґвалт m
Gwatemala - Гватемала f
gwatemalczyk - гватемалець m
Gwatemalczyk - гватемалець m
gwatemalka - гватемалка f
Gwatemalka - гватемалка f
gwatemalski - гватемальський
gwiazda - зоря, зірка f
gwiazdarz - астроном m, астролог m
gwiaździarz - астроном m, астролог m
Gwinea - Гвінея f
Gwinea Bissau - Гвінея-Бісау
Gwinea Równikowa - Екваторіальна Гвінея
Gwinejczyk - гвінеєць m
Gwinejka - гвінейка f
gwinejski - гвінейський
gwóźdź - цвях m
gżegżółka - зозуля f
gzub - дитина f
haczka - мотика f
hafn - гафній m
Haitańczyk - гаїтянин m
Haitanka - гаїтянка f
haitański - гаїтянський
Haiti - Гаїті f
hajtok - ніж m
hak - крюк m, гак m
haki - крюк m, гак m
halabarda - алебарда f
halibut - палтус m
halucynacja - галюцинація f
Hana - Гана f
handel - гендель m, торгівля f
handlowy - торго́вий, торгіве́льний
handszuły - рукавиця f
hara - горілка f
harcerstwo - бойскаутизм m
harfa - арфа f
harfista - арфіст m, арф'яр m
harfistka - арфістка f, арф'ярка f
harować jak wół - робити, як віл
hau - гав, дзяв
haubica - гаубиця
haw - туди, там
Hawana - Гавана f
hawerz - сапер m
hazard - азарт (azart)
hę - що, кожний, кожен
hedonizm - гедонізм m
hektar - гектар m
hektolitr - гектолітр m
hel - гелій m
Hellada - Греція f
Helsinki - Гельсінкі
hemisfera - півкуля f
heparyna - гепарин
herbarz - гербарій
herbata - чай m
hermafrodytyzm - гермафродитизм (germafroditizm)
Herod - Ірод m
heteroseksualizm - гетеросексуалізм m
hiacynt - гіацинт
hidżab - хіджаб m
higiena - гігієна f
hinduistka - індуска f
Hindus - індус m
Hinduska - індуска f
hipokryta - лицемір m
hipokryzja - лицемірство n
hipologia - гіпологія f
hirudoterapia - гірудотерапія f
histeryczka - істеричка f
historia - історія f
historiozofia - філософія історії f
Hiszpan - іспанець m
Hiszpania - Іспанія f
hiszpanka - іспанка f
Hiszpanka - іспанка f
hiszpański - іспанський
hiszpańskojęzyczny - іспаномовний
Hitler - Гітлер m
hitlerowiec - гітлерівець m
holajza - долото n (doloto), стамеска (stameska) f
Holandia - Нідерланди
Holandyja - Нідерланди
Holender - нідерландець m
Holenderka - нідерландка f
holm - гольмій m
Hołodomor - Голодомор m
holokaust - голокост m
homeopatia - гомеопатія f
homiletyka - гомілетика f
homoseksualizm - гомосексуалізм m
homoseksualny - гомосексуальний
Honduras - Гондурас
Hongkong - Гонконг
Honolulu - Гонолулу
hotel - готель
hrabia - граф m
hreczka - гречка f
hrywna - гривня f
Hucuł - Гуцул
humor - гумор m
hydraulik - тромбоніст m
hydrologia - гідрологія f
i - і, й, та
ich - їх
ichtiologia - іхтіологія f
idealistka - ідеалістка f
ideologia - ідеологія f
idiota - ідіот m
idiotka - ідіотка f
idiotyczny - ідіотичний, ідіотський
igrać z ogniem - грати з вогнем, бавитися з вогнем, жартувати з вогнем
II wojna światowa - друга світова війна f
ile - скільки
imbir - імбир m
imiesłów przymiotnikowy bierny - пасивний дієприкметник
imiesłów przymiotnikowy czynny - активний дієприкметник
immoralizm - імморалізм m
impotent - імпотент m
ind - індій m
Indie - Індія f
Indonezja - Індонезія f
Indonezyjczyk - індонезієць m
Indonezyjka - індонезійка f
indonezyjski - індонезійський
indyferentny - індиферентний
indyferentyzm - індиферентизм m
indyjski - індійський
indyk - індик m
Indyk - Індійський океан m
indywidualista - індивідуаліст m
indywidualistka - індивідуалістка f
indywidualny - індивідуальний
infekcja - інфекція f
inkunabuł - інкунабула f
inkwizycja - інквізиція f
innowierca - іновірець m
innymi słowy - іншими словами
ino - тільки, лише
insekt - комаха f
instynkt - інстинкт m
insurekcyjny - повстанський
integralność - цілісність f
integralny - інтегральний
inteligencja - інтелігенція f
interes - діло, заняття
interesowny - корисливий
internista - терапевт m
interseksualizm - гермафродитизм (germafroditizm)
introligator - палітурник m
inż. - інж.
inżynier - інженер
inżynieria - інженерія
iracki - іракський
Irak - Ірак m
Irakijczyk - іракець m
Irakijka - іракійка f
Iran - Іран m
Irkuck - Іркутськ m
Irlandczyk - ірландець m
Irlandia - Ірландія f
Irlandia Północna - Північна Ірландія f
Irlandka - ірландка f
irlandzki - ірландський
ironia - іронія f
ironiczny - іронічний
ironizować - іронізувати
iryd - іридій
iście - напевно (napewno)
islamistka - ісламістка f
islamizm - ісламізм m
islamski - ісламський
Islandczyk - ісландець m
Islandia - Ісландія f
Islandka - ісландка f
islandzki - ісландський
istnieć - існувати
istny - наречений m, жених m
Itaka - Ітака
Italok - італієць m
italski - італійський
itd. - і т. д.
iterb - ітербій m
itp. - і т. п.
itr - ітрій m
Iwan - Іван m
I wojna światowa - перша світова війна f
izba - мир m, кімната f
-izm - -ізм
Izrael - Ізраїль m
Izraelczyk - ізраїльтянин m
Izraelka - ізраїльтянка f
izraelski - ізраїльський
ja - я
jabłko - яблуко n
jabłko Adama - адамове яблуко n
jabłko niezgody - яблуко незгоди n, яблуко розбрату n
jabłoń - яблуня f
jabłoń domowa - яблуня домашня
jadać - їсти
jąderko - ядерце
Jadwiga - Ядвіґа f
jagoda - чорниця f, щока f, ляпас m
jajko - яйце n
jajo - яйце n (jajcé)
jak grom z jasnego nieba - як грім з ясного неба
jakikolwiek - абиякий
Jamajka - Ямайка f
Jan - Ян m, Іван m
jangryst - аґрус m
japa - печера f
Japonia - Японія f
jarecka - мати f
jarosz - вегетаріанець m
jarzębina - горобина f
jaskinia - печера f
jaskółka - ластівка f
Jasna Góra - Ясна Ґура
jasny - ясний, світлий
jastrząb - яструб m
jaszczurka - ящірка f
jątrznica - кров'я́нка f
Jaworzno - Явожно
jebadło - ліжко n
jeden - один
jedlina - ялиця f
jedna jaskółka nie czyni wiosny - одна ластівка не робить весни
jedna jaskółka wiosny nie czyni - одна ластівка не робить весни
jednobarwny - монохромний
Jędrzej - Андрій m
jedynie - тільки
jego - його
jej - її
jeleń - олень m
jełop - дурень, глупак m, йолоп m
Jemen - Ємен m
jemeński - єменський
jen - єна f
Jerozolima - Єрусалим
Jerycho - Єрихон
jeść - їсти
jesień - осінь f
jesienny - осінній
jesień życia - осінь життя f
jesion - ясен m
jest - бути
jeszcze - ще
jeż - їжак (ižak) m
jezioro - озеро n
Jezioro Galilejskie - Тиверіадське озеро
Jezioro Tyberiadzkie - Тиверіадське озеро
jezuicki - єзуїтський
jezuita - єзуїт m
jezuityzm - єзуїтство n
Jezus - Ісус m
Jezus Chrystus - Іісус Христос
język - язик m, мова f
język ojczysty - рідна мова
językoznawca - мовознавець m
językoznawstwo - мовознавство n
jeżyna - ожина f
jidysz - їдиш
jod - йод
jodła - ялиця f
Jordania - Йорданія f
Jozafat - Йосафат m
judofob - антисеміт m
Jugosławia - Югославія
Julia - Юлія f
juny - молодий m (molodýj)
jutro - завтра
Jutrzenka - Аврора f
już - вже
kabaczek - кабачок m
kaban - свиня f
kabat - колега m, друг m
Kabul - Кабул
kabza - кишеня f
kacap - кацап m, дурень, глупак m, йолоп m
kacapski - кацапський
kaczka - качка f
kadm - кадмій m
Kafarnaum - Капернаум
kafej - кав'ярня f
kaffa - кавове дерево n, кава f
kaganat - каганат m
Kair - Каїр
kaj - де
kajak - байдарка f
Kajenna - Каєнна f
kakao - какао n, анус m
kałabania - калюжа f
kalafa - ніс m, обличчя n, лице n
kalafior - цвітна капуста f
kalapitra - голова
kalejdoskop - калейдоскоп m
kalendarz - календар m
kalifat - халіфат m
kaliforn - каліфорній m
kalkulator - калькулятор m
kaloria - калорія f
kalosz - калоша f
kałuża - калюжа f
kalwin - кальвініст m
kalwinista - кальвініст m
kalwinistka - кальвіністка f
kalwinizm - кальвінізм m
kalwinka - кальвіністка f
kam - де
kamasz - чобіт m, черевик m
Kambodża - Камбоджа f
kambr - кембрій m
Kamerun - Камерун m
kamień - камінь m
kampania - кампанія f
Kanada - Канада f
kanał - канал m
kandydat - кандидат m
kaniła - маска f, капот m, каптур m, капюшон m
kanka - коновка, поливальниця f, бідон m, булька, банька f, пузир m, марихуана f
kanonizacja - канонізація f
kaolin - каолін m
kapitalista - капіталіст m
kapitan - капітан m
kaptur - каптур m, капюшон m
kapuśniak - капусняк m
kapusta - гроші
kapusta kiszona - квашена капуста f
karaba - кіт m
Karaczi - Карачі
karat - карат
karbowaniec - карбованець m
karczoch - артишок m
karibu - північний олень m
karlus - хлопець m
karmenadel - котлета f
karp - короп m
Karpaty - Карпати
kartofel - картопля f
Karwat - хорват m
kary - карий
karykatura - карикатура f
kaszanka - кров'я́нка f
kąt - кут m, куток m, точка зору
katalityczny - каталітичний
Katar - Катар
katastrofa - катастрофа
katechizm - катехізис m
katedra - кафедральний собор m, кафедра f
katolicki - католицький
katolicyzm - католицизм m, католицтво n
katoliczka - католичка f
katolik - католик m
katus - сіра сова f
Katyń - Катинь m
kawa - кавове дерево n, кава f
kawa wesoła - публічний дім m, публічний будинок m
kawiarnia - кав'ярня f
kawka - галка f, сестра f
kawon - кавун m
Kazach - казах m
kazachski - казахський
Kazachstan - Казахстан m
kazachstański - казахстанський
kazalnica - амвон m
kazanie - проповідь f
kazaski - казахський
Kazaszka - казашка f
kazatelnica - амвон m
każdy - кожний, кожен
kaznodzieja - проповідник m
kciuk - великий палець m
keczup - кетчуп m
kędy - де
kejter - собака m, пес m
kejza - сир m
Kenia - Кенія f
kenijski - кенійський
khmerski - кхмерська
kiat - к'ят m
kici, kici - киць-киць
kicz - кіч
kiedy - коли
kiedykolwiek - коли-небудь
kiejda - кишеня f
kiełbasa - ковбаса f
kiep - кеп m
kiepeła - голова
kierowca - водій m
kieszeń - кишеня f
kij - кий m, поверх m
kijanka - пуголовок
Kijów - Київ m
kiks - кікс m
kilka - кілька
kilkadziesiąt - кількадесят
kilkanaście - кільканадцять
kilogram - кілограм m
kilometr - кілометр m
kimać - спати
kimono - сон m, сон, мрія f
kinol - ніс m
Kinszasa - Кіншаса
kip - кіп m
kira - горілка f
kirchóf - кладовище n, цвинтар m
Kirgistan - Киргизстан m
Kiribati - Кірибаті f
kiszka - молоко n, кров'я́нка f
Kiszyniów - Кишинів m
kit - брехливість
kitajski - китайський
klamot - камінь m
kłamstwo - брехливість
kłapaczka - рот m, вуста
klara - Сонце n
klarnecista - кларнетист m
klarnet - кларнет m
klarnetowy - кларнетовий
kłaść - класти, кластися, лягати
klawisz - клавіш m, клавіша f
klekotun - лелека m
klerykalizm - клерикалізм m
kliber - ніс m
klimat - клімат m
klimatyczny - кліматичний
kłos - колос m
kluber - ніс m
klucz - ключ m
klucz francuski - французький ключ m
kluka - ніс m
klupać - шукати
kluza - в'язниця
kniądz - князь m, герцог m, принц m
knipa - книжка f (knyžka), книга f (knyha)
koalicja - коаліція f
kobalt - кобальт m
kobieta - жінка f
kobieta lekkich obyczajów - проститутка f
kochać - любити, кохати
kochać kochajmy się jak bracia, rachować rachujmy się jak Żydzi - брат братом, сват сватом, а гроші не рідня, хоч ми собі брати, але наші кишені не сестри
kochanie - кохання
kochanka - коханка f
koci - котячий
kociamber - кіт m
kocioł - котел m
kodeina - кодеїн m
kod kreskowy - штрих-кодування n
kogut - півень m
koja - ліжко n
kojo - ліжко n
kojot - койот m
kokosz - курка f
kokoszka - курка f
kokot - півень m
kokota - проститутка f
kołacz - калач (kaláč) m, колач (koláč) m
kolano - коліно n
kołchoz - колгосп
kolega - колега m, друг m
kolegium - колегія
kolejny - наступний, черговий
kolektywizacja - колективізація f
kolektywnie - колективно
kolektywny - колективний
koleś - чоловік m
koło - коло n, круг m, колесо n, коло
koło garncarskie - гончарний круг m
kolokwializm - коллоквіалізм m
Kolonia - Кельн
kolonista - колоніст m
kolonoskopia - колоноскопія f
kolor - колір m, фарба f
Kolumb - Колумб m
Kolumbia - Колумбія f
kolumbijski - колумбійський
kołysanka - колисанка f, колискова f
koma - кома f
komar - комар m
komat - кома f
komentator - коментатор m
kometa - комета f
komis - комісія f
komisja - комісія f
Komisja Europejska - Європейська комісія f
komórka - клітина f, мобільний телефон m, стільниковий телефон m
Komory - Коморські Острови, Коморські острови
komp - комп'ютер m
komputer - комп'ютер m
komuch - комуніст m
komunikacja - комунікація
komunista - комуніст m
komunistka - комуністка f
komunistyczny - комуністичний
komunizm - комунізм m
koń - кінь
kóń - кінь
Konakry - Конакрі
konewka - коновка, поливальниця f
konflikt - конфлікт m
konformista - конформіст m
konformistka - конформістка f
konformistyczny - конформістський
konformizm - конформізм m
Konfucjusz - Конфуцій m
Kongo - Конго n
koniec - кінець m
koniunkturalność - опортунізм m
konował - коновал m
konserwatywny - консервативний
konserwatyzm - консерватизм m
kontrabanda - контрабанда f
kontrabas - контрабас m
kontrabasista - контрабасист m
kontrgambit - контргамбіт m
koń trojański - троянський кінь m
kontrrewolucja - контрреволюція f
kontynent - континент m, материк m
kontynentalny - континентальний
kontynuować - продовжувати
Kopenhaga - Копенгаген
koper - кріп m
Kopernik - Коперник m
kopia - копія f
kopruch - комар m
Koran - Коран m
korbol - гарбуз m
Korea - Корея f
Korea Północna - Північна Корея f
Korea Południowa - Південна Корея f
kormoran - баклан m
koromysło - коромисло n
korona - корона f, вінець m, крона f
korona z głowy nie spadnie - корона з голови не впаде
korowód - хоровод m
korpulentny - корпулентний
korzystny - корисний
Kos - Кос
kosa - ніж m
kość - кістка f
Kościan - Косцян m
Kościerzyna - Косьцежина
Kościuszko - Костюшко m
kosmopolita - космополіт m
Kostaryka - Коста-Ріка f
kosz - корзина f, кошик m, кіш m
kosztować - коштувати
kosztowny - дорогий
koszula - сорочка f
kot - кіт m
kotka - кішка f
kotlet - котлета f
kotwica - якір m
koza - коза f
Kozak - козак m
kozioł ofiarny - козел відпущення m
Koziorożec - Козеріг
koźlak - маслюк звичайний m
koźlarz babka - підберезовик m
koźlarz czerwony - підосиковик m
kożuch - дублянка f
krab - крабб
kradzież - крадіжка f
kraj - держава f
Kraków - Краків
krasula - корова f
krauza - банка f
krawat - краватка f
krawatka - краватка f
krawędź - край m, грань f, ребро n
kreacjonizm - креаціонізм m
krem - крем
krematorium - крематорій m
kret - кріт m
krętacz - пройдисвіт m
krew - кров f
kroczyć - крокувати
krok - крок m
król - король m
królestwo - королівство n, царство n
królewicz - королевич m
królik - кріль m, кролик m, крілик m
królowa - королева f
kromka - скибка f
kropka - крапка f
kropla drąży skałę - вода і камінь довбає
kropla w morzu - крапля в морі, краплина в морі
krótki - короткий
krowa - корова f
krtań - гортань
kruk - крук m, ворон m
krupniok - кров'я́нка f
kruty - міцний
krwiomocz - гематурія f
krwionośny - кровоносний
krybuny - хрест m
krykiet - крикет
kryminał - в'язниця
krymski - кримський
krypel - церква f
krypton - криптон m
Kryspin - Кріспін m
krzeczek - хом'як m
krzem - кремній m
krzesło - стілець m
krzyczeć - кричати
krzyk - крик m
krzywonogi - кривоногий
krzywousty - кривоустий
krzyż - хрест m
krzyżówka - кросворд m
Ksenia - Оксана f
ksenofobia - ксенофобія f
książę - князь m, герцог m, принц m
książka - книжка f (knyžka), книга f (knyha)
książka kucharska - кулінарна книга f
księgowość - бухгалтерія f
księgowy - бухгалтер m, бухгалтерський
księgozbiór - бібліотека
księżyc - місяць f
Księżyc - Місяць m
kto - хто
ktoś - хтось
któż - хто
Kuba - Куба f
kubizm - кубізм m
kucharz - кухар m, куховар m
kudłacz - кудлай
kujot - койот m
kukułka - зозуля f
kukuruźnik - кукурудзник m
kula - нога f
kulesza - кулеша f
kulinarny - кулінарний
kuloodporny - куленепробивний
kulos - нога f
kultura - культура f
kulturalny - культурний
kulturowy - культурний
kulturystka - культуристка f
kuna - куница f, куна f
kup - купити
kupić - купити
kupować - купувати
kupować kota w worku - купувати кота в мішку
kur - півень m
kura - курка f
kurdupel - курдупель m
kurka - курка f
kurki - курка f
Kurówka - Куровка, Курувка, Курівка
kurtyzana - проститутка f
kurwacik - краватка f
kusik - поцілунок m
Kusz - Куш m
kutafon - хуй m
kutas - хуй m
Kuwejt - Кувейт m, Ель-Кувейт m
kwacha - квача f
kwadrans - чверть години f
kwadratowy - квадратовий, квадратний
kwadratura koła - квадратура кола
kwant - квант
kwantowy - квантовий
kwanza - кванза
kwartał - квартал m
kwartet - квартет m
kwas akrylowy - акрилова кислота
kwas askorbinowy - аскорбінова кислота f
kwas chlebowy - квас m
kwas foliowy - фолієва кислота
kwas hialuronowy - гіалуронова кислота f, гіалуронан m
kwas mlekowy - молочна кислота
kwas siarkowy - сірчана кислота f
kwiat - квітка f, цвіт m
kwiczoł - чикотень m
kwiecień - квітень m
kwietniowy - квітневий
łabęć - лебідь m
łabędź - лебідь m
labirynt - лабіринт m
laboratorium - лабораторія f
łacinnik - латинник m
łaciński - латинський
lacz - голова
ładny - гарний
laga - кий m, поверх m
łąka - лука f, луг m
laktacja - лактація
lala - лялька f, дівчина f
lalka - лялька f
lamaizm - ламаїзм m
lampa - лампа f
lampart - леопард m
łańcuch pokarmowy - харчовий ланцюжок, трофічний ланцюжок
land - село n
Laos - Лаос m
łapka - пастка, западня
lari - ларі
larwa - маска f, капот m
las - ліс m
laski - лашський
Laszczyzna - Лахія f
lat - рік m
łat - лат m
lata - рік m
lato - літо n
latopis - літопис f
łatwowierność - довірливість f
łatwowierny - довірливий
ławka - лавка f
lebo - або
legendarny - легендарний
lej - лей m
lek - лек, лік m, ліки
lekarstwo - лік m, ліки
lekarz - лікар m
lekarz choroby chorób kobiecych - гінеколог m
lekka atletyka - легка атлетика f
lekkoatletyka - легка атлетика f
leksyka - лексика f
leksykolog - лексиколог m
leksykologia - лексикологія f
lempira - лемпіра
Leon - Лев m
leopard - леопард m
lepak - знову
łepetyna - голова
lepiej późno niż wcale - краще пізно, ніж ніколи
leprozorium - лепрозорій m
lepszy wróbel w garści niż gołąb na dachu - краща синиця в жмені, ніж журавель у небі
lesbijka - лесбіянка f
lesisty - лісистий
leśnictwo - лісництво n
leśny - лісовий, партизан m
Lesotho - Лесото n
lew - лев m
Lew - Лев m
lewicowy - лівий
lewy - лівий
leżeć - лежати
Lhasa - Лхаса
Liban - Ліван m
Liberia - Ліберія f
Libia - Лівія f
licencja - ліцензія f
licho - лихо n
licho wie - чорт його знає, дідько знає
licytacja - аукціон m
liczba - число n
liczba mnoga - множина (množyn') f
liczba podwójna - двоїна f
liczba pojedyncza - однина f
liczebnik - числівник m
Likaonia - Лікаонія f
likier - лікер m
lilia - лілія
liliput - ліліпут m
lingwista - лінгвіст m
lingwistka - лінгвістка f
lingwistyczny - лінгвістичний
lingwistyka - лінгвістика f
linie lotnicze - авіалінія f
lipa - липа f
lipiec - липень m
lira - ліра f
lis - лис m
lis polarny - полярний лис m
listonosz - листоноша (lystonoša)
listopad - листопад m
lit - літій m, лит m
litania - літанія
litera - буква f, літера f
literacki - літературний
litewski - литовський
litr - літр m
litra - літр m
Litwa - Литва f
Litwin - литовець m, литвин m
Litwinka - литовка f, литвинка f
łochynia - буяхи, лохина f, пя́ниця f, голубиця f, гнобобель m
lód - лід m, морозиво n
lodowiec - льодовик m
lodówka - холодильник m
łódź - Човен
logika - логіка f
logiko - логіка f
lojolita - єзуїт m
lokatiwus - місцевий відмінок m
lokomotywa - локомотив m
lola - дівчина f, кий m, поверх m
Londyn - Лондон m
lorandyt - лорандит m
lorens - лоуренсій
łoś - лось m
łosoś - лосось m
łotewski - латвійський, латиська мова f
loti - лоті
lotnik - авіатор m, льотчик m
lotnisko - аеродром m, летовище n
lotniskowiec - авіаносець m
Łotwa - Латвія f
Łotysz - латвієць m
Łotyszka - латвійка f
łowca - мисливець m
łoże - ліжко n
łóżko - ліжко n
Luanda - Луанда
lub - або
lubić - любити
Lubliniec - Люблінець
ludność - населення n
ludobójczy - геноцидний
ludobójstwo - геноцид m
ludożerstwo - людоїдство n
łudzikwiat - квітень m
łuk - арка f
luksemburczyk - люксембуржець m
Luksemburczyk - люксембуржець m
Luksemburg - Люксембург m
luksemburka - люксембуржка f
Luksemburka - люксембуржка f
lulka - сигарета f, цигарка f, папіроса f
luna - місяць f
luńt - собака m, пес m
lupanar - лупанарій m, лупанар m
lustro - дзеркало n (dzerkalo)
luteranin - лютеранин m
luteranizm - лютеранство n
luteranka - лютеранка f
lutet - лютецій m
luty - лютий m, холодний
Lwów - Львів m
łyżka - ложка f
łża - брехливість
mać - мати f
Macedończyk - македонець m, македонянин m
Macedonia - Македонія f
Macedonka - македонка f
macedoński - македонський
macica - матка f
macierz - матриці
Madagaskar - Мадагаскар m
madla - акушерка f
mądrość - мудрість f
mądry - мудрий
Madryt - Мадрид
MAEA - МАГАТЕ
mafia - мафія f
magister - магістр m
magnes - магніт m
magnetofon - магнітофон m
magnez - магній m
maj - травень m
majeranek - майоран m
major - майор m
Majotta - Майотта
majtki - труси
mak - мак m
mąka - борошно n, мука f
makaron - макарони, локшина f
makiawelista - макіавелліст m
makiawelizm - макіавеллізм m
makówka - маківка f
Malabo - Малабо
malarstwo - живопис m
malarz - маляр m, художник m, живописець m
Malawi - Малаві f
malawijski - малавійський
Male - Мале n
malediwski - мальдівський
Malediwy - Мальдіви
Malezja - Малайзія f
Mali - Малі f
malin - малина f
malina - малина f
małoduszność - малодушність f
Małopolska - Малопольща
malować - фарбувати, малювати
małpa - мавпа
Malta - Мальта f
mały palec - мізинний палець m, мізинець m
małżonek - чоловік m
mam - мати
mamałyga - мамалига f
Manama - Манама
manat - ламантини m, манат m
mangan - манган m
maniurka - дівчина f
manufaktura - мануфактура f
maoista - маоїст m
mapa topograficzna - топографічна карта
Maputo - Мапуту n
maras - бруд m, болото n, грязь f
maratończyk - марафонець m
marchew - морква f
marchewka - морква f
marihuana - марихуана f
marka - марка
marksista - марксист m
marksizm - марксизм m
Maroko - Марокко
marskość - цироз m
maruda - маруда m
maruder - мародер m, маруда m
maruderstwo - мародерство n
marzec - березень m
marzenie - мрія
marzenie senne - сон m, сон, мрія f
marzyć - мріяти
masara - муха f
Maseru - Масеру
maska - маска f, капот m, обличчя n, лице n
maślak - маслюк m
maślak lepki - маслюк модриновий синіючий m
maślak pstry - моховик жовто-бурий m
maślak sitarz - козляк m
maślak ziarnisty - маслюк зернистий m
maślak żółty - маслюк модриновий m
maślak zwyczajny - маслюк звичайний m
maślarz - маслюк m
masło - масло n
maszkara - маска f, капот m
matka - мати f
matura - атестат зрілості m
Matuzal - Метушалах m
Matuzalem - Метушалах m
Mauretania - Мавританія f
Mauritius - Маврикій m
mąż - чоловік m
mazak - обличчя n, лице n
mecenas - адвокат m
medycyna - медицина f
medyk - лікар m
meitner - майтнерій
Meksyk - Мексика f, Мехіко n
melki - цукерка f
melodia - мелодія f
melodio - мелодія f
mendelew - менделєвій m
Merkury - Меркурій (Merkúrij)
metafizyczny - метафізичний
metempsychoza - метемпсихоз m
meteor - метеор
meteoryt - метеорит
meteorytyka - метеоритика f, метеорна астрономія f
metical - метикал m
mętny - хмарний
metr - метр m
metr kwadratowy - квадратний метр m
Metuszelach - Метушалах m
mężczyzna - чоловік m
Mezopotamia - Месопотамія f
mezozoik - мезозой m
MFW - МВФ
Miami - Маямі
mianownik - називний відмінок m, знаменник m
miasto - місто n
miasto stołeczne - столиця f
miau - няв
Michał - Михайло (mykhajlo) m
mieć - мати
mieć dziurawą kieszeń - дірява кишеня у кого
mieć głowę na karku - мати голову на плечах
mieć gzik w kolanach - боятися
mieć nóż na gardle - мати ніж на горлі
mieć pełne kieszenie - повна кишеня у кого
mieć pustą kieszeń - у кишені вітер гуде, у кишені вітер свище, у кишені вітер гуляє
mieć puste kieszenie - у кишені вітер гуде, у кишені вітер свище, у кишені вітер гуляє
mieć wypchane kieszenie - повна кишеня у кого
miecznik - касатка f
miedź - мідь f
miedźwiedź - ведмідь m
międzyakt - антракт m
Międzyrzec Podlaski - Межиріччя, Мендзижець-Підляський
miejscownik - місцевий відмінок m
miejski - міський
mielcarz - пивовар m
mielcuch - пиво n
mieli - мати
miesiąc - місяць m, місяць f
miesiączek - місяць f
mięsień - м'яз, мускул m
mięso - м'ясо n
mięsopustnik - лютий m, холодний
mieszkać - жити
mięta - м'ята f
mikologia - мікологія f
mikrobiologia - мікробіологія
mikrofon - мікрофон m
Mikronezja - Мікронезія f
Mila - Емілія
milicja - міліція f
milicjantka - міліціонерка f
milimetr - міліметр m
militarny - військовий
miłość - любов f, кохання n
miłośnica - коханка f
mimo - коло n, круг m, колесо n, коло
mimowolny - мимовільний
minaret - мінарет m
minimalistka - мінімалістка f
Mińsk - Мінськ
minuta - хвилина f
miód - мед m
mitologia - міфологія f
mitologiczny - міфологічний
mleko - молоко n
młody - молодий m (molodýj)
młodzieniec - младенець m
młodzież - молодь f
mnich - брат m
mnogdy - часто
moc - сила f
móc - могти
mocny - міцний
modlitewnik - молитовник (molytóvnyk) m
modrakowy - голубий, блакитний, синій, небесний
modry - голубий, блакитний, синій, небесний
modrzew - модрина f
mój - мій
Mojżesz - Мойсей
mokry - мокрий, дощовий
Mołdawia - Молдова f, Молдавія f
Mołdawianin - молдаванин m
Mołdawianka - молдаванка f
mołdawski - молдавський
moment - момент m, мить f
Monako - Монако n, Монако
monarchista - монархіст m
Mongolia - Монголія f
monopol - монополія f
monoteista - монотеїст m
monoteistka - монотеїстка f
Monrovia - Монровія f
monstrancja - монстранція, монстрація
mora - дух m
moralista - мораліст m
morela - абрикос m
morelówka - абрикосівка f
morelowy - абрикосовий
morkwa - морква f
Moroni - Мороні n
morski - морський
morze - море n
Morze Adriatyckie - Адріатичне море n
Morze Arktyczne - Північний Льодовитий океан m
Morze Azowskie - Азовське море
Morze Bałtyckie - Балтійське море
Morze Północne - Північне море n
Morze Śródziemne - Середземне море
mosiądz - лату́нь
most - міст m
moszna - калитка f
motyka - мотика f
motyl - метелик m
Mount Everest - Еверест
mowa - промова f, язик m, мова f
mówić - говорити, казати
Mozambik - Мозамбік m
może - могти
mózg - мозок
mrowisko - мурашник m
mrówka - мураха f
mrówkojad - мурахоїд m
mróz - мороз m
Ms - місцевий відмінок m
mściwy - мстивий
mucha - муха f
muchomor - мухомор m
muchomór - мухомор m
muchomor cytrynowy - мухомор цитриновий m
muchomor czerwieniejący - мухомор червоніючий m
muchomor czerwonawy - мухомор червоніючий m
muchomor czerwony - мухомор червоний m
muchomor jadowity - мухомор білий смердючий m
muchomor plamisty - мухомор пантерний m
muchomor sromotnikowy - мухомор зелений m
muchomor zielonawy - мухомор зелений m
mućka - корова f
municypalny - муніципальний
muraszka - мураха f
Murzynka - негритянка f
muzeum - музей m
muzułmanin - мусульманин m
muzułmański - мусульманський
muzyczka - музикантка f
muzyk - музикант m
mużyk - чоловік m
muzyka - музика f
muzykalny - музикальний
my - ми
mydło - мило n
mykita - лис m
mykologia - мікологія f
myrmekologia - мірмекологія f
myśl - думка f, мисль m
myśleć - думати
myślenie - мислення n
myślenie magiczne - магічне мислення n
myśliwiec - мисливець m
myśliwy - мисливець m
mysz - миша f
Myszka Miki - Міккі Маус m
N - орудний відмінок m
na - на
na bezrybiu i rak ryba - на безриб'ї і рак риба, на безвідді і рак риба
nacjonalista - націоналіст m
nacjonalistka - націоналістка f
nacjonalistyczny - націоналістичний, націоналістський
nacjonalizacja - націоналізація f
nacjonalizm - націоналізм m
naczyniak - ангіома
naczyniak krwionośny - гемангіома f
naczyniowy - судинний
nadciśnienie płucne - легенева гіпертензія f
nadopiekuńczość - гіперопіка f
na dwoje babka wróżyła - надвоє баба ворожила
nadwrażliwość - гіперчутливість f
nadzieja - надія
nagość - нагота f
nagota - нагота f
Nahum - Наум m
Nairobi - Найробі
naiwność - наївність f
naiwny - наївний
najmniej - анітрохи, зовсім ні
nakfa - накфа
naleśnik - налисник, млинець
Namibia - Намібія f
namiot - намет m
napad - атака f
napaść - атака f
na pewno - напевно (napewno)
napój - напій, напиток m
naprany - п'яний, п'яний m
na przykład - наприклад
narba - рубець m, шрам m
narkomania - наркоманія f
narodowy socjalizm - націонал-соціалізм m
narzeczony - наречений m, жених m
narzędnik - орудний відмінок m
naślennik - наслідник m, наступник m
Nassau - Нассау
następca - наслідник m, наступник m
na sto procent - напевно (napewno)
nasz - наш
nauczyciel - вчитель m
na wagę złota - на вагу золота
Nawakszut - Нуакшот m
nawet - навіть
nawiasem mówiąc - до речі
na własną rękę - на свій страх і ризик, на свою відповідальність
na zdrowie - будь здоров
Ndżamena - Нджамена
neodym - неодим
neofaszysta - неофашист m
neofaszyzm - неофашизм m
neoliberalizm - неолібералізм m
neon - неон m
neonatologia - неонатологія f
neptun - нептуній m
nestorianizm - несторіанство n
neurobiologia - нейробіологія f
neurochirurgiczny - нейрохірургічний
neurolog - невролог m
ngultrum - нгултрум
ni - ню, ні, не
nic - нічого
Nicea - Ніцца f
Niderlandy - Нідерланди
nie - ні, не
nie- - не-
niebieski - голубий, блакитний, синій, небесний
niebiosa - небо n
niebo - небо n
niech żyje - хай живе!
nie czuć nóg - падати з ніг
niedokrwistość - анемія f
niedowierzanie - недовір'я n
nieduch - хвороба
niedziela - неділя f
niedźwiedź - ведмідь m
niedźwiedź polarny - білий ведмідь m
niegramotny - неграмотний
nie ma - немає
nie ma dymu bez ognia - нема диму без вогню
niemal - майже
Niemcy - Німеччина f, німці
Niemiec - німець m
nie mieć - ні, не, мати
Niemiecka Republika Demokratyczna - Німецька Демократична Республіка
niemiecki - німецький, німецький m
Niemka - німка f
nieoczekiwany - несподіваний
nieodpowiedzialny - безвідповідальний
nieopłacalny - нерентабельний
niepodległość - незалежність f, непідвладність f
nieruchomość - нерухомість
nieśmiało - соромливо
niespodziewany - несподіваний
niesprawiedliwość - несправедливість f
niestety - на жаль
nieszczęścia chodzą parami - біда ніколи сама не ходить
nietoperz - кажан m
niewdzięczny - невдячний
niewiasta - жінка f
nie widzieć dalej niż czubek własnego nosa - далі від свого носа не бачити, не бачити поза своїм носом
nie wierzyć własnym oczom - не вірити своїм очам
niewypłacalność - неплатоспроможність f, банкрутство n
niewypłacalny - неплатоспроможний
nigdy - ніколи
nihilista - нігіліст m
nihilistka - нігілістка f
nikiel - нікель m
Nikozja - Нікосія
nikt - ніхто
nim - він, воно
Niniwa - Ніневія f
niszczyciel - есмінець m, ескадрений міноносець m
niż - низький атмосферний тиск m, низовина f, ніж
NKWD - НКВС
NLPZ - НПЗП, НПЗА, НПЗЗ
no - так
nobel - нобелій m
noc - ніч f
noga - нога f
nonkonformista - нонконформіст m
nonkonformistka - нонконформістка f
nonkonformistyczny - нонконформістський
nonkonformizm - нонконформізм m
nonteizm - нетеїзм m
Norwegia - Норвегія f
norweski - норвезький
Norymberga - Ню́рнберг
nos - ніс m
Nowa Holandia - Нова Голландія f
Nowa Zelandia - Нова Зеландія f
nowicjat - новіціат m
noworodek - новонароджений m
nowotwór - новоутворення
nowy - новий
Nowy Rok - Новий Рік
nóż - ніж m
np. - напр.
nudle - макарони, локшина f
nudny - скучний
nudysta - нудист m
nudziarz - зануда m
Numidia - Нумідія f
ny - ню
nyga - комар m
o - про
oaza - оазис m
obcokrajowiec - іноземець m
obejmować - обіймати
obelisk - обеліск m
oberżyna - баклажан m
obiad - обід m
obiecać - обіцяти
obiecadło - азбука f, абетка f, алфавіт m
obiecanka - обіцянка f
obiecanki cacanki - обіцянки-цяцянки
obiecny - звичайний
obiekt - об'єкт m
obierać - чистити
obietnica - обіцянка f
obłuda - лицемірство n, лицемірність f
obłudnica - лицемірка f
obłudnik - лицемір m
obłudny - лицемірний
obój - гобой m
obojnactwo - гермафродитизм (germafroditizm)
obowiązek - обов'язок m
obowiązkowość - добросовісність f
obowiązkowy - обов'язковий
obóz koncentracyjny - концентраційний табір m, концтабір m
obraz - картина f, образ m, ікона f, уявлення n, фільм m
obrona - оборона f, захист m
obrońca - адвокат m
OBWE - НБСЄ
ocean - океан m
Ocean Arktyczny - Північний Льодовитий океан m
Ocean Atlantycki - Атлантичний океан m
oceaniczny - океанічний, океанський
Ocean Indyjski - Індійський океан m
Ocean Południowy - Південний океан m, Антарктичний океан m
Ocean Spokojny - Тихий океан m
ocelot - оцелот m
ochota - апетит m
ociec - батько m
oczywiście - авжеж, очевидно, звичайно, аякже
oczywisty - очевидний
od - від
od A do Z - від а до я
od a do zet - від а до я
odbyt - анус m
ode - від
Odessa - Одеса f
odkurzacz - пилосос m
odludek - відлюдок m, безлюдько m, відлюдник m, відлюдько m
odludzie - безлюддя n
odmiana - рід m
odór - сморід m
odpowiadać - відповідати
Odra - Одер
odyniec - одинец
ogień - вогонь m
ognisko - вогнище n, багаття n, фокус m
ogon - хвіст m
ogórek - огірок m
ogrodnik - садівник m, садівничий m
ojciec - батько m
ojczyc - син m
ojczysty - рідний
ojla - сова (sova) f
okaryna - окарина f, зозулка f
okno - вікно n
oko - око
oko cyklonu - око циклону
okoń - окунь m
okrąg - круг m
okręt podwodny - підводний човен
oksza - сокира f
okulary - окуляри
okultyzm - окультизм m
okupacja - окупація f
oładka - оладка f
olej - олі́я f
oligarcha - олігарх m
oligarchia - олігархія f
Olimpia - Олімпія f
ołówek - олівець m
oma - бабуся f
omieszkać - ні, не
on - він
ona - вона
one - вони
oni - вони
onkologiczny - онкологічний
ono - воно
onomastyka - ономастика f
ONZ - ООН
oologia - оологія f
opactwo - абатство n
opal - опал m
opat - абат m
operacja - операція f
opiąć - знову
opięć - знову
opinia - думка f, погляд m, репутація f
opłacalność - рентабельність f
opłacalny - рентабельний
opłatek - оплаток m
oportunista - опортуніст m
oportunistka - опортуністка f
oportunistyczny - опортуністський, опортуністичний
oportunizm - опортунізм m
opozycja - опозиція f
oprócz - окрім
opuścić nos na kwintę - спустити носа на квінту, спустити ніс на квінту, повісити носа на квінту, повісити ніс на квінту
oraz - і, й, та
orchestrion - оркестріон
organista - органіст m
organistka - органістка f
Organizacja Narodów Zjednoczonych - Організація Об'єднаних Націй f
organizm - організм m
orgazm - оргазм m
orka - касатка f
Ormianin - вірмен m
Ormianka - вірменка f
ormiański - вірменський
orogeneza - орогенез
orzba - касатка f
orzeł - орел m
osa - оса f
ość - кістка f
-ość - -ість
osełedec - оселедець m
osiągać - досягати, здобувати
osierdzie - перикард m
osioł - осел m
osm - осмій m
osoba - особа
Osobłoga - Особлоґа f (na terenie Polski), Особлага f (na terenie Czech), Особлага f
ostatni - останній
ostracyzm - остракізм m
ostrężyna - ожина f
ostrodamski - амстердамський
ostrodomski - амстердамський
oszukiwanie - ошукування n
oszustka - ошуканка f
otoczenie - оточення n
Ottawa - Оттава f
owad - комаха f
owadoznawstwo - ентомологія f
owca - вівця f
owczy - овечий
o wilku mowa - про вовка помовка
o wilku mowa, a wilk tu - про вовка помовка
o wilku mowa, a wilk tuż - про вовка помовка
owoc - фрукт m, плід m
owocnik - плодове тіло, спорокарп m
owulacja - овуляція f
ożarty - п'яний, п'яний m
ożyna - ожина f
pacan - дурень, глупак m, йолоп m
pachnący - ароматний
pachniarz - ніс m
pacholę - хлопець m
paciuk - пацюк, пацюк (pacjuk), щур (ščur)
Pacyfik - Тихий океан m
pacyfistka - пацифістка f
padać - говорити, казати
padać z nóg - падати з ніг
padalec - веретільниця f, гладун m
pająk - павук m
pajęcznik - вересень m, жовтень m, листопад m
pała - голова
palacz - курець m, опалювач, кочегар m, водій m
pale - голова
palec - палець m
palec wskazujący - вказівний палець m
paleoantropologia - палеоантропологія f
paleobotanika - палеоботаніка f
paleofitologia - палеофітологія f
paleontologia - палеонтологія f
paleozoologia - палеозоологія f
palić - палити, курити, топити
Palikir - Палікір m
pallad - паладій m
palladianizm - палладіанство n
palma - па́льма f
pamiątka - сувенір m
pamięć - пам’ять f
pamiętliwy - злопам'ятний, злопам'ятливий
panda - панда
pandemia - пандемія f
pani - пані
pan młody - молодий m
Panna - Діва
państwo - держава f
państwowy - державний
pańszczyzna - панщина f
pantałyk - пантелик m
pantera - леопард m
papier - папір m
papier jest cierpliwy - папір усе терпить, папір усе зносить
papieros - сигарета f, цигарка f, папіроса f
papier toaletowy - туалетний папір m
paproć - папороть f
papuć - чобіт m, черевик m
papuga - папуга f
para - пара f, пара, водяна пара f
paranoja - параноя f
parasol - парасоль m
parcie - зусилля
park - парк (park) m
parlament - парламент m
parlamentarny - парламентський
parowar - пароварка f
parszywiec - паршивець m
parszywy - паршивий
partyzana - протазан m
partyzant - партизан m
Paryż - Париж
parzybroda - капусняк m
pasieka - пасіка
pasożyt - паразит m
pasz - брак m, недостаток m
paszport - паспорт m
pasztet strasburski - фуа-гра
patriota - патріот m
patriotka - патріотка f
patriotyczny - патріотичний
patriotyzm - патріотизм m
patrzałki - окуляри
patrzeć - дивитися
patrzeć przez różowe okulary - дивитися крізь рожеві окуляри
patrzyć - дивитися
pawian - бабуїн m
październik - жовтень m
paździerzeń - жовтень m
pazur - кіготь m, пазур m, ніготь m
pazura - рука f
pchła - блоха f
pedant - педант m
pedantka - педантка f
pedantyczny - педантичний
pederastia - педерастія f
pedofil - педофіл m
pedofilia - педофілія f
pejzaż - пейзаж m
Pekin - Пекін
Pełczyce - Пелчице
pełny - повний
peniak - боягуз m, тхір m
penicylina - пеніцилін m
pensja - зарплатня, зарплата пансіон
Pepik - чех m
perka - картопля f
Persepolis - Парса, Персеполь, Персеполіс
persona - особа
peryfraza - перифраз m, перифраза f
peso - песо
petronelka - сонечко n
piana - пиво n
piasek - пісок m
piaskownica - пісочниця f
piątek - п'ятниця f
piąte koło u wozu - п'яте колесо до воза n
pić - пити
pieczara - печера f
pieczarka - печериця f
pieczeń - діло, заняття
piedestał - п'єдестал m
piegowaty - веснянкуватий
piekło - смола f
piemontyt - п'ємонтит m
pieniądz - гроші
pierdy - плітка f
pierdzieć - пердіти
pieróg - вареник m
pierogi - вареник m
pierścień - перстень m
pierścionek - перстеник m, каблучка f
pierwiastek chemiczny - хімічний елемент m
pierwszak - першокласник m
pierwsza wojna światowa - перша світова війна f
pierwszoklasista - першокласник m
pies - собака m, пес m
piesiec - полярний лис m
pieski - псі, собачий
pieśń - пісня f
Pieśń nad pieśniami - Пісня над піснями f
pies ogrodnika - собака на сіні
piętro - поверх m
pietruszka - петрушка f
pietruziel - петрушка f
pietuch - півень m
pigularz - аптекар m
pigułka - пілюля f
pigwa - айва f
pigwówka - айвівка f
pijanica - буяхи, лохина f, пя́ниця f, голубиця f, гнобобель m
pijany - п'яний, п'яний m
pijany jak bela - п'яний, аж носом оре, п'яний як ніч
pijawa - веселка f
pikawa - серце n
piksel - пі́ксель, пі́ксел
piłka - м'яч m
piłka nożna - футбол m
piłka ręczna - гандбол m, ручний м'яч m
piłkarski - футбольний
piłkarz - футболіст m
piłkarzyki - кікер m
pionier - піонер m
pionierka - піонерка f
pióro - перо n, ручка f
piorun - блискавка f, грім m
piosenka - пісенька, пісня f
piromania - піроманія f
pisanka - писанка f
pisco - піско n
pisklę - пташеня́ n
pismo - алфавіт m, абетка f
Pittsburgh - Піттсбург m
piwo - пиво n
piwowar - пивовар m
piwowarstwo - пивоваріння n, пивоварство n
pizda - пизда f
pizgać - кидати
Pizydia - Пісідія
Pjongjang - Пхеньян m
plajster - пластир
płakać - плакати
plakat - плакат m, афіша f
planeta - планета f
planetarium - планетарій
planetarny - планетарний
planetoida - астероїд m
planta - рослина f
plaster - пластир
plebiscyt - плебісцит m
pleśń - цвіль
pliszka - плиска f
płoć - плітка f
plotka - плітка f
płotka - плітка f
pluton - плутоній m
płynny - плинний, рідкий, текучий
pobożność - благочестя n, набожність f
pocałować - поцілувати
pocałować klamkę - поцілувати замок, поцілувати колодку
pocałunek - поцілунок m
pochodzenie - походження n
POChP - ХОЗЛ
pociąg - поїзд m, потяг m
początkowy - початковий
poczta - пошта f
pocztowy - поштовий
pod - під, попід, проти
pode - під, попід, проти
pod gołym niebem - під відкритим небом, під голим небом
podłoga - підлога f
podłożyć świnię - підкласти свиню, підсунути свиню, підставити свиню
podmiot - підмет m
podnosić - піднімати, підніматися
podpułkownik - підполковник m
podstawówka - початкова школа f
poduszka - подушка f, перина f
poduszka powietrzna - подушка безпеки f
podwójny - подвійний
podziemie - підземелля n
podziemny - підземний, підпільний
pogarda - гордування n, презирство n
pogoda - погода f
po grób - до гробу
pojąć - зрозуміти
pojedynek - дуель f
pojutrze - післязавтра
pokładać się ze śmiechu - качатися зо сміху, заходитися зо сміху, лягати зо сміху
pokój - мир m, кімната f
pokojowy - мирний, кімнатний
pół - пів
Polak - поляк m
Polak, Węgier – dwa bratanki, i do szabli, i do szklanki - поляк та угорець – добра парочка, і до шаблі і до чарочки
polana - поляна f
Polanów - Полянув
pole - поле n, площа f
pole bitwy - бойове поле, поле битви, бойовисько n
polegać - здаватися, покладатися
polibuda - політехнікум m, політехнічний інститут m, політехнічний університет m
policzek - щока f, ляпас m
politechnika - політехнікум m, політехнічний інститут m, політехнічний університет m
politura - політу́ра
polityka - політика
polka - полька f
Polka - полька f, полечка f
półksiężyc - півмісяць m
półkula - півкуля f
północ - північ f
północnoamerykański - північноамериканський
północny - північний
polon - полоній m
połonina - полонина f
polonizacja - полонізація f
położnik - акушер m
półsiostra - зведена сестра
Polska - Польща f (Pol'šča)
polski - польський, польська
półtora - півтора
półtorej - півтори, півтора
półudenyk - обід m
południe - південь m
południk - меридіан
południowoamerykański - південноамериканський
południowy - південний
Półwysep Apeniński - Апеннінський півострів m
Półwysep Bałkański - Балканський півострів
Półwysep Krymski - Кримський півострів m
połykać łzy - ковтати сльози
pomarańczowy - апельсиновий, оранжевий, помаранчевий
pomidor - помідор m, томат m
pomocny - корисний
pomysł - іде́я f
poniedziałek - понеділок m
ponieważ - бо (bo), тому (tomu), тому що (tomu ščo), так як (tak jak), оскільки (oskil’ky), адже (adže), внаслідок (vnaslidok), унаслідок (unaslidok)
ponownie - знову
popadia - попадя f
popiersie - погруддя
poprawność polityczna - політична коректність f, політкоректність f
pora roku - пора року f
pornografia - порнографія f
pornograficzny - порнографічний
portier - портьє m
Portugalczyk - португалець m
Portugalia - Португалія f
Portugalka - португалка f
portugalski - португальський
porzeczka - порічка, смородина f
poseł - амбасадор
posiadać - мати
pośladek - сідниця f
pośledni - останній
posłuszeństwo - послушність f
postawić kropkę nad i - поставити всі крапки над і
potas - калій m
poufny - конфіденційний
poważny - серйозний
powiat - повіт
powiedzieć - сказати
powieka - повіка f
powieść - роман m
powietrze - повітря n
powolny - повільний
powstańczy - повстанський
powstanie - повстання n
powstaniec - повстанець m
poza - окрім
pozawczoraj - позавчора
pozdrawiać - вітати
Poznań - Познань
pozór - увага f, примітка f, зауваження f
pozostawiać - залишати
pożyteczny idiota - корисний ідіот m
pracować - працювати
pracowitość - працьовитість f
pracownia - ательє n
pracuś - трудяга m, трудяка m, трудівник m
praczka - праля f
Praga - Прага
praktyka - практика f
prawak - білий гриб m
prawa ręka - правий, рука f
prawa zwierząt - права тварин
prawda - істина f
prawdziwek - білий гриб m
prawnik - юри́ст m, правник m
prawo - право n, закон m
prawosławie - православ'я n
prawowity - законний
prawy - правий
prazeodym - празеодим m
precz - геть
prędko - швидко
prędkość - прудкість f, швидкість f
prek - геть
prezbiter - пресвітер
prezbiterium - презбітерій
prezes - президент m
prezydent - президент
prima aprilis - День сміху m, День усіх дурнів m
probiotyk - пробіотик
prócz - окрім
produkt krajowy brutto - валовий внутрішній продукт m
promet - прометій m
prosić - прохати, просити
prostoduszność - простодушність f
prostoduszny - простодушний
prostytucja - проституція f
prostytutka - проститутка f
proszę - будь ласка
proszek - порошок m
protaktyn - протактиній m
protekcjonizm - протекціонізм m
protestancki - протестантський
protestantyzm - протестантизм m, протестантство n
protozoologia - протозоологія f
prowitamina - провітамін
prowizja - комісія f
pruski - прусський, прусський m
prymatologia - приматологія f
prymitywny - примітивний
pryncypialny - принциповий
prywaciarz - приватник m
prywatnie - приватно
prywatny - приватний, особистий
prywatyzacja - приватизація f
przać - любити, кохати
przechadzka - провітрювання, прогулянка f
przecinek - кома f
przeciwpożarowy - протипожежний
przeczytać - прочитати
przedszkole - дитячий садок m
przedwczoraj - позавчора
przejeżdżać - проїжджати, переїжджати, переїздити
przemożność - сила f
przeorysza - абатиса f
przestępstwo - злочин m
przestrzeń kosmiczna - космічний простір
przetarg - аукціон m
przewrotka - бісіклета f
przoć - любити, кохати
przychodzić - приходити
przydatny - придатний, корисний
przyimek - прийменник
przyjaciel - друг m, приятель m, товариш m
przyjaciółka - коханка f
przyjemność - приємність f
przymiotnik - прикметник m
przynosić - приносити
przypadek - випадок m, випадковість f, відмінок m
przypadkiem - випадково
przypadkowo - випадково
przypominać - згадувати
przyroda - природа f
przysłówek - прислівник m
przystanek - зупинка f
przytcza - випадок m, випадковість f, відмінок m
przytrzeć nosa - утерти носа
przytulić - обійняти
psi - псі, собачий
psisko - собака m, пес m
psychiatra - психіатр m
psychiatria - психіатрія f
psychiczny - психічний
psychika - психіка f
psycholog - психолог m
psychologia - психологія f
psychologiczny - психологічний
pszczelarstwo - бджільництво n
pszczoła - бджола f
pszenica - пшениця f
ptak - птах m, птиця f
ptasia grypa - грип пташиний
ptaszę - птах m, птиця f
publicystyka - публіцистика f
pukać - стріляти
puklaty - горбатий
pula - пула
pułapka - пастка, западня
pułapka na myszy - мишоловка f
pulmonologia - пульмонологія f
pultok - індик m
punktualny - пунктуальний
purpurowy - пурпурний
purytański - пуританський
pustelnik - пустельник m, пустинник m, відлюдник m
pusty - дурний, безглуздий
puszczyk - сіра сова f
puszka - в'язниця, пиво n
puter - індик m
puzonista - тромбоніст m
puzonistka - тромбоністка f
pyra - картопля f
pyrrusowe zwycięstwo - піррова перемога f
Pyrzyce - Пижице
Rabat - Рабат m
rachatłukum - лукум, рахат-лукум
raciądz - рицар m, лицар m, вітязь m
racjonalista - раціоналіст m
racjonalistka - раціоналістка f
racjonalność - раціональність f
rad - радій m
rada - ра́да f
radio - радіо n, радіоприймач m
radioaktywny - радіоактивний
radocha - радість f
radon - радон m
radość - радість f
radosny - рожевий, веселий
radziecki - радянський
Rajch - Німеччина f, німці
rajza - екскурсія f
rajzować - бродити
rak - рак m
Rak - Рак (Rak)
rakuski - австрійський
ramię - плече n
randka - зустріч
ranek - рано, ранком, вранці, ранок m
rano - рано, ранком, вранці, ранок m
rasa - раса f
rasizm - расизм m
raz - удар m, раз m
razdziawa - крук m, ворон m, гайворон m, ворона, гава
rdzewieć - ржавіти
reakcjonista - реакціонер m
real - ріал
realistka - реалістка f
ręce do góry - руки вгору!, руки догори!
Recz - Реч
ręczna - гандбол m, ручний м'яч m
ręcznik - рушник m
redyska - редиска f
redźka - редиска f
referendum - референдум m
regent - регент m
rejs - круїз m
ręka - рука f
rękaw - рукав m
rękawica - рукавиця f
rękawiczka - рукавиця f
rekin - акула (akula) f
rekolekcje - ретрит m, рітріт m
religia - релігія f
religijność - релігійність f
religijny - релігійний, побожний, набожний
relikwia - реліквія f
ren - реній m, північний олень m
rencista - пенсіонер m
renifer - північний олень m
rentowny - рентабельний
repatriacja - репатріація f
reporter - репортер m
Republika Federalna Niemiec - Федеративна Республіка Німеччини (Federatyvna Respublika Nimeččyny)
Republika Słowacka - Словацька Республіка
Resko - Реско
reumatyczny - ревматичний
reumatyzm - ревматизм m
rewolucja - революція f
rewolucja październikowa - Жовтнева революція f
rezun - різун
RFN - ФРН
rho - ро
rial - ріал
riel - рієль
Rijad - Ер-Ріяд
ringgit - ринггіт m
RNA - РНК f
ro - ро
robić - робити
robić z igły widły - робити з мухи слона
robić z muchy słonia - робити з мухи слона
robota - робота f
robota nie zając, nie ucieknie - робота не вовк, в ліс не втіче
robotyka - робототехніка f
rod - родій m
rodzaj - рід m
rodzaj męski - чоловічий рід m
rodzaj nijaki - середній рід m
rodzaj żeński - жіночий рід m
rodzić - народжувати
rogal - рогалик, ріжок
rok - рік m
rokoko - рококо n
rok przestępny - високосний рік m
rokrocznie - рік у рік
rolnictwo - сільське господарство n
romans - роман m
romantyczny - романтичний
romantyzm - романтизм m
ropień - абсцес m, нарив m
ropucha - ропуха f
róść - рости
Rosja - Росія f
roślina - рослина f
roślinność - рослинність f
rosnąć - рости
rosomak - росомаха f
rosyjski - руський
rotmistrz - ротмістр m
rouza - троянда f, рожа f, бешиха f
rowerowy - велосипедний
rówieśniczka - ровесниця f
rówieśnik - ровесник m
równanie - рівняння
równanie stanu - рівняння стану
również - також
róża - троянда f, рожа f, бешиха f
rozdział - розділ m
rożek - рогалик, ріжок
rozmawiać - розмовляти, говорити
różowy - рожевий
rozpustnik - розпутник m, розпусник m
rozpustny - розпусний
Roztocze - Розточчя
roztwór - розчин m
rozum - розум m
rozumny - розумний
rozwijać - розвивати, розвиватися
RP - РП
rtęć - ртуть
rubel - рубель m, рубль m, карбованець m
rubid - рубідій m
ruch - рух m
ruchome schody - ескалатор m
ruczaj - струмінь m
rudny - червоний, комуніст m
Rudolf - Рудольф
rufa - сідниця f
rugby - регбі n
Rumun - румун m
Rumunia - Румунія f
Rumunka - румунка f
rumuński - румунський
rupia - рупія f, руфія f
rusofobia - русофобія f
rusyfikacja - русифікація f
ruten - рутеній m
rutherford - резерфордій m
ryba - риба f
Ryby - Риби
rycerz - рицар m, лицар m, вітязь m
Ryga - Рига f
ryś - рись f
rywal - суперник m
ryż - рис m
rzadko - рідко
rząd marionetkowy - маріонеткова держава
rzecz - річ
rzeczownik - іменник m
Rzeczpospolita - Річ Посполита f
rzeka - ріка
rzemiosło - ремесло n
rzęsa - вія f
Rzeszów - Ряшів
rzeżączka - гонорея
rzeź wołyńska - волинська трагедія f
rżnąć głupa - дурня клеїти
rzodkiewka - редиска f
rzucać - кидати
rzucać słowa na wiatr - кидати слова на вітер
rzut - кидок m
rzut karny - штрафний удар m, пенальті n
rzut rożny - кутовий удар m, корнер m
SA - АТ
sad - сад m
sadu - сад m
Sadzawka Owcza - Овеча купіль f
sagan - голова
Sahara - Сахара f
saksofonista - саксофоніст m
saksofonistka - саксофоністка f
saksofonowy - саксофонний
sałata - салат m
Samarkanda - Самарканд m
Samarytanin - самаритянин m, самарянин m
sambar - самбар m
samobójca - самогубець m, самогубця m, самовбивець m, самовбивця m
samobójczy - самогубний, самовбивчий
samobójczyni - самовбивця, самогубця
samobójstwo - самовбивство n, суїцид m
samochód - автомобіль m
samochodowy - автомобільний
samochwalstwo - хвастовство n
samogłoska - голосний звук m
samogon - самогон m, самогонка f, самогон, сивуха, первак
samolot - літак m
samotnik - відлюдок m, відлюдник m, безлюдько m
samowar - самовар m
Sana - Сана f
sanatorium - санаторій m
sandacz - судак m
Santiago - Сантьяго
Santo Domingo - Санто-Домінго
saper - сапер m
Sarajewo - Сараєво
sardela - анчоус m
sardynka - сардинка f
satyna - сатин m
satyra - сатира f
satysfakcja - дуель f
sceptycyzm - скептицизм m
schizofrenia - шизофренія f
schizofreniczka - шизофренічка f
schizofreniczny - шизофренічний
schizofrenik - шизофренік m
schody - сходи
schody ruchome - ескалатор m
ściana - стіна f
ściany mają uszy - стіни мають вуха
ścichapęk - несподіваний
ścięgno - сухожилля n
ścierać - стирати
ściółka - підстилка f
Scylla - Скілла f
se - собі
seaborg - сіборгій m
sejsmiczny - сейсмічний
sejsmologia - сейсмологія f
seksturystyka - секс-туризм
seksualny - сексуальний
sekunda - секунда f
selen - селен m
seler - селера f
sen - сон m, сон, мрія f
separatyzm - сепаратизм m
sepulka - сепулька f
ser - сир m
Serb - серб m
Serbia - Сербія f
Serbka - сербка f
serbski - сербський
serce - серце n
serdce - серце n
serdeczny palec - підмізинний палець m
seroka - сорока f
serologia - серологія
serwatka - сироватка f
sesja - сесія f
Seul - Сеул m
seulski - сеульський
si - цей
siano - сіно n
Sianów - Сянув
siarka - сірка f
siarkowodór - сірководень
siebie - себе
sieczeń - лютий m
siedem grzechów głównych - сім смертних гріхів
Siedmiogród - Трансільванія f
siedzieć - сидіти
siedzieć cicho - сидіти тихо
siedzieć jak na szpilkach - сидіти як на шпичках, сидіти як на голках
siekiera - сокира f
sierpień - серпень m
sikora - синиця f
siła - сила f
silno - дуже, вельми, більш
silny - міцний
sin - sin
Singapur - Сінгапур m
sinologia - синологія f, китаєзнавство n
sioło - село n
siostra - сестра f
siostrzenica - племінниця f
sioty - полька f
sirpień - серпень m
sitko - мікрофон m
skałosz - даман
skand - скандій m
skarbonka - скарбничка f
skaut - скаут m
skiba - крадіжка f
skład - крамниця f
sklep - крамниця f
sklero- - склеро-
skocznia narciarska - трамплін
skok - стрибок m
skok o tyczce - стрибки з жердиною
Skop - Овен
Skopje - Скоп'є n
skopowina - баранина f
skóra - шкіра f
skóra i kości - шкіра та кості, кості та шкіра
Skorpion - Скорпіон
skorupa - шкаралупа f, черепашка f, панцир m, черепок m
skorupa ziemska - кора землі f
skoruśniak - горобина f
skot - худоба f
skowronek - жайворонок m
skrupulatny - скрупульозний
skrytka pocztowa - абонементна скринька f
skrzydło - крило n, фланг m
skrzynka - скри́нька f, пошто́ва скри́нька f
skrzypaczka - скрипачка f
skrzypce - скрипка f
skrzypcowy - скрипковий
skrzypek - скрипаль m
skrzyp polny - хвощ польовий
skutek - результат, наслідок
skutkiem - результат, наслідок
Śląsk - Сілезія f
slawistyka - слов'янознавство n, славістика f
śleboda - воля, свобода f
śledź - оселедець m, краватка f
śledziona - селезінка
śleptać - плакати
ślepucha - курка f
ślepy lelek - кажан m
ślicznotka - красуня f, красуха f
ślimak - равлик, слимак m
ślips - краватка f
śliwka - слива f
słodki - солодкий
słoik - банка f
słońce - сонце n
Słońce - Сонце n
słoniowy - слоновий
słowa - слово n
Słowacja - Словаччина f
słowacki - словацький, словацький m
Słowaczka - словачка f
Słowak - словак m
Słowenia - Словенія (Slovenija)
Słoweniec - словенець m
Słowenka - словенка f
słoweński - словенський, словенська мова f
Słowianin - слов'яни m, слов'янин m
słowik - соловей m
słownik - словник m
słowo - слово n
słuch absolutny - абсолютний слух m
słuchać - слухати
słuchalnia - аудиторія f
slup - шлюп
służba bezpieczeństwa - служба безпеки f
słyszeć - чути
smacznego - смачного, приєммого апетиту, доброго апетиту
smartfon - смартфон m
śmiech - сміх m
śmietana - сметана f
smoła - смола f
Smoleńsk - Смоленськ m
smoleński - смоленський
smród - сморід m
smrodliwy - сморідний
smrodyla - чорна смородина f
smutniak - хліб m
smysł - розум m
śnieg - сніг m
snob - сноб m
sobą - собою
sobaczy - псі, собачий
sobaka - собака m, пес m
sobie - собі
sobota - субота f
sobotni - суботній
socjalista - соціаліст m
socjalistyczny - соціалістичний
socjalizm - соціалізм m
socjologia - соціологія f
Soczi - Сочі n
sód - натрій m
Sofia - Софія
sójka - сойка f
sokół - сокіл m
sól - сіль f
sola - морський язик m
solidarność - солідарність f
Solon - Солон m
som - сом m
sopel - бурулька f
Sopot - Сопот m
sopran - сопрано
sosna - сосна f
sos sojowy - соєвий соус
sowa - сова (sova) f
sowa śnieżna - біла сова f
sowiecki - радянський
sowietologia - совєтологія f
spać - спати
spadkobierca - наслідник m
spaghetti - спагеті n
spec - фахівець m
specjalista - спеціаліст m
specjalistka - спеціалістка f
specjalność - спеціальність f
spektakularny - показний
spichlerz - амбар m
spichrz - амбар m
śpiewać - співати
śpiwór - спальний мішок m
spójnik - сполучник m
spółgłoska - приголосний звук m
spółka - товариство n
spółka akcyjna - акціонерне товариство n
spółka z ograniczoną odpowiedzialnością - товариство з обмеженою відповідальністю n
sponsor - спонсор m
sportowiec - спортсмен m
spowiedź - визнання, зізнання, сповідь
sprawiedliwie - справедливо
sprawiedliwy - справедливий
sprzątaczka - прибиральниця f
sprzedawać - продавати, реалізувати
spuścić nos na kwintę - спустити носа на квінту, спустити ніс на квінту, повісити носа на квінту, повісити ніс на квінту
sp. z o.o. - ТОВ
srebrna - срібний
srebrny - срібний
srebro - срібло n
średnik - крапка з комою f
średniowiecze - середньовіччя
Sri Lanka - Шрі-Ланка
ŚRK - ВРЦ
środa - середа f
środowisko - середовище n
sroka - сорока f
ssak - ссавець m
stabilność - стабільність f
stabilny - стабільний
stacja benzynowa - автозаправна станція, АЗС
stąd - звідси, тому
stadion - стадіон m
stalinista - сталініст m
stalinowiec - сталініст m
Stanisław - Станіслав m
stara panna - стара діва f
starek - дід, дідусь m
stare miasto - старий, місто n
Stargard Szczeciński - Старгард Щецінський
starka - бабуся f
starość - старість f
starosek - дід, дідусь m
staroszek - дід, дідусь m
starszy - батько m
stary - старий
starzyk - дід, дідусь m
statek - судно n, корабель m
staw - став m, ставок m, суглоб m
staw łokciowy - ліктьовий суглоб
Stefan - Степан (Stepan)
step - степ m
stół - стіл m
stolarz - столяр m
stolica - столиця f
stomatologia - стоматологія f
stopa - стопа f, фут m, норма f
strach - страх m, опудало n
strach ma wielkie oczy - у страха великі очі
strach na wróble - страх m, опудало n
strąpacz - лютий m, холодний
stront - стронцій m
strudel - штрудель
strugać wariata - дурня клеїти
strumień - струмінь m
strumyk - струмок m, струмінь m
strzała - стріла f
strzałka - стрілка f
strzec jak oka w głowie - берегти як ока, пильнувати як ока, шанувати як ока
strzec jak źrenicy oka - берегти як зіницю ока, пильнувати як зіницю ока, шанувати як зіницю ока
strzelać - стріляти
Strzelec - Стрілець
stuła - стола f
stulecie - століття n, вік m
styczeń - січень m
stypendium - стипендія f
subiektywny - суб'єктивний
subkontynent - субконтинент m
substancja - речовина f
Suchań - Сухань
Sudety - Судети
sukinsyn - сучий син m
sukmana - сукмана f
sułtanat - султанат
sum - сом m
Sumatra - Суматра f
sumienie - совість f, сумління n
sumienność - добросовісність f
sumienny - добросовісний
surrealista - сюрреаліст m
suseł - ховрах m
suwenir - сувенір m
suwerenność - суверенітет m
suwerenny - суверенний
świat - світ m
światło - світло n
świątynia - храм
Świdwin - Свідвин
świeca - свіча, свічка f
świecę - свіча, свічка f
świerszcz - цвіркун m
Świetlana - Світлана f
święty - святий, святий m
świgać - кидати
świnia - свиня f
Świnica - Свиниця f
świnka morska - морська свинка f
Świnoujście - Свіноуйсцє
świt - світанок m, світання n
świtanie - світанок m, світання n
swoisty - своєрідний
swój - свій
swoje - свій
swołocz - сволота f
syjonistyczny - сіоністський
symbol - символ m
Symferopol - Сімферополь
syn - син m
synchroniczność - синхронність f
synek - хлопець m
synergia - синергія
syn marnotrawny - блудний син m
synogarlica senegalska - сенегальська горлиця
syntagma - синтагма f
synteza - синтез m
syra - нога f
system operacyjny - операційна система f
system plików - файлова система
szabrownictwo - мародерство n
szac - наречений m, жених m
szacherka - шахрайство n
szacher-macher - шахер-махер m
szachista - шахіст m
szachraj - шахрай m
szachrajski - шахрайський
szachrajstwo - шахрайство n
szajs - гівно n
szałwia - шавлія f
szamanizm - шаманізм m
szampan - шампанське
szarańcza - сарана f
szara strefa - тіньова економіка
szary - сірий
szaszłyk - шашлик
szaszok - боягуз m, тхір m
Szczecin - Щецін
szczegółowy - акуратний
szczepionka - вакцина
szczęście - щастя n
szczęśliwego Nowy Nowego Roku - з Новим роком
szczewik - чобіт m, черевик m
szczodry - щедрий
szczupak - щука f
szczur - пацюк (pacjuk), щур (ščur)
szczypiorniak - гандбол m, ручний м'яч m
szczyt - оргазм m
szekel - шекель m
szept - шепіт m, шерех m
sześcian - куб m
szkielet - скелет m
szkira - дівчина f
szkita - нога f
szklistka - скловидне тіло n, склисте тіло n
Szkocja - Шотландія (Šotlandija)
szkoła - школа f
szkoła podstawowa - початкова школа f
szkoła powszechna - початкова школа f
szkop - німець m
Szkot - шотландець f
szlag - удар m
Szląsk - Сілезія f
szlauch - вуж m, змія f, шланг m
szlifierka - шліфувальний верстат
szlifierka kątowa - кутова шліфувальна машина
szlips - краватка f
szlug - сигарета f, цигарка f, папіроса f
szneka - обличчя n, лице n
sznita - скибка f
sznytka - скибка f
szogun - шьоґун m
szolka - ча́шка f
szowinista - шовініст m
szowinizm - шовінізм m
szpiegostwo - шпигунство n
szpilka - шпилька f, голка f
szpital - лікарня f, шпиталь m
szpuk - голуб m
sztabka - зливок m
sztuka - мистецтво n, штука f, п'єса f, дівчина f
szuflada - шухляда f
szukać - шукати
szukajcie, a znajdziecie - шукайте і знайдете
szulak - яструб m
szwab - німець m
Szwabia - Швабія f
szwaja - нога f
Szwajcar - швейцарець m
Szwajcaria - Швейцарія f
Szwajcarka - швейцарка f
szwajcarski - швейцарський
Szwecja - Швеція f
Szwecyjo - Швеція f
Szwed - швед m
Szwedka - шведка f
szwedzki - шведський, шведський m
szwestera - сестра f
szybki - швидкий
szybko - швидко
szyja - шия f
szykowny - елегантний, гарний
szyling - шилінг m
szympans - шимпанзе m
szynal - цвях m
szynd - насильство n, зґвалтування n, ґвалт m
tabaka - тютюн m
tachykardia - тахікардія f
tacik - батько m, дід, дідусь m
Tadżykistan - Таджикистан
tajemnica poliszynela - секрет Полішинеля m
tak - так
taka - така
taksydermia - таксидермія f
także - також
tak zwany - так званий
tal - талій m
Tallinn - Таллінн
tam - туди, там
tamdotąd - туди, там
tamten - той
tan - танець m, танок m
tani - дешевий
taniec - танець m, танок m
tanksztela - автозаправна станція, АЗС
tantal - тантал
tarcza - обличчя n, лице n
tarcza strzelecka - обличчя n, лице n
Tarnów - Тарнув
tartak - лісопильня f, лісопилка f
tarzać się ze śmiechu - качатися зо сміху, заходитися зо сміху, лягати зо сміху
taśma filmowa - кіноплівка
taśma perforowana - перфострічка
taternictwo - альпінізм m
Tatry - Татри
Tbilisi - Тбілісі
tchórz - боягуз m, тхір m
te - цей
technokracja - технократія
technologia - технологія f
tęcza - веселка f
tegdy - тоді
Tegucigalpa - Тегусігальпа
Teheran - Тегеран m
tej - ти, Ви
telefon - телефон m
telefon komórkowy - мобільний телефон m, стільниковий телефон m
telewizyjny - телевізійний
tellur - телур m
temat - тема
temperatura pokojowa - кімнатна температура f
ten - цей
tenge - тенге
tenże - цей, це
teologia - теологія f
teologiczny - теологічний
terapeuta - терапевт m
terb - тербій m
terminologia - термінологія f
terminologiczny - термінологічний
termodynamika - термодинаміка f
Termopile - Фермопіли
terrorystka - терористка f
terroryzm - тероризм m
tęsknić - тужити, сумувати
teszarz - столяр m
tętnica - артерія f
tetum - тетум
też - також
tg - tg
Tirana - Тірана
tiul - тюль m
tkanka tłuszczowa - жирова тканина f
tlen - кисень m
tłustodupy - толстожопий
to - це
tobie - ти, Ви
tojad - аконіт m
Tokio - Токіо
tolerancja - толерантність f
tolerancyjny - толерантний
tom - том m
Tomisław - Томіслав m
tor - торій m
Tora - Тора f
torpeda - торпеда f
tory - торій m
totalitarny - тоталітарний
totalitaryzm - тоталітаризм m
towarzystwo - товариство n
tradycja - традиція f
tradycjonalistka - традиціоналістка f
tradycjonalistyczny - традиціоналістський
tradycyjnie - традиційно
tradycyjny - традиційний
traf - випадок m, випадковість f, відмінок m
trafiła kosa na kamień - натрапила коса на камінь, наткнулася коса на камінь, наскочила коса на камінь
tragedia - трагедія f
tragicznie - трагічно
tragikomedia - трагікомедія f
trambimba - трамвай
tramwaj - трамвай
tramwajka - трамвай
transeuropejski - трансєвропейський
transsubstancjacja - пресуществління
tranzystor - радіо n, радіоприймач m
trawa - трава f
trockista - троцькіст m
tróhła - труна f, гріб m
troje - троє
trolejbus - тролейбус
trombita - трембіта
trucizna - отрута f
trumna - труна f, гріб m
truskawka - полуниця f
trwać - тривати
trybalizm - трибалізм m
tryb rozkazujący - наказовий спосіб m
trylion - трильйон
Trypolis - Тріполі
trzcina cukrowa - цукрова тростина f, (cukróva trostýna)
Trzej Królowie - три царі
trzęsienie ziemi - землетрус m
trzmiel - джміль m
trznadel zwyczajny - Звичайна вівсянка
tsunami - цунамі (tsunámi) f
tudzież - і, й, та
tu i ówdzie - і там і тут
tuńczyk - тунець m
Tunezja - Туніс
tunfisz - тунець m
Turcja - Туреччина
Turczynka - турчанка f
turecki - тюркський, турецький
tureckojęzyczny - тюркомовний
Turek - турок m
turkusowy - бірюзовий
turysta - турист m
tuż - майже (majže), сливе (slywe)
tuzin - дюжина f
twardy - твердий, жорсткий
twarz - обличчя n, лице n
twój - твій
ty - ти, Ви
tydzień - тиждень m
tygr - тигр m, Тигр m
tygrys - тигр m, Тигр m
tyj - чай m
tyle, co kot napłakał - як кіт наплакав
tylko - тільки, лише
tymianek - чебрець m
typ - тип m
typografia - типографія
Tyrteusz - Тіртей m
tytan - титан m
tytanowy - титановий
tytoń - тютюн m
tzw. - т.з. (= так званий)
ubezpieczenie - страхування n, страховка f
ubiór - наряд m
ucha - уха f
ucho - вухо n, ручка f
uczennica - учениця f
uderzać w czułą strunę - бити в болюче місце, вражати в болюче місце
UE - ЄС
ufnal - цвях m
ufny - довірливий
ugija - угія f
ugrupowanie - угруповання
UKF - УКХ
układ krwionośny - кровоносна система f
układ okresowy - періодична система
Ukraina - Україна f
Ukrainiec - українець m
ukrainizm - українізм m
Ukrainka - українка f
ukrainoznawstwo - українознавство n
ukraiński - український, українська мова, українська
ul. - вул.
Ułan Bator - Улан-Батор m
Ułan Ude - Улан-Уде m
ułaskawienie - помилування n
ulica - вулиця f
ultramaryna - ультрамарин m
umiak - уміак
unia - унія f
Unia Europejska - Європейський Союз m
uniwerek - університет m
uniwersytet - університет m
uón - він
UPA - УПА
upiór - упир m (upýr)
upór - упертість
urlopowicz - відпочиваючий
urodzić się pod szczęśliwą gwiazdą - під щасливою зіркою народитися, під щасливою зіркою вродитися
urodziwy - гарний
urologia - урологія f
uśmiechać się - посміхатися
usta - рот m, вуста
Ustrzyki Dolne - Устрики Долішні
utrzeć nosa - утерти носа
uwaga - увага f, примітка f, зауваження f
uzasadniać - виправдовувати
uzbecki - узбецький, узбецька мова f
użyteczny - корисний, придатний
użyteczny idiota - корисний ідіот m
wacha - дощ m, море n, вода f (woda)
wąchać - нюхати
waga - вага f, значення n
Waga - Терези
wagon - вагон m
wajco - яйце n
wakacje - канікули
wakacyjny - канікуловий
waliza - валізка f, чемодан m
walizka - валізка f, чемодан m
waltornia - валторна f
wampuka - вампука f
wanad - ванадій m
wandalizm - вандалізм m
wanta - ванта f
wapń - кальцій m
warga - губа f
warstwowy - стратифікований
Warszawa - Варшава (Varszava)
Warta - Варта f
wartość - вартість, цінність f
warunek - умова f
wasz - ваш
waszkorb - корзина f, кошик m, кіш m
wata cukrowa - цукрова вата f, солодка вата f
Watykan - Ватикан
wąż - вуж m, змія f, шланг m
ważka - бабка f
ważny - важливий
wcześnie - рано
wcześniej - рано
wczoraj - вчора
wdzięczność - вдячність f
wedle - по
według - по
wędrować - бродити
wegetarianin - вегетаріанець m
wegetarianizm - вегетаріанство n
węgiel - вуглець m, вугілля n
Węgier - угорець m
Węgierka - угорка f
węgierski - угорський
węglowy - вугільнй
węgorz - вугор m
Węgry - Угорщина f
Wenecja - Венеція f
wenecjanin - венеціанець m
wenecjanka - венеціанка f
wenecki - венеціанський, венеціанський m
Wenezuela - Венесуела f
wenezuelski - венесуельський
wesołe miasteczko - атракціон m
Wesołych Świąt - з Різдвом, З Різдвом Христовим
weterynaria - ветеринарія
wiara - віра f
wiatr - вітер m
wiązać koniec z końcem - кінці з кінцями зводити
wideo - відео n
wieczór - вечір m
wieczorny - вечірній, вечоровий
Wiedeń - Відень m
wiedzieć - знати
wiek - вік m
wiek emerytalny - пенсійний вік
wiela - скільки
wielbłąd - верблюд m
Wielkanoc - Великдень (Velykdenʹ) m, Пасха (Pascha) f
wielkanocny - великодній
wielki - великий
Wielki Piątek - Страсна П'ятниця f
wielkomocarstwowy - великодержавний, великодержавницький
wielkorosyjski - великоруський
wielkoruski - великоруський
wielokrotny - багаторазовий
wieniec - віно́к m
Wientian - В'єнтьян
Wieruszów - Веру́шув
wierzba - верба́
wieś - село n
wiewiór - гонорея
wiewiórka - білка f
wieża - вежа f, тура f
więzienie - в'язниця
wigilia - переддень m
Wikipedia - Вікіпедія
Wikisłownik - Вікі-словник (Viki-slovny&#769, k), Вікісловник (Wikisɫowny&#769, k) m
Wikiźródła - ВікіТека
wiktoria - перемога f
Wilamowice - Вілямовіце
wilga - вивільга f
wilgoć - вологість
wilgotny - вологий, вогкий
wilia - переддень m
wilija - переддень m
wilk - вовк m
wilk morski - морський вовк m
wilk w owczej skórze - вовк в овечій шкурі m
willa - вілла f, дача f
Wilno - Вільнюс
Windhuk - Віндгук m
wino - вино n
winograd - вино n
wiolonczela - віолончель f
wiolonczelista - віолончеліст m
wiolonczelistka - віолончелістка f
wiosenny - весняний, весінній
wioska - село n
wiosna - весна f
wirusologia - вірусологія f
wisieć - висіти
Wisła - Вісла f
wiśnia - вишня
wiśniówka - вишнівка f
wiszczeć - кричати
Wisznu - Вішну m
witać - вітати
witamina A - вітамін А
witarianizm - сироїдство n
wiza - віза f
wizjer - приціл m, давальний відмінок m
Włoch - італієць m
Włochy - Італія f
Włodzimierz - Володимир
włoski - італійський
włosy - волосся n
Włoszka - італійка f
wnęk - внук, онук m
wnuk - внук, онук m
woda - вода f (woda)
wóda - горілка f
woda kolońska - одеколон
wódka - горілка f
wodniczka - очеретянка прудка f
Wodnik - Водолій
wodór - водень m
wodzić za nos - водити за носа, проводити за носа, водити за ніс, проводити за ніс
w ogóle - взагалі
wojak - солдат, жовнір m
wojna - війна f
wojna domowa - громадянська війна f
wojskowy - армієць m, солдат, жовнір m
wokabularz - словник m
wół - віл m
wołacz - кличний відмінок m
wolna miłość - вільне кохання
wolność - воля, свобода f
wolność słowa - свобода слова f
wolny - вільний, повільний
wolny rynek - вільний ринок m
Wołoszczyzna - Волощина f
wołowina - воловина f, яловичина f
Wołyń - Волинь
won - вона f, геть
woniączka - горілка f
worek - мішок m, виступ m
worek sercowy - перикард m
wosk - віск
wówczas - тоді
wóz - віз m
wózek dziecięcy - дитячий візок m
w pocie czoła - у поті чола
wróbel - горобець m
Wrocław - Вроцлав m
wrogi - ворожий
wrogość - ворожість f
wrona - ворона, гава
wrzesień - вересень m
wrzód - виразка f
wrzos - верес m
wschód - схід m
Wschód - Близький Схід m
wschodniosłowiański - східнослов'янський
wskazywać - вказувати
wstępny - вступний
wszechstronny - різнобічний, різносторонній
wszystko - все, усе
wszystko jedno - все одно
wtorek - вівторок m
w tym - це
wulgarny - вульгарний
wulkan - вулкан m
wuszt - ковбаса f
wy - ви
wyborca - виборець m
wyborczy - виборчий
wybory - вибори
wychodzić ze skóry - вилазити із шкіри
wycieczka - екскурсія f
wydma - дюна
wydra - видра f
wyglądać - виглядати, визирати
wyjątek - виняток
wykrzyknik - вигук m
wykusz - еркер, ґанок m
wyłazić ze skóry - вилазити із шкіри
wymowa - вимова f
wyraz - слово n
wysoki - високий
wyspa - острів m
Wyspa Świętego Wyspy Świętego Tomasza i Wyspa Książęca - Сан-Томе і Принсіпі
wyspiarz - острівець m
Wyspy Kanaryjskie - Канарські острови
wytrysk - еякуляція
wytrzymałość - витривалість f
wywielga - вивільга f
-yzm - -ізм
ząb - зуб m
żaba - жаба f
Zabulon - Завулон m
zabyły - дурний, безглуздий
zachłanny - жадібний
zachód - захід m
zachód słońca - захід сонця m
zaćmienie - затемнення
zacząć - почати, початися
zaczynać - починати
żądło - жало n
zadowolenie - задоволення n
zadzierać nosa - задирати носа
Żagań - Загань
żagiel - вітрило n
żaglowiec - вітрильник m
Zagrzeb - Загреб
zaimek - займенник
zając - заєць m
zajmować - займатися
zakażenie - інфекція f
zakład karny - в'язниця
żako - жако
zakochany - закоханий
zakonnica - сестра f
zakonnik - брат m
żal - горі
zalany - п'яний, п'яний m
zamek - замок m, застіжка f, застібка f, блискавка f
zamieć - сніговиця f
zamorski - заморський
Zamość - Замостя f
Zaolzie - Заолжя n
zapad - захід m
zapalenie płuc - пневмонія
zapaska - запаска f
zapaśnik - борець
Zaporoże - Запорожжя, Запоріжжя
zaraza - епідемія f
zaręczyny - заручини
zaś - знову
zaszczytciel - адвокат m
zatoka - затока f
zatrudniać - брати на роботу
zawierać - містити, укладати
zawód - зайняття, професія, розчарування
zazdrość - заздрість f, ревнощі
zazula - зозуля f
zazulka - сонечко n
zazwyczaj - зазвичай
zbić z pantałyku - збити з пантелику
zbłąkana owieczka - заблукана вівця f, блудна вівця f
zboże - збіжжя n, хліб m
żdać - чекати, очікувати, вичікувати
zdanie - речення n, думка f, погляд m
zdrowie - здоров'я n
zdrowy - здоровий
zdrzadło - дзеркало n (dzerkalo)
zebra - зебра f
żeby - аби, щоб
żec - палити, курити, топити
zegar - годинник m
zegarek - годинник m
zegar słoneczny - сонячний годинник m
zegewerk - лісопильня f, лісопилка f
żeglarz - мореплавець m, моряк m
żegleń - вуглець m, вугілля n
żelazo - залізо n
żelazobeton - залізобетон m
żelbet - залізобетон m
żeńczyna - жінка f
zero - нуль
zespół - ансамбль m
żgak - тріска f
Zgierz - Згеж
żgok - тріска f
zgromadzenie - асамблея f
ziele angielskie - духмяний перець m
zielnik - гербарій
zielony - зелений
zielony ludzik - зелений чоловічок m, зелена людинка f
ziemia - земля f
Ziemia - Земля f
Ziemia Święta - Свята земля f
ziemniak - картопля f
zieziulka - зозуля f
zima - зима f
zimny - холодний
zimorodek - зимородок m
zista - бабуся f
złodziejstwo - злодійство n, крадіжка f
złota rączka - золота рука f, золоті руки
złoto - золото n
złotówka - золотий, злотий
złoty - золотий, злотий
złoty środek - золота середина f
zmiana - зміна f
znać - знати
znać jak swoje dziesięć palców - знати як свої десять пальців
znać jak swoje pięć palców - знати як свої п'ять пальців
znaczyć - мати значення, значити
znajdować - знаходитися
znak - знак m
znak wodny - водяний знак m
znaleźć - знайти
znicz - вічний вогонь
znosić - анулювати
znów - знову
znowu - знову
zob. - див.
zol - підлога f
zola - підлога f
żołądek - шлунок m
żółć - жовтий (žóvtyj) m
żołnierz - солдат, жовнір m
żółta kartka - жовта картка f
żółty - жовтий (žóvtyj) m
żółw - черепаха f
żółw lamparci - черепаха леопардова
żółw skórzasty - шкіряста черепаха
zoo- - зоо-
zoofilia - зоофілія f, скотолозтво n
zoologia - зоологія f
zooplankton - зоопланктон m
zorza - зоря f
zostawiać - залишати
zozula - зозуля f
zozulka - зозулка
zrękowiny - заручини
źrenica - зіниця f, око
zrobić - зробити
źródlany - джере́льний
źródło - джерело n
zrozumieć - зрозуміти
ZSRR - СРСР
żuaw - зуави, зуав
ZUM - ІСШ
żur - жур
żuraw - журавель m, стерх m, піднімальний кран m
żurawina - журавлина
żurnalista - журналіст m
Żwaniec - Жванець
związek chemiczny - хімічний зв'язок m
Związek Socjalistycznych Republik Radzieckich - Союз Радянських Соціалістичних Республік
związek zawodowy - професійна спілка f, профспілка f
związek zgody - узгодження f
zwierciadło - дзеркало n (dzerkalo)
zwierzak - тварина f
zwierzę - тварина f
zwiesić nos na kwintę - спустити носа на квінту, спустити ніс на квінту, повісити носа на квінту, повісити ніс на квінту
zwolennik - прихильник m, послідовник m
zwrot - поворот m, повернення n, зворот m
zwrotnik - тропік m
zwycięstwo - перемога f
zwyciężać - перемагати
zwyczajny - звичайний
z wyjątkiem - окрім
z wyłączeniem - окрім
życie - життя n
żyć na wysokiej stopie - жити на широку ногу
życzenie - бажання n
żydaczowski - жидачівський
żydożerstwo - антисемітизм m
żymła - булка f
żynich - молодий m
żyrandol - жирандоль, абажур m
Żytomierz - Житомир
żywe srebro - ртуть
żywić - їсти
żywica - смола f
żywny - живий
żywy - живий
żyzność - родючість f
