AA - AA (Alcoólicos Anónimos)
Aaron - Aarão, Arão
abandon - abandono m
abasiofilia - abasiofilia
abcyksymab - abciximab
Abdon - Abdão m
abdykacja - abdicação
abdykować - abdicar, desistir, exonerar
abecadło - alfabeto m, abecedário
abecadłowo - alfabeticamente
Abelard - Abelardo
aberracja - aberração f
abfal - imundície, lixo, anomalia f
Abidżan - Abidjan
abiecadło - alfabeto m, abecedário
Abisynka - abissínia f
abisyński - abissínio
ablegat - delegado m
ablegierek - filho m, criança f
ablutomania - mania das limpezas f
abnegacja - abnegação f
aborcja - aborto
abordaż - abordagem f
Abraham - Abraão
abrazja - abrasão
Abruzja - Abruzos
ABS - ABS
abstynencja - abstinência f
Abwehra - Abwehr
abwera - Abwehr
acefalia - acefalia
Achitofel - Aitofel
Adam - Adão m
Adelajda - Adelaide
administracja - administração
administrator - administrador
admiracja - admiração f
Adolf - Adolfo m
Adonis - Adônis
adopcja - adopção f
adrenalina - adrenalina f
adres - endereço m
adwentnik - dezembro m
adwokat - advogado m
adwokat diabła - advogado do diabo
aeracja - aeração
aerodrom - aeródromo m, aeroporto m
afa - arroba f
afelzina - laranja f
Afganistan - Afeganistão m
afgański - afegão
Afrodyzja - Afrodisias
Afryka - África f
agnostycyzm - agnosticismo
agonia - agonia f
agrarny - agrário
agresja - agressividade
agroturystyka - turismo rural
aikido - aikido m
ajurwedyjski - aiurvédico
akacja - acácia
akademicki - académico
akademski - académico
Akadia - Acádia f
akcent - acento m
akceptacja - aceitação f
akcja - ação
akolita - acólito m
akordeon - sanfona,acordeão
akredytować - credenciar
akrobatka - acrobata f
akropol - acrópole
aksamit - veludo m
aktorka - atriz f
akt urodzenia - certidão de nascimento, assento de nascimento
aktyn - actínio m
aktynomikoza - actinomicose f
aktywność - atividade f
aktywować - ativar
akupresura - acupressão f
akupunktura - acupunctura f
akwedukt - aqueduto
alabaster - alabastro
Aladyn - Aladim m
Albania - Albânia f
albatros - albatroz m
albinos - albino m
albumina - albumina
Aldona - Aldona
alegoria - alegoria f
aleja - avenida f
Aleksander - Alexandre m
alergia - alergia f
alergiczny - alérgico
alergologia - alergologia f
alfabet - alfabeto m, abecedário
alfabetu - alfabeto m, abecedário
alfabetycznie - alfabeticamente
Al-Falludża - Falluja (Fallujah, Fallouja, Falowja)
algebraiczny - algébrico
Algieria - Argélia f
algofobia - algofobia f
algorytm - algoritmo m
alkaliczność - alcalinidade f
alkohol - álcool m
allel - allelo m
alleluja - aleluia
alokucja - alocução f
alpinista - alpinista m
altana - coreto
aluminium - alumínio m
Alzacja - Alsácia
Amanda - Amanda
Amazonka - Amazonas
ambasada - embaixada f
ambasador - embaixador
ambicja - ambição
ambirz - gengibre m
ambitny - ambicioso
Ambroży - Ambrósio m
ambulatoryjny - ambulante
ambus - bigorna
ameba - ameba
ameryk - amerício m
Ameryka Północna - América do Norte f
Ameryka Południowa - América do Sul f
amfa - anfetamina f
amfetamina - anfetamina f
aminokwas egzogenny - aminoácido essencial
Amman - Amã
amnestia - anistia, amnistia
amnestyja - anistia, amnistia
amoniak - amoníaco, gás amoníaco, amônia
amoralizm - niilismo moral m, amoralismo m
ampułka - ampola f
amputacja - amputação f
Amu-daria - Amu Dária
analiza - análise
analogia - analogia f
ananas - ananaseiro m, ananás m, elemento m
anarchista - anarquista
anarchistyczny - anárquico
anarchizm - anarquismo m
Anatolia - Anatólia f
anatomia - anatomia f
anatomiczny - anatómico
Andaluzja - Andaluzia f
Andaluzyjka - andaluza f
andaluzyjski - andaluz
androgen - andrógeno m
andrologia - andrologia f
Andromeda - Andrômeda
Andrzej - André
Andy - Andes, Cordilheira dos Andes
aneksja - anexação
anemia - anemia
anestezjolog - médico anestesista m
anewryzm - aneurisma m
angiografia - angiografia f
angiologia - angiologia f
Anglia - Inglaterra
anglicyzm - anglicismo m
Anglija - Inglaterra
anglikanin - anglicano m
anglikanka - anglicana f
ani - nem … nem, nem mesmo
animacja - animação
animista - animista m
anioł - anjo m
Anioł Stróż - anjo da guarda m
aniżeli - que, do que
anjoł - anjo m
anomalia - anomalia f
anonimowy - anônimo
anoreksja - anorexia f
anorektyk - anorético
antagonista - antagonista m
antagonistka - antagonista f
Antananarywa - Antananarivo
Antares - Antares
Antarktyda - Antártica
Antoni - Antônio
Antonia - Antonia f
antropofagia - antropofagia f
antropologia - antropologia f
Antwerpia - Antuérpia
antybakteryjny - antibacteriano
antybiogram - antibiograma m
antybiotyk - antibiótico m
antyczny - antigo
antyfaszysta - antifascista m
antyfaszyzm - antifascismo
antygen - antígeno m
antyklerykalizm - anticlericalismo m
antykoagulant - anticoagulant m
antykomunizm - anticomunismo m
antykoncepcja - contracepção
Antyle Holenderskie - Antilhas Neerlandesas
antyoksydacyjny - antioxidante
antyoksydant - antioxidante
antypatia - antipatia
antyseptyczny - antisséptico
antyteizm - antiteísmo m
antyutleniacz - antioxidante
anyż gwiazdkowy - estrela-de-anis, anis-estrela
anyż gwiaździsty - estrela-de-anis, anis-estrela
aorta - aorta f
aparat rentgenowski - unidade de raio-X f
apasz - criminal
apatia - apatia f
Apeniny - Apeninos
apetyt - apetite
aplikator - aplicador m
aplikować - administrar
apluzyna - laranja f
Apollo - Apolo
aporia - aporia
apryl - abril
apsik - atchim!
a psik - atchim!
aptek - farmácia f
apteka - farmácia f
aptekarz - farmacêutico m
Arab - árabe
Arabia Saudyjska - Arábia Saudita
arabista - arabista m
arabistka - arabista
arabski - árabe
arabus - árabe
Aragonia - Aragão
arak - arak m
arbuz - melancia f
archaiczny - arcaico
archanioł - arcanjo m
archimandryta - arquimandrita m
architraw - arquitrave
Argentyna - Argentina
argon - argônio m, árgon m
argumentacja - argumentação f
arka Noego - arca de Noé f
Armenia - Arménia, Armênia
armia - exército m
armijo - exército m
arogancja - arrogância f
aromaterapia - aromaterapia f
aromatyczny - aromático
arsen - arsénico m, arsênio m
artefakt - artefacto m
Aruba - Aruba f
as - ás
aseksualizm - assexualidade
asfaltować - asfaltar
aspiracja - aspiração f
astat - astatínio m, astato m
astenosfera - astenosfera f
asterysk - asterisco
astma - asma f
astronom - astrônomo, astrónomo
astronomia - astronomia f
astronomio - astronomia f
Asyria - Assíria
aszynbecher - cinzeiro m
atak - attaque m
atak serca - infarto Agudo do Miocárdio, IAM
ateista - ateísta, ateu
ateistka - ateia f
ateistyczny - ateístico, ateu
ateusz - ateísta, ateu
atmosfera - atmosfera f
atrybut - atributo
Augiasz - Aúgias m
aukcja - leilão m
australijski pies pasterski - boiadeiro australiano m
Austria - Áustria f
austriacki - austríaco
autentycznie - autenticamente
autobana - auto-estrada
autobus - ônibus m
autoklaw - autoclave
autokracja - autocracia
autonomia - autonomia f
autostrada - auto-estrada
autyzm - autismo m
awokado - abacateiro m, abacate m
Azerbejdżan - Azerbaijão
Azja - Ásia f
Azja Mniejsza - Ásia Menor f
Azjatka - asiática f
Azory - Açores
azot - nitrogênio m
baba - mulher f, velha f (stara), bolo m
babcia - vovó f, avó f
babka - vovó f, avó f
bachraty - gordo, obeso, grosso, grosseiro
bać się - temer, ter medo
Badenia-Wirtembergia - Baden-Württemberg
bagnet - baioneta f
bajer - mentira
bajtel - filho m, criança f
bajzel - bordel m
bakcyl - bacilo m
bakłażan - beringela, berinjela
bakteriemia - bacteremia f, bacterémia f
bakteriobójczy - germicida
bakteriolog - bacteriologista m
bakteryjny - bacteriano
bałaganiarz - bagunceiro m
bałaguła - cacete m
balet - balé
balsam - bálsamo m
Bałtyk - Mar Báltico
Bałtyka - Báltica
bana - trem (braz.) m, comboio (port.) m, desejo m, atração f
banał - banalidade f
banan - banana m
banana - banana m
bandaż - ligadura f
bandyta - bandido m
bandzioch - barriga f
bandzior - bandido m
bania - cabeça f, pessoa f
baniak - cabeça f, pessoa f
banjo - banjo m
bank krwi - banco de sangue m
bank spermy - banco de esperma m
bar - bário m
Baran - Áries
Baranek Boży - Cordeiro de Deus m
bark - ombro m
barki - ombro m
barok - barroco
Bartłomiej - Bartolomeu m
barwa - cor f, naipe m
bas - barriga f
Bask - basco m
baskijski - basco
batalion - batalhão m
batat - batata-doce, batata-da-terra, batata-da-ilha
bateria - pilha f
batłąch - garrafa f
batymetria - batimetria f, batometria f
Bazylea - Basileia
Bazylisa - Vasilisa f
beatyfikacja - beatificação
bebech - barriga f
bęben - barriga f
bębenek - membrana timpânica, tímpano
bejc - bêbedo
Belgia - Bélgica
Beniamin - Benjamim m
Benin - Benim
berbela - vodka f, aguardente m
bergamota - bergamota
Berlin Zachodni - Berlim Ocidental
bermudy - bermuda f
beryl - berílio m
bety - pijama
bezbożnik - ateu m
bezdech - apnéia f
bezgorączkowy - sem febre
bezmocz - anúria f
bezosobowy - impessoal
białaczka - leucemia f
biała herbata - chá branco
Białoruś - Bielorrússia
biały - branco
Biblia - Bíblia f
bibliografia - bibliografia f
biblioteka - biblioteca
biedronka - joaninha f
biegunka - diarreia f
bierne palenie - tabagismo passivo
bikorn - bicorne, bisão m
bindasz - pênis m, pénis m
bindka - ligadura f
binia - moça f, menina f, rapariga f, namorada f, empregada f, doméstica f
biochemia - bioquímica
biofilm - biofilme m
biograficzny - biográfico
biologia - biologia f
biologicznie - biologicamente
biologiczny - biológico
bioróżnorodność - biodiversidade f
biseksualizm - bissexualidade f
biskup - bispo m
bitwa pod Termopilami - batalha das Termópilas f
biurko - escrivaninha f
bizmut - bismuto m
bizon - bisão m
blaga - mentira
blasfemia - blasfémia f
bławat - aciano m
Bliski Wschód - Médio Oriente, Oriente Médio
blizna - cicatriz f
Bliźnięta - Gêmeos
bliźnięta syjamskie - gémeos siameses
błona bębenkowa - membrana timpânica, tímpano
błona dziewicza - hímen m
błona śluzowa - mucosa f
błonnik - fibra dietética f, fibra alimentar f
bluza - blusa f
bluźnierstwo - blasfémia f, blasfêmia f
bo - porque, já que
bóbr - castor m
bocian - cegonha f
bodziec - estímulo m
bóg - deus m
Bóg - Deus
Bohemia - Chéquia f, Tchéquia f, Boémia
bohr - bóhrio m
bojkot - boicote
bojownik - batalhão m
ból - dor f
Boliwia - Bolívia
bomba atomowa - bomba atômica f
bombarda - bombarda
bombel - filho m, criança f
bómbón - bombom
bor - boro m
borowina - fango m
boski - divino
Bośnia i Hercegowina - Bósnia e Herzegovina
Bośniak - bósnio m
botanik - botânico m
boża krówka - joaninha f
brać - tomar, pegar
brachol - irmão m
bracieniec - irmão m
brak miesiączki - amenorreia f
bramkarz - goleiro, guarda-redes
bransoletka - pulseira f
brat - irmão m
braterski - fraterno
bratni - fraterno
brauza - laranjada f
brąz - bronze m
Brazylia - Brasil m
brazyliana - árvore de café f, café m
Brazylijczyk - brasileiro m
Brazylijka - brasileira f
brazylijski - brasileiro
brodawka sutkowa - mamilo m
broń - arma f
browar - cerveja f
brudzić - sujar
brutalnie - brutalmente
brydż - bridge m
bryg - brigue
bryka - carro
brzemię - acusação f
brzemienny - grávida f
brzmienie - som
brzoskwinia - pêssego m
brzuch - barriga f
brzydki - feio m, feia f
brzydota - feiura f, fealdade f
brzytwa - navalha
buc - chuj
buchalter - guarda-livros m, contador m, contabilista m
buda - escola f
buddyjski - budista
buddysta - budista m
budyń - pudim m
Bułgaria - Bulgária
bulić - custear, pagar
bulimia - bulimia nervosa f, bulimia f
burak - beterraba
bursztyn - âmbar
burza - tempestade
burzowiny - cerveja f
but - sapato m, bota f
butelka - garrafa f
buzi - beijo
być - ser, estar
bydło - gado m
Byk - Touro
Była Jugosłowiańska Republika Macedonii - Antiga República Jugoslava de Macedónia
bździągwa - percevejo
całki - todo, inteiro, intacto
całkowicie - inteiramente, totalmente
całus - beijo
cały - todo, inteiro, intacto
cały i zdrowy - são e salvo
cecha - atributo m, característica f
cedr libański - cedro-do-líbano
cegła - tijolo m
Cejlon - Ceilão
cellulit - celulite
celtycki - céltico
cel uświęca środki - os fins justificam os meios
cenotaf - cenotáfio
centryzm - centrismo m
centurion - centurião
cera - filha f
cesarskie cięcie - cesariana f
cewka moczowa - uretra f
cewnik - catéter m
chabanina - carne f
chabas - carne f
chaber - aciano m
chachoł - cerviz f
chachor - bêbedo
chamera - nuvem f
chaotyczny - caótico
charakterystyczny - característico
charakterystyka - característica f
charakteryzacja - caracterização f
charczeć - ressonar
charkać - cuspir
charyzmat - carisma
charyzmatyczny - carismático
chemia biologiczna - bioquímica
chemia organiczna - química orgânica
chemik - químico m
chemioterapia - quimioterapia f
chemoterapia - quimioterapia f
chemotropizm - quimiotropismo m
Cheronea - Queroneia
Cheroneja - Queroneia
chilijski - chileno
chira - vodka f, aguardente m
chirurgia kosmetyczna - cirurgia estética f
chirus - bêbedo
chitozan - quitosana
chleb - pão m
chleb pokładny - pão da proposição m
chlor - cloro m, bêbedo
chmiel - lúpulo m, cerveja f
chmura - nuvem f
choinka - árvore de Natal
chójk - árvore de Natal
cholesterol - colesterol m
choroba - doença
choroba lokomocyjna - cinetose, enjoo m
choroba morska - enjoo marítimo m
choroba Parkinsona - doença de Parkinson f
choroba von Willebranda - doença de Von Willebrand
chorobotwórczość - patogenicidade f
Chorwacja - Croácia
chować - enterrar
chów wsobny - endocruzamento m
chrapać - ressonar
chrom - crômio m
chromosfera - cromosfera f
chromosom - cromossoma m
chruścik - tricóptero
chrypka - rouquidão f
chrząstka - cartilagem f
chrześcijanin - cristão m
chrześcijański - cristão
chuj - chuj
chustka - pano
chwila - momento m
chwost - rabo m, cauda f
chytry - astuto
ciąg arytmetyczny - progressão aritmética f
ciało - corpo m
ciało obce - corpo estranho m
ciało szkliste - humor vítreo
ciebie - você
ciecierzyca - grão-de-bico, gravanço, ervanço, ervilha-de-galinha, ervilha-de-bengala
ciecz łzowa - líquido lacrimal m
ciemnia - câmara escura f
ciemnia fotograficzna - câmara escura f
ciemno - escuridão, trevas
ciemność - escuridão, trevas
ciepło - calor
cierpliwość - paciência f
cieść - sogro m
cieśń gardzieli - istmo das fauces, orofaríngeo
ciężarny - grávida f
ciężki - pesado m, pesada f
ciocia - tia f
ciorać - sujar
ciśnienie - pressão f, pressão sangüínea
ciuciek - cachorro m, cachorrinho m, cãozinho m
ciupa - prisão, cadeia, cárcere
ciurlocek - pênis m, pénis m
ciurma - prisão, cadeia, cárcere
ciżma - sapato m, bota f
ćma - traça f, mariposa f, borboleta noturna f, falena f, escuridão, trevas
ćmaga - vodka f, aguardente m
ćmik - cigarro m
cnota - virtude f
cnoty kardynalne - virtudes cardinais
co - O que
cokolwiek - qualquer
cołki - todo, inteiro, intacto
córa - filha f
córczysko - filha f
córka - filha f
cos - cos
co z oczu, to z serca - longe dos olhos, longe do coração
ctg - cot, ctg
cud - milagre
cudzić - purificar
cudzokrain - estrangeiro m
cudzołożyć - adulterar
cudzoziemiec - estrangeiro m
cug - trem (braz.) m, comboio (port.) m, desejo m, atração f
cukier - açúcar
cukierdoza - açucareiro
cukierek - bombom
cukiernica - açucareiro
cukierniczka - açucareiro
cukinia - abobrinha
cukrowiec lekarski - cana-de-açúcar f
cukrzyca - diabetes f
cumel - chupeta
cumelek - chupeta
ćwiczenie czyni mistrza - a prática faz a perfeição
ćwierć - quarto
ćwierćfinał - quartas de final
ćwierćnuta - semínima f
cyber- - ciber-
cybernetyka - cibernética f
cyberprzestrzeń - ciberespaço
cyferblat - rosto m
cyfra - dígito m, algarismo m, cifra, número
Cygan - cigano m
cygański - cigano
cygareta - cigarro m
cygaretka - cigarro m
cygaro - charuto m
cyklista - ciclista m
cykoria - chicória f
cylindryczny - cilíndrico
cyna - estanho
cynizm - cinismo
cynk - zinco m
Cypr - Chipre
cypresz - cipreste m
cyprys - cipreste m
cyrk - circo m
cyrkiel - compasso m
cytologia - citologia f
cytryna - limão m
cytrynat - limão m
cywilizacja - civilização f
czad - monóxido de carbono m
czador - xador, chador
czaj - chá m
czajnik - cabeça f, pessoa f
czarna dziura - buraco negro
czarna skrzynka - caixa-preta f, caixa-negra f
Czarnogóra - Montenegro
czarny - preto, prateado
czarny rynek - mercado negro
czarodziej - bruxo m
czarujący - charmoso
czasopismo - revista
czasownik - verbo m
czasowy - passageiro
cząsteczka - molécula f
czas to pieniądz - tempo é dinheiro
czciciel - adorador m
Czechosłowacja - Checoslováquia, Tchecoslováquia
Czecho-Słowacja - Checoslováquia, Tchecoslováquia
Czechy - Chéquia f, Tchéquia f, Boémia
czędo - filho m, criança f
czekolada - chocolate m
czernica - amora
czerwiec - junho
czerwone mięso - carne vermelha
czerwony - vermelho, encarnado
czerwony olbrzym - estrela vermelha gigante f
cześć - oi
częstość - frequência f
częstoskurcz - taquicardia f
częsty - freqüente
członek - membro m, pênis m, pénis m
człowieczy - humano
czorny - preto, prateado
czuć się jak ryba w wodzie - estar como peixe na água
czwartek - quinta-feira f
czwartorzęd - Quaternário
czyhunka - tório
czyrwiec - junho
czyrwień - junho
czyścić - purificar
czyściec - Purgatório
czystość - limpeza f, virtude f, castidade f
czytać - ler
D - genitivo m
dąb - carvalho m
dać - dar, oferecer, permitir, deixar
dach - telhado m
Dafne - Dafne f
Dagestan - Daguestão
daktyl - tâmara f
dała - dar, oferecer, permitir, deixar
dalekowzroczność - hipermetropia f
Dalmacja - Dalmácia
dalmatyńczyk - dálmata
dana - dar, oferecer, permitir, deixar
Dania - Dinamarca
dany - dar, oferecer, permitir, deixar
daremny - desnecessário m
darowanemu koniowi w zęby się nie zagląda - a cavalo dado não se olha os dentes
dawca - doador m
defenestracja - defenestração f
definicja - definição
deizm - deísmo m
Dekan - Decão
dekiel - cabeça f, pessoa f
deklamować - declamar
dekolonizacja - descolonização f
dekoracja - decoração
dekorować - decorar
delegat - delegado m
delfin - golfinho
delikatność - delicadeza f
demagogia - portugalski f
demografia - demografia f
Demokratyczna Republika Wyspy Świętego Tomasza i Wysp Świętego Tomasza i Książęcej - República Democrática de São Tomé e Príncipe
demontować - desmontar
dentysta - dentista m
depopulacja - infrapopulação f
deportacja - deportação f
derkacz - codornizão m
derwisz - dervixe
despotyzm - despotismo m
destabilizacja - desestabilização f
destrukcja - destruição
deszcz - chuva f
deżdż - chuva f
dezinformacja - desinformação f
dezodorant - desodorante m, desodorizante m
dialekt - dialecto (port.), dialeto (braz.)
diecezja - diocese
Diogenes - Diógenes m, Diógenes m (de Sinope)
dla - para, com, por
dławić - sufocar
długi - comprido m, longo m, demorado m
Dniepr - Dnieper m, Dniepre m, Borístenes m
dobranoc - boa noite
dobrobyt - prosperidade f
dobry - bom, correto, certo, saboroso, gostoso, comportado, competente, interessante
dobry wieczór - boa noite
dochód - lucro m
dogmat - dogma
dogodny - oportuno
doić - ordenhar, mamar
dokładność - exactidão f
doktor - médico m
doktorant - doutorando
doktryna - doutrina f
dokument - documento m
dół - buraco m
dolmen - anta, dólmen
dołować - enterrar
dom - casa f, lar m, residência f
dom dziecka - orfanato m
domowej roboty - caseiro
dom publiczny - bordel m
dopełniacz - genitivo m
dopiero - só, somente, apenas
doradca - conselheiro m
dorzecze - bacia f
doskonałość - perfeição f
dostęp - acesso m
dostojnik - dignitário m
do trzech razy sztuka - às três é de vez
do widzenia - adeus, até logo, passe-bem
dowód - demonstração f, prova f, evidência f, documento de identidade m
do zobaczenia - adeus, até logo, passe-bem
dramatyczny - dramático
drapacz chmur - arranha-céu
drażnić - irritar
drewno - madeira f
droga - caminho m, estrada f, viagem f, itinerário m, trajeto m, trajetória f
droga ekspresowa - via expressa, via rápida, via reservada
Droga Mleczna - Via Láctea
druga wojna światowa - Segunda Guerra Mundial
drukarka - impressora f
drwić - zombar
drybling - drible
drżenie - palpitação
drzewo - árvore f
drzwi - porta f
duch - fantasma, aparição, alma, espírito
duchowość - espiritualidade f
dudy - pulmão m
duet - dueto m
dukat - ducado m
duma - orgulho m
duński - dinamarquês
dupa - bunda f
durniacha - crédulo
dusza - fantasma, aparição, alma, espírito
duszpasterski - pastoral
duży - grande
dwukropek - dois pontos /m
dwupłat - biplano m
dwupłatowiec - biplano m
dychawica - asma f
dycht - inteiramente, totalmente
dycki - sempre
dydaktyczny - didático
dyktator - ditador m
dylać - dançar
dymbcok - carvalho m
dymek - balão de diálogo
dyplom - diploma m
dysfagia - disfagia f
dysforia - disforia
dysk - disco m
dyskryminować - discriminar
dysmorfofobia - dismorfofobia f
dyspozycyjny - descartável
dziadek - avô m
dzieciobójstwo - infanticídio
dzieciszczko - filho m, criança f
dziecko - filho m, criança f
dzięki - agradecimento m, obrigado, obrigada, graças a
dziękówa - obrigado
dziękówka - obrigado
dziękuję - obrigado
dziękuję bardzo - muito obrigado
dziela - para, com, por
dzień - dia m
dzień dobry - bom dia
dziennikarski - periodístico
dziennikarstwo - jornalismo m
dzień wypłaty - dia de pagamento m
dziewa - moça f, menina f, rapariga f, namorada f, empregada f, doméstica f
dziewczę - moça f, menina f, rapariga f, namorada f, empregada f, doméstica f
dziewczyna - moça f, menina f, rapariga f, namorada f, empregada f, doméstica f
dzik - javali
dżinn - gênio m
dziób - bico m
dziołcha - moça f, menina f, rapariga f, namorada f, empregada f, doméstica f
dziopa - moça f, menina f, rapariga f, namorada f, empregada f, doméstica f
dziś - hoje
dzisiaj - hoje
dziunia - moça f, menina f, rapariga f, namorada f, empregada f, doméstica f
dziura - caverna f
dżungla - selva f
dźwig - elevador m
EBOiR - BERD
EBOR - BERD
echo - eco m
echolalia - ecolalia f
edometr - edómetro m, edômetro {{m, consolidômetro }
edytor tekstu - processador de texto
edytować - editar
efekt uboczny - efeito adverso, reação adversa (ao medicamento)
Egina - Egina
Egipt - Egipto (w Portugalii), Egito (w Brazylii)
egiptolog - egiptólogo
egocentryczny - egocêntrico
egzaltacja - exaltação f
egzekwować - executar, exigir
egzemplarz - espécime
egzystencjalizm - existencialismo m
ekologia - ecologia f
ekologiczny - ecológico
ekologio - ecologia f
ekonomiczny - económico
ekosystem - ecossistema
ekran - tela f, blindagem f
eksfoliacja - esfoliação f, exfoliação f
ekshibicjonizm - exibicionismo m
eksplikować - traduzir
ekspozycja - exposição f
ekstrakcja - extração f
ekstremizm - extremismo
Ekwador - Equador
elefant - elefante m
elegancko - elegantemente
elekcja - eleição f
elektroluks - aspirador m
elektron - elétron m
elektronika - eletrônica f, eletrónica f
elektryk - eletricista m
element - elemento m
elipsa - elipse f
Elza - Elisabete f
Elżbieta - Elisabete f
embriologia - embriologia f
Emili - Emília
Emilia - Emília
Emilia-Romania - Emília-Romanha f
emirat - emirado m
emocja - emoção f
empiryzm - empirismo
emu - emu m
encefalopatia - encefalopatia f
encyklopedia - enciclopédia f
encyklopedyczny - enciclopédico
encyklopedysta - enciclopedista
endogenny - endógeno
endokrynologia - endocrinologia f
endorfina - endorfina f
epitafium - epitáfio m
epoka - epoceus
epoka kamienia łupanego - Paleolítico
eponim - epônimo
erekcja - ereção f
erotyka - erotismo m
Erytrea - Eritreia (w Portugalii), Eritréia (w Brazylii)
ESBC - SEBC
eschatologia - escatologia f
eskalator - escada rolante f
eskimoski - esquimó
eskulap - médico m
Estonia - Estónia (w Portugalii), Estônia (w Brazylii)
eta - eta
eteromania - eteromania f
Etiopia - Etiópia
etniczny - étnico
ETPC - TEDH
etymologia - etimologia f
euforia - euforia f
eurocent - cêntimo
Europa - Europa
Europa Zachodnia - Europa Ocidental, Oeste Europeu
ewangeliarz - evangeliário m
ewolucjonizm - evolucionismo m
eż - que
Ezdrasz - Esdras
Ezop - Esopo m
ezoteryczny - esotérico
facet - homem m, varão m
facetka - mulher f
facjata - rosto m
fagocista - fagotista m
fajek - cigarro m
fajerwer - cigarro m
fajfus - pênis m, pénis m
fajka - cigarro m
fakt - fato m
fala - onda f
fana - bandeira
fanatycznie - fanaticamente
fanatyzm - fanatismo m
farma - fazenda f, sítio m, granja f
faryna - açúcar
fasola - feijão f
faszysta - fascista m
faszyzm - fascismo
fatalista - fatalista m
Fatima - Fátima
fatwa - fatwa f, fátua f
fawela - favela f
Federacyjna Republika Brazylii - República Federativa do Brasil
fefrać się - temer, ter medo
felieton - folhetim m
feminizm - feminismo m
fenek - feneco m, raposas-do-deserto
Fenicja - Fenícia f
Ferdynand - Fernão
fermata - fermata f
ferska - pêssego m
feta - feta, anfetamina f
fezeła - abelha f
Fidżi - Fiji
filip - lebre
Filip - Felipe m
film - filme m, película f
filmować - filmar
filozofia - filosofia f
filozofia dziejów - filosofia da história
filozofia historii - filosofia da história
filozoficzny - filosófico
filtr - filtro m
filtrowanie - filtração f
finalizować - finalizar, completar
finansowo - financeiramente
Finlandia - Finlândia
fiołek trójbarwny - amor-perfeito
fioletowy - violeta, lilás
fiut - chuj
fiżon - feijão f
fizyka Słońca - heliofísica f
flag - bandeira
flaga - bandeira
flaszka - garrafa f
flaszowiec miękkociernisty - graviola, pinha
fleks - rebarbadora
flep - documento m
flet - flauta, chuj
Florencja - Florença
fluoksetyna - fluoxetina f
fluor - flúor m
Fobos - Fobos m
fojercojg - isqueiro
fojercok - isqueiro
folacyna - folacina f
fontanna - fonte f, chafariz m
formatować - formar, formatar
forteklapa - piano (de cauda) m, pianoforte m, fortepiano m
fortepian - piano (de cauda) m, pianoforte m, fortepiano m
foryster - estrangeiro m
fosfor - fósforo m
fotografia - fotografia f
fotografie - fotografia f
fotorealizm - fotorrealismo m
fototropizm - fototropismo
fowistyczny - fauvista
fowizm - fauvismo m
Francja - França
francuski pocałunek - beijo de língua m
Francuz - francês
frasunek - aflição, pesar, preocupação
frela - moça f, menina f, rapariga f, namorada f, empregada f, doméstica f
fresk - afresco m
frutarianizm - frugivorismo m
fryc - alemão m
Fryc - alemão m
fryzura - penteado
Fudżi - Fuji
fundamentalista - fundamentalista
fundamentalny - fundamental
funkcja - função f
funkcja stanu - função de estado
fura - carro
furdygarnia - prisão, cadeia, cárcere
furosemid - furosemida
furt - de novo, novamente
fusbal - futebol m
futbol - futebol m
futuryzm - futurismo
Gabon - Gabão
gad - réptil m
gadałka - fada
gała - olho m, futebol m, gralha cinzenta
galaktyka - galáxia
galicyzm - galicismo
Galilea - Galileia f, Galilea f
gametangium - gametângio
ganc - inteiramente, totalmente
gapa - gralha cinzenta
gara - sono m, sonho m
garb - corcunda f, corcova f
garbus - corcunda m, fusca m
gasa - rua f
gąść - jogar, tocar (emitir som), combinar, tocar (instrumento musical), apresentar (peça teatral), fazer papel
gąsienica - lagarta f
gatunkowizm - especismo m
gaz - gás m, acelerador m
gazela - gazela
gaz musztardowy - gás mostarda
gdy - quando, enquanto
gdy kota nie ma, myszy harcują - quando o gato sai, os ratos fazem a festa
gdyż - porque, já que
gdzie - onde
geburstag - dia de anos, aniversário
gędzić - jogar, tocar (emitir som), combinar, tocar (instrumento musical), apresentar (peça teatral), fazer papel
generator - gerador m
genetyczny - genético
geniusz - gênio m
gentamycyna - gentamicina f
Genua - Génova
geografia - geografia
geologia - geologia
gepard - chita
geriatria - geriatria f
germański - alemão
getto - gueto n, favela n
gimnastyka - ginástica
ginąć - desaparecer, perder-se, morrer, ficar extinto
ginekologia - ginecologia f
gira - perna f
gladiator - gladiador m
glajza - tório
glancować - purificar
glapa - gralha cinzenta
gleba - solo m
głęboko - profundamente
glicerol - glicerol
gliceryna - glicerol
glicerynowy - glicérico
glin - alumínio m
glina - policial m
gliniarz - policial m
globus - cabeça f, pessoa f
głód - fome
głodny - faminto, com fome
głośnik - altifalante m, alto-falante m
głowa - cabeça f, pessoa f
główka - cabeça f
głuchota - surdez f
głuchy - surdo
glukometr - glicosímetro m
glukoza - glicose f, glucose
gnat - osso m, dado m
gniew - ira f, cólera f
gnot - filho m, criança f
gnu - gnu
godka - língua f, linguagem f
godność - dignidade f
Godzilla - Godzilla
godzina - hora f
Godzina dla Ziemi - Hora do Planeta
godzinnik - relógio m
golfista - golfista m
gondola - gôndola f
gonić - perseguir, alcançar
goniec - bispo m
gora - incêndio m
góra - montanha f, monte m, morro m, topo m
górą - montanha f, monte m, morro m, topo m
gorący - quente
góralek - damão
gorczyca - mustarda f
Górny Śląsk - Alta Silésia f
gorszy - pior
Góry Skaliste - Montanhas Rochosas
gorzała - álcool m
gorzałka - vodka f, aguardente m
gorzoła - vodka f, aguardente m
górzysty - montanhoso
gość - convidado m, hóspede m, cliente m, sujeito m
gościniec - estrada f, pousada f
gospodyni domowa - dona-de-casa f, dona de casa f
gotować - ferver, cozinhar, cozer
gotowy - pronto
gotyk - gótico m
goździk - cravo-da-índia m
gra - jogo m, competição f, tocar m (instrumento musical) (ato de)
graba - mão
grabarz - coveiro m
grabie - ancinho m
grać - jogar, tocar (emitir som), combinar, tocar (instrumento musical), apresentar (peça teatral), fazer papel
gracz - jogador m
grad - granizo m, enxurrada f, grado m
grafia - grafia f
gramatyka - gramática
granatowy - grená, índigo
granica - fronteira f
gratulacja - congratulação f
gratyfikacja - gratificação f
gregoriański - gregoriano
grejpfrut - grapefruit f, toronja f, toranja f
grób - túmulo m
gróbarz - coveiro m
grobowiec - piano (de cauda) m, pianoforte m, fortepiano m
grobowy - fúnebre, sepulcral
gronostaj - arminho
groźba - ameaça f
gruby - gordo, obeso, grosso, grosseiro
grudzień - dezembro m
grupa - grupo m
grupa śmierci - grupo da morte
gruszka - pera f
gryf - grifo
gryka - sarraceno m
grynszpan - azinhavre m
gryzoń - roedor m
grzbiet - dorso
grzebać - cavar, mexer, enterrar
grzech - pecado m
grzeczny - polido, cortês
Grzegorz - Gregório m
gułag - gulag m
guli - porque, já que
gwałt - estupro m, pressa f
gwiazda - estrela f
gwiazdarz - astrônomo, astrónomo
gwiazdozbiór - constelação
gwiaździarz - astrônomo, astrónomo
Gwinea Równikowa - Guiné Equatorial
gwizdek - apito m
gzub - filho m, criança f, barriga f
habituacja - habituação
haft - bordado m
Haiti - Haiti
hajtok - faca f
hak - gancho m
haki - gancho m
hałaśliwy - buliçoso
halucynacja - alucinação f
hamburger - hambúrguer m, hamburger m
haplotyp - haplótipo m
hara - vodka f, aguardente m
harcerz - escoteiro m
harfista - harpista m
harmonijny - harmonioso
haś - imundície, lixo
hau - au-au, ão-ão
haubica - obus
hę - O que
hedonista - hedonista
hedonistyczny - hedónico
hedonizm - hedonismo m
hektolitr - hectolitro m
helio- - helio-
heliofizyka - heliofísica f
hellenistyczny - helenístico
hemisfera - hemisfério m
hemoliza - hemólise
hentai - hentai m
heparyna - heparina
herbarz - herbário
herbata - chá m
herbatnik - bolacha f
hermeneuta - hermeneuta m
Herod - Herodes m
heroiczny - heróico
hetki - inteiramente, totalmente
hiacynt - jacinto m
Hiacynt - Jacinto m
hidżab - hijab m
higroskopijność - higroscopia
Himalaje - Himalaia, Himalaias
hiperestezja - hiperestesia
hipoalergiczny - hipoalergénico
hipokorystyk - hipocorístico m
hipomania - hipomania f
hipotetyczny - hipotético
hirsutyzm - hirsutismo m
histeria - histeria f
historia - história f, conto m
historiozofia - filosofia da história
historyk - historiador
Hiszpania - Espanha f
hiszpanka - gripe espanhola
hokej - hóquei m
Holandia - Holanda, Países Baixos, Neerlândia
Holandyja - Holanda, Países Baixos, Neerlândia
homeopatia - homeopatia f
homeostaza - homeostasia, omeostase
homiletyka - homilética f
Hongkong - Hong Kong
hoplita - hoplita m
Horacy - Horácio m
Horeb - Horebe
hormon - hormona f
hormonozależny - hormonodependente
Horus - Hórus
horyzont - horizonte
hotel - hotel
hreczka - sarraceno m
hummus - homus, hommos
Hurghada - Hurghada
hydrologia - hidrologia f
hydrostatyka - hidrostática
hymenopterologia - himenopterologia f
i - e
idea - idéia f
ideologia - ideologia f
idol - ídolo m
idole - ídolo m
igła - agulha f
ignorancja - ignorância f
II wojna światowa - Segunda Guerra Mundial
ikona - ícone
ilość - quantidade f, número m
ilustrator - ilustrador m, desenhador m
ilustrować - ilustrar
imam - imame, imamo, imã, imam
imbir - gengibre m
imię - nome m
imiennik - tocaio m, xará (braz.) m
imiesłów - particípio m
imperator - imperator
implant - implante
inauguracja - inauguração f
indoeuropejski - indo-europeu
infiltracja - infiltração f
inflacja - inflação f
informacja - informação f
informatyka - informática f, computação f
infrastruktura - infraestrutura f
inicjalizować - inicializar
inkszy - outro, diferente
inkwizycja - Inquisição f
inny - outro, diferente
ino - apenas
insekt - inseto m
instalować - instalar, instalar-se
instynkt - instinto m
insulina - insulina f
insulinooporność - resistência à insulina f
integracja - integração
inteligencja - inteligência
intencja - intenção
intencjonalny - intencional
intensywność - intensidade f
interakcja - interação
internauta - internauta
interpretacja - interpretação f
interwencjonizm - intervencionismo m
introdukcja - introdução f
inundacyja - inundação f
inwestycja - investimento
iny - outro, diferente
inżynier - engenheiro
inżynieria - engenharia
Irlandka - irlandês
iryd - irídio m
iryzacja - iridescência f
iść - andar, ir
iście - certamente
Islandia - Islândia
islandzki - islandês, islandês m
Itaka - Ítaca
iż - que
izba - paz, sala m, aposento m, quarto m, câmara f
ize - que
izolacjonizm - isolacionismo m
izotop - isótopo m
Izrael - Israel
ja - eu
jabłko - maçã f
jabłoń - macieira f
Jacek - Jacinto m
Jahwe - Javé m
jajko - ovo m
jajo - ovo m
jak - como
jakie drzewo, taki klin, jaki ojciec, taki syn - tal pai, tal filho
jaki ojciec, taki syn - tal pai, tal filho
jako - como
jakość - qualidade f
jak się masz? - como você está?, como está?
Jakub - Jacó, Jaime, Iago, Tiago, Diogo
jałmużna - esmola f
Jan - João
jantar - âmbar
japa - caverna f
jara - sogra f
jarecka - mãe f, madre f
jaskinia - caverna f
jaskiniowiec - cavernícola
jaśmin - jasmim
jaszczurka - lagarto m, lagartixa f
jebadło - quarto m, dormitório m, cama m
jeden - só, sozinho
jedna jaskółka nie czyni wiosny - uma andorinha só não faz verão
jedna jaskółka wiosny nie czyni - uma andorinha só não faz verão
jednorożec - unicórnio m, licórnio m
Jędrzej - André
jemioła - visco m
Jerycho - Jericó
Jerzy - Jorge
jesień - outono m
jeśli - se
jeśli wejdziesz między wrony, musisz krakać jak i one - quando em Roma, faça como os romanos
jest - ser, estar
jeż - ouriço m
jeżeli - se
Jezus - Jesus m
Jezus Chrystus - Jesus Cristo
język - língua f, linguagem f
język ojczysty - língua materna f
jeżyna - amora
jidysz - iídiche
jod - iodo m
joga - ioga f
Jordan - Jordão m
Jowisz - Júpiter
Jozafat - Josafat m, Josafá m
Judasz - Judas m
Jugosławia - Jugoslávia
juliański - juliano
juny - jovem
jupa - blusa f
Jupiter - Júpiter
Jur - Jorge
jurgielt - soldo m
jutro - amanhã
kabaczek - abobrinha
kabergolina - cabergolina f
Kabylia - Cabília
kaczka - pato
kadzidło - incenso m
Kafarnaum - Cafarnaum
kaffa - árvore de café f, café m
kaftan bezpieczeństwa - camisa de força f
kaj - onde
kakao - cacau m
kaki - caqui
kałabania - charco m
kalafa - nariz m, rosto m
kalapitra - cabeça f, pessoa f
kalejdoskop - caleidoscópio m, calidoscópio m
kalfas - barriga f
kalifat - califado m
kałuża - charco m
kam - onde
kamasz - sapato m, bota f
kamfora - cânfora f
kamień szlachetny - gema f
Kampania - Campânia f
Kanada - Canadá m
kanalizacja - efluente
kandydat - candidato m
kaolin - caulim
kapeć - pneumático
kapecytabina - capecitabina f
kąpiółka - banheiro m
kapitan - capitão m
kapować - compreender, entender
Kapsztad - Cidade do Cabo m
karaba - gato
karaibski - caraíba
Karaiby - Caribe
karczoch - alcachofra
kardamon - cardamomo m
kardiolog - cardiólogo m
kardiologia - cardiologia f
kardynał - cardeal m
kark - cerviz f
karp - carpa f
Kartagińczyk - cartaginês
karta graficzna - placa de vídeo
karta pocztowa - cartão postal
kartka - cartão postal
kastrat - castrado m
Kaszmir - Caxemira f
kaszubski - cachúbio
kat - carrasco m
kataloński - catalão
Katarzyna - Catarina f, Cátia f, Kátia f
katastrofa - desastre
kąt dwuścienny - diedro, ângulo diedro / ângulo diédrico
Katyń - massacre de Katyn
kawa - árvore de café f, café m
kawa wesoła - bordel m
kawior - caviar m
kawka - gralha-de-nuca-cinzenta
kawon - melancia f
kawowiec - cafeeiro m
każda pliszka swój ogonek chwali - cada bufarinheiro louva seus alfinetes
kciuk - polegar m
kędy - onde
kefija - keffiyeh
kejter - cão m
kelner - garção m
Kenia - Quénia f
kenotaf - cenotáfio
kenotafium - cenotáfio
keta - pulseira f
khmerski - khmer, língua khmer
kicz - kitsch
kiedy - quando
kiełbasa - salsicha f
kiepeła - cabeça f, pessoa f
kierunek - direção f, tendência f
Kilimandżaro - Kilimanjaro
kilogram - quilo
kimono - sono m, sonho m
kinol - nariz m
kira - vodka f, aguardente m
Kirgistan - Quirguizistão
kiszka - leite m
Kiszyniów - Chişinău
kit - mentira
kłącze - rizoma f, fizoma f
klajdać - cobrir, vestir, revestir
kłamstwem daleko się nie zajdzie - a mentira tem perna curta
kłamstwo - mentira
kłamstwo ma krótkie nogi - a mentira tem perna curta
kłapaczka - boca
klara - Sol m
klasy - amarelinha f
klatka - tórax
klatka piersiowa - tórax
klaustrofobia - claustrofobia f
klawiatura - teclado m
klawisz - tecla f
klękać - ajoelhar-se
klekotun - cegonha f
kliber - nariz m
klon - ácer, bordo
klops - almôndega f
kluber - nariz m
klucz - chave f, chave de fenda f
kluft - roupa f
kluka - nariz m
kluza - prisão, cadeia, cárcere
koafiura - penteado
kobalt - cobalto m
kobieta - mulher f
kociamber - gato
kocimiętka - erva-de-gato f
kocioł - caldeirão
kocioł parowy - caldeira
kod - código m
kod kreskowy - código de barras m
kodu - código m
kod źródłowy - código fonte m
koja - cama m
kojo - cama m
kokotek - elevador m
kołchoz - kolkhoz
kołdra - edredão
kolegium - colégio m
kolekta - coleta f
koleś - homem m, varão m
koło garncarskie - roda de oleiro f
Kolonia - Colônia
kolonializm - colonialismo m
kolonoskopia - colonoscopia f, coloscopia f
kolor - cor f, naipe m
koło sterowe - roda do leme
Kolumb - Colombo m
Kolumbia - Colômbia
kolumna - coluna f
komar - mosquito m
komedia - comédia f
komentować - comentar
kometa - cometa
komiks - banda desenhada
komisariat - delegacia, distrito policial, esquadra
komisja - comissão
komp - computador m
kompas - bússola f
kompensacyjny - compensatório
komputer - computador m
koń - cavalo, pênis m, pénis m
kóń - cavalo
koncepcja - concepção f, conceito m
kończyna - membro m
kondensator - condensador m, capacitor
konferencja - conferência
konfiskować - confiscar
konformista - conformista m
konformistka - conformista f
konformistyczny - conformista
konformizm - conformismo m
konfraternia - confraria f
konfucjanizm - confucianismo m, confucionismo m
Konfucjusz - Confúcio m
koń mechaniczny - cavalo-vapor
konsens - consenso m
konsensus - consenso m
Konstancja - Constança f
konstelacja - constelação
konstruktywistyczny - construtivista
konstruktywizm - construtivismo m
konstytucja - constituição f
konstytucyjny - constitucional
konsumpcja - consumo
konsumpcjonizm - consumismo
kontekst - contexto m
kontemplować - contemplar
kontur - contorno m
kontynent - continente m
konwojować - comboiar
kopala - coveiro m
Kopenhaga - Copenhaga
koper - endro
kopruch - mosquito m
kora - súber m
koral - coral
Koran - Alcorão m, Corão m
kordła - edredão
Korea Północna - Coreia do Norte
Kos - Cós
kosa - faca f
kość - osso m, dado m
kosmetyczny - cosmético
kosmetyk - cosmético
kosmologia - cosmologia
kosmopolita - cosmopolita m
koszt - despesa, custo, gasto
kot - gato
kowadło - bigorna
kowalno - bigorna
Kozak - Cossaco m
Koziorożec - Capricórnio
kpić - zombar
krab - cogulho, colchete, cogoilo
Kraków - Cracóvia
kran - elevador m
krasula - vaca
kreatynina - creatinina f
kręgosłup - coluna vertebral f
kremacja - cremação f
krew - sangue m
Krista - Cristina f
krokodyle łzy - lágrimas de crocodilo
Królestwo Bhutanu - Reino do Butão
królik - coelho m
królowa - rainha f
krowa - vaca
krtań - laringe
krucyfiks - crucifixo m
krwotoczny - hemorrágico
krykiet - críquete
kryminał - prisão, cadeia, cárcere
Kryspin - Crispim m
Krystyna - Cristina f
krytykować - criticar
Krzysztof - Cristóvão
krzywoprzysięstwo - perjúrio m
ksenofobia - xenofobia f
książka telefoniczna - lista telefônica f
księgowy - guarda-livros m, contador m, contabilista m
księgozbiór - biblioteca
Księżyc - Lua
księżycowy - lunar
ksylitol - xilitol m
kształt - forma f, figura f
kształty - forma f, figura f
kto chce żyć z swojej pracy, dolegać nie trzeba - deus ajuda quem cedo madruga
kto rano wstaje, temu Pan Bóg daje - deus ajuda quem cedo madruga
Kuba - Cuba
kuć żelazo, póki gorące - malhar enquanto o ferro está quente
Kujawy - Cujávia
kula - perna f
kuloodporny - a prova de balas
kulos - perna f
kultura - cultura f
kupować - comprar
kurkuma - curcuma
kusik - beijo
kuśka - pênis m, pénis m
kuskus - cuscuz
Kusz - Cush m, Cuche
kutafon - chuj
kutas - chuj
kuzaj - primo m
kuzyn - primo m
kuzynka - prima f
kwas - ácido
kwas akrylowy - ácido acrílico
kwas azotowy - ácido nítrico
kwas foliowy - ácido fólico m, folacina f
kwas hialuronowy - ácido hialurónico m, ácido hialurônico m
kwas krotonowy - ácido crotônico
kwas mlekowy - ácido láctico
kwiecień - abril
kynologia - cinologia f
Lacjum - Lácio
lacz - cabeça f, pessoa f, pênis m, pénis m, policial m
łagodzić - suavizar, acalmar, aligeirar
lakier do paznokci - verniz de unha m, verniz para as unhas m, esmalte para as unhas {{m, esmalte }
laktaza - lactase
laktoowowegetarianizm - lacto-ovo vegetarianismo
lala - moça f, menina f, rapariga f, namorada f, empregada f, doméstica f
las - floresta f
lat - ano m
lata - ano m
lato - verão
łatwowierny - crédulo
latynizm - latinismo m
latyński - latino
Łazarz - Lázaro m
łazienka - banheiro m
Lazurowe Wybrzeże - Costa Azul f, Riviera Francesa
legalizacja - legalização f
legenda - lenda
lekarz - médico m
Leningrad - Petersburgo m
lepak - de novo, novamente
łepetyna - cabeça f, pessoa f
lepiej późno niż wcale - antes tarde do que nunca
lepszy wróbel w garści niż gołąb na dachu - é melhor um pássaro na mão do que dois voando
leszczyna - avelaneira f, aveleira f
lew - leão
Lew - Leão
lewica - esquerda f
Lhasa - Lassa, Lhasa
Liban - Líbano m
Libijczyk - líbio m
liczba podwójna - dual
lilia - lírio
limnologia - limnologia
linia - linha f, carreira
lipiec - julho
lipodystrofia - lipodistrofia
liściokwiat garbnikowy - sarandi
lis polarny - raposa-do-ártico, raposa-polar
lista - lista
listopad - novembro
literacki - literário
liturgiczny - litúrgico
Litwa - Lituânia
liza - lise f
Lizbona - Lisboa f
łobocyć - ver, olhar
lodowiec - glaciar m, geleira f
łódź - barco
logarytm - logaritmo m
logika - lógica f
logiko - lógica f
lojalność - lealdade f, fidelidade f
lokalizacja - localização f
lokatiwus - locativo m
łokieć - cotovelo m
lola - moça f, menina f, rapariga f, namorada f, empregada f, doméstica f
Lombardia - Lombardia
Londyn - Londres f
łosoś - salmão m
losowy - aleatório
lot - voo, vôo
lotnisko - aeroporto m
lotniskowiec - porta-aviões
lotos - lótus m
lotus - lótus m
Łotwa - Letónia
łoże - leito m, cama m
łoże śmierci - leito de morte m
łóżko - cama m
łóżko piętrowe - beliche m
lub - ou
łucznictwo - tiro com arco m
łucznik - arqueiro m
ludność - população f
ludobójstwo - genocídio
łudzikwiat - abril
ludzki - humano
łuk - arco m
luksus - luxo m
luksusowo - à grande
lulka - cigarro m
lumbago - lumbago m
luńt - cão m
lupa - lupa f
łupek - ardósia f
luty - fevereiro, Fevereiro
łża - mentira
mać - mãe f, madre f
Maciej - Mathias m
maciek - barriga f
macierz - matriz
mączka - pó m
MAEA - AIEA
Maghreb - Magrebe, Magreb
magiczny - mágico
magnetofon - gravador m
magnez - magnésio m
magnolia - magnólia f
Mahomet - Maomé m
maj - maio m
Maj - maia m
makrela - cavala f
malajski - malaio malaio
malaria - malária f
malarstwo - pintura f
malarz - pintor m
mało - pouco
małostkowy - mesquinho
małpa - arroba f
Malta - Malta f
małżeński - matrimonial
małżeństwo - casamento m, matrimônio m, casal m
małżonka - esposa f
mama - sogra f
Mandżuria - Manchúria f
maniurka - moça f, menina f, rapariga f, namorada f, empregada f, doméstica f
manometr - manômetro
mapa - mapa m, carta (geográfica) f
mapa topograficzna - carta topográfica
marksizm - marxismo m
Marsylia - Marselha
marszałek - marechal m
marynarz - marinheiro m
marzec - março
marzenie senne - sono m, sonho m
marznący deszcz - chuva congelada
masakra - massacre m
masa krytyczna - massa crítica f
masara - mosca f, gravata borboleta f
mascara - rímel
maska - rosto m
maślanka - leitelho, leite de manteiga
masturbacja - masturbação f, bronha, onanismo m
masywny - maciço
maszyna do szycia - máquina de costura f
Matiasz - Mathias m
matka - mãe f, madre f
Matka Matki Boskiej Pieniężnej - dia de pagamento m
matriarchalny - matriarcal
matriarchat - matriarcado m
matros - marinheiro m
Maur - mouro m
mazak - rosto m
Mazowsze - Mazóvia
mecenas - advogado m
mechaniczny - mecânico
mechatronika - mecatrônica f
męczennik - mártir m
meczet - mesquita f
mediana - mediana
medina - almedina f
Mediolan - Milão m
medyk - médico m
medyna - almedina f
megalomański - megalómano, megalômano
męka - tormento, martírio, mortificação, suplício, tortura
melać - cuspir
melancholia - saudade f
melatonina - melatonina f
melki - bombom
menel - bêbedo
menstruacja - menstruação
mentalizm - mentalismo m
Merkury - Mercúrio
męskość - masculinidade f
metabolizm - metabolismo m
metafizyka - metafísica f
metafora - metáfora f
metaforyczny - metafórico
metan - metano m
metempsychoza - metempsicose f
meteor - meteoro
meteorologiczny - meteorológico
meteoryt - meteorito
meteorytyka - meteorítica
metr kwadratowy - metro quadrado
metronidazol - metronidazol m
mężczyzna - homem m, varão m
Mezopotamia - Mesopotâmia f
miałki - superficial
Miami - Miami
mianownik - nominativo m, denominador m
miastenia - miastenia f
miasto - cidade f, centro (da cidade) m
miau - miao
miażdżyca - aterosclerose f
micela - micela f
Michał - Miguel m
mieć gzik w kolanach - temer, ter medo
miedź - cobre m
miejsce - lugar m
miejscownik - locativo m
miejska legenda - lenda urbana
miękkość - suavidade f
mielcuch - cerveja f
mierzyć - medir
mieśćce - lugar m
mieśce - lugar m
miesiąc - mês m
miesiączka - menstruação
miesięcznik - revista mensal f
miesięczny - lunar
mięsień krawiecki - músculo sartório m
mięso - carne f
mięso armatnie - carne de canhão, bucha de canhão
mięsopustnik - fevereiro, Fevereiro
mięsożerca - carnivora f
migdałek - amígdala f
migotanie przedsionków - fibrilação atrial f
Mila - Emília
milczenie - silêncio
milimetr - milímetro m
milimetrowy - milimétrico
milioner - milionário m
militaryzm - militarismo m
miłość - amor m
miłosierdzie - misericórdia f
minerał - mineral m
minimalista - minimalista m
minimalistka - minimalista f
minuta - minuto m
miotła - vassoura f
mistrzostwa - campeonato m
mitra - mitra f
mizantropia - misantropia
mizoginia - misoginia f
mleko - leite m
młody - jovem
modlić się - rezar
modrakowy - azul, celeste, divino
modraszka - chapim-azul
modry - azul, celeste, divino
Mojżesz - Moisés
moneta - moeda
monocykl - monociclo m
monografia - monografia f
monopol - monopólio m
monopolowy - loja de bebidas f
monstrancja - ostensório, custódia
mora - fantasma, aparição, alma, espírito
mordować - matar
morfologia - morfologia f
mortadela - mortadela f
morze - mar m
Morze Arabskie - mar Árabe, mar da Arábia, mar Arábico
Morze Bałtyckie - Mar Báltico
Morze Barentsa - mar de Barents m
Morze Kaspijskie - mar Cáspio
Morze Śródziemne - Mar Mediterrâneo
mosiądz - moeda
most - ponte f
Mostar - Mostar
moszna - калитка f
Mount Everest - Monte Everest
mowa - língua f, linguagem f
mozaika - mosaico m
Mozambik - Moçambique
może - talvez
mrównik - oricterope, porco-da-terra m
Ms - locativo m
msza - missa f
mucha - mosca f, gravata borboleta f
mućka - vaca
muł - macho m
multiplikacja - multiplicação f
mundurowy - policial m
mural - pintura mural
muszkiet - mosquete
mutacja - mutação f
muzułmanka - muçulmana
mużyk - homem m, varão m
my - nós
mydło - sabão m
myśleć - pensar
mysz - rato m
Myszka Miki - Rato Mickey m
myszy tańcują, gdy kota nie czują - quando o gato sai, os ratos fazem a festa
N - instrumental m
nacjonalista - nacionalista m
na cołki łeb - inteiramente, totalmente
naczyniak krwionośny - hemangioma m
nadarzyciel - doador m
nadmiar - excesso
nadnaturalny - sobrenatural
nadprzewodnictwo - supercondutividade
nadprzyrodzony - sobrenatural
nadwzroczność - hipermetropia f
nadzieja - esperança
Nahum - Naum m
Nairobi - Nairobi
nakaz - ordem, comando
Namibia - Namíbia f
namiot - tenda f
na pewno - certamente
napisać - escrever
napój - bebida f
naprany - ébrio, bêbado
narba - cicatriz f
narkolepsja - narcolepsia f
narkomania - drogadicção, drogadição
narzędnik - instrumental m
następny - seguinte
na sto procent - certamente, inteiramente, totalmente
nasz - nosso
natychmiast - logo
natychmiastowo - logo
nauka - ciência f, ensino m, aprendizado m, estudo m
naukowiec - cientista, pesquisador m
na wynos - para viagem
na zdrowie - saúde
nazizm - nazismo
nazwisko - sobrenome, apelido de família
Neapol - Nápoles
neofaszysta - neofascista m
neofaszyzm - neofascismo
neoliberalizm - neoliberalismo m
neon - néon
neonatologia - neonatologia f
Nepal - Nepal
nepotyzm - nepotismo m
Neptun - Neptuno, Netuno
nestorianin - nestoriano m
nestorianka - nestoriana f
neuropatia - neuropatia f
neurotoksyna - neurotoxina f
neutralny - neutral, neutro
ni - nem … nem, nem mesmo, não
niacyna - niacina f
Niagara - rio Niágara
nic - nada
Niderlandy - Holanda, Países Baixos, Neerlândia
nie - não
nieakceptowalny - inaceitável
niebieski - azul, celeste, divino
niebiosa - céu m
niebo - céu m
nieć - primo m
niechlujny - desmazelado
niecierpliwie - impacientemente
nieczułość - insensibilidade f
niedokrwienie - isquemia
niedokrwistość - anemia
niedopałek - beata f
niedoskonałość - imperfeição f
nie dospać trzeba, kto chce dostać chleba - deus ajuda quem cedo madruga
nieduch - doença
niedziela - domingo
niedźwiedź biały - urso-branco m, urso branco m
niedźwiedź polarny - urso polar m, urso-polar m
nieetyczny - antiético
niegodziwy - perverso
nieistnienie - inexistência
niekompetentny - incompetente
niełupka - aquénio
niemal - quase
Niemcy - Alemanha
Niemiec - alemão m
nie mieć - não
Niemiecka Republika Demokratyczna - República Democrática Alemã
niemiecki - alemão
nienawidzić - odiar
nie od razu Kraków zbudowano - Roma não foi construída em um dia
nieodwracalny - irreversível
nieodzowny - essencial
nieoficjalny - extraoficial
nieparzysty - ímpar
niepodległość - independência f
niepodległy - independente
niepodważalny - irrefutável
niepokoić - alarmar
nieposłuszny - desobediente
nierówność - desigualdade f
nieściora - prima f
nieskończony - eterno
nieskuteczny - ineficaz
nieśmiałość - timidez
nieszczęśnik - infeliz m
nieszpułka - nêspera
nietolerancja - intolerância f
niewdzięcznie - ingratamente
niewdzięczność - ingratidão f
niewiara - desconfiança f
niewiarygodny - incrível
niewiasta - mulher f
niewolniczy - escravo, escravista
nie wszystko złoto, co się świeci - nem tudo que reluz é ouro
niezapominajka - não-me-esqueças m
niezmiennie - imutavelmente
nieznany - desconhecido
niezniszczalny - indestrutível
nigdy - nunca
nigdzie - em nenhum lugar
Niger - Níger
nihilizm - niilismo m
nikab - niqab
nikaj - em nenhum lugar
nikotyna - nicotina
Nix - Nix
niż - que, do que
NLPZ - AINE
no - sim
noc - noite f
noga - perna f
nonkonformistyczny - inconformista
nonkonformizm - inconformismo m
nonteizm - não teísmo m, não-teísmo m
Norbert - Norbert m
Norweg - norueguês m
Norwegia - Noruega f
nos - nariz m
nosówka - panleucopenia
Nowa Zelandia - Nova Zelândia
nowicjat - noviciado
nowicjusz - noviço m
nowicjuszka - noviça f
nowotwór - neoplasma
nowy - novo
Nowy Jork - Nova Iorque
Nowy Orlean - Nova Orleães
Nowy Rok - Ano-Novo
nóż - faca f
nóż do masła - faca de manteiga
nożyce - tesouras f
nożyczki - tesouras f
Nubia - Núbia f
nudelzupa - sopa f
nudziarz - cacete m
nukleotyd - nucleótido
numer - número m
numerować - numerar
Numidia - Numídia f
nupel - chupeta
nyga - mosquito m
obcokrajowiec - estrangeiro m
obecność - assistência f
oberżyna - beringela, berinjela
obiad - almoço m
obiecadło - alfabeto m, abecedário
obiektywność - objetividade f
obierać ogóra - punheta, bronha f, cinco-contra-um m
obłok - nuvem f
obnażać - descobrir
obój - oboé m
obraz - filme m, película f
obrońca - defensor m
obrzezanie - circuncisão f
obsesja - doença f
obwód - circunferência f
ocean - oceano m
Ocean Spokojny - Oceano Pacífico m, oceano Pacífico m
ocet - vinagre m
ociec - pai m
oczekiwać - esperar
oczodół - órbita f
odcisk palca - impressão digital
odczucie - sensação f, sentimento m
oddychać - respirar, espirar
oddzielnie - isoladamente
odkurzacz - aspirador m
odłam - fracção f, fração f
odmiana - gênero m, sexo m
odpadek - imundície, lixo
odpowiedzialność - responsabilidade f
odstawiać - esquecer
odwet - retaliação f, represália f
odzież - roupa f
ogień - fogo m
ogon - rabo m, cauda f
ogórek - pepino m
ogród - jardim m
ogród botaniczny - jardim botânico m
ogrodnik - jardineiro
OIOM - UTI, UCI
ojciec - pai m
ojczym - padrasto m
ojczyzna - pátria f
ojla - coruja f, mocho m
okapi - ocapi
okazały - pomposo
okno - janela f
oko - olho m
okoliczność - circunstância f, ocorrência f, posição f
okrąg - círculo m
okręt podwodny - submarino m
oksiran - óxido de etileno, oxirano
okultyzm - ocultismo m
okupacja - ocupação f
olejek eteryczny - óleo essencial
Olimpia - Olímpia
ołów - chumbo m
oma - vovó f, avó f
omieszkać - não
omikron - ómicron
ona - ela
onanizm - onanismo m
onkologiczny - oncológico
ontologia - ontologia
onycholiza - onicólise f
oologia - oologia f, ovologia f
opal - opala f
opiąć - de novo, novamente
opięć - de novo, novamente
opona - pneumático
opór - resistência f
oprych - bandido m
oranżada - laranjada f
oraz - e
orbita - órbita f
orchidea - orquídea f
orgazm - orgasmo m, clímax m
orientalny - oriental
ornament - ornamento m
ornitologia - ornitologia f
ornitologiczny - ornitológico
orogeneza - orogénese f, orogênese f
ortografia - ortografia
ortograficznie - ortograficamente
ortopeda - ortopedista
ortopedyczny - ortopédico
ortoreksja - ortorexia f
Osaka - Osaca, Osaka
osoba - pessoa f
osobno - isoladamente
ostatni - último
osteoporoza - osteoporose
Ostia - Óstia f
ostracyzm - ostracismo m
ostrężyna - amora
ostrożny - prudente
ostryga - ostra
oszczerstwo - calúnia f
oszustwo - fraude
otwierać - abrir
owad - inseto m
owca - ovelha f
Owernia - Auvergne
owoc - fruta
owolaktarianizm - ovo-lakto vegetarianismo
owulacja - ovocitação f, ovulação f
ożarty - ébrio, bêbado
ozdoba - adorno m, ornamento m
ożyna - amora
ożyrok - bêbedo
ożywienie - agitação f, movimentação f
pachniarz - nariz m
paciuk - rato m, rata f, ratazana f
Pacyfik - Oceano Pacífico m, oceano Pacífico m
pacyfistyczny - pacifista
paginować - paginar
pająk - aranha f
pajęcznik - setembro, outubro, novembro
Pakistan - Paquistão
pakli - se
pała - cabeça f, pessoa f, pênis m, pénis m, policial m
Palau - Palau m
palczatka cytrynowa - capim-limão, capim santo, capim cidreira
pale - cabeça f, pessoa f, pênis m, pénis m, policial m
paleogen - Paleogeno m
paleolit - Paleolítico
paleoproterozoik - Paleoproterozóico
Palermo - Palermo m
Palestyńczyk - palestino m
paliatywny - paliativo
palimpsest - palimpsesto
palindrom - palíndromo
palladianizm - palladianismo
pamflet - panfleto, folheto
pan - senhor m
Pan - Senhor m
pana - pneumático
panarabizm - pan-arabismo m
Pan Bóg - Senhor m
pandeizm - pandeísmo m
pandemia - pandemia f
panleukopenia - panleucopenia
pan młody - noivo m
panna - senhorita f, solteira f
Panna - Virgem
panna młoda - noiva
pantera śnieżna - leopardo-das-neves
papier - papel m, documento m
papieros - cigarro m
papież - papa m
papuć - sapato m, bota f
papuga - papagaio m
para - vapor de água, vapor d'água
paradygmatyczny - paradigmático
paraliż - paralisia
paraplegia - paraplegia f
parasol - guarda-chuva m, guarda-sol m
park - parque m
parostatek - barco a vapor m
partia polityczna - partido político
pasażerka - passageira f
pasożyt - parasita m
pasta - pasta f
pastorał - báculo m
pasztet strasburski - foie gras
patetyczny - patético
patio - pátio
pątnik - peregrino m, romeiro m
patria - pátria f
patriotyzm - patriotismo m
Paulek - Paulo m
Paweł - Paulo m
pawęża - escudo m
pawilon - coreto
październik - outubro
paździerzeń - outubro
pazura - mão
pedofilia - pedofilia f
pejoratywny - pejorativo
pekator - pênis m, pénis m
pekińczyk - pequinês
Pelagiusz - Pelágio m
penis - pênis m, pénis m
pentagon - pentâgono m
peptyd - péptido m
perfumeria - perfumaria f
perkusista - baterista m
perła - pérola
persona - pessoa f
persymona - caqui
perykopa - perícope f
peryskop - periscópio
pęseta - pinça f
Petersburg - Petersburgo m
petronelka - joaninha f
pewien - um, certo
pewność - certeza f
pewny - um, certo
piana - cerveja f
pianista - pianista
piątek - sexta-feira f
pidżama - pijama
pięciokąt - pentâgono m
pieczara - caverna f
pieczarka - champignon
pielęgniarka - enfermeira f
pielgrzym - peregrino m, romeiro m
Piemont - Piemonte
pień - tronco m
pierwsza dama - primeira-dama
pierwsza pomoc - primeiros socorros
pies - cão m
pieścić - amimar
pies do towarzystwa - cão de companhia m
piesek - cachorro m, cachorrinho m, cãozinho m
piesiec - raposa-do-ártico, raposa-polar
pies obronny - cão de guarda
pies pasterski - cão pastor
pies przewodnik - cão-guia
pigularz - farmacêutico m
pigułka gwałtu - boa noite Cinderela m, boa-noite Cinderela m
pigwa - marmelo m
pijak - bêbedo
pijanica - bêbedo
pijany - ébrio, bêbado
pijawa - arco-íris m
piksel - pixel, píxel
piłka nożna - futebol m
piłkarzyki - totó m, fla-flu m, futebol de mesa
pinczer średni - pinscher alemão
piołun - absinto m
pióro - pena f
piorun - relâmpago m
piorunochron - para-raios
piosenka - canção f
Piotr - Pedro m
pirania - piranha
pirat - pirata m
piromania - piromania f
pisać - escrever
pisco - pisco m
pismo - alfabeto m, abecedário
pistolet maszynowy - pistola-metralhadora, submetralhadora, metralhadora de mão
Pittsburgh - Pittsburgh
piwo - cerveja f
piżama - pijama
Pizydia - Pisídia
pizza - pizza f
pizzeria - pizaria f, pizzaria f
plac - praça
płacić - custear, pagar
plagiator - plagiador m, plagiário m
planeta - planeta
planetarium - planetário m
planta - planta
płaskorzeźba - baixo-relevo m
płatek - pétala
płatek śniegu - floco de neve m
Platon - Platão
pleochroizm - pleocroísmo m
płodność - fertilidade f
pluć - cuspir
płuco - pulmão m
pluskwa - percevejo
płyn Lugola - solução de Lugol, lugol
płynny - líquido, fluido
PNA - CEP
pocałunek - beijo
pocałunek z języczkiem - beijo de língua, beijo de língua m
pocestny - viajante
POChP - DPOC
pociąg - trem (braz.) m, comboio (port.) m, desejo m, atração f
pociecha - conforto m
pocieszenie - consolação f
pocieszyciel - consolador m
początkowy - inicial
poczta - correio m
pocztówka - cartão postal
podatek - imposto m
podejrzenie - suspeita f
Podlasie - Podláquia
podmiejski - suburbano
podniebienie - paladar m
podobny - parecido, semelhante
podologia - podologia f
podpułkownik - tenente-coronel
podróżnik - viajante
podtlenek - subóxido m
podwójny podbródek - queixo duplo m
podziwiać - admirar
poezja konkretna - poesia concreta
pogański - pagão
pogaństwo - paganismo m
pogróżka - ameaça f
pójść do Canossy - ir a Canossa
pojutrze - depois de amanhã
pokój - paz, sala m, aposento m, quarto m, câmara f
pole - campo m, área f
pole elektryczne - campo eléctrico m
poleku - lentamente, devagar
poli- - poli-
poliamoria - poliamor m
polibuda - escola politécnica
policja - polícia f
policjant - policial m
policyjny - policial
polifenol - polifenol m
poligamia - poligamia f
poliglota - poliglota
poligon - polígono m
poliptyk - políptico m
poliszynel - polichinelo m
politechnika - escola politécnica
polityk - político m
polityka - política f
półkula - hemisfério m
półmaraton - meia maratona f
północnoamerykański - norte-americano
polon - polónio
połowa - metade f
półowa - metade f
polować - caçar
położenie - localização f
położnica - parturiente f
Polska - Polónia, Polônia
polski - polonês m, polaco m
polucja - polução f
półudenyk - almoço m
południk - meridiano
Półwysep Bałkański - Península Balcânica f, Bálcãs, Balcãs
połykać - engolir
pomarańcza - laranja f
pomarańcza bergamota - bergamota
pomidor - tomateiro m, tomate m
pomoc - ajuda, socorro
Pomorze - Pomerânia
pomyślność - ventura f
poniedziałek - segunda-feira f
ponieważ - porque, já que
ponownie - de novo, novamente
popielniczka - cinzeiro m
porcelana - porcelana f
porcelano - porcelana f
pornografia - pornografia f
pornograficzny - pornográfico
porównanie - comparação f
portugalski - português
poruszać się jak słoń w składzie porcelany - comportar-se como un elefante numa loja de cristais
posiadacz - proprietário m
posiadłość - fazenda f
pośledni - último
posowa - teto m
potajemny - segredo
potamologia - potamologia
potas - potássio m
potwierdzenie - confirmação f
potwór - monstro
powierzchowny - superficial
powiestka - chamada f, nome m
powietrze - ar
powódź - inundação f
powoli - lentamente, devagar
pozamałżeński - extraconjugal
pożar - incêndio m
pozawczoraj - anteontem
pozaziemski - extraterrestre, extraterreno
pozłacać - dourar
pożyteczny idiota - idiota útil m
PP - PP
praca domowa - lição de casa
prącie - pênis m, pénis m
pradziadek - bisavô m
pralnia - lavanderia f
prawa człowieka - direitos humanos
prawa ręka - mão
prawa zwierząt - direitos animais, direitos dos animais
prawda - verdade f
prawdziwych przyjaciół poznaje się w biedzie - amigo na necessidade é amigo de verdade
prawica - direita f
prawidło - régua
prawko - carta de condução f, carteira de motorista {{f, carta de motorista }
prawnik - jurista
prawo - direito m, direito
prawo jazdy - carta de condução f, carteira de motorista {{f, carta de motorista }
prawo międzynarodowe - direito internacional m
preferować - preferir
prezbiterium - presbitério
prezydent - presidente
primogenitura - primogenitura
probiotyk - probiótico
proch - pólvora
proch strzelniczy - pólvora
producent - produtor
produkcja - manufatura
profilaktyczny - profiláctico
proliferacja - proliferação f
promienica - actinomicose f
propaganda - propaganda f
propagando - propaganda f
propanotriol - glicerol
propriocepcja - propriocepção
prorok - profeta m
prosię ziemne - oricterope, porco-da-terra m
prostoduszny - cândido
proszę - por favor
proton - próton m
prowansalski - provençal m
prowitamina - provitamina f
Prusy - Prússia
przebaczenie - perdão
przebiśnieg - galanto m
przebój - hit m
przeciwciało - anticorpo m
przeciwgrzybiczny - fungicida, antifúngico
przeciwgrzybiczy - fungicida, antifúngico
przeciwpasożytniczy - antiparasitário
przeciwutleniacz - antioxidante
przedmiesiączkowy - pré-menstrual
przedsięwzięcie - empreendimento m
przedwczoraj - anteontem
przekaźnik - relé
przekształcać - modificar, mudar
przeludnienie - superpopulação f
przemysł zbrojeniowy - indústria bélica
przenośnia - metáfora f
przesadzać - exagerar
przestępca - criminal
przestraszyć - assustar
przestrzeń kosmiczna - espaço sideral
przewlekły - crônico
przybity - desanimado
przyczyniać się - contribuir
przydomek - alcunha f
przyjacielski - amigável
przykrość - mágoa
przypadkowy - acidental, aleatório
przypuszczalnie - presumivelmente
przyroda - natureza f
przyrodniczy - natural
przyrznia - caixa de esquadria f
przysadka mózgowa - hipófise, glândula pituitária
przysięgać - jurar
przysłowie - provérbio m, refrão
przytomność - assistência f
psiarnia - polícia f
psisko - cão m
psiuk - cachorro m, cachorrinho m, cãozinho m
psowate - Canídeos
psychiatria - psiquiatria f
psy szczekają, karawana idzie dalej - os cães ladram, mas a caravana passa
pszczoła - abelha f
Ptah - Ptah
ptak - pênis m, pénis m
ptaszę - pênis m, pénis m
PTFE - PTFE
puder - pó m
pulmonologia - pneumologia f
pulyr - bêbedo
purpurowy - púrpura
puste - vazio
pustka - vazio m
pusty - vazio
puszczyk uralski - coruja-dos-urais
puszka - prisão, cadeia, cárcere, cerveja f
Pyjter - Pedro m
pypka - chupeta
pyta - pênis m, pénis m
rabarbar - ruibarbo m
rabdomioliza - rabdomiólise
rąbek - pano
rachatłukum - delícia turca, manjar turco, Bala de Goma
raciądz - cavaleiro m
racjonalność - racionalidade f
radon - rádon
radykalny - radical
Rafał - Rafael m
rafinować - refinar
raj - paraíso m
Rajch - Alemanha
Rak - Câncer
rakieta - foguete, foguetão
rakuski - austríaco
ramadan - Ramadão, Ramadã
ramiączko - alça f
razdziawa - gralha cinzenta
reakcja - reacção, reação
reakcja katalityczna - reação catalítica f
reaktor - reator
realizm - realismo m
rebelia - rebelião f
rebelie - rebelião f
ręce do góry - mãos ao alto!
ręcznik - toalha
referencja - referência f
regent - regente m
reguła - regra f
ręgulec - fraude
reinkarnacja - reencarnação
rejs - cruzeiro m
ręka - mão
rekin - tubarão m
reklama - anúncio m, publicidade f, reclame m, propaganda f
rekolekcje - retiro m
rekomendacja - recomendação
rekomendować - recomendar
religia - religião
Republika Czeska - República Tcheca
Republika Federalna Niemiec - República Federal da Alemanha
Republika Słowacka - República Eslovaca
respekt - respeito
responsorium - responsório m
reumatyzm - reumatismo m
rewolta - revolta f
risotto - risotto m, risoto m
Robert - Roberto m
robić z igły widły - fazer tempestade em copo d'água
robotyka - robótica f
Rodezja - Rodésia f
rodzaj - gênero m, sexo m
rodzina językowa - família linguística
Róg Afryki - Corno de África
rok - ano m
Roland - Rolando m, Roldão m
rompelkamera - lavanderia f
rondo - rotatória f, rotunda f
ropień - abscesso m
ropucha - sapo m
Rosja - Rússia
roślina - planta
roślina oleista - planta oleaginosa f
roślina zielna - erva f
roślinność - vegetação f
roszurzać - irritar
rotunda - rotunda f
rowerzysta - ciclista m
rowerzystka - ciclista f
równanie - equação
równanie stanu - equação de estado
również - também
rozbieżność - discrepância f, divergência f
rozdrażnienie - exasperação f
rozgwiazda - estrela-do-mar f
rozmowny - falador
różnorodność - diversidade f, variedade f, multiplicidade f
różowy - cor-de-rosa
rozsierdzie - ira f, cólera f
roztwór - solução f
rozum - razão
rozumieć - compreender, entender
różyczka - rubéola f
rubid - rubídio m
rubinowy - rubi m
ruchome schody - escada rolante f
ruch oporu - movimento de resistência m
rudny - vermelho, encarnado
rugby - rúgbi m
rumianek - camomila f
Rumun - romeno m
rura - tubo m
ryba - peixe m
ryboflawina - riboflavina f
Ryby - Peixes
rycerz - cavaleiro m
rysownik - desenhista
rysunek - desenho m
rytuał - ritual m, rito m
rytualny - ritual
rywal - rival m
rywalizować - competir
ryż - arroz
rząd marionetkowy - estado fantoche
rzadny - feio m, feia f
rzeka - rio
Rzeka Świętego Wawrzyńca - rio São Lourenço
rzeź - massacre m
rzić - bunda f
rzut karny - pênalti, penalidade máxima
rzykać - rezar
sabotaż - sabotagem
sadzawka - piscina f
sadzić - plantar
sagan - cabeça f, pessoa f
Sahara Zachodnia - Saara Ocidental
sałata - táxi
sałatka - salada f
salceson - policial m
Salwador - Salvador (w Portugali), El Salvador (w Brazylii)
samar - samário
Samarkanda - Samarcanda f
samba - samba f
samiec - macho m, varão m
samobójca - suicida m
samobójczyni - suicida
samobójstwo - suicidio m
samochód - carro
sandacz - lúcioperca
sandałowiec - sândalo
sanie - trenó
Sardynia - Sardenha
sarkofag - sarcófago m
sarkopenia - sarcopenia f
sarna - corça f
sąsiedztwo - vizinhança f
satyra - sátira f
sceptycyzm - ceticismo m
schody ruchome - escada rolante f
ściany mają uszy - as paredes têm ouvidos
segregacja rasowa - segregação racial f
seksualizm - sexualidade f
seksualność - sexualidade f
seksuologia - sexologia f
selen - selénio m, selênio m
selenografia - selenografia f
seler - aipo m
sen - sono m, sonho m
separatyzm - separatismo m, independentismo m
sepsa - septicemia
Serbia i Czarnogóra - Sérvia e Montenegro
serwatka - soro m
siarkowodór - ácido sulfídrico, gás sulfídrico, sulfeto de hidrogênio, sulfidreto, sulfureto de hidrogênio
sieczeń - fevereiro, Fevereiro
siedem grzechów głównych - sete pecados capitais
siemię lniane - sementes de linhaça
sierociniec - orfanato m
sierpień - agosto
sigma - sigma
sikać - fazer xixi, urinar, mijar
sikhizm - sikhismo
sikora modra - chapim-azul
sin - sen, sin
Singapur - Singapura f, Cingapura f
siodło - sela f
siostra - irmã f
sirpień - agosto
siurać - fazer xixi, urinar, mijar
skałosz - damão
skand - escândio m
Skandynaw - escandinavo
Skandynawka - escandinava f
skandynawski - escandinavo
skład - teto m
sklep - teto m
sklep monopolowy - loja de bebidas f
sklero- - esclero-
skok o tyczce - salto com vara
Skop - Áries
skórka pomarańczowa - celulite
Skorpion - Escorpião
skot - gado m
skrobia - amido m
skrzydło - asa
skuteczność - eficácia f, eficiência f, efetivação f
skuteczny - eficiente
skuter - motoneta
ślabrać - sujar
ślad wodny - pegada hídrica f
Śląsk - Silésia
śledziona - baço
ślimak - caramujo m, caracol m
slipy - cueca, slip
śliwka - ameixa f
słodki - doce
słoń - elefante m
słońce - Sol m
Słońce - Sol m
słowa - palavra, vocábulo
Słowenia - Eslovénia
Słowianin - eslavo
słowik - rouxinol
słowik rdzawy - rouxinol-comum
słowiński - eslovíncio
słownik - dicionário m
słowo - palavra, vocábulo
słup słoneczny - pilar de luz m
smacznego - bom apetite
smażyć - fritar
smerf - Estrumpfe, Estrumpfes, Smurfs
śmieć - imundície, lixo
śmierć - morte
smoczek - chupeta
smutniak - pão m
smysł - razão
śniady - abaçanado
śnieg - neve f
śnieżyć - nevar
sobaka - cão m
sobota - sábado
socjalista - socialista
socjalizm - socialismo
socjologia - sociologia f
soczewka kontaktowa - lente de contato, contacto
sód - sódio m
soda - soda f
sodalicja mariańska - congregação mariana
soi - soja f
soja - soja f
sojusznik - aliado m
solniczka - saleiro m
Solon - Sólon m
Somalia - Somália f
sonata - sonata f
sos - molho
sowa - coruja f, mocho m
sowa śnieżna - coruja-das-neves, coruja-do-ártico
sowiecki - soviético
spadkobierca - sucessor m
spadochron - paraquedas m, pára-quedas m
specjalnie - especialmente
specjalność - especialidade f
sperma - sémen, sêmen
śpiący - sonolento
śpiewać - cantar
śpioch - dorminhoco, preguiçoso
spironolakton - Espironolactona
spirytualistyczny - espiritualista
spójnik - conjunção f
spółdzielnia - cooperativa f
spontaniczność - espontaneidade
sport - esporte m
sport narodowy - esporte nacional
sportowiec - desportista m
spowiedź - confissão
sprawdzać - checar, inspecionar, examinar, verificar-se, realizar-se
sprzątanie - limpeza
sprzeczność - incompatibilidade f
sprzedaż - venda f
srąbek - trenó
srebro - prata f
Sri Lanka - Sri Lanka
ŚRK - CMI
środa - quarta-feira
stabilność - estabilidade f, constância f
stała - constante
stalagmit - estalagmite
Stany - Estados Unidos da América, Estados Unidos
Stany Zjednoczone - Estados Unidos da América, Estados Unidos
Stany Zjednoczone Ameryki - Estados Unidos da América, Estados Unidos
stara panna - solteira f, solteirona f
starek - avô m
stare miasto - velho, cidade f, centro (da cidade) m, almedina f
starka - vovó f, avó f
starofrancuski - francês antigo m
starosek - avô m
staroszek - avô m
starówka - almedina f
starożytny - antigo
starszy - pai m
stary - velho
starzyk - avô m
staw łokciowy - cotovelo m
Stefan - Estévan, Estevão
stereotyp - estereótipo
stół - mesa f
stolarz - carpinteiro m
stomatolog - dentista m
stomatologia - estomatologia f
stonka - besouro
stopień wyższy - comparativo m
stosowny - oportuno
stożek - cone m
strach - medo, temor, susto m, espantalho m
strach na wróble - medo, temor, susto m, espantalho m
strąpacz - fevereiro, Fevereiro
strategicznie - estrategicamente
strawa - despesa, custo, gasto
stres - estresse
strit - sequência f
strychnina - estricnina
strzała - flecha f, seta f
Strzelec - Sagitário
stwardnienie rozsiane - ssclerose múltipla
stwórca - criador m
styczeń - janeiro
subiektywny - subjectivo
subkontynent - subcontinente m
subtelność - subtileza f
suchy - seco
Suez - Suez
sufit - teto m
sufizm - sufismo m
sugilit - sugilite
suka - cadela f
sułtanat - sultanismo
sumienie - consciência
sumienny - assíduo
sumo - sumô m
superbohater - super-herói
sutek - mamilo m
świat arabski - mundo árabe m
światłowstręt - fotofobia f
świątynia - templo m
świekier - sogro m
świekra - sogra f
świeść - sogra f
święta krowa - vaca sagrada f
świostka - sogra f
świt - aurora
świtanie - aurora
syfilis - sífilis f
Syjam - Sião m
Syjon - Sião m
sylaba - sílaba f
sylfida - sílfide f
symbolizować - simbolizar
synapsa - sinapse
syndrom miodowy miodowego miesiąca - síndroma de cistite de lua de mel m
synergia - sinergia f
synteza - síntese f
sypialnia - quarto m, dormitório m
syra - perna f
syrop klonowy - xarope de ácer, xarope de bordo
sytuacja - situação
szafran - açafrão m
szal - xale
szamanizm - xamanismo m
szamanka - xamã, xamane
szampon - shampoo, champô, xampu
szary - cinzento
Szczecin - Estetino
szczegół - detalhe
szczepionka - vacina
szczerość - sinceridade f
szczery - sincero, franco, verdadeiro, real, genuíno
szczęśliwego Nowy Nowego Roku - feliz ano novo
szczewik - sapato m, bota f
szczur - rato m, rata f, ratazana f
szczyt - orgasmo m, clímax m
szechina - Shekhinah f
Szechina - Shekhinah f
szept - sussurro m
szermierka - esgrima f
szkira - moça f, menina f, rapariga f, namorada f, empregada f, doméstica f
szkita - perna f
szklistka - humor vítreo
szkoła - escola f
szkop - alemão m
szlachar - merganso-de-pequeno m
Szląsk - Silésia
szlifierka - moedor
szlifierka kątowa - rebarbadora
szlug - cigarro m
szmer - zunzum
szmer sercowy - sopro cardíaco m
szminka - batom m
szmucha - fraude
szneka - rosto m
szok - choque m
szowinizm - chauvinismo m, chovinismo m
szowinizm gatunkowy - especismo m
szpic japoński - spitz japonês
szpinak - espinafre m
sztajmes - bêbedo
sztuka - arte, moça f, menina f, rapariga f, namorada f, empregada f, doméstica f
szukać igły w stogu siana - procurar agulha num palheiro
szwab - alemão m
szwaja - perna f
Szwajcaria - Suíça
Szwecja - Suécia f
Szwecyjo - Suécia f
szwestera - irmã f
szyba - vidro
szyjka macicy - cérvix, cérvice, colo do útero
szynd - estupro m, pressa f
tabletka gwałtu - boa noite Cinderela m, boa-noite Cinderela m
tablica rejestracyjna - placa de identificação de veículos, chapa de matrícula de veículos automóveis
tachykardia - taquicardia f
tacik - pai m, avô m
Tadżykistan - Tadjiquistão
tajemnica poliszynela - segredo de polichinelo m
Tajlandia - Tailândia
tajny - segredo
tak - sim
taksonomia - taxinomia f
taksówka - táxi
taksydermia - taxidermia f
także - também
tal - tálio
tan - dança
tancerz - dançarino m
tańczyć - dançar
taniec - dança
tantal - tântalo
Tantal - Tântalo
Tanzania - Tanzânia
taoista - taoista, tauista, taoísta
tapir - anta f
tarcza - escudo m, rosto m
tarcza krystaliczna - escudo m
tarcza strzelecka - escudo m, rosto m
tarcza szkolna - escudo m
taśka - cápsula
taśma filmowa - película cinematográfica, filme cinematográfico, película, filme
taśma perforowana - paper tape
tatuaż - tatuagem f
tatuażysta - tatuador m
tatuażystka - tatuadora f
technet - tecnécio m
technokracja - tecnocracia
technologia - tecnologia f
tęcza - arco-íris m
tej - você
tellur - telúrio
temat - tópico m, matéria f
temperatura pokojowa - temperatura ambiente f
ten śmiać się śmieje, kto śmiać się śmieje ostatni - quem ri por último ri melhor, rirá melhor quem rirá por fim
teofania - teofania f
teoria - teoria f
terapeuta - terapeuta m
terapia - terapia f
teratologia - teratologia f
teraz - agora
terb - térbio
terier brazylijski - terrier brasileiro m, fox paulistinha
terier szkocki - terrier escocês
terminologia - terminologia
termit - cupim m
termodynamika - termodinâmica
Termopile - Termópilas
termopunktura - moxabustão f
teść - sogro m
teściowa - sogra f
tęsknota - nostalgia, saudades
testament - testamento m
teszarz - carpinteiro m
tetraplegia - tetraplegia, quadriplegia
tetum - tétum, teto
też - também
tg - tan, tg
tiamina - tiamina f
Timor - Timor
Timor Wschodni - Timor Leste
tkactwo - tecelagem m
tlen - oxigênio m, oxigénio m
tlenek etylenu - óxido de etileno, oxirano
tlenek węgla - monóxido de carbono m
tłumaczyć - traduzir
tobie - você
tokoferol - tocoferol m
toksyczność - toxicidade f
toksyna - toxina f
Tomasz - Tomé m
-tomia - -tomia
tonik - água tónica, tônica
topograf - topógrafo m, topógrafa f
toponim - topónimo m, topônimo m
tor - tório
torebka - cápsula
torpedować - torpedear
tors - tórax
tortura - tormento m, tortura f
tory - tório
totalitaryzm - totalitarismo
totem - totem m
tracić - perder
trąd - lepra f
tragikomedia - tragicomédia f
traktat - tratado m
transliteracja - transliteração f
transmigracja - transmigração f
transmisja - transmissão f
transport - transporte m
transsubstancjacja - transubstanciação
trawa cytrynowa - capim-limão, capim santo, capim cidreira
trias - Triássico m
trichotillomania - tricotilomania f
tróhła - caixão n, ataúde n, esquife n
trojka - troika f
trójskok - triplo salto, salto triplo
trumna - caixão n, ataúde n, esquife n
trwałość - constância f
trybalizm - tribalismo m
trychologia - tricologia f
tryk - carneiro m
trywialny - trivial
trzcina cukrowa - cana-de-açúcar f
trzeć - esfregar
Trzej Królowie - Três Reis Magos
trzeźwy - sóbrio
trznadel zwyczajny - escrevedeira-amarela
tu - aqui, este lugar
tudzież - e
tukan - tucano m
tukej - aqui, este lugar
Tunezja - Tunísia
turban - turbante
Turcja - Turquia
turecki - turco
turkusowy - turquesado
Turyn - Turim
turysta - turista m
turystyka - turismo m
tusz do rzęs - rímel
tutaj - aqui, este lugar
tuż - quase
twarz - rosto m
ty - você
tydzień - semana f
tyj - chá m
tylko - apenas
tymczasowy - temporário
tymianek - timo m, tomilho m
typografia - tipografia f
typowy - típico
Tyr - Tiro
tyrania - tirania f
tyroksyna - tiroxina f
Tyrteusz - Tirteu m
tytan - titã m, titânio m
ubierać - cobrir, vestir, revestir
ubiór - vestuário
ubóstwo - pobreza f
uchodźca - refugiado
uczuć - sensação, sentimento
uczucie - sensação, sentimento
ujgurski - uigur, uigure
ukamienowanie - lapidação f
układ okresowy - tabela periódica
układ planetarny - sistema planetário
Ukraina - Ucrânia
ulica - rua f
ultimogenitura - ultimogenitura
Umbria - Úmbria
umywalka - lavatório
Unia Europejska - União Européia f
Ural - Montes Urais, Rio Ural
urodziny - dia de anos, aniversário
urologia - urologia f
usta - boca
utęsknienie - nostalgia, saudades
utopia - utopia
uzasadniać - justificar
użyteczny idiota - idiota útil m
w - em
wacha - cavala-da-índia, chuva f, mar m, água f
waga - balança f, peso m
Waga - Libra, Balança
wagon - vagão m
wajco - ovo m
wąkrota azjatycka - centela
wąkrotka azjatycka - centela
wałach - capão m
walczerz - batalhão m
walczyć - lutar
wałek - fraude
walić konia - punheta, bronha f, cinco-contra-um m
Walijczyk - galês m
warga - beiço m
Warszawa - Varsóvia
warszawiak - varsoviano m
warszawianin - varsoviano m
warzyć - ferver, cozinhar, cozer
wąski - estreito
wata cukrowa - algodão-doce
wątroba - fígado m
Watykan - Vaticano
ważka - libélula f
ważny - válido
w chuj - pra cacete
wcześnie - cedo
wcześniej - cedo
wczoraj - ontem m
we - em
weduta - veduta f
wedyjski - védico
weganin - vegetalista m
weganizm - veganismo m
weganka - vegetalista f
wegański - vegetalista
wegetarianizm - vegetarianismo m
węgiel - carbono
Węgierka - húngara f
węglowodan - carboidrato m
Węgry - Hungria f
wehikuł - veículo m
wentroba - fígado m
werdykt - veredicto m
wernakularny - vernáculo
Werona - Verona n
Wesołych Świąt - Feliz Natal
weterynaryjny - veterinário
węzeł chłonny - gânglio linfático, linfonodo
wezwanie - chamada f, nome m
wiatr - vento m
wiązadło - ligamento m
widelec do porcjowania - garfo de churrasco
wideoklip - videoclipe
widnokrąg - horizonte
wieczność - eternidade f
wieczór kawalerski - despedida de solteiro f
wiedzieć - saber
Wielka Brytania - Grã-Bretanha
Wielkanoc - Páscoa f
Wielkie Antyle - Grandes Antilhas
Wielkie Równiny - Grandes Planícies
wielokulturowość - multiculturalismo
wieloryb - baleia f
wielorybnictwo - caça à baleia f
wielotorbielowaty - policístico
wiewiórka - esquilo m
wieża - torre
więzień - prisioneiro, preso
więzienie - prisão, cadeia, cárcere
wikariusz - vigário m
Wikipedia - Wikipédia
Wikisłownik - Wikcionário
Wikiźródła - Wikisource
Wilczy Szaniec - Toca do Lobo
wilgoć - humidade f
wilgotność - humidade f, umidade f
wilgotny - úmido
wilk - lobo m
wilk morski - lobo do mar m
wilk w owczej skórze - lobo em pele de cordeiro
willa - villa
winien - culpável, culpado
winnica - vinha
winny - culpável, culpado
winograd - videira f, vinha, uva f
winogrono - uva f
winorośl - videira f
wiosna - primavera
wirusologia - virologia f
Wisła - Vístula m
wiśnia - cerejeira, cereja
witarianizm - crudivorismo m
władza - autoridade
włócznia - lança f
włos - cabelo, pêlo
wnęka - neta f
wniwecz - inteiramente, totalmente
wnuczka - neta f
woda - água f
wóda - vodka f, aguardente m
woda mineralna - água mineral f
wódka - vodka f, aguardente m
Wodnik - Aquário
wodór - hidrogénio m, hidrogênio m
wojak - soldado m
wojna domowa - guerra civil
wojna religijna - guerra santa
wojskowy - soldado m
wokabularz - dicionário m
wół - boi m
wola - vontade
wolna miłość - amor livre
wolnomyślicielstwo - pensamento livre m
woniączka - vodka f, aguardente m
wosk - cera f
w pełni - inteiramente, totalmente
wróg - inimigo m
wrona - gralha cinzenta
wróżka - fada
wróżyć - adivinhar
wrzesień - setembro
wrzód - úlcera f
Wschód - Médio Oriente, Oriente Médio
wścieklizna - raiva f, hidrofobia f
współczucie - compaixão f
wszystkie drogi prowadzą do Rzymu - todos os caminhos levam a Roma
wtorek - terça-feira
w tym - em
wuszt - salsicha f
wybierać - escolher
wybitny - eminente
Wybrzeże kość Kości Słoniowej - Costa do Marfim
wyjątek - exceção f
wyjść - sair
wykałaczka - palito m
wykrywacz kłamstw - detector de mentiras m
wynalazek - invenção f
wyposażenie - armação f
wyprzedzać - anteceder, preceder, ultrapassar
wyraz - palavra, vocábulo
wyrostek robaczkowy - apêndice vermiforme, apêndice cecal
wyrzeczenie - abnegação f
wyścig w workach - corrida de sacos
wysoki - alto
wysokość - altura f
wyspa - ilha f
Wyspa Bożego Narodzenia - Ilha Christmas f
Wyspa Książęca - Ilha do Príncipe
Wyspa Świętego Tomasza - Ilha de São Tomé
Wyspa Świętego Wyspy Świętego Tomasza i Wyspa Książęca - São Tomé e Príncipe
Wyspa Wniebowstąpienia - Ascensão
Wyspy Kanaryjskie - Canárias, Ilhas Canárias
Wyspy Marshalla - Ilhas Marshall
Wyspy Zielony Zielonego Przylądka - Arquipélago de Cabo Verde
wystarczający - suficiente
wyszukiwarka - motor de busca, motor de pesquisa, máquina de busca
wyża - altura f
wyżeł pirenejski - braco francês tipo pirineus
wyższość - superioridade f
wyzwoleńczy - libertador
wzdręga grecka - escardínio grego
z - de, com
ząb - dente m
żaba - rã f
żabie oczko - não-me-esqueças m
zabijać - matar
żabnica - tamboril
Zabulon - Zabulom, Zebulom m
zachód - ocaso m, pôr m, poente m, oeste m, ocidente m
Zachód - Ocidente m
Zachodni Brzeg - Cisjordânia f, Margem Ocidental
Zachodni Brzeg Jordanu - Cisjordânia f, Margem Ocidental
zachwycony - entusiasta
zaciągać - alistar-se, tragar
zaćmienie - eclipse m
zaczynać - começar, iniciar, iniciar-se
zadanie domowe - lição de casa
żądło - ferrão m
zaganiacz szczebiotliwy - felosa-poliglota f
zaganiacz wielomówny - felosa-poliglota f
żaglowiec - veleiro m
zagrożenie - ameaça
zaimek dzierżawczy - pronome possessivo
zając - lebre
zakaz - proibição f
zakażać - infectar
zakażenie - infecção f
zakład karny - prisão, cadeia, cárcere
zakrystian - sacristão m
żal - dor
zalany - ébrio, bêbado
założyciel - instituidor m
zamek - castelo m, fechadura f, fecho m
zamknąć - fechar, cerrar
zanik - desaparição f, desaparecimento m, extinção f, perdida f
zapad - ocaso m, pôr m, poente m, oeste m, ocidente m
zapalenie płuc - pneumonia
zapalenie skóry - dermatite f
zapalenie wyrostek wyrostka robaczkowego - apendicite f
zapalniczka - isqueiro
zapinać - abotoar
zapisywać - salvar, guardar
zapominać - esquecer
zapora - dique m, barragem f, barreira f
zapowiedź - anúncio
zaprzeczenie - negação f
żarliwy - fervoroso
zarodek - embrião f
zarozumiałość - empáfia f
zaś - de novo, novamente
zaskórnik - cravo m, comedão m
zasnąć - adormecer
zaspokajać - satisfazer
zaspokojenie - satisfação f
zaszczytciel - defensor m
Zatoka Bengalska - Golfo de Bengala
zatrzymać - deter, parar, imobilizar, interromper
zatrzymywać - deter, parar, imobilizar, interromper
zaufanie - confiança f
zawierać - conter
zawistny - invejoso
zawój - turbante
zawsze - sempre
zawżdy - sempre
zazdrość - inveja f, ciúme m
zazulka - joaninha f
zazwyczaj - habitualmente
zbieg okoliczności - coincidência f
zbrodnia - crime m
zbrodnia katyńska - massacre de Katyn
zbrodnia wojenna - crime de guerra
zdanie - sentença, opnião
zdjęcie - fotografia f
zdrowie - saúde
zdrowy - são
ze - de, com
że - que
zebra - zebra f
żebrak - mendicante, pedinte
zefir - zéfiro
zegar - relógio m
zegar słoneczny - relógio de sol m
żegleń - carbono
żelazo - ferro m
zelter - água mineral f
żeńczyna - mulher f
zero - zero
zespół kanał kanału nadgarstka - síndrome do túnel carpal, síndrome do túnel cárpico, síndrome do túnel do carpo, síndrome do canal cárpico
zespół napięcia przedmiesiączkowego - tensão pré-menstrual
zespół Sjögrena - síndrome de Goujerot-Sjögren m, síndrome de Sjögren m
zez - estrabismo, de, com
ziele - erva f
ziele angielskie - pimenta-da-jamaica f
zielnik - herbário
zielona herbata - chá verde
zielony - verde
ziemia - terreno m, terra f
Ziemia - Terra f
Ziemia Święta - Terra Santa f
zima - inverno m
zimno - frio m
zioło - erva f
ziołowy - herbário
zista - vovó f, avó f
zjeżdżalnia - escorregador
złoto - ouro m
zmartwienie - aflição, pesar, preocupação
zmaza nocna - polução f
zmiana - mudança f
zmrok - crepúsculo m, anoitecer m
znać - conhecer, saber
znajdować - encontrar-se, estar
znajomy - conhecido
znak wodny - marca d'água f
znalezisko - achado m
zniknięcie - desaparecimento m
znów - de novo, novamente
znowu - de novo, novamente
zobaczyć - ver, olhar
żółć - amarelo m
żołd - soldo m
żołnierz - soldado m
żółty - amarelo m
żółw - tartaruga
żona - esposa f
żonaty - casado
zoo- - zoo-
zoofobia - zoofobia f
zoogeografia - zoogeografia f
zoolatria - zoolatria f
zooplankton - zooplâncton m
źrebak - potro m
źrebię - potro m
źrebiec - potro m
źrenica - pupila f, menina dos olhos f, olho m
zrozumiały - luzente
z tyłu - atrás
żubr - bisonte-europeu m, bisão-europeu f
żul - bêbedo
ZUM - ITU
zupa - sopa f
zupełnie - inteiramente, totalmente
żurawina - oxicoco m, arando, uva-do-monte
żurnal - revista
Zurych - Zurique
Zuzanna - Susana, Susanna
zwężenie - estreitamento m
związek frazeologiczny - expressão idiomática f, expressão popular f
Związek Socjalistycznych Republik Radzieckich - União das Repúblicas Socialistas Soviéticas
zwierzak - animal m, besta f
zwierzę - animal m, besta f
zwierzęcość - animalidade f
zwycięski - vitorioso
zwykle - geralmente, em geral
życie - vida f
żyd - judeu
Żyd - judeu m
żyła udowa - veia femoral f
żynich - noivo m
żywnościowy - alimentício
