a - przedimek określony | do | o | za | na
à - a + a
Aarão - Aaron
aba - rondo (kapelusza) | brzeg | abar
ABA - Brazylijskie Towarzystwo Antropologiczne
abaçanado - śniady | ciemny | smagły | ciemnolicy | abaçanar
abacate - awokado
abacateiro - awokado
abacaxi - ananas
abacaxizeiro - ananas
ábaco - abakus | liczydło
abade - przeor | opat
abadessa - przeorysza
abadia - opactwo
abafado - duszny | parny
abafador - tłumik
abafar - dusić | tłumić
abaixamento - obniżenie | depresja
abaixar - obniżać | opuszczać | poniżać się
abaixo - poniżej | precz! | abaixar
abajur - abażur
abalanço - abalançar
abandona - abandonar
abandonado - porzucony | opuszczony | zaniedbany
abandonar - porzucać | opuszczać | popaść w coś
abandono - opuszczenie | porzucenie | abandonar
abastecer - dostarczać | zaopatrywać
abastecimento - zaopatrzenie
abater - obalać | powalać
abatido - powalony | przygnębiony | zniechęcony | zmęczony
abatimento - zniechęcenie | przygnębienie
abdicação - abdykacja
abdicar - abdykować | rezygnować
abdome - brzuch | abdómen
abdómen - brzuch
abdominal - brzuszny
abdução - porwanie | uprowadzenie
Abecásia - Abchazja
abecedário - abecadło | alfabet
Abel - Abel
abelha - pszczoła
abençoar - błogosławić
aberração - aberracja | zboczenie
aberto - otwarty | szczery | abrir
abertura - otwarcie
abeto - jodła
abismo - otchłań
abissínia - Abisynka | abissínio
Abissínia - Abisynia
abissínio - abisyński
abjurar - wyrzekać się | wypierać się
ablativo - ablatyw | ablacyjny
abnegação - abnegacja | wyrzeczenie się
abóbora - dynia
abobrinha - cukinia
abolição - abolicja | umorzenie
abolir - znosić
abominação - ohyda | wstręt | odraza
abominar - nienawidzić | nie znosić | gardzić
abominável - wstrętny
abordagem - abordaż
abordar - przybić do brzegu | cumować
aborde - abordar
aborrecer - nudzić | nużyć
aborrecido - znudzony | nudny | smutny
aborrecimento - nuda | wstręt | przykrość
abortar - poronić
abortas - abortar
aborto - poronienie | aborcja | abortar
Abraão - Abraham | imię męskie
abraçar - obejmować
abraço - uścisk | objęcie | przytulenie | abraçar
abranger - obejmować
abrasão - abrazja | otarcie
abrase - abrasar
abre-latas - otwieracz (do konserw)
abreviação - skrót
abreviar - skracać
abreviatura - skrót
abricó - morela
abrigar - chronić | osłaniać | schronić się
abrigo - schronienie | osłona | abrigar
abril - kwiecień
Abril - kwiecień | abril
abrir - otworzyć | otworzyć się
Abruzos - Abruzja
absinto - absynt | piołun
absolutamente - całkowicie | kompletnie | absolutnie | zupełnie
absolutismo - absolutyzm
absoluto - absolutny | bezwarunkowy | całkowity
absolver - uniewinniać | rozgrzeszać
absolvição - absolucja | uniewinnienie | rozgrzeszenie
absorção - absorpcja
absorver - wchłaniać | absorbować
abstenção - powstrzymanie się | wstrzymanie się
abstinência - abstynencja
abstração - abstrakcja
abstracção - abstrakcja | abstrakt
abstraccionismo - abstrakcjonizm
abstracionismo - abstrakcjonizm
abstracto - abstrakcyjny
absurdo - absurd | absurdalny
Abu Dhabi - Abu Zabi
abunda - abundar
abundância - zasobność | obfitość
abundante - obfity
abundar - obfitować
abusar - nadużywać | nadużyć | niewolić | gwałcić
abuso - nadużycie
abutre - sęp
acabar - kończyć
acácia - akacja
academia - akademia
académico - akademicki
acadêmico - akademicki
academismo - akademizm
açafrão - szafran
acalanto - kołysanka
acalmar - uspokajać | łagodzić
acampamento - obóz
acampar - obozować | rozkładać obóz
acanhado - nieśmiały | wstydliwy
ação - akcja | wątek
acariciar - pieścić | głaskać | muskać
acasalar - łączyć | dobierać
acaso - przypadek
acautelar - przestrzegać | chronić
acção - akcja | czyn | uczynek | czynność | działanie
accionista - akcjonariusz | udziałowiec | akcjonariuszka
aceder - zgodzić się | przystać na coś
aceitação - przyjęcie | akceptacja
aceitar - przyjąć | przyjmować
aceleração - przyspieszenie
aceleradamente - szybko
acelerar - przyśpieszać | przyspieszać
acelga - burak liściowy | boćwina
acenar - kiwać | skinąć
acender - zapalać | podpalać
acento - akcent
acentuar - akcentować | podkreślać
ácer - klon
acerbar - rozgoryczać
acerbo - acerbar
acérrimo - bardzo gorzki | bardzo cierpki | zgorzkniały
acertar - uzgadniać | dopasować | trafić
acessar - uzyskać dostęp do
acessível - dostępny
acesso - dostęp | dojście | dojazd
acessório - dodatkowy | dodatek
acetato - octan
acetificar - zakwaszać | kwasić
acetileno - acetylen
aceto - ocet
acetona - aceton | zmywacz do paznokci
acha - achar
achado - znalezisko | rzecz znaleziona | znaleziony | achar
achado não é roubado - znalezione nie kradzione
achar - znajdować | odkrywać | sądzić | uważać
acho - achar
acidentado - pagórkowaty | nierówny | acidentar
acidental - przypadkowy
acidentalmente - przypadkowo | przypadkiem
acidente - wypadek | przypadek | nierówność | acidentar
acidez - kwasowość | kwaśność
ácido - kwas | kwaśny
ácido fólico - kwas foliowy
ácido hialurónico - kwas hialuronowy
ácido hialurônico - kwas hialuronowy
acima - ponad | powyżej | w górę | do góry
aclamar - oklaskiwać | wiwatować
aclimatar - aklimatyzować | aklimatyzować się
acne - trądzik
aço - stal
acobardar - przestraszyć
açodamento - pośpiech
açodar - spieszyć się
açoitar - smagać | chłostać | biczować
acolá - tam
acolhedor - przytulny
acolher - gościć
acometer - napadać | atakować | nacierać
acomodação - dostosowanie | akomodacja | uzgodnienie | zakwaterowanie
acomodar - przystosowywać
acompanhar - towarzyszyć | akompaniować
acondicionar - czynić odpowiednim | dostosowywać | przystosowywać
aconselhar - radzić | doradzać | radzić się | konsultować
acontecer - zdarzyć się | wydarzyć się
acontecimento - wydarzenie | zdarzenie
acordar - budzić | uzgadniać | budzić się
acorde - akord
acordeão - akordeon | harmonia
acordo - porozumienie | układ | acordar
Açores - Azory
açoriano - azorski | mieszkaniec Wysp Azorskich
acossar - gonić | ścigać | prześladować
acostumar - przyzwyczajać | przyzwyczajać się
açougue - rzeźnia
acre - akr | gorzki | cierpki
acreditar - zaświadczać | gwarantować | akredytować
acrescentar - dodawać | powiększać
acrílico - akryl | akrylowy
acrobata - akrobata | akrobatka
acrofobia - akrofobia | lęk wysokości
acrónimo - akronim
acrônimo - akronim
acrópole - akropol
actínio - aktyn
activa - activar | activo
activação - aktywacja
activar - aktywować | aktywizować | uaktywnić
active - activar
actividade - aktywność | czynność | działalność
activismo - aktywizm
activista - aktywista | aktywistka
activo - aktywny | aktyw | activar
acto - czyn | akt
actor - aktor
actriz - aktorka
actuação - działalność | działanie | gra
actual - aktualny | bieżący | obecny
actualidade - aktualność | teraźniejszość
actualização - aktualizacja
actualizar - aktualizować | uaktualniać | zaktualizować
actualmente - aktualnie | obecnie
açúcar - cukier
açucareiro - cukiernica | cukierniczka
açucena - lilia
acudir - pomagać
acuminar - ostrzyć | wyostrzać
acumulação - akumulacja | nagromadzenie
acumulador - akumulator
acumular - gromadzić | akumulować | kumulować
acupunctura - akupunktura | acupuncturar
acupuntura - akupunktura
acusação - oskarżenie | obwinienie | ciężar | obciążenie | brzemię | fakt obciążający
acusado - oskarżony
acusar - oskarżać | obwiniać
acusativo - biernik
adaga - sztylet
Adalberto - Adalbert | imię męskie
Adão - Adam
adaptação - adaptacja | przystosowanie
adaptar - przystosować
adapte - adaptar
adega - piwnica służąca do przechowywania wina
adentro - wewnątrz | w środku | adentrar
adepto - zwolennik | kibic
adequado - właściwy | odpowiedni | adekwatny
aderente - zwolennik | zwolenniczka | przylegający
aderir - przystępować | przylegać
adesão - przystąpienie
adesivo - plaster
adeus - do widzenia
adiantamento - postęp | przyspieszenie | przyśpieszenie | płatność z góry
adiantar - posuwać naprzód | przyspieszać | powiedzieć zawczasu | uprzedzać
adiante - naprzód | dalej
adiar - przekładać | odraczać
adição - dodawanie
adicção - nałóg
adicionar - dodawać | dołączać
adido - attaché
adivinha - zagadka | wróżka | adivinho | adivinhar
adivinhar - zgadywać | wróżyć
adjacente - przyległy | sąsiadujący | sąsiedni | przylegający
adjectivo - przymiotnik
adjetivo - przymiotnik
adjudicar - rozstrzygać | orzekać | wyrokować
adjunto - dołączony | pomocniczy | zastępca
administração - administracja
administrador - administrujący | zarządzający | administratorski | administrator | zarządca
administrar - administrować | kierować | rozporządzać
administrativo - administracyjny
admiração - admiracja | podziw | zdumienie
admirador - wielbiciel | wielbicielski
admirar - podziwiać
admirável - godny podziwu
admissão - dopuszczenie | przyjęcie
admitir - dopuszczać | przyjmować
adoção - adopcja
adoecer - zachorować
adolescência - dojrzewanie | wiek młodzieńczy
adolescente - nastolatek | nastolatka | młodociany
Adolfo - Adolf
adopção - adopcja
adoptar - adoptować
adopte - adoptar
adorar - wielbić | uwielbiać
adorável - uroczy
adormecer - uśpić | ukoić | zasnąć
adornar - zdobić | upiększać | przyozdabiać
adorno - ozdoba | adornar
adotar - adoptować
adquirir - nabywać | nabyć | osiągać | uzyskiwać | uzyskać | zdobywać | zdobyć | kupować | kupić
adrenalina - adrenalina
Adriano - Adrian
Adriático - Adriatyk
aduaneiro - dotyczący prawa celnego
adular - chwalić | wychwalać | pochlebiać
adulterar - fałszować | cudzołożyć
adultério - cudzołóstwo | zdrada małżeńska
adúltero - cudzołożnik | cudzołożny
adulto - dorosły | dorosła osoba
advérbio - przysłówek
adversário - przeciwnik | adwersarz
adverso - niekorzystny
advertir - ostrzeć | uprzedzić
advogado - adwokat
advogado do diabo - adwokat diabła
aéreo - powietrzny | lotniczy
aeróbica - aerobik | aeróbico
aerodinâmico - aerodynamiczny
aeronáutica - aeronautyka | lotnictwo | aeronáutico
aeroplano - samolot
aeroporto - lotnisko
aerossol - aerozol
afã - zapał
afamado - sławny | znany
afasia - afazja
afastamento - oddalenie
afastar - oddalać | odsuwać | oddalać się
afável - uprzejmy | łaskawy
afectar - udawać | dotykać | naruszać | dotyczyć czegoś
Afeganistão - Afganistan
afegão - Afgańczyk | afgański
afeição - uczucie | umiłowanie | czułość
afiado - wyostrzony | ostry | zdenerwowany | poirytowany
afiar - ostrzyć
afilar - ostrzyć
afinidade - pokrewieństwo | podobieństwo
afirmação - twierdzenie | stwierdzenie
afirmar - twierdzić
afixo - afiks
aflição - zmartwienie
afluente - dopływ
afogar - topić | utopić
aforismo - aforyzm
África - Afryka
África do Sul - Afryka Południowa | Republika Południowej Afryki
africana - Afrykanka | africano
africâner - afrykanerski
africano - afrykański | Afrykańczyk
ágata - agat
agência - agencja
agente - agent | agentka
agir - robić | wykonywać
agitação - poruszenie | niepokój | wzburzenie | ożywienie
agitar - potrząsać | trząść | wstrząsać
aglomeração - aglomeracja
agnosticismo - agnostycyzm
agonia - agonia
agora - teraz
agorafobia - agorafobia
agosto - sierpień
Agosto - sierpień | agosto
agradável - przyjemny | miły | sympatyczny | ładny
agradecer - dziękować
agradecido - wdzięczny
agradecimento - podziękowanie | wdzięczność
à grande - bogato | luksusowo
agrário - rolniczy | rolny
agressão - agresja | napaść
agressividade - agresja
agressivo - agresywny
agrícola - rolniczy
agricultura - rolnictwo
agronomia - agronomia
água - woda
água mineral - woda mineralna
aguentar - wytrzymywać | znosić | podtrzymywać
agüentar - wytrzymywać | znosić | podtrzymywać
águia - orzeł
agulha - igła
ai - och! | oj!
aí - tam (obok ciebie)
ainda - jeszcze | wciąż
aipo - seler
ajuda - pomoc
ajudador - pomocnik
ajudar - pomóc | pomagać
ajuda-te que Deus te ajudará - Bóg pomaga tym, co sami sobie pomagają
ajuizar - sądzić | osądzać
ajuntar - zbierać | gromadzić
ajustar - uzgadniać | regulować
ajuste - porozumienie | ugoda | rozliczenie | ajustar
alabastro - alabaster
Aladim - Aladyn
alameda - alejka
álamo - topola
alaranjado - pomarańczowy | alaranjar
alargamento - rozszerzenie | poszerzenie
alargar - poszerzać | rozszerzać
alarmar - alarmować | niepokoić | trwożyć | przestraszyć | przejąć się
alarme - alarm | alarmar
alaúde - lutnia
alavanca - dźwignia | alavancar
alba - biały
albanês - albański | Albańczyk
albanesa - Albanka | albanês
Albânia - Albania
albatroz - albatros
albergue - schronienie | schronisko młodzieżowe | albergar
albinismo - bielactwo | albinizm
albino - albinos
álbum - album
albumina - albumina
alça - ramiączko | ucho (od torby) | alçar
alcachofa - karczoch
alcachofra - karczoch
alcáçova - kasba
alcalino - alkaliczny
alcalóide - alkaloid
alcançar - dosięgnąć | zdobyć | dogonić
alcance - zasięg | alcançar
alçapão - drzwi zwodowe | klapa w podłodze
alcaparra - kapar ciernisty
alcatifa - wykładzina dywanowa | alcatifar
alcatifar - wykładać dywan/wykładzinę | przykrywać wykładziną
alcatrão - smoła
alce - łoś
álcool - alkohol
alcoólico - alkoholowy | alkoholik
alcoolismo - alkoholizm
Alcorão - Koran
alcova - alkowa
alcunha - przydomek | alcunhar
alcunhar - nadawać przydomek
aldeão - wieśniak | wiejski
aldeia - wieś | wioska | miejscowość zamieszkała wyłącznie przez autochtonów
aleatório - przypadkowy | losowy
alecrim - rozmaryn
alegoria - alegoria
alegrar - rozweselać | cieszyć
alegre - radosny | alegrar
alegria - radość
além - tam daleko
alemã - Niemka | alemão
Alemanha - Niemcy
alemão - Niemiec | język niemiecki | niemiecki
alento - otucha | odwaga | oddech | tchnienie | alentar
alergia - alergia
alérgico - alergiczny | alergik
Alexandre - Aleksander
alfa - alfa (nazwa greckiej litery α)
alfabeticamente - alfabetycznie
alfabético - alfabetyczny
alfabeto - alfabet | alfabetar
alface - sałata
alfaiate - krawiec
alfândega - urząd celny | alfandegar
alfandegário - celnik | celny
alfanumérico - alfanumeryczny
alfinete - szpilka | agrafka | alfinetar
alga - wodorost | glon | alga
algazarra - hałas | zgiełk | tumult
álgebra - algebra
algébrico - algebraiczny
algemas - kajdanki | algema | algemar
algibeira - kieszeń
álgido - mroźny
algo - coś
algodão - bawełna
algofobia - algofobia
algoritmo - algorytm
alguém - ktoś
alguidar - miednica
algum - jakiś
alheio - obcy | cudzy | alhear | cudza własność
alho - czosnek | szczypiorek
alho-porro - por
ali - tam (daleko)
aliado - sojusznik | sprzymierzeniec | aliar
aliança - sojusz | przymierze | obrączka | aliançar
aliás - zresztą
alicate - kombinerki | szczypce | cążki
alienação - wyobcowanie | choroba umysłowa
alienar - odstępować | wyobcować | odizolować się
alieno - alienar
aligátor - aligator
aligeirar - łagodzić
alimentação - żywność | wyżywienie
alimentar - karmić
alimentício - spożywczy | żywnościowy
alimento - pożywienie
alinhar - wyprostować | dołączyć do czegoś
alisar - gładzić | wygładzać
aliteração - aliteracja
alívio - ulga | ulżenie
alma - dusza
almanaque - almanach
almedina - stara dzielnica | starówka
almoçar - jeść obiad (w południe)
almoço - obiad | almoçar
almofada - poduszka
almôndega - pulpet | klops
alojamento - zakwaterowanie
alojar - kwaterować
alomorfia - metamorfoza | przeobrażenie
alopecia - łysienie | alopecja
alpaca - alpaka
alpargata - espadryla | alpercata
alperce - morela
alpinismo - alpinizm
alquimia - alchemia
alquimista - alchemik
Alsácia - Alzacja
altar - ołtarz
altar-mor - ołtarz główny
alteração - zmiana | poprawka
alterar - przemieniać | zmieniać | poprawiać
alternação - wymiana | zamiana
alternadamente - na zmianę
alternar - wymieniać się | zamieniać się
alternativa - alternatywa | wybór | alternativo
alternativo - przemienny | naprzemienny | alternatywny
alterno - alternar
alteza - wysokość
altifalante - głośnik | kolumna
altíssimo - najwyższy
altitude - wysokość nad poziomem morza
altivo - dumny | wyniosły
alto - wysoki
altruísmo - altruizm
altruísta - altruista | altruistka | altruistyczny
altruístico - altruistyczny
altura - wysokość | szczyt
alucinação - zjawa | iluzja | halucynacja
aludir - wzmiankować | czynić aluzje
alugar - wynajmować
aluguer - wynajem | wypożyczalnia
alumínio - glin | aluminium (metal)
aluno - uczeń
alusão - aluzja
alusivo - odnoszący się | wzmiankujący | aluzyjny | zawierający aluzję | przenośny
alva - brzask | alvo
alvacento - białawy
alvo - biały | czysty | cel | białko oka
alvorada - świt
alvorecer - świtać
alvoroço - poruszenie | entuzjazm | hałas | krzyk | wrzask | krzyczenie | rewolta | bunt | alvoroçar
ama - opiekunka do dzieci | niania | amo | amar
amabilidade - uprzejmość | grzeczność
amaciador - zmiękczacz | zmiękczacz do tkanin | płyn do płukania tkanin
amador - miłośnik | amator
amadorismo - amatorstwo
amadurecer - dojrzewać
âmago - sedno | serce | rdzeń
amai - amar
amaldiçoar - potępiać
amamentar - karmić piersią
amanhã - jutro | w przyszłości (zazwyczaj nieokreślonej) | dzień jutrzejszy | przyszłość (nieokreślona)
amanhecer - świtać
amante - kochanek | miłośnik | kochanka | miłośniczka | kochający | zakochany
amar - kochać
amarelo - żółty
amargo - gorzki smak | gorzki | smutny | trudny | bolesny
amargura - gorycz | rozgoryczenie | zgryzota | amargurar
amarrar - wiązać
amarrotado - pognieciony | amarrotar
amarrotar - gnieść | miąć
amável - miły
amazona - amazonka
âmbar - bursztyn
ambição - ambicja
ambicioso - ambitny
ambientador - odświeżacz (powietrza)
ambiental - środowiskowy
ambiente - środowisko | okalający | otaczający
ambiguidade - niejednoznaczność
ambiguo - ambiguar
ambíguo - dwuznaczny
âmbito - zakres | zasięg
ambos - obaj | obydwaj | jeden i drugi
Ambrósio - Ambroży
ambulância - karetka pogotowia
ambulante - wędrowny | objazdowy | ruchomy | obwoźny
ameaça - ameaçar | pogróżka | groźba
ameaçar - zagrażać | grozić
amedrontar - przerażać | straszyć | bać się
amêijoa - małż
ameixa - śliwka
ameixeira - śliwa
amêndoa - migdał
amendoim - orzech ziemny
ameno - łagodny | delikatny
a mentira tem perna curta - kłamstwo ma krótkie nogi
América - Ameryka
América do Norte - Ameryka Północna
América do Sul - Ameryka Południowa
americana - Amerykanka | americano
americanização - amerykanizacja
americano - Amerykanin | amerykański
amerício - ameryk
ametista - ametyst
amieiro - olsza czarna
amiga - przyjaciółka | kochanka | konkubina | amigo
amigável - przyjacielski | przyjazny
amigavelmente - przyjaźnie | przyjacielsko
amígdala - migdał | migdałek
amigo - przyjaciel
amigo-da-onça - zdrajca
amigo do alheio - złodziej
amiloidose - amyloidoza | skrobiawica | betafibryloza
amimar - pieścić
amimo - amimar
amistoso - przyjazny | przyjacielski
amiúde - często
amizade - przyjaźń
amnésia - amnezja
amnistia - amnestia | amnistiar
amo - amar | pan | pan domu | mąż | gospodarz | właściciel | szef
amoníaco - amoniak
amor - miłość
amora - jeżyna
amoral - amoralny
amoralidade - amoralność
amoralismo - amoralizm
amoreira - morwa
amorfo - bezkształtny | amorficzny
amoroso - kochający
amor-próprio - miłość własna
amostra - próbka | amostrar
amparar - wspierać | chronić
amparo - wsparcie | ochrona | schronienie | amparar
ampere - amper
amperímetro - amperomierz
ampliar - poszerzać | rozszerzać
amplitude - szerokość | amplituda
amplo - szeroki | rozległy
ampulheta - klepsydra
amputação - amputacja
ampute - amputar
Amsterdã - Amsterdam
amuleto - amulet
anabolismo - anabolizm
anaconda - anakonda
anacronismo - anachronizm
anagrama - anagram
anágua - halka
anal - analny | odbytniczy | odbytowy
analfabetismo - analfabetyzm
analfabeto - niepiśmienny | analfabeta
analisar - analizować
análise - analiza
analogamente - analogicznie
analogia - analogia
analogía - analogia
analógico - analogiczny
análogo - analogiczny
ananás - ananas
ananaseiro - ananas
anão - karzeł
anarquia - anarchia | nieład | chaos
anarquismo - anarchizm
anatomia - anatomia
anatómico - anatomiczny
anca - biodro
ancinho - grabie
âncora - kotwica
ancorar - kotwiczyć | zakotwiczyć | opuścić kotwicę
andaime - rusztowanie
andaluz - andaluzyjski | Andaluzyjczyk
andaluza - andaluz | Andaluzyjka
Andaluzia - Andaluzja
andar - iść | chodzić
Andes - Andy
andorinha - jaskółka
Andorra - Andora
andorrano - andorski
andorrense - andorski
andrógeno - androgen
anel - pierścień
anemia - anemia
anestesia - znieczulenie | anestezja | anestesiar
anestesiar - znieczulać
anestesiologia - anestezjologia
anestesiológico - anestezjologiczny
anexação - aneksja
anexar - anektować | przyłączać | zaanektować | dołączyć
anexo - załącznik | anexar
anfiteatro - amfiteatr
angina - angina
angio- - angio-
angiologia - angiologia
anglicana - anglikanka | anglicano
anglicanismo - anglikanizm
anglicano - anglikanin | anglikański
Angola - Angola
ângulo - kąt
angústia - strapienie | trwoga | smutek | udręka | niepokój
anho - owieczka | jagnię
animação - animacja
animal - zwierzę
animismo - animizm
animista - animista | animistka
anis - anyż | biedrzeniec anyż | likier z anyżu
anis-estrela - anyż gwiazdkowy | anyż gwiaździsty | badian właściwy
aniversário - rocznica | urodziny | rocznica urodzin
anjo - anioł
anjo da guarda - Anioł Stróż
ano - rok
a noite é boa conselheira - noc jest dobrym doradcą
anomalia - anomalia
anônimo - anonimowy
Ano-Novo - Nowy Rok
anorético - anorektyk | anorektyczny
anorexia - anoreksja
anoréxico - anorektyk | anorektyczny
anormal - nienormalny | anormalny | nieprawidłowy
ansiedade - niepokój
ansiosamente - trwożnie | z lękiem | z niepokojem
ansioso - niespokojny | chętny
anta - tapir | idiota | głupek
antagonista - antagonista | oponent | przeciwnik | antagonistka | oponentka | przeciwniczka
Antártica - Antarktyda
antebraço - przedramię
anteontem - przedwczoraj
anterior - poprzedni | wcześniejszy
anterioridade - pierwszeństwo
antes - przedtem | wcześniej | dawniej | kiedyś | raczej | lepiej
antes só do que mal acompanhado - lepiej być samemu niż w złym towarzystwie
antes tarde do que nunca - lepiej późno niż wcale
antibiótico - antybiotykowy | antybiotyk
anticlericalismo - antyklerykalizm
anticomunismo - antykomunizm
anticorpo - przeciwciało
antídoto - antidotum
antiético - nieetyczny
antifascista - antyfaszysta | antyfaszystka | antyfaszystowski | antyfaszystowska
Antiga República Jugoslava de Macedónia - Była Jugosłowiańska Republika Macedonii
antigo - antyczny | stary | z minionej epoki | antyk
Antígua e Barbuda - Antigua i Barbuda
antiguidade - starożytność
antílope - antylopa
antimónio - antymon
antimônio - antymon
antipatia - antypatia | niechęć
antisséptico - antyseptyczny | antyseptyk
antissionismo - antysyjonizm
antiteísmo - antyteizm
antítese - antyteza
antônimo - antonim
António - Antoni | imię męskie
antropofagia - kanibalizm | ludożerstwo
antropogeografia - antropogeografia
antropogeográfico - antropogeograficzny | związany z antropogeografią
antropologia - antropologia
Antuérpia - Antwerpia
anual - coroczny
anualmente - rocznie | co rok
anular - anulować | unieważniać | odwoływać | odwołać | pierścieniowy | obrączkowy
anúncio - reklama | ogłoszenie
ânus - anus | odbyt
aonde - gdzie
aorta - aorta
apagar - gasić | dusić
aparecer - pojawiać się | zjawiać się | ukazać się
aparelho - urządzenie
aparência - wygląd | pozór
aparição - aparycja
apartamento - mieszkanie
apelar - apelować | dopraszać się | błagać
apenas - tylko
apêndice - appendiks
apêndice cecal - wyrostek robaczkowy
apendicite - zapalenie wyrostka robaczkowego
Apeninos - Apeniny
aperitivo - aperitif
apertado - ciasny
apertar - ściskać
aperto - apertar
apetite - apetyt
apicultor - pszczelarz
apicultura - pszczelarstwo
apinhado - zatłoczony
apito - gwizdek
aplaudir - oklaskiwać
aplauso - aplauz | oklaski
aplicação - aplikacja
aplicar - stosować | używać | aplikować
aplicável - odpowiedni
apocalipse - apokalipsa
apocalíptico - apokaliptyczny
apócrifo - apokryficzny
apodrecer - psuć | gnić | rozkładać się
apoiar - wspierać
apólice - polisa
apolinarianismo - apolinaryzm
apoplexia - apopleksja | udar mózgu
aporia - aporia
após - po
aposento - pokój | sypialnia
apostar - zakładać się | obstawiać zakłady | stawiać na (kogoś/coś)
apostasia - apostazja
apóstrofo - apostrof
apreciar - szacować | cenić | doceniać
aprender - uczyć się | dowiedzieć się
apresentar - przedstawiać
a pressa é inimiga da perfeição - pośpiech jest wrogiem doskonałości
aprisionar - uwięzić | osadzić w więzieniu
apropriado - właściwy | odpowiedni
aprovação - zgoda | akceptacja | aprobata
aprovar - aprobować | uznawać | zatwierdzać | zgadzać się | przyjmować
aproveitar - korzystać
aproximar - przybliżać | zbliżać
aptidão - umiejętność | zdolność
apto - zdolny | zdatny
apunhalar - ugodzić sztyletem | zasztyletować | ukłuć | urazić słowami | zasztyletować się
aquarela - akwarela
aquário - akwarium
Aquário - Wodnik
aquático - wodny
aquecer - rozgrzewać | ocieplać
aquecimento global - globalne ocieplenie
aqueduto - akwedukt
aquele - tamten | ów
aquénio - niełupka
aqui - tu | tutaj
aquiescer - przyzwalać | godzić się | zgadzać się
ar - powietrze
árabe - Arab | Arabka | arabski
Arábia Saudita - Arabia Saudyjska
arábico - arabski
arabista - arabista | arabistka
araçá-boi - gatunek goździkowca z Amazonii w Brazylii
aracnofobia - arachnofobia
Aragão - Aragonia
arame - drut
arando - czarna jagoda
aranha - pająk
arbitrariamente - dowolnie
árbitro - sędzia
arbusto - krzew | krzak
arcada - arkada | arcado
arca de Noé - arka Noego
arcaico - archaiczny
arcanjo - archanioł
arcebispo - arcybiskup
arco - łuk
arco da velha - tęcza
arco de triunfo - łuk triumfalny
arco-e-flecha - łucznictwo
arco-íris - tęcza
arder - palić się | płonąć
árduo - pracochłonny | żmudny
área - obszar | powierzchnia | region | rejon
área penal - pole karne
areia - piasek
arejar - przewietrzyć
arena - arena
arenque - śledź
argamassa - moździerz
Argélia - Algieria
argelina - argelino | Algierka
argênteo - srebrny
argentina - argentino | Argentynka
Argentina - Argentyna
árgon - argon
argónio - argon
argônio - argon
argumentação - argument | argumentacja
árido - jałowy | wysuszony | nieczuły | ciężki | nieprzyjemny
Áries - Baran
aríete - taran
aristocracia - arystokracja
aristocrata - arystokrata | arystokratyczny | arystokrakta
aristocrático - arystokratyczny
Aristóteles - Arystoteles
aritmética - arytmetyka | aritmético
arma - broń
armação - uzbrojenie | wyposażenie | oprawa okularów
arma de fogo - broń palna
armadilha - pułapka
armadilho - pancernik
armar - zbroić
armário - szafa
armas - arma | armar
armazém - magazyn | skład | hurtownia
Arménia - Armenia
Armênia - Armenia
armênio - ormiański | Ormianin
arminho - gronostaj
armistício - rozejm
aromático - wonny | aromatyczny
arpão - harpun
arpista - nieufny | podejrzliwy | bojaźliwy | ostrożny
arqueiro - łucznik | bramkarz
arqueologia - archeologia
arqueológico - archeologiczny
arquétipo - archetyp
arquipélago - archipelag
Arquipélago de Cabo Verde - Wyspy Zielonego Przylądka
arquitectura - architektura
arquiteto - architekt
arquitetônico - architektoniczny
arquitetura - architektura
arquitrave - architraw
arquivo - archiwum | arquivar
arranha-céu - wieżowiec
arranhar - drapać
arranja - arranjar
arranjar - aranżować | organizować
arrefecer - ochładzać | ochłodzić | chłodzić
arrogância - arogancja | zuchwałość
arrogante - arogancki
arroz - ryż
arrumação - porządkowanie | porządki
arsénico - arsen
arsênio - arsen
arte - sztuka
artéria - arteria
artesão - rzemieślnik | rękodzielnik
arte urbana - street art | sztuka ulicy
articulação - staw | artykulacja
artificial - sztuczny
artigo - rodzajnik | artykuł
artilharia - artyleria
artista - artysta | artystka
artisticamente - artystycznie
artístico - artystyczny
Aruba - Aruba
árvore - drzewo
árvore de Natal - choinka
as - o
asa - skrzydło
as aparências iludem - pozory mylą
ascenão - uniesienie się | wniebowstąpienie
ascensão - wspinaczka | wschodzenie | wspinanie | wniebowstąpienie
asfaltar - asfaltować | kłaść asfalt
asfalto - asfaltar | asfalt
Ásia - Azja
asiática - asiático | mieszkanka Azji | Azjatka
asiático - azjatycki | orientalny | mieszkaniec Azji | Azjata
asma - astma
asneira - głupota
asno - osioł
as paredes têm ouvidos - ściany mają uszy
aspargo - szparag
aspecto - aspekt | wygląd | widok
áspero - szorstki | chropowaty
aspiração - aspiracja | dążenie | życzenie | pragnienie
aspirador - odkurzacz
aspirina - aspiryna
assaltar - napadać | atakować
assalto - napad | napaść | atak | assaltar
assar - piec
assassina - assassinar | assassino
assassinar - mordować
assegurar - zapewniać | gwarantować | upewniać się
assembleia - zebranie | zgromadzenie
assembléia - zebranie | zgromadzenie | assembleia
assente - assentar | assentir
assento - assentar
assertividade - asertywność
assexualidade - aseksualność
assíduo - wytrwały | skrzętny | gorliwy | pilny | sumienny
assim - w ten sposób | tak
assimilação - asymilacja
assimilar - asymilować
assinar - podpisywać
assinatura - podpis | sygnatura
assiriologia - asyriologia
assistência - obecność | publiczność | audytorium | pomoc | opieka
assistir - asystować
asso - assar
assoalho - assoalhar
assobiar - gwizdać
assobio - gwizd
associação - stowarzyszenie
assunção - założenie | przypuszczenie
assunto - temat | wątek | materia | kwestia
assustar - straszyć | przestraszyć
astatínio - astat
astato - astat
astenosfera - astenosfera
asterisco - asterysk | gwiazdka | odsyłacz
asteroide - planetoida | asteroida
asteróide - asteroida
astral - astralny | gwiezdny
às três é de vez - do trzech razy sztuka
astrologia - astrologia
astronauta - astronauta | astronautka
astronomia - astronomia
astronômico - astronomiczny
astrónomo - astronom
astrônomo - astronom
astuto - przebiegły | chytry | podstępny
às vezes - czasami | czasem
atacar - atakować
atalho - atalhar
ataque - atak
ataúde - trumna
atchim - apsik! | a psik!
até - do | aż do | dopóki | nawet
ateia - ateistka | atear | ateu
ateísmo - ateizm
ateísta - ateistyczny | niewierzący | ateista
ateístico - ateistyczny
até logo - do zobaczenia | do widzenia wkrótce
atemorizar - przestraszyć
Atenas - Ateny
atenção - uwaga | atencja | uwaga!
atencioso - uważny
atentado - zamach
atento - uważny
aterrar - terroryzować | przerażać
ateu - ateista | ateusz | ateistyczny
atingir - osiągnąć | sięgać | dotrzeć | trafić
atirar - rzucać
ativação - aktywacja
atividade - aktywność
ativo - aktywny
Atlântico - Atlantyk
atleta - lekkoatleta | lekkoatletka
atletismo - lekkoatletyka | atletyka
atmosfera - atmosfera | środowisko | otoczenie
atmosférico - atmosferyczny
ato - akt | czyn | atar
atómico - atomowy
atômico - atomowy
átomo - atom
ator - aktor
atracção - atrakcja
atractivo - atrakcyjny | interesujący
atrás - z tyłu
atrasar - opóźniać | przekładać | cofać zegar | spóźniać się
atributo - atrybut | cecha
atriz - aktorka
atrocidade - okrucieństwo
atuação - działalność | działanie | gra
atual - aktualny | bieżący | obecny
atualidade - aktualność | teraźniejszość
atualização - aktualizacja
atualizar - aktualizować | uaktualniać | zaktualizować
atualmente - aktualnie | obecnie
atum - tuńczyk
audácia - śmiałość
auditório - widownia | publiczność | audytorium
aumento - aumentar
a união faz a força - w jedności siła
aurora - świt
ausência - nieobecność
ausente - nieobecny
austero - poważny
Austrália - Australia
australiano - australijski | Australijczyk
Áustria - Austria
austríaca - austríaco | Austriaczka
austríaco - austriacki | Austriak
autenticamente - autentycznie
autenticidade - autentyczność
autentico - autenticar
autêntico - autentyczny
autismo - autyzm
autocarro - autokar
auto-estrada - autostrada
autografo - autografar
autógrafo - autograf
automático - automatyczny
automóvel - auto | pojazd | samochód | automatyczny
autonomia - autonomia
autónomo - autonomiczny | niezależny | samodzielny
autônomo - niezależny | autonomiczny
autópsia - autopsja
autor - autor
autoridade - autorytet
autorização - autoryzacja | zezwolenie | pozwolenie | uprawnienie
auxiliar - pomocniczy | pomagać | wspierać
avalanche - lawina
avançado - napastnik
ave - ptak
aveia - owies
avelã - orzech
avelaneira - leszczyna | leszczyna pospolita
aveleira - avelaneira
avenida - aleja | bulwar
aventura - przygoda | aventurar
aventure - aventurar
averiguar - sprawdzać | badać | dociekać
avestruz - struś
aviação - lotnictwo | awiacja
avião - samolot
avó - babcia | babka
avô - dziadek
axioma - aksiomat | pewnik
azar - traf | przypadek | los | ryzyko | niebezpieczeństwo
azedo - kwaśny
azeite - olej | oliwa | azeitar
azeitona - oliwka
azerbaidjano - Azerbejdżanin | azerbejdżański | azerski
azerbaijano - Azerbejdżanin | azerbejdżański | azerski
Azerbaijão - Azerbejdżan
azevinho - ostrokrzew kolczasty
azimute - azymut
azul - niebieski
azulejo - kafel | płytka ceramiczna | azulejar
baba - babar
babuíno - pawian
bacalhau - dorsz | bacalhau
bacano - bogaty
bacilo - bakcyl
baço - śledziona
bactéria - bakteria
bactericida - bakteriobójczy | środek bakteriobójczy
bacteriologia - bakteriologia
baga - jagoda
bagagem - bagaż
bagatela - bagatela | błahostka | drobiazg | drobnostka
Bagdá - Bagdad
bagunça - bałagan | nieporządek
bagunceiro - bałaganiarski | niechlujny | bałaganiarz
baía - zatoka
bailar - tańczyć
baile - bal
baioneta - bagnet
bairro - dzielnica
baixo - niski | niewysoki | nieduży | mały | tani | nieistotny | nisko | bas
baixo-relevo - płaskorzeźba
bala - pocisk
balança - waga (przyrząd) | bilans
Balança - Waga
balão - balon
balcão - balkon
baldaquim - baldachim | baldaquino
baldaquino - baldachim
balde - wiadro
baldo - baldar
balé - balet
balear - strzelać
baleia - wieloryb
baleia-assassina - orka
baleia-azul - płetwal błękitny
Báltica - Bałtyka
báltico - bałtycki
bambu - bambus
banal - zwyczajny | mało oryginalny | banalny | zwykły | powszechny
banalidade - frazes | banał
banana - banan
bancário - bankowy
banco - bank | ławka
bandeira - flaga
bandeirante - pionier
bandeja - taca
bandido - bandyta | rozbójnik | zbój | rabuś
Bangladeche - Bangladesz
banheira - wanna
banheiro - łazienka | toaleta | ubikacja
banho - kąpiel | banhar
banjo - banjo
banqueiro - bankier
banquete - bankiet
baobá - baobab
baptismo - chrzest
barafunda - zamieszanie | zgiełk
barão - baron
barata - karaluch
barato - tani
barba - broda
barbacã - barbakan
Barbados - Barbados
Bárbara - Barbara
barbeiro - fryzjer
barco - łódź
barda - żywopłot
Barém - Bahrajn
bário - bar
barista - barman | barmanka
barítono - baryton
barômetro - barometr
baronesa - baronowa
barraca - namiot | barak | szałas | stragan
barranco - wąwóz
barreira - bariera | zapora
barricada - barykada
barriga - brzuch
barril - beczka
barulho - hałas | zgiełk | wrzawa | barulhar
basco - Bask | baskijski (język) | baskijski
base - baza | podstawa | zasada
basebol - baseball
básico - podstawowy | elementarny | fundamentalny
basquete - koszykówka
basquetebol - koszykówka
basta - bastar | basto
bastante - dostatecznie | wystarczająco
bastão - kij
bastar - wystarczać
bastimento - abastecimento
batalha - bitwa | batalia
batalhão - batalion
batas - bata | bater
batata - ziemniak | kartofel | duży nos | „kartoflany” nos
batata-da-terra - wilec ziemniaczany | batat | patat | słodki ziemniak
batata-doce - wilec ziemniaczany | batat | patat | słodki ziemniak
bater - bić
baterista - perkusista | perkusistka
batismo - chrzest
batizar - chrzcić | ochrzcić | nazwać
batom - szminka | pomadka
baunilha - wanilia
beata - dewotka | niedopałek | pet
beato - pobożny
bêbado - pijany | alkoholik | pijak
bebé - niemowlę | osesek
bebê - niemowlę
bêbedo - pijany
beber - pić
bebida - napój
bebo - beber
beco - uliczka
beiço - warga
beige - beżowy
beija-flor - koliber
beijar - całować
beijo - pocałunek
Beirute - Bejrut
beisebol - baseball
beleza - piękno | uroda
belga - belgijski | Belg | Belgijka
Bélgica - Belgia
beliscar - szczypać
Belize - Belize
belo - piękny
bem - dobrze
bem-vindo - mile widziany
bênção - błogosławieństwo
benfeitor - dobroczyńca
bengala - kij | pałka | laska
Benim - Benin
benzeno - benzen
berço - kołyska
bergamota - pomarańcza bergamota | owoc pomarańczy bergamoty
berílio - beryl
beringela - bakłażan
berinjela - bakłażan
Berlim - Berlin
Bermudas - Bermudy
berquélio - berkel
besouro - żuk
besta - zwierzę | osoba brutalna
betão - beton
beterraba - burak
betoneira - betoniarka
bétula - brzoza
bexiga - pęcherz moczowy
Bíblia - Biblia
bíblico - biblijny
bibliografia - bibliografia
biblioteca - biblioteka
biche - bichar
bicicleta - rower | przewrotka
bico - dziób
Bielorrússia - Białoruś
bigode - wąsy | wąs
bilateral - dwustronny
bilhar - bilard
bilhete - bilet
binóculo - lornetka
biocentrismo - biocentryzm
biográfico - biograficzny
biologia - biologia
biologicamente - biologicznie
biológico - biologiczny
biologista - biolog | biolożka | kobieta biolog
biólogo - biolog
bioquímica - biochemia | kobieta biochemik | bioquímico
biossíntese - biosynteza
bioterapia - bioterapia
Birmânia - Birma | Mianmar
bisão - bizon
bisavô - pradziadek
biscoito - ciastko
bismuto - bizmut
bisneta - prawnuczka
bisneto - prawnuk
bispado - biskupstwo
bispo - biskup | laufer | goniec
bissexual - biseksualny | dwupłciowy
bissexualidade - biseksualizm
blandícia - pieszczota | pochlebstwo
blasfemar - złorzeczyć | bluźnić
blusa - bluza | bluzka
boa - boa | bom
boa noite - dobranoc
boa tarde - dobry wieczór
boato - pogłoska | plotka
bobo - błazen
boca - usta | buzia
bocejar - ziewać
bocejo - ziewnięcie
bochecha - policzek
bode - kozioł
bóhrio - bohr
boi - wół
bola - kula | piłka
bolacha - herbatnik
boletim - biuletyn
boletim meteorológico - prognoza pogody
Bolívia - Boliwia
bolo - ciasto | ciastko
bolsa - torebka
bolso - kieszeń
bom - dobry | właściwy
bom apetite - smacznego!
bomba - bomba | pompa
bombardear - bombardować
bombeiro - strażak
bombom - czekoladka | cukierek
bom dia - dzień dobry
bondade - dobroć
bondoso - dobry | dobrotliwy | dobroduszny
boné - czapka
bonito - ładny | ładniutki | ładniusieńki
borboleta - motyl
bordado - haft
bordar - haftować | obrębiać
bordel - dom publiczny | burdel
Bordéus - Bordeaux
bordo - pokład | klon | burta | temperament | nastrój | usposobienie (umysłu) | bordar
bordô - bordo | bordowy | szkarłatny
borla - frędzel
boro - bor
borracha - gumka do ścierania
Bósnia e Herzegovina - Bośnia i Hercegowina
bósnio - Bośniak | bośniacki
bosque - las
bota - but
botânica - botanika | kobieta botanik | botânico
botânico - botaniczny | botanik
botão - guzik
Botsuana - Botswana
boutique - butik
boxe - boks
boxeador - bokser
braço - ramię
branco - biały
Brasil - Brazylia
brasileira - Brazylijka | brasileiro
brasileiro - Brazylijczyk | brazylijski
Brasília - Brasília | stolica Brazylii
brasílico - brazylijski
bravo - śmiały | dzielny | dzielny mężczyzna
brejo - bagno | mokradło | moczary
Bretanha - Bretania
bretão - bretoński | brytyjski
breve - krótki
brevemente - zwięźle
brigada - brygada
brilhante - wspaniały | brylant
brilhar - błyszczeć
brincar - grać
brinco - kolczyk | brincar
brinquedo - zabawka | zabawa | impreza taneczna
brócolis - brokuł
bromo - brom
bronha - masturbacja (mężczyzny)
bronze - brąz
bronzear - opalać | opalić
bronzear-se - opalać się | opalić się
brotar - kiełkować
Brunei - Brunei
brutalidade - brutalność
bruto - zwierzę | bestia | brutal | chamski | niegrzeczny | prymitywny | prostacki | niewychowany
bruxa - wiedźma
bruxaria - sztuka magiczna | uprawianie magii
Bruxelas - Bruksela
bruxismo - bruksizm | briquismo
bruxo - czarodziej
bucal - ustny
Bucareste - Bukareszt
bucho - flaczki | flaki | żołądek | brzydka kobieta | paszczur
buchuda - w ciąży
Budapeste - Budapeszt
budismo - buddyzm
budista - buddysta | buddystka | buddyjski
búfalo - bawół
bulbo - bulwa | cebula | cebulka
búlgara - búlgaro | Bułgarka
Bulgária - Bułgaria
búlgaro - bułgarski
bulgur - bulgur
bunda - tyłek | odbyt
buraco - dziura
burguês - burżuj | snob | mieszczanin | drobnomieszczanin | burżuazyjny | burżujski
burguesia - mieszczaństwo | burżuazja
Buriácia - Buriacja
burocracia - biurokracja
burocrata - biurokrata
burocraticamente - biurokratycznie
burocrático - biurokratyczny
Burquina Faso - Burkina Faso
burro - osioł | głupiec
burros velhos não aprendem línguas - nie przesadza się starych drzew
busca - buscar | szukanie | poszukiwanie
buscar - poszukiwać | szukać | wyszukiwać
bússola - busola
Butão - Butan
buzina - klakson
cá - tu | tutaj
cabeça - głowa | główka (zaokrąglony koniec jakiejś rzeczy) | mądrość
cabelo - włosy
caber - mieścić się | wchodzić | należeć
cabergolina - kabergolina
cabes - caber
cabide - wieszak
cabo - kabel
Cabo Verde - Republika Zielonego Przylądka
cabra - koza
caça - polowanie
caçador - myśliwy
caçar - polować
cacarejo - gdakanie | paplanina | gadanie
cacau - kakao
cacete - pałka | maczuga | nudziarz | denerwowująca lub męcząca osoba | fiut | natarczywy | natrętny | nużący | męczący
cachalote - kaszalot
cachimbo - fajka
cachoeira - wodospad
cachopa - dziewczyna
cachorra - suka | suczka | samica psa
cachorro - szczenię | szczeniak
cacique - kacyk
cacófato - kakofonia
cacto - kaktus
caçula - najmłodsze dziecko w rodzinie | najmłodszy
cada - każdy | wszelki
cadáver - trup | zwłoki
cadeia - łańcuch | więzienie | seria
cadeira - krzesło
cadeira de rodas - wózek inwalidzki
cadela - suka | samica psa
cádmio - kadm
Cafarnaum - Kafarnaum
café - kawa
café da manhã - śniadanie
cafeeiro - kawowiec
cafeína - kofeina
cagar - srać
caibo - caber
cair - spaść | upaść
cais - nabrzeże | cal | cair
caixa - pudełko | skrzynka
caixa-negra - czarna skrzynka
caixão - trumna
caixa-preta - czarna skrzynka
caju - nerkowiec
calabouço - ciemnica | loch
calamidade - klęska | katastrofa | nieszczęście
calar - milczeć | być cicho
calça - calças | calçar
calçada - chodnik
calçadeira - łyżka do butów
calçado - but
calcadouro - klepisko
calcanhar - pięta
calcário - wapienny | wapnisty | wapienniczy
calças - spodnie
cálcio - wapń
calcular - obliczać | kalkulować | liczyć
cálculo - kalkulacja | rachunek | obliczenie
caldeirão - kocioł
caldo - bulion
cale - calar
caleidoscópio - kalejdoskop
calendário - kalendarz
calhandra - kalandra
calibre - kaliber | calibrar
califado - kalifat
Califórnia - Kalifornia
califórnio - kaliforn
calma - ciepło | parność | spokój | calmar | calmo
calmo - calmar | spokojny
calor - ciepło
caloria - kaloria
calórico - kaloryczny
calvinismo - kalwinizm
cama - łóżko
camaleão - kameleon
câmara - izba | pomieszczenie
camarada - towarzysz
camarão - krewetka
Camarões - Kamerun
Camboja - Kambodża
camelo - wielbłąd
camião - caminhão
caminhão - ciężarówka
caminhar - chodzić | iść
caminho - droga | ścieżka
camisa - koszula
camisa de força - kaftan bezpieczeństwa
camisinha - prezerwatywa
camomila - rumianek
campainha - dzwonek
campana - dzwon
campeão - mistrz
campeonato - mistrzostwo | czempionat | mistrzostwa
campina - łąka | obszar trawiasty
campo - obóz | boisko
campo eléctrico - pole elektryczne
camuflar - kamuflować
camundongo - mysz
camurça - kozica
cana - laska | trzcina
Canadá - Kanada
cana-de-açúcar - trzcina cukrowa | cukrowiec lekarski
canadense - Kanadyjczyk | Kanadyjka | kanadyjski
canal - kanał
canário - kanarek
canção - piosenka
canção de ninar - kołysanka
cancela - cancelar
cancelar - unieważniać | wykreślać
câncer - rak
Câncer - Rak
cancro - rak | nowotwór złośliwy
cândido - biały | śnieżnobiały | czysty | niewinny | szczery | otwarty | uczciwy | prostoduszny | naiwny
candura - niewinność | czystość
canela - cynamon
caneta - długopis
cangambá - skunks
canguru - kangur
canhão - armata | działo
canja de galinha - rosół
cano - rura | rurka | tuba
canoa - kanu | kanadyjka
cansaço - zmęczenie | znużenie
cansado - zmęczony
cansar - męczyć
cantar - śpiewać
cantaram - cantar
cântaro - dzban
cantaste - cantar
cantei - cantar
canto - śpiew | róg
cantor - śpiewak
cantou - cantar
cão - pies
cão de companhia - pies do towarzystwa
caos - chaos
caótico - chaotyczny
cãozinho - szczeniak
capa - koperta | nakrycie | osłona | przykrycie | okładka | płaszcz
capacete - hełm
capacidade - pojemność
capataz - majster | przodownik | kierownik
capaz - zdolny
capecitabina - kapecytabina
capela - kaplica
capicua - palindrom
capital - stolica | kapitał | główny
capitalismo - kapitalizm
capitão - kapitan
capítulo - rozdział
capivara - kapibara
capricho - kaprys | zachcianka | caprichar
Capricórnio - Koziorożec
capuz - kaptur
caqui - persymona | kaki
caquizeiro - persymona
cara - twarz
carabina - karabin | strzelba
caracol - ślimak | lok (włosów) | kędzior | loczek
carácter - charakter | caráter
característica - charakterystyka | cecha (charakterystyczna) | właściwość | característico
característico - charakterystyczny
caracterização - charakteryzacja
caraíba - karaibski
caranguejo - krab
carapau - ostrobok
caratê - karate
carbono - węgiel
cárcere - karcer | więzienie
Carcóvia - Charków
cardamomo - kardamon
cardiologia - kardiologia
careca - łysina | łysienie | łysa osoba | łysy
carecer - nie mieć | nie posiadać | brakować | potrzebować
careta - grymas | mina
carga - ciężar | obciążenie | brzemię | ładunek
caricatura - karykatura
carinho - czułość | delikatność
Carlos - Karol
carnaval - karnawał
carne - mięso | ciało | muskularna część
carneiro - baran
carnificina - masakra | rzeź
caro - drogi | kosztowny | bliski
caroço - pestka | guz
carpa - karp
carpinteiro - stolarz
carregar - ładować
carretel - szpula | zwój
carro - wóz | samochód
carruagem - przewóz
carta - list | karta | spis | np. dań | win | oficjalny dokument | mapa | dyplom | karta do gry | cartar
carta de condução - prawo jazdy
cartão - karta
cartão amarelo - żółta kartka
cartão de crédito - karta kredytowa
cartão-postal - pocztówka
cartão vermelho - czerwona kartka
cartaz - afisz | plakat
carteira - portfel
carteiro - listonosz
cartilagem - chrząstka
carvalho - dąb
carvão - węgiel
casa - dom | mieszkanie | dynastia | firma
casaco - płaszcz
casa de banho - łazienka
casamento - małżeństwo | ślub
casar - żenić | wydać za mąż
casca - cascar
cascalho - żwir
cascata - wodospad | kłamstwo | rzecz zmyślona
cascavel - grzechotnik
caso - sytuacja | sprawa | przypadek | casar
caspa - łupież
casta - kasta | rasa | ród | gatunek | szczep
castanha - kasztan
castanho - ciemny brązowy
castelo - zamek
castidade - niewinność | czystość
castigar - karać | karcić
castigo - kara | castigar
castor - bóbr
castrar - kastrować
catalão - kataloński | Katalończyk | język kataloński
catalisador - katalizator
Catalunha - Katalonia
cataplexia - katapleksja
catapulta - katapulta
Catar - Katar | alternatywna pisownia słowa Qatar
catástrofe - katastrofa
catastrofismo - katastrofizm
catecismo - katechizm
catedral - katedra
categoria - kategoria | klasyfikacja | klasa | typ | gatunek
cativeiro - niewola
cativo - więzień | jeniec | pojmany | niewolnik | uwięziony | w niewoli
católica - católico | katoliczka
católico - katolicki | katolik
catorze - czternaście (14)
caucasiana - mieszkanka Kaukazu | caucasiano
caucasiano - Kaukaz | mieszkaniec Kaukazu | kaukaski
cauda - ogon | tren
caudaloso - obfity
caudilho - caudillo | dyktator | wódz | przywódca (partyjny, wojskowy)
causa - powód | sprawa
causar - powodować | sprawiać | wywoływać
cautela - ostrożność | roztropność | rozwaga | uwaga | troska
cavala - makrela
cavaleiro - rycerz
cavalgar - jechać na koniu
cavalo - koń
cavar - kopać | drążyć
caveira - czaszka
caverna - jaskinia
caviar - kawior
cavidade - jama | otwór
Cazaquistão - Kazachstan
CDHU - Companhia de Desenvolvimento Habitacional e Urbano
cebola - cebula
cedi - ceder
cedilha - znak diakrytyczny cedylla | cedilhar
cedo - wcześnie
cedro - cedr
cefaleia - ból głowy
cegamente - ślepo
cego - ślepy | niewidomy
cegonha - bocian
cegueira - ślepota
ceia - kolacja
celebração - świętowanie | uroczystość
celebrar - świętować | obchodzić | sławić | upamiętniać
célebre - słynny | sławny
celha - rzęsa
célula - komórka
celular - komórkowy | telefon komórkowy
cem - sto | 100
cementar - cementować
cemitério - cmentarz
cena - scena
cenoura - marchew
censura - cenzura | censurar
censurar - cenzurować
centauro - centaur
centeio - żyto
centésimo - setny | jedna setna
centímetro - centymetr
cento - sto | 100
central - centrala
centrismo - centryzm
centro - centrum | centrar
centroamericano - środkowoamerykański | mieszkaniec Ameryki Środkowej
cera - wosk
cerâmica - ceramika
cerca - ogrodzenie | płot | około
cercar - oblegać | otaczać
cerda - szczecina
cereal - zboże
cérebro - mózg | mentor
cereja - wiśnia
cerejeira - wiśnia
cerimônia - ceremonia
cério - cer
cerrar - zamykać | kończyć
certamente - na pewno
certeza - pewność
certidão - świadectwo | zaświadczenie | odpis
certidão de nascimento - akt urodzenia
certificar - certyfikować | uwierzytelniać | uwierzytelnić | poświadczyć | poświadczać | potwierdzać
certo - pewny | poprawny | na pewno
cerveja - piwo
cerviz - kark
cervo - jeleń
césio - cez
cesta - kosz | koszyk
cesto - kosz
céu - niebo | firmament | niebiosa | raj | Bóg | opatrzność
cevada - jęczmień
chá - herbata (napój) | herbata (roślina) | herbatka (drobne przyjęcie, poczęstunek) | uporczywy nawyk
chacal - szakal
Chade - Czad
chaleira - czajnik
chama - płomień
chamada - wezwanie | wzywanie
chamar - wzywać | wołać
chaminé - komin
champô - szampon
chantagem - szantaż
chão - ziemia | podłoga | poziom
chapéu - kapelusz
charco - kałuża
charlatanismo - szarlataneria
charlatão - szarlatan
charuto - cygaro
chau - do widzenia
chave - klucz
chave de fenda - śrubokręt
chávena - filiżanka
checa - checo | Czeszka
checar - sprawdzać
checo - czeski | Czech | czeski (język)
Checoslováquia - Czechosłowacja
chefe - szef
chegada - przybywanie | przybycie | nadchodzenie
chegam - chegar
chegar - przybyć | przyjechać | dojechać | dojść | dotrzeć do konkretnego miejsca | celu
cheio - pełny
cheirar - wąchać | pachnieć | mieć zapach
cheiro - węch | powonienie | woń | zapach
cheiroso - pachnący
cheque - czek
Chéquia - Czechy
cherne - wrakoń (gatunek ryby)
chicória - cykoria
chifre - róg
Chile - Chile
chilena - chileno | Chilijka
chileno - chilijski | Chilijczyk
chimarrão - yerba mate | herbata mate | maté
chimpanzé - szympans
China - Chiny
chinela - kapeć
chinelo - klapek | japonki
chinês - język chiński | Chińczyk | chiński
Chipre - Cypr
Chişinău - Kiszyniów
chocar - zderzać się | uderzać o coś | kolidować
choco - mątwa lub kałamarnica
chocolate - czekolada
chofer - kierowca | szofer
chorar - płakać
choro - lament | płacz
choupo - topola
chove - chover
chover - padać
chover a cântaros - lać jak z cebra
chuj - język chuj
chumbo - ołów
chupar - ssać | wsysać | wysysać | wchłaniać
chupeta - smoczek
chute - kopniak
chuva - deszcz
chuvisco - mżawka
chuvoso - deszczowy
ciber- - cyber- (internetowy)
cicatriz - blizna
cíclico - cykliczny | okresowy
ciclista - rowerzysta | rowerzystka
ciclo - cykl
ciclone - cyklon
cidadão - obywatel
cidade - miasto
Cidade do Cabo - Kapsztad
Cidade do Vaticano - Państwo Watykańskie
ciência - nauka | wiedza
ciência da computação - informatyka
ciência política - politologia
cientificamente - naukowo
científico - naukowy
cientista - naukowiec
cifra - cyfra
cigano - Cygan | cygański
cigarra - cykada
cigarro - papieros
cilada - zasadzka
cilindro - walec | cylinder
cílio - rzęsa
cima - wierzchołek | szczyt
cimento - cement | cimentar
cinabre - cynober
cinco - pięć
cinema - kino
cingalês - Syngalez | syngaleski
Cingapura - Singapur
cinicamente - cynicznie
cinismo - cynizm
cinologia - kynologia
cinquenta - pięćdziesiąt | 50
cinqüenta - pięćdziesiąt | cinquenta
cinta - cintar
cintura - talia
cinza - szary
cinzeiro - popielniczka
cinzel - dłuto
cinzento - szary
cipreste - cyprys
cipriota - cypryjski | Cypryjczyk | Cypryjka
circo - cyrk
circulação - cyrkulacja
circular - krążyć | obiegać
círculo - koło
circuncidar - obrzezać
circuncisão - obrzezanie
circunferência - obwód
circunstância - okoliczność | okoliczności | warunki
cirurgia - chirurgia
cirurgião - chirurg
cisne - łabędź
cisterna - cysterna
citação - cytat
citar - cytować | przytaczać
citologia - cytologia
citoplasma - cytoplazma
ciúme - zazdrość
ciumento - zazdrośnik | zazdrosna osoba | zazdrosny
civil - obywatelski | cywilny
civilização - cywilizacja | cywilizowanie
civilizar - cywilizować
clareza - jasność | klarowność
claridade - jasność | czystość | klarowność | przejrzystość
claro - jasny
classe - poziom | klasa | ranga | sala
clássico - klasyczny
classificação - klasyfikacja
cleptomania - kleptomania
cliente - klient | klientka
clima - klimat
clímax - apogeum | moment kulminacyjny | szczyt | orgazm
clínica - klinika | kliniczna | clínico
cloro - chlor
clorofila - chlorofil
coala - koala
cobalto - kobalt
cobarde - tchórzliwy | tchórz
cobra - kobra
cobre - miedź
cobrir - zakrywać | pokrywać
cocaína - kokaina
cóccix - kość guziczna
código - kod
codorniz - przepiórka | codorna
coelho - królik
cofre - kufer | skrzynia
cogitar - rozmyślać | dumać | zastanawiać się
cognome - przydomek | nazwisko rodowe
coima - mandat | grzywna
coincidência - zbieg okoliczności
coiote - kojot
coisa - obiekt | przedmiot | rzecz | sprawa | temat | interes
cola - klej
colaborador - współpracownik
colaborar - współpracować
colapso - upadek
colar - skleić | kleić
colchão - materac
coleção - kolekcja
cólera - cholera | złość | gniew
colérico - gniewliwy | wybuchowy | choleryczny | choleryk
colesterol - cholesterol
coletivo - zbiorowy
colher - łyżka
colherzinha - łyżeczka
colibri - koliber
colina - wzgórze | pagórek | cholina
colisão - kolizja
colmeia - ul
colméia - ul
colo - szyja
colocar - umieszczać | ulokować
Colômbia - Kolumbia
Colombo - Kolumb (odkrywca) | Kolombo
Colônia - Kolonia
colonial - kolonialny
colonialismo - kolonializm
colonização - kolonizacja
colonoscopia - kolonoskopia
colore - colorar | colorir
coloscopia - kolonoskopia
coluna - kolumna
com - z | ze
combate - bitwa | walka
combater - walczyć | zwalczać | zwalczyć
combinação - kombinacja
comboio - pociąg
combustão - spalanie
combustível - paliwo
começar - zaczynać
começo - początek | comedir | começar
comedão - zaskórnik | wągier
comédia - komedia
comemorar - upamiętniać | uczcić
comentar - komentować
comentário - komentarz | uwaga
comer - jeść | spożywać
comercial - handlowy | reklama (w radio lub telewizji)
comerciante - handlowiec | sprzedawca | kobieta handlowiec | sprzedawczyni
comércio - handel
cometa - kometa
comida - jedzenie | żywność | pokarm | comido
comigo - ze mną
comissão - komisja
comissário - komisarz
comitê - komitet
commisão - komisja | misja | prowizja
como - jak | skoro | ponieważ | jako że | comer
cômoda - komoda
Comores - Komory
compaixão - współczucie
companheiro - kompan | towarzysz
companhia - towarzystwo | spółka
comparação - porównanie | przyrównanie | konfrontacja
comparar - porównać | porównywać
comparativo - porównawczy | komparatyw | stopień wyższy (przymiotnika, przysłówka)
compartimento - pomieszczenie | przedział
competente - kompetentny | fachowy
competição - konkurencja | zawody
competir - rywalizować | konkurować
compito - competir
complemento - dopełnienie | uzupełnienie | complementar
completamente - kompletnie | całkowicie
completar - kompletować | dopełniać | kończyć | finalizować
completude - kompletność
complexidade - złożoność
complicação - komplikacja
complicar - komplikować
componente - składnik | składowy
compor - komponować
comportamento - zachowanie | postępowanie
composição - kompozycja | skład
compositor - kompozytor | zecer | składacz
compra - zakup | comprar
comprador - klient | osoba kupująca | nabywca
comprar - kupować
compreender - zrozumieć | rozumieć | zawierać | obejmować
comprimento - długość
compromisso - kompromis | obietnica
computador - komputer
computar - wyliczać | szacować
com toda a força - z całej siły
comum - pospolity | pospolitość | pospólstwo
comumente - powszechnie
comunhão - komunia
comunicação - komunikacja
comunidade - wspólnota | społeczność | grupa żyjących wspólnie ludzi | zwierząt
comunismo - komunizm
concavidade - wklęsłość
conceito - koncepcja | koncept | idea | pomysł
concentração - koncentracja | skoncentrowanie (się) | skupienie | gromadzenie
concepção - koncepcja
concerto - koncert
concha - muszla
concluir - kończyć | zamykać | konkludować | wnioskować
conclusão - wniosek
concordar - zgadzać się
condado - hrabstwo
conde - hrabia
condessa - hrabina
condição - warunek
condimento - przyprawa
conduzir - prowadzić
confederação - konfederacja
conferência - konferencja
conferir - sprawdzać | weryfikować | kontrolować
confiabilidade - niezawodność | wiarygodność | bycie godnym zaufania
confiança - zaufanie
confiar - powierzać | mieć nadzieję | ufać (komuś)
confiável - wierny | rzetelny
confine - confinar
confirmação - potwierdzenie
confisca - confiscar
confiscar - konfiskować
conflito - konflikt
conformismo - konformizm
conformista - konformista | konformistka | konformistyczny
confortavelmente - wygodnie
confucianismo - konfucjanizm
Confúcio - Konfucjusz
confusão - zamieszanie | zamęt | zagmatwanie
confuso - mętny | niejasny | zagmatwany | speszony
conhecer - wiedzieć | mieć pojęcie | pojmować | rozumieć
conhecimento - wiedza | znajomość
conjugação - koniugacja
cônjuge - małżonek | mąż
conjunção - spójnik
conjunto - łączny | połączony | wspólny | zespół | grupa | zbiór | całość | całokształt | komplet | drużyna | team
conotação - konotacja | skojarzenie
conquista - podbój | conquistar
conquistar - podbijać | zdobywać
consciência - sumienie | świadomość
consciente - świadomy
conseguir - osiągnąć | zdobyć | następować (jako konsekwencja, rezultat)
conselho - rada | synod
consenso - konsensus | zgoda
consequência - konsekwencja
conseqüência - konsekwencja
conserto - naprawa
conserva - conservar
considera - considerar
considerar - rozważać | uważać za
consideravelmente - znacząco | istotnie
considero - considerar
consigo - conseguir | z nim | z nią | z nimi | ze sobą…
consoante - spółgłoska
consócio - partner | towarzysz
consolação - pocieszenie
consolar - pocieszać | krzepić | podtrzymywać na duchu
constância - trwałość | stałość | wierność | stabilność | wytrzymałość
constantemente - ciągle
Constantinopla - Konstantynopol
constelação - konstelacja
constipação - przeziębienie
constitucional - konstytucyjny
constituição - konstytucja
construção - konstrukcja | budynek
construir - budować | konstruować
construtivismo - konstruktywizm
construtivista - konstruktywistyczny | konstruktywista | konstruktywistka
cônsul - konsul
consulado - konsulat
consulta - consultar
consultação - konsultacja
consultar - konsultować | radzić się | brać pod uwagę | zasięgać rady
consulto - consultar
consumidor - konsument
consumir - konsumować
consumo - zużycie | konsumpcja
conta - rachunek | liczenie | contar
contabilidade - księgowość | rachunkowość
contabilista - księgowy | księgowa
contabilizou - contabilizar
contaminar - skażać | zakażać
contar - liczyć | opowiadać
contemplar - kontemplować | przyglądać się | podziwiać | kontemplować w zachwycie
contemporâneo - współczesny
contenção - spór | niezgoda | konflikt | sprzeczka | debata | kontrowersja
conteúdo - zawartość
contexto - kontekst
contigo - z tobą | w twoim towarzystwie
contíguo - przyległy
continente - kontynent
continuação - kontynuacja
continuar - kontynuować | trwać
continuo - continuar
conto - historia | historyjka | opowieść | opowiadanie
contorno - kontur | contornar
contra - przeciw
contra-ataque - kontratak
contracepção - antykoncepcja
contrário - przeciwny | przeciwstawny | sprzeczny
contraste - contrastar
contribuição - kontrybucja | danina | datek | wkład
contribuir - przyczyniać się | wnosić wkład
controlar - kontrolować | kontrolować się
controvérsia - kontrowersja
contusão - kontuzja
convencer - przekonywać
convénio - konwencja | układ | umowa
conversa - rozmowa | konwersacja
conversação - rozmowa
conversar - rozmawiać | konwersować | konsultować
converso - conversar
convidar - zapraszać
convosco - z wami
convulsão - konwulsja
cooperar - kooperować | współpracować
cooperativa - spółdzielnia | kooperatywa
copa - korona drzewa | puchar | czara | denko kapelusza
Copenhaga - Kopenhaga
copiar - kopiować
copo - szklanka
cor - kolor
coração - serce
coragem - odwaga
corajoso - odważny | dzielny
coral - koral | koralowiec
Corão - Koran | Alcorão
corcunda - garbus | garbaty
corda - sznur
cordão - tasiemka | sznurowadło
cordão umbilical - pępowina
cordeiro - jagnię | baranek
cor-de-rosa - różowy
cordial - serdeczny | kordialny | szczery
coreana - coreano | Koreanka
coreano - koreański | Koreańczyk
Coreia do Norte - Korea Północna
Coreia do Sul - Korea Południowa
coreografia - choreografia
corno - róg
coroa - korona | wieniec | starsza osoba lub osoba w wieku średnim | coroar
coroação - koronacja
coronel - pułkownik
corpo - ciało
corpo celeste - ciało niebieskie
corporação - korporacja
corporativismo - korporacjonizm
corpulento - korpulentny | otyły | tęgi
correção - korekta | poprawka
corredor - korytarz
correio - poczta
corremos - correr
corrente - łańcuch
correr - biec | biegać
correspondência - korespondencja | zgodność
corretamente - poprawnie
correto - poprawny
corretor - makler
corri - correr
corrigir - korygować | poprawiać
corrimão - poręcz
corrosão - korozja
corrupção - korupcja | zepsucie
cortar - ciąć
corte - sąd
cortês - uprzejmy | grzeczny | kurtuazyjny
cortesia - uprzejmość | kurtuazja
cortiça - korek
coruja - sowa
corvo - kruk
coser - szyć
cosmético - kosmetyk | kosmetyczny
cósmico - kosmiczny
cosmologia - kosmologia
cosmonauta - kosmonauta | kosmonautka
cosmopolita - kosmopolita | kosmopolityczny
costa - wybrzeże
Costa do Marfim - Wybrzeże Kości Słoniowej
Costa Rica - Kostaryka
costas - grzbiet | plecy | wybrzeża | costa
costeiro - przybrzeżny
costela - żebro
costumar - być przyzwyczajonym | przyzwyczaić się
costume - nawyk
costurar - szyć
cotovelo - łokieć
cotovia - skowronek
couro - skóra
couve - kapusta
couve-flor - kalafior
coxa - udo
cozinha - kuchnia
cozinhar - gotować
cozinheiro - kucharz
Cracóvia - Kraków
crânio - czaszka
cravo - gwóźdź | wągier | wągr | zaskórnik | klawesyn
cravo-da-índia - goździk
crê - crer
creatinina - kreatynina
credes - crer
crédito - kredyt
credor - wierzyciel
crédulo - łatwowierny | naiwny
crêem - crer
creio - crer
cremos - crer
crença - wiara
crepúsculo - zmierzch
crer - wierzyć
creram - crer
crês - crer
crescer - rosnąć
creste - crer | crestar
creu - crer
cri - crer
cria - crer
criação - tworzenie | kreacja
criam - crer
críamos - crer
criança - dziecko
criar - tworzyć | stwarzać | wytwarzać | produkować | wynaleźć | zapoczątkować | założyć | wychowywać | hodować | uczyć | edukować
crias - crer | cria
criativo - kreatywny
críeis - crer
crime - przestępstwo
criminalizar - kryminalizować
cripta - krypta
criptografia - kryptografia
criptográfico - kryptograficzny
crípton - krypton
criptônio - krypton
críquete - krykiet
crisântemo - chryzantema
crise - kryzys
Crispim - Kryspin (imię męskie)
cristã - chrześcijanka | cristão
cristal - kryształ
cristão - chrześcijanin | chrześcijański
cristianismo - chrześcijaństwo
cristianizar - chrystianizować
cristologia - chrystologia
criticar - krytykować
Croácia - Chorwacja
croata - Chorwatka | croato
crocodilo - krokodyl
crómio - chrom
crômio - chrom
cromo - chrom
cromosfera - chromosfera
cromossomo - chromosom
crônico - przewlekły | chroniczny
cronológico - chronologiczny
cru - surowy
crucifixo - krucyfiks | crucifixar
cruel - okrutny
crueldade - okrucieństwo
cruelmente - okrutnie
cruz - krzyż
cu - dupa | zad
Cuba - Kuba
cubismo - kubizm
cubista - kubistyczny | kubista | kubistka
cuco - kukułka
cuidado - troska
culinária - sztuka kulinarna | kuchnia | culinário
culpa - wina | culpar
culpado - przestępca | sprawca | winowajca | winny | winien
culpar - obwiniać
cultivar - uprawiać
culto - kult
cultura - kultura
culturalmente - kulturalnie | kulturowo
cume - szczyt | najwyższy punkt | apogeum
cunhada - szwagierka
cunhado - szwagier
cupim - termit
curcuma - kurkuma
curcumina - kurkumina
curdo - Kurd | kurdyjski
cúrio - kiur
curioso - ciekawski | ciekawy
curo - curar
curta - curto | curtir
curto - krótki
curva - łuk | wygięcie | zakręt
curvo - curvar
cuspir - pluć
custar - kosztować
custo - cena
dadaísmo - dadaizm
dadaísta - dadaistyczny | dadaista | dadaistka
dádiva - prezent | podarunek | podarek
dama - dama
damasco - morela
dança - taniec | dançar
dançar - tańczyć
dançarina - tancerka
dançarino - tancerz
dano - szkoda | strata
Danúbio - Dunaj
dar - dawać
dar a entender - dać do zrozumienia
dar à luz - urodzić
dar a palavra de honra - dać słowo honoru
darmstádio - darmsztadt
data - data
de - z | do | o
debate - debata | dyskusja | obrady | debater
debater - debatować
década - dekada
decagramma - dekagram
decanado - dziekanat
decano - dziekan
decência - przyzwoitość
decente - przyzwoity
decentemente - przyzwoicie
decidir - decydować | rozstrzygać | przesądzać | postanawiać
décimo - dziesiąty
décimo primeiro - jedenasty
decisão - decyzja
declaração - deklaracja
declarar - deklarować | oświadczać | ogłaszać | proklamować | wyznawać
decoração - dekoracja | ozdoba | ozdobienie
decorar - dekorować | zdobić | uczyć się na pamięć
decorativo - dekoracyjny
decretar - dekretować | wydawać dekret
decreto - dekret | zarządzenie | rozporządzenie
dedo - palec
dedução - dedukcja | rabat | odpis | potrącenie
deduzir - wnioskować | dedukować | potrącać
defecar - wypróżniać się
defeito - wada | niedoskonałość | defekt
defender - bronić | bronić się
defensivo - defensywny | obronny
defensor - rzecznik | obrońca | orędownik
defesa - obrona | defensywa
déficit - deficyt
definição - definicja | określenie
definir - definiować | określać
degrau - stopień
degustar - smakować
dei - dar
deidade - bóstwo
deísmo - deizm
deitar - leżeć
deixar - opuszczać | zostawiać | pozwalać
deixo - deixar
delação - oskarżenie
delega - delegar
delegação - delegacja
delegado - delegat
delfim - delfin
delgado - szczupły | chudy | cienki | cienka część
deliberante - uchwalający | postanawiający
deliberativo - odnoszący się do deliberacji | obrad | narady | odnoszący się do postanowienia
delicadeza - delikatność
delicioso - pyszny | bardzo smaczny
deluso - zwodzący | oszukujący
demagogia - demagogia
demagogo - demagog
demais - zbyt | za bardzo
demande - demandar
demasiado - zbyt | zbytnio | zbytni | nadmierny
demissão - dymisja | rezygnacja
demmisão - zwolnienie | dymisja
democracia - demokracja
democratizar - demokratyzować
demografia - demografia
demonstração - demonstracja | dowodzenie | dowód | pokazywanie | pokaz
demonstrar - demonstrować | dowodzić | udowadniać | pokazywać
densidade - gęstość | rozdzielczość
dente - ząb
dentista - dentysta
dentre - wśród
dentuça - kobieta z wielkimi zębami | dentuço
departamento - departament
depauperar - ubożeć
depois - ponadto
deportar - deportować
depósito - depozyt
depravar - deprawować
depressa - szybko
depressão - depresja
deputado - deputowany
derivação - derywacja
derivar - wywodzić (z)
dermatologia - dermatologia
dermatologicamente - dermatologicznie
dermatológico - dermatologiczny
derradeiro - ostatni
desafiar - wyzywać | prowokować
desafio - wyzwanie | rozgrywka
desaparecer - znikać | ginąć | zapodziewać się
desaparecimento - zniknięcie | znikanie | zanikanie
desastre - nieszczęście | katastrofa | klęska
desavergonhado - bezwstydny
descanso - odpoczynek
descoberta - wynalazek | odkrycie
descoberto - obnażony | odsłonięty | odkryty
descobrimento - odkrycie
descobrir - odkrywać | wynajdować | obnażać | odsłaniać | ujawniać się | dawać się poznać
descolonização - dekolonizacja
desconfortável - niewygodny
descrever - opisywać
descrição - opis | opracowanie
desculpar - wybaczać | usprawiedliwiać
desculpe - przepraszam!
desde - od (kiedy)
desejar - chcieć | pragnąć | tęsknić | życzyć sobie
desejável - pożądany
desejo - pragnienie | pożądanie | pociąg (seksualny)
desemprego - bezrobocie
desenhar - rysować
desenhista - rysownik | rysowniczka
desenho - rysunek | desenhar
desenvolvimento - rozwój
deserto - pustynia
designadamente - mianowicie
desjejum - śniadanie
desleal - nielojalny
desligar - wyłączać | odłączać | oddzielać
desmaiar - omdlewać | zasłabnąć | zemdleć | blednąć
desmazelado - niechlujny
desmontar - demontować
desmoralização - demoralizacja | zgorszenie
desnecessário - niepotrzebny
desobediência - nieposłuszeństwo
desobediente - nieposłuszny
desocupação - bezrobocie
desodorante - dezodoryzujący | dezodorant
desordem - nieporządek | nieład | bałagan | bezład | dezorganizacja | chaos
desorganização - dezorganizacja | rozkład
despedida de solteiro - wieczór kawalerski
despertador - budzik
despesa - koszt
desporto - sport
déspota - despota
despotismo - despotyzm
deste - dar
destilação - destylacja
destino - los | przeznaczenie
destruição - destrukcja
destruir - niszczyć
destrutivo - destrukcyjny
desumano - nieludzki
desventura - niepowodzenie | nieszczęście
detalhado - szczegółowy
detalhar - wyszczególniać
detalhe - detal | szczegół
detenção - aresztowanie | zatrzymanie
determinado - określony | ustalony | zdeterminowany | pewien | pewny
determinar - określać | ustalać | oznaczać | rozstrzygać
detestar - nienawidzić | gardzić | pogardzać
detetive - detektyw
detetor - detektor
deus - bóg
Deus - Bóg
devagar - wolno | powoli
devaneio - marzenie | sen
devastação - dewastacja
devedor - dłużnik
dever - musieć
devi - dever
devo - dever
dez - dziesięć
dezanove - dziewiętnaście | 19
dezasseis - szesnaście | 16
dezassete - siedemnaście
dezembro - grudzień
Dezembro - grudzień | dezembro
dezenove - dziewiętnaście | 19
dezesseis - szesnaście | 16
dezessete - siedemnaście | 17
dezoito - osiemnaście | 18
dia - dzień
diabo - diabeł
diácono - diakon
diagnóstico - diagnostyczny
dialética - dialektyka
dialeto - dialekt
diálogo - dialog | rozmowa
diamante - diament
diâmetro - średnica
diário - dziennik
diarreia - biegunka
dicionário - słownik
difamação - zniesławienie
diferença - różnica | niepodobieństwo | różność
diferente - różny | inny
difícil - trudny
dificuldade - trudność
dificultar - utrudniać | przeszkadzać
difusão - dyfuzja
digerir - trawić | strawić | tolerować
digestão - trawienie
digestório - pokarmowy
dígito - cyfra | numer
dignidade - godność
dimensão - wymiar
diminuição - zmniejszenie | redukcja
diminuir - maleć | skracać
dimorfismo - dymorfizm
Dinamarca - Dania
dinamarquês - Duńczyk | duński
dinamite - dynamit
dinheiro - pieniądz | pieniądze | waluta
dinossauro - dinozaur
diploma - dyplom | diplomar
dique - zapora | tama | wał | przeszkoda
direção - kierunek
direcção - kierunek
direita - prawa strona | prawica | prawa ręka
direito - prawo
direitos animais - prawa zwierząt
direitos humanos - prawa człowieka
diretamente - bezpośrednio
direto - prosty | bezpośredni
diretor - dyrektor
disco - krążek | płyta ( kompaktowa) | dysk
discussão - dyskusja
discutir - dyskutować
disenteria - dyzenteria | czerwonka
disfagia - dysfagia
disponibilidade - dostępność
disprósio - dysprosium
disputa - dysputa | dyskusja | sprzeczka | disputar
disputar - dyskutować | dysputować | sprzeczać się
disque - discar
disquete - dyskietka
distância - dystans | odległość
distante - odległy | daleki
distinguir - rozróżniać | wyróżniać
distintivo - charakterystyczny | znamienny | szczególny | wyróżniający | znak | znaczek | odznaka
distinto - odmienny | inny | różny | niepodobny | jasny | wyraźny | zauważalny
distribuição - dystrybucja
disturbo - disturbar
ditador - dyktator
ditadura - dyktatura
diversamente - odmiennie | inaczej
diversidade - różnorodność
diverso - różny | inny | niepodobny
divertido - zabawny | wesoły | śmieszny | rozrywkowy
dívida - dług
dividi - dividir
dividir - dzielić | oddzielać
divindade - boskość
divisão - podział | rozłam | podzielenie | dzielenie
divisível - podzielny
divo - boski | bóstwo | bóg | idol
divorciar - rozwodzić się
divórcio - rozwód
divulgação - upowszechnianie
dizer - mówić
do - de + o
doação - datek | darowizna
doador - dawca
dobro - podwójność | dwukrotność | duplikacja | dobrar
doce - słodki
doce como o mel - słodki jak miód
dócil - uległy | posłuszny
documento - dokument
doçura - słodycz
doença - choroba | mania | obsesja | nałóg
doente - chory | osoba chorowita | mająca problemy ze zdrowiem
doentio - niezdrowy
dogma - dogmat
dogmático - dogmatyczny
dogmatismo - dogmatyzm
dois - dwa
dois pontos - dwukropek
dólar - dolar
doloroso - bolesny
domestica - domesticar
domestico - domesticar
doméstico - domowy | rodzinny | krajowy | domowy (o zwierzęciu)
domicílio - miejsce zamieszkania
dominar - panować | dominować
domingo - niedziela
domínio - panowanie | zwierzchnictwo
dona-de-casa - gospodyni domowa
doninha - łasica
dopo - dopar
dor - ból | przykrość
dorminhoco - śpioch
dormir - spać
dormitório - akademik | dom studencki
dorso - grzbiet
dos - de + os
dourado - złoty
doutor - lekarz
doutorado - doktorat
doutoramento - doktorat
doutorando - doktorant
doutrina - doktryna
doze - dwanaście | 12
draconiano - drakoński | bardzo surowy
dragão - smok
dramático - dramatyczny
droga - lek | narkotyk
drogaria - drogeria
dromedário - dromader
dualismo - dualizm
ducentésimo - dwusetny | dwóchsetny
duplo - podwójny
durabilidade - trwałość
duração - czas trwania
durante - podczas | w czasie
duro - trudny
dúvida - wątpliwość
duvidar - wątpić
duzentos - 200 | dwieście
dúzia - tuzin
e - i
é - ser
ébano - heban
eclipse - zaćmienie
eco - echo
ecologia - ekologia
ecológico - ekologiczny
economia - ekonomia
económico - ekonomiczny
ecossistema - ekosystem
edema - obrzęk
edição - edycja | publikacja | wydanie
edificar - budować
edifício - budynek
editar - edytować
educação - edukacja | wychowanie
educar - wychowywać | edukować | uczyć | nauczać | kształcić | hodować (rośliny)
educo - educar
efeito - wynik | rezultat | efekt
efetivação - skuteczność | efektywność
efetividade - skuteczność | efektywność
eficácia - skuteczność | sprawność
eficiência - skuteczność | kompetencja
eficiente - skuteczny | kompetentny
efusão - wylanie | rozlanie | wylewność
egípcia - Egipcjanka | egípcio
egípcio - Egipcjanin | egipski
Egipto - Egipt
egiptólogo - egiptolog
Egito - Egipt
egocêntrico - egocentryczny
egoisticamente - egoistycznie
égua - klacz
einstânio - einstein
einstênio - einstein
eixo - oś
ela - ona
elaborar - dopracowywać
elas - one
ele - on
electrão - elektron
electricidade - elektryczność
electricista - elektryk
eléctrico - tramwaj | elektryczny
electrotécnico - elektrotechniczny
elefanta - słonica
elefante - słoń
elegância - elegancja
elegante - elegancki
elegantemente - elegancko | wytwornie | wykwintnie
elegia - elegia
eleição - elekcja | wybory
elenco - elencar | lista | katalog | rejestr | wykaz | spis
eles - oni
eletricidade - elektryczność
eletricista - elektryk
elétrico - elektryczny
eletrodo - elektroda
elétrodo - elektroda
eletromagnético - elektromagnetyczny
elétron - elektron
eletrônica - elektronika | elektroniczna | eletrônico
eletrónico - elektroniczny
elevador - winda | podnośnik | dźwig
elfo - elf
eliminação - eliminacja
eliminar - eliminować | usuwać | wykluczać
elipse - elipsa
elmo - ster
elogiar - chwalić
elogio - pochwała
eloquência - elokwencja
El Salvador - Salwador
em - w
emagrecer - chudnąć
emancipação - emancypacja
emancipar - uwalniać | emancypować | wyzwalać
embaixada - ambasada
embaixador - ambasador
embaralhado - zagmatwany | zmieszany | embaralhar
embora - choć | chociaż | pomimo
embriagado - pijany | upojony
embrião - embrion | zarodek | początek | rozpoczęcie
embriologia - embriologia
embriotomia - embriotomia
Emília - Emilia
emirado - emirat
Emirados Árabes Unidos - Zjednoczone Emiraty Arabskie
Emiratos Árabes Unidos - Zjednoczone Emiraty Arabskie
emissora - stacja nadawcza | radiostacja
emoção - emocja
emotivo - emocjonalny | uczuciowy
empáfia - zarozumiałość
empate - remis
empirismo - empiryzm
emplastro - tynk
empreendimento - przedsięwzięcie
empregar - zatrudniać | stosować | wykorzystywać
empreiteiro - budowniczy
empresário - przedsiębiorca
empréstimo - pożyczka
empurrar - pchać | popychać
em segunda mão - z drugiej ręki | używany
em tempo - przy okazji
emu - emu
encanador - hydraulik
encher - wypełnić | wypełniać
enciclopédia - encyklopedia
enciclopedicamente - encyklopedycznie
enciclopédico - encyklopedyczny
enciclopedismo - encyklopedyzm
enciclopedista - encyklopedysta | zwolennik encyklopedyzmu | encyklopedystka | zwolenniczka encyklopedyzmu
encoberto - ukryty | schowany | skrywany
encontrar - spotkać | znaleźć | znaleźć się
encontro - spotkanie | encontrar
endêmico - endemiczny
endereço - adres
endoplasma - endoplazma
endorfina - endorfina
endro - koper
endurecer - hartować | twardnieć | utwardzać
energia - energia
enfadar - nudzić | zanudzać
enfermeira - pielęgniarka
enfisema - rozedma
enganar - oszukiwać
engenharia - inżynieria
engenheiro - inżynier
engolir - łykać | połykać | przełykać | pochłaniać
engraçado - dziwny | śmieszny | ucieszny | pocieszny
enguia - węgorz
enigma - zagadka | zgadywanka | enigma | tajemnica
enigmático - enigmatyczny | zagadkowy | niejasny | zagmatwany | niezrozumiały
enjoo - mdłość | choroba lokomocyjna | wstręt | odraza
enlaçar - łączyć | połączyć | splatać | sznurować | ogarnąć
enologia - enologia
enorme - potężny | olbrzymi | ogromny
enquanto - podczas | gdy
enriquecer - wzbogacać | czynić bogatszym | bogacić się
ensinar - uczyć
então - wtedy
entender - rozumieć | znać się (na czymś)
enterro - pogrzeb
entrada - wejście | wjazd | brama
entrar - wchodzić
entre - między | pomiędzy
entregar - doręczać | wręczać | przekazywać | poddawać | oddawać w ręce
entrevista - wywiad | entrevistar
entusiasmo - entuzjazm | zachwyt | entusiasmar
entusiasta - entuzjastyczny | zachwycony | entuzjasta | zapaleniec | entuzjastka
envelope - koperta
enviar - wysyłać | posyłać
enxada - motyka | praca | zawód
enxame - chmara
enxofre - siarka
enzima - enzym
epitáfio - epitafium
época - czas | epoka
equação - równanie
equador - równik
Equador - Ekwador
equatorial - równikowy
équestre - konny
equilíbrio - równowaga
equimose - siniak
equinócio - równonoc
equipa - ekipa | equipar
equipar - ekwipować | wyposażać
equipe - zespół | ekipa
era - era | ser
érbio - erb
ereção - erekcja
Erevan - Erywań
Eritreia - Erytrea
erótico - erotyczny
errar - mylić się | błądzić | robić błąd
erro - błąd | pomyłka
erupção - erupcja
erva - trawa | ziele | zioła | zioło | marihuana
erva-de-gato - kocimiętka
ervilha - groch | groszek
escada - schody | drabina
escada rolante - schody ruchome
escaldar - sparzyć się
escândalo - skandal
escandinava - escandinavo | Skandynawka
Escandinávia - Skandynawia
escandinavo - skandynawski | Skandynaw
escândio - skand
escapar - uciekać
escapatória - wybieg | wymówka | schronienie
escocês - szkocki
escocesa - escocês | Szkotka
Escócia - Szkocja
escola - szkoła
escolher - wybierać | przebierać | selekcjonować | oddzielać
esconder - chować
esconderijo - kryjówka | schowek
escondido - ukryty
escopeta - karabin
escorpião - skorpion
Escorpião - Skorpion
escova - szczotka
escrava - niewolnica | escravo
escravatura - niewolnictwo
escravidão - niewolnictwo
escravo - niewolnik | niewolniczy
escrever - pisać | zapisać
escrita - pismo | pisanie
escritor - pisarz
escritório - biuro
escudo - tarcza
esculpir - rzeźbić
escultor - rzeźbiarz
escultura - rzeźba | sztuka rzeźbiarska
escuridade - ciemność
escuridão - ciemność | mrok
escuro - ciemny | mroczny
escuta - podsłuch
escutar - słuchać
escuteiro - harcerz
esfera - kula
esfinge - sfinks
esfregar - szorować | ścierać | zetrzeć | trzeć
esgrima - szermierka | esgrimir
Eslováquia - Słowacja
Eslovénia - Słowenia
Eslovênia - Słowenia
eslovíncio - słowiński
esmeralda - szmaragd
esmola - jałmużna | pomoc | zapomoga | wsparcie | ofiara (podczas mszy)
esófago - przełyk
Esopo - Ezop
espaço - przestrzeń
espaçoso - przestrzenny
espaço-tempo - czasoprzestrzeń
espada - miecz
Espanha - Hiszpania
espanhol - hiszpański
espanhola - Hiszpanka | espanhol
espantalho - strach na wróble
espargo - szparag
espasmo - spazm
especial - specjalny | szczególny
especialidade - specjalność | szczególność | specjalizacja
especialista - specjalista | specjalistka
especialmente - szczególnie | w szczególności | zwłaszcza | specjalnie
especiaria - przyprawa
espécie - gatunek
especificação - specyfikacja
especificadamente - szczególnie
especificamente - szczególnie
espelho - zwierciadło | lustro
espera - nadzieja | oczekiwanie
esperança - nadzieja
esperantista - esperantysta | esperantystka | esperancki
esperanto - esperanto
Esperanto - esperanto
esperar - czekać | mieć nadzieję
espero - esperar
espessura - zwartość | gęstość
espetáculo - spektakl
espião - szpieg
espinafre - szpinak
espírito - duch | dusza | energia | żywość | żywotność | zapał | skłonność
espiritual - duchowy
espiritualmente - duchowo
espirituoso - dowcipny
espirrar - kichać
espirro - kichnięcie
esplêndido - świetny | wspaniały
espontaneidade - spontaniczność
espontâneo - spontaniczny | naturalny | odruchowy
esporte - sport
esposa - małżonka | żona
esposo - mąż | esposar
esquecer - zapominać (coś, o czymś) | wyrzucać z pamięci | zapominać (czegoś) | zostawić coś gdzieś przypadkowo | rezygnować z czegoś | odstawiać coś (na bok) | nie myśleć więcej o czymś | utracić zdolności | nie umieć więcej czegoś
esqueleto - szkielet
esquerda - lewa strona | lewica
esquerdo - lewy
esqui - narta
esquiar - jeździć na nartach
esquilo - wiewiórka
esquizofrenia - schizofrenia
essa - f  esse
esse - ten | to
essencial - istotny | ważny | niezbędny | nieodzowny
está - estar
estabilidade - stabilność | trwałość | bezpieczeństwo
estação - pora roku | stacja
estadão - pompa | przepych | zbytek | luksus
estadia - pobyt | przebywanie
estádio - stadion | faza | etap
estado - stan
Estados Unidos - Stany Zjednoczone | USA
Estados Unidos da América - Stany Zjednoczone Ameryki
estalagem - zjazd | gospoda
estanho - cyna | estanhar
estante - półka | regał na książki
estar - być | przebywać | znajdować się
estar como peixe na água - czuć się jak ryba w wodzie
estar de olho em - mieć na oku
estar em maus lençóis - mieć kłopoty | być w tarapatach
estar no céu - czuć się jak w niebie
estatística - statystyka
estátua - posąg | statua
estatura - wzrost | postura
estável - stabilny | stały | trwały
este - ten
esterco - ekskrement | kał | wydalina
esterno - mostek
estética - estetyka | estético
Estevão - Stefan
estio - lato
estival - letni
estivo - estivar | letni | estival
estojo - futerał
estômago - żołądek
Estónia - Estonia
Estônia - Estonia
estorninho - szpak
estorvo - przeszkoda
estrada - droga | szosa | ulica | trasa | szlak | marszruta
estrangeiro - obcokrajowiec | zagraniczny
estrangular - dusić
estranha - estranho | estranhar
estratagema - podstęp
estratégia - strategia
estratégico - strategiczny
estrebaria - stajnia
estreia - premiera | debiut
estreitamento - zwężenie | zwężanie | zawężanie
estreito - ciasny | wąski
estrela - gwiazda
estricnina - strychnina
estrôncio - stront
estrutura - struktura | organizacja
estudante - uczeń | student | uczennica | studentka
estudantil - uczniowski | studencki
estudar - uczyć się | studiować | badać | obserwować
estudo - nauka | badanie naukowe | uczenie się | studium | estudar
estupefaciente - narkotyczny | narkotyk
estupidez - głupota | bezmyślność | prostactwo
estúpido - głupi | tępy | głupiec
esvaziar - opróżniać | wyczerpywać
eta - nazwa siódmej litery alfabetu greckiego i ósmej alfabetu starogreckiego | η
etapa - etap
eternamente - wiecznie | zawsze
eternidade - wieczność | nieskończoność
eterno - wieczny | nieskończony
eteromania - eteromania
eticamente - etycznie
ético - etyczny
etimologia - etymologia
etimológico - etymologiczny
Etiópia - Etiopia
etiqueta - etykieta | ceremoniał | nalepka
eu - ja
EUA - USA | Stany Zjednoczone Ameryki
eucalipto - eukaliptus
eufemismo - eufemizm
euforia - euforia
eugenol - eugenol
eunuco - eunuch
euro - euro
Europa - Europa
européia - Europejka | europeu
europeu - Europejczyk | europejski
európio - europ
eutanásia - eutanazja
evacuação - ewakuacja | opuszczanie
evacuar - ewakuować | opuszczać | opróżniać
evaporação - parowanie | wyparowywanie | odparowywanie
evaporar - parować
evento - wydarzenie | zdarzenie
evitar - unikać | omijać | strzec się | wystrzegać się
evitável - do uniknięcia
evolução - ewolucja
exactidão - dokładność | precyzyjność | poprawność
exageração - przesada
exagerar - przesadzać | przejaskrawiać | wyolbrzymiać
exagero - przesada | pretensjonalność | afektacja
exaltação - egzaltacja | uniesienie
exame - egzamin
examinar - egzaminować | badać | sprawdzać
exatamente - dokładnie
exceção - wyjątek
excelência - doskonałość | świetność | wyborność
excelente - wspaniały | wyborny | doskonały
excepção - wyjątek
excepto - oprócz
excerto - wyciąg | wypis | fragment
excesso - nadwyżka | nadmiar
excitação - pobudzenie | podniecenie | wzburzenie | podrażnienie
excitar - ekscytować | podniecać | pobudzać | prowokować | powodować | podniecać się
exclamação - okrzyk | wykrzyknięcie
exclamar - wykrzykiwać | wykrzyknąć
exclusivo - wyłączny | osobisty | jedyny | wyłączność
excomungar - ekskomunikować | wyklinać
excremento - kał | wydalina
excursão - wycieczka
executador - kat
executar - wykonywać | egzekwować
exemplo - przykład
exercício - ćwiczenie
exército - armia
exíguo - znikomy | bardzo mały
exílio - banicja | wygnanie | zsyłka
existência - egzystencja | istnienie | byt
existencialismo - egzystencjalizm
existir - istnieć | żyć | egzystować
êxito - powodzenie | sukces
exótico - egzotyczny
expansão - ekspansja
expansionismo - ekspansjonizm
expedição - wyprawa | ekspedycja | wysyłka
experiência - doświadczenie | próba | eksperyment
experimentar - eksperymentować
experimento - eksperyment | experimentar
explanação - wyjaśnienie
explicar - tłumaczyć | wyjaśniać
exploração - eksploracja
explorar - badać | eksplorować
explosão - eksplozja
exportação - eksport
exportar - eksportować
exposição - ekspozycja | przedstawienie | wystawa | naświetlenie kliszy
expressão - wyrażenie | zwrot | formuła | ekspresja
expressionismo - ekspresjonizm
expressionista - ekspresjonista | ekspresjonistka | ekspresjonistyczny
expropriar - wywłaszczać | konfiskować | zabierać
êxtase - ekstaza | uniesienie | zachwyt
extensão - długość | rozmiar | wielkość
extintor - gaśnica
extração - ekstrakcja | wydobycie
extraconjugal - pozamałżeński
extraordinário - nadzwyczajny
extremidade - koniec | skraj
extremo - skrajny
fã - zwolennik | wielbiciel | fan | zwolenniczka | wielbicielka | fanka
fábrica - fabryka
fábula - bajka
faca - nóż | skalpel
faça - fazer
facão - maczeta
face - twarz | bok
fácil - łatwy
facilidade - łatwość
facilmente - łatwo
faculdade - umiejętność | zdolność | fakultet | kolegium
fada - wróżka | duszek | urocza | piękna kobieta | fadar
fagote - fagot
faisão - bażant
faísca - iskra
fala - mowa | rozmowa
falador - gadatliwy | rozmowny
falar - mówić | powiedzieć | rozmawiać
falcão - sokół
falecer - umrzeć
falido - zbankrutowany | niewypłacalny
falo - falar | fallus | członek
falso - fałszywy | błędny | nieprawdziwy | podrobiony | sfałszowany
faltar - brakować
fama - reputacja | fama | sława
família - rodzina | ród
famoso - sławny | słynny
fanaticamente - fanatycznie
fanático - fanatyczny | fanatyk
fanatismo - fanatyzm
fantasioso - pełen wyobraźni | fantazji | fantazyjny | wyobrażony
fantasma - duch
fantasticamente - fantastycznie
fantástico - fantastyczny
fantoche - marionetka
faraó - faraon
faringe - gardło
farinha - mąka
farinheira - farinheira | portugalska kiełbasa mączna
farmacêutico - farmaceuta | farmaceutyczny
farmácia - apteka
farmacologia - farmakologia
fascinação - fascynacja
fascinar - fascynować
fascismo - faszyzm
fatalismo - fatalizm
fatalista - fatalista | fatalistka | fatalistyczny
fato - fakt | odzież | ubranie | garnitur
fatwa - fatwa | fátua
fauno - faun
fauvismo - fowizm
fauvista - fowista | fowistka | fowistyczny
fava - bób
favela - fawela | slums | getto w Brazylii
favor - przysługa
favorável - przychylny | sprzyjający
fazenda - majątek ziemski | posiadłość | majątek | skarb | materiał | tkanina | towar | artykuł | plantacja | farma
fazer - robić | czynić | wykonywać
fazer amor - kochać się | uprawiać miłość
fazer tempestade em copo d'água - robić z igły widły
fé - wiara | wierzenie | wyznanie | przekonanie
fealdade - brzydota
febre - gorączka
fechadura - zamek (w drzwiach)
fechar - zamykać
federação - federacja | związek
federal - federalny
feição - forma | postać | kształt | charakter | rodzaj | styl | sposób | cechy | oblicze | fizjonomia | rysy twarzy | wygląd
feieza - brzydota
feijão - fasola
feio - brzydki | nieprzyjemny
feira - targ
feitiço - czary | czarnoksięstwo | czarodziejstwo | czarowanie | amulet | talizman | czar | urok | udawany | symulowany | sztuczny
feito - zrobiony | wykonany | wyprodukowany | osiągnięty | stworzony | czyn | osiągnięcie | wykonanie
felicidade - szczęście
Felipe - Filip
feliz - szczęśliwy | zadowolony | wesoły
feminino - kobiecy | żeński
fênice - feniks
fenilalanina - fenyloalanina
fenilcetonúria - fenyloketonuria | oligofrenia fenylopirogronowa
fênix - feniks
feno - siano
fenómeno - fenomen | zjawisko
fenômeno - zjawisko
Ferdinando - Ferdynand
feriado - świąteczny | wolny od pracy | święto | dzień świąteczny | dzień wolny od pracy
ferida - rana | ferido
ferido - ranny
fermata - fermata
férmio - ferm
Fernão - Ferdynand | imię męskie
feroz - dziki | okrutny | zaciekły
ferradura - podkowa
ferramenta - narzędzie
ferro - żelazo
ferrovia - kolej | droga kolejowa
ferrugento - zardzewiały
fervoroso - zapalony | zagorzały | żarliwy
festa - przyjęcie
festival - festiwal
feto - zarodek | płód
feudalismo - feudalizm
fevereiro - luty
Fevereiro - luty | fevereiro
fibrilação atrial - migotanie przedsionków
fica - ficar
ficar - pozostawać | zostawać | zostać
ficção - fikcja | fantazja | twór umysłu | produkt wyobraźni
fico - ficar
fidalgo - szlachcic
fideísmo - fideizm
fidelidade - wierność | lojalność | skrupulatność | dokładność
fiel - wierny | lojalny | dokładny | skrupulatny
fígado - wątroba
figo - figa
figura - figura | kształt | wygląd
Fiji - Fidżi
filantrópico - dobroczynny
filha - córka
filho - syn
Filipinas - Filipiny
filmar - filmować
filme - film
filologia - filologia
filólogo - filolog
filosofia - filozofia
filosófico - filozoficzny
filósofo - filozof
filtração - sączenie | filtrowanie
filtro - filtr | eliksir magiczny
fim - koniec
financeiro - finansowy
finlandês - Fin | fiński
finlandesa - finlandês | Finka
Finlândia - Finlandia
fino - finar
finta - fintar
finto - fintar
fio - drut
fioritura - ornament | ozdobnik
firmar - podpisać
física - fizyka
fisicamente - fizycznie
físico - fizyczny
fita - wstążka | wstęga | taśma
flamingo - flaming
flauta - flet
flecha - strzała
flexibilidade - elastyczność
floco - płatek (śniegu)
floco de neve - śnieżynka | płatek śniegu
flocos de cereais - płatki zbożowe
floema - łyko
flor - kwiat
florescer - kwitnąć | rozkwitać | prosperować
floresta - las
florestação - zalesianie
floricultor - ogrodnik (uprawiający kwiaty)
fluir - płynąć | spływać | wpływać
flúor - fluor
fluoxetina - fluoksetyna
flutuação - fluktuacja
flutuar - unosić się na wodzie
fobia - fobia
Fobos - Fobos (księżyc Marsa)
foca - foka
focinho - ryj
foder - pierdolić
fogo - ogień
foguete - rakieta
foice - sierp
folacina - folacyna | kwas foliowy
folclore - folklor
folgado - luźny | wolny | swobodny | wygodny
folha - liść
folhetim - felieton
fome - głód (potrzeba zjedzenia czegoś) | głód | potrzeba | pragnienie czegoś
fonte - źródło | font
fora - oprócz | na zewnątrz
fora-de-jogo - spalony
força - siła | moc
forçar - zmusić
forças armadas - siły zbrojne
forces - forçar
forma - kształt | formar
formação - formowanie | formacja
formal - formalny
formalismo - formalizm
forme - formar
formiga - mrówka
formoso - piękny
fórmula - formuła
formulário - formularz
fornalha - piec
forno - piekarnik
fortalecimento - fortyfikacja
fortaleza - forteca
forte - silny | mocny
fortemente - silnie | mocno
fortificação - umocnienie | forteca | fort | fortyfikacja | twierdza | bastion
fosco - przytłumiony | bez blasku | matowy | ciemny | mroczny | zachmurzony | zaciemniony
fósforo - fosfor | zapałka
fóssil - skamielina | skamieniałość
foste - ser | ir
fotão - foton
fotofobia - światłowstręt
fotógrafa - fotografka
fotografar - fotografować
fotografia - fotografia | sztuka fotograficzna | zdjęcie
fotograficamente - fotograficznie
fotográfico - fotograficzny
fotografo - fotografar
fotógrafo - fotograf
fóton - foton
fotorrealismo - fotorealizm
fototropismo - fototropizm
fração - łamanie | pęknięcie | złamanie | fragment | część | odłam | ułamek
fraco - słaby
fralda - pielucha
framboesa - malina
França - Francja
francamente - szczerze
francês - Francuz | francuski
francesa - francês | Francuzka
frâncio - frans
franco - szczery | otwarty
frango - kurczak | gej | homoseksualista
frase - zdanie | wyrażenie
fraternidade - braterstwo | bractwo
fraterno - braterski | bratni
fraude - oszustwo
freguês - klient | kupujący | pracownik | robotnik | parafianin | facet | gość
freguesa - klientka
freira - zakonnica
freixo - jesion | jesion wyniosły
frenar - hamować
frente - przód | front
frequência - częstotliwość | frekwencja
frequentemente - często
frigideira - patelnia
frigorífico - chłodzący | oziębiający | chłodniczy | ziębniczy | chłodnia | lodówka
frio - chłodny | zimny | chłód | zimno
frisão - fryzyjski
fritar - smażyć
frontal - przedni | kość czołowa
fronteira - granica | fronteiro
frota - flota
frugivorismo - frutarianizm
fruta - owoc
fruto - owoc
fuga - ucieczka
fugir - uciekać
fui - ser | ir
fuligem - sadza
fumaça - dym
fumar - palić (papierosy, fajkę)
fumo - dym | fumar
função - funkcja
funcho - fenkuł | fenkuł włoski | koper włoski
fundação - fundament (konstrukcja) | fundacja (instytucja)
fundamental - fundamentalny | podstawowy
fundamentalismo - fundamentalizm
fundamentalista - fundamentalista | fundamentalistka | fundamentalistyczny
fundar - ustanowić | ufundować
fundo - fundir | fundar
fungo - grzyb
furacão - huragan
furar - przebijać
fúria - gniew
furioso - wściekły | rozwścieczony
furna - jaskinia
furtar - kraść
furtivo - ukradkowy | potajemny | skryty
fusca - garbus (model samochodu marki Volkswagen)
fusto - trzon | to samo co fuste
futebol - piłka nożna
futurismo - futuryzm
futurista - futurysta | futurystka | futurystyczny
futuro - przyszły | przyszłość
futurologia - futurologia
futurólogo - futurolog
fuzil - karabin
Gabão - Gabon
gado - bydło
gadolínio - gadolin
gafanhoto - konik polny
gaivota - mewa
gaja - laska | ładna dziewczyna
galático - galaktyczny
galáxia - galaktyka
galego - galicyjski | galicyjski (język)
galês - Walijczyk | walijski
galesa - Walijka | galês
galho - gałąź
Galilea - Galilea (miasto w Hiszpanii)
galinha - kura
gálio - gal
galo - kogut
Gâmbia - Gambia
Gana - Ghana
ganhar - zdobywać | osiągać | zyskać | zarabiać | wygrywać
ganso - gęś | gąsior
garagem - garaż
garantia - gwarancja | kaucja | poręka
garantir - gwarantować | zapewniać
garça - czapla
garçom - kelner
gare - platforma stacji kolejowej
garfo - widelec
garganta - gardło | jar | wąwóz
Gargântua - Gargantua
garota - dziewczynka | dziecko płci żeńskiej | dziewczyna | młoda kobieta | garoto
garrafa - karafka
gás - gaz
gasolina - benzyna
gaspacho - zupa gazpacho
gastronomia - gastronomia | sztuka kulinarna
gata - kocica | kotka
gatas - gata
gato - kot
gaveta - szuflada
gavião - mewa
gaze - gaza
gazela - gazela
geada - mróz
geena - piekło
gelado - zimny
gelar - zamrozić | zamarznąć | mrozić | oszukać | oszukiwać | nabrać (kogoś)
geleira - lodowiec | lodówka
gelo - lód | mróz | chłód | obojętność | nieczułość | brak zainteresowania | gelar
gelosia - kratownica
gema - żółtko | kamień szlachetny | pąk
gêmeo - bliźniak | bliźniaczy
Gêmeos - Bliźnięta
genealogia - genealogia
general - generał
genérico - ogólny | rodzajowy | typowy | standardowy | generyczny
género - rodzaj
gênero - gatunek | rodzaj | typ
genética - genetyka
geneticamente - genetycznie
genético - genetyczny
gengibre - imbir
gengiva - dziąsło
genocídio - ludobójstwo
genro - zięć
gente - lud | ludzie
geodésia - geodezja
geografia - geografia
geologia - geologia
geólogo - geolog
geometria - geometria
Geórgia - Gruzja
georgiano - Gruzin | gruziński
geração - generacja | pokolenie
geral - powszechny | ogólny
geriatria - geriatria
germânio - german
gesto - gest
Gibraltar - Gibraltar
ginásio - gimnazjum
girafa - żyrafa
girassol - słonecznik
girino - kijanka
giz - kreda
glaciologia - glacjologia
glândula - gruczoł
glândula pituitária - przysadka mózgowa
glicérico - glicerynowy
glicerina - gliceryna
glicose - glukoza
global - globalny
globalização - globalizacja
globalmente - globalnie
gnomo - gnom
gnosticismo - gnostycyzm
GNR-BT - Narodowa Gwardia Republikańska - Brygada Drogowa
Godzilla - Godzilla
goleiro - bramkarz
golfe - golf
golfinho - delfin
golfista - golfista | golfistka
golfo - zatoka
golo - gol
gordo - gruby
gordura - tłuszcz
gorila - goryl
gorjeta - napiwek
gostar - lubić
gosto - gust
gótico - gotyk | gotycki
governador - gubernator
governar - kierować | zarządzać | dowodzić
governo - rząd
gozo - przyjemność | rozkosz | zadowolenie | satysfakcja
Grã-Bretanha - Wielka Brytania
gradativamente - stopniowo
gradativo - stopniowy
gradualmente - stopniowo
grafia - postać graficzna wyrazu | pisownia
grafite - grafit
grafólogo - grafolog
gralha - ptak z rodziny krukowatych | gaduła | osoba gadatliwa
grama - gram
gramática - gramatyka
gramatical - gramatyczny
gramaticalmente - gramatycznie
Granada - Grenada
grande - duży | wielki
granizo - grad
grão - ziarno | wielki
grapefruit - grejpfrut
gratificação - gratyfikacja
grau - stopień
gravata - krawat
gravata borboleta - mucha (część ubioru męskiego)
grave - poważny | gravar
gravidade - grawitacja
gravidez - ciąża
gravilha - żwir
gráviton - grawiton
Grécia - Grecja
grega - Greczynka | grecka | grego
grego - Grek | grecki
gregoriano - gregoriański
greve - strajk
grifo - gryf | gryfon
gripe - grypa
gritar - krzyczeć
groenlandesa - groenlandês | Grenlandka
Groenlândia - Grenlandia
Gronelândia - Grenlandia
groselha - porzeczka
grosso - gęsty | szorstki
grupo - grupa | zbiór | zespół
grupo da morte - grupa śmierci
gruta - grota
guarda - straż | ochrona | czujność
guarda-chuva - parasol
guarda-costas - ochroniarz
guardanapo - serwetka
guardar - opiekować się | pilnować
guarda-redes - bramkarz
Guatemala - Gwatemala
guatemalteco - gwatemalski | guatemalense | Gwatemalczyk
guepardo - gepard
guerra - wojna
guerra civil - wojna domowa
guerreiro - wojownik | wojowniczy
guerrilheiro - partyzant
gueto - getto
Guiana - Gujana
Guiana Francesa - Gujana Francuska
guilhotina - gilotyna
Guiné - Gwinea
Guiné-Bissau - Gwinea Bissau
Guiné Equatorial - Gwinea Równikowa
guitarra - gitara
guitarrista - gitarzysta | gitarzystka
gula - obżarstwo
gulag - gułag
gulodice - smakołyk
gustativo - smakowy
há - haver
hábil - zdolny
habilidade - zdolność
habilmente - umiejętnie
habitação - mieszkanie
habitacional - mieszkaniowy
habitante - mieszkaniec | mieszkanka
habitar - mieszkać
hábito - nawyk | habit
habituar - przyzwyczajać
háfnio - hafn
Haiti - Haiti
haitiano - haitański | Haitańczyk
halitose - halitoza | cuchnący oddech
hangar - hangar
haplótipo - haplotyp
harmonioso - harmonijny
harpa - harfa
harpista - harfista | harfistka
haver - mieć | posiadać | brać | pobierać | osiągać | zdobyć
hebraísmo - hebraizm
hedonicamente - hedonistycznie
hedónico - hedonistyczny
hedonismo - hedonizm
hedonista - hedonistyczny | hedonista | hedonistka
helenístico - hellenistyczny
helicóptero - helikopter | śmigłowiec
helio- - helio-
hélio - hel
Helsínquia - Helsinki
hematoma - krwiak
hematúria - hematuria | krwiomocz
hemisfério - półkula
hemorragia - krwotok
hemorrágico - krwotoczny
hera - bluszcz
herança - spadek
herdar - dziedziczyć
hereditário - dziedziczny
heresia - herezja
hermenêutica - hermeneutyka | hermenéutico
hérnia - przepuklina
herói - bohater
heróico - bohaterski
hesitar - wahać się
heterossexualidade - heteroseksualność | heteroseksualizm
heterossexualismo - heteroseksualność | heteroseksualizm
hidráulico - hydrauliczny
hidrogenação - uwodornianie | uwodornienie | hydrogenizacja
hidrogénio - wodór
hidrogênio - wodór
hidrólise - hydroliza
hiena - hiena
hierarquia - hierarchia
hífen - dywiz
higiene - higiena | czystość
hijab - hidżab
hino - hymn
hiperligação - hiperłącze
hipermercado - hipermarket
hipermetropia - nadwzroczność
hipersonia - hipersomnia
hipnose - hipnoza
hipnotizar - hipnotyzować
hipoalergénico - hipoalergiczny
hipocorístico - hipokorystyk | wyraz pieszczotliwy
hipocrisia - hipokryzja
hipócrita - obłudny | dwulicowy | fałszywy | hipokryta | obłudnik | hipokrytka | obłudniczka
hipopótamo - hipopotam
hipoteca - hipoteka
hipotenusa - przeciwprostokątna
hipótese - hipoteza
hipoteticamente - hipotetycznie
hipotético - hipotetyczny | przypuszczalny
hirsutismo - hirsutyzm
histerectomia - histerektomia
histeria - histeria
história - historia | opowiadanie | anegdota
historiador - historyk
hoje - dziś | dzisiaj | obecnie | w dzisiejszych czasach | dzień dzisiejszy
Holanda - Holandia
holandês - holenderski | Holender | język holenderski
holandesa - holandês | Holenderka
hólmio - holm
homem - człowiek | mężczyzna
homem do fogo - strażak
homenagear - składać hołd | oddawać cześć
homenagem - hołd
homossexual - homoseksualny | homoseksualista | homoseksualistka
homossexualidade - homoseksualność | homoseksualizm
Honduras - Honduras
hondurenho - honduraski
honestamente - szczerze | uczciwie
honesto - uczciwy
honrado - prawy | uczciwy | przywoity | szanowany
honrar - honorować
hóquei - hokej | hockey
hora - godzina
horda - horda
horizontal - horyzontalny | poziomy
horizonte - horyzont | widnokrąg
hormona - hormon
hormónio - hormon
hormônio - hormon
horóscopo - horoskop
horrível - straszny | okropny
horta - warzywnik
hortaliça - jarzyna | warzywo
hortelã - mięta | mięta zielona
hóspede - gość | pensjonariusz | pensjonariuszka
hospital - szpital
hospitalidade - gościnność
hostil - wrogi | wrogo nastawiony
hotel - hotel
humanidade - ludzkość
humanitário - humanitarny
humano - ludzki
humidade - wilgoć | wilgotność
humilhação - upokorzenie
humilhar - poniżać
humor vítreo - ciało szkliste
húngaro - Węgier | język węgierski | węgierski
Hungria - Węgry
iaque - jak
ibérico - iberyjski
iceberg - góra lodowa
ícone - ikona
idade - wiek
-idade - -ość | -stwo
idealismo - idealizm
ideia - idea | myśl
idêntico - identyczny | jednakowy
identidade - tożsamość
identificação - identyfikacja
identificar - identyfikować | utożsamiać | rozpoznawać
ideologia - ideologia
ideológico - ideologiczny
ideólogo - ideolog | głosiciel | teoretyk
idioma - język (mowa)
idiomático - idiomatyczny
idiota - idiotyczny | idiota
ido - ir
ídolo - idol | bożek | bałwan
Iémen - Jemen
ignorância - ignorancja
igreja - kościół
igualdade - równość
iguana - iguana
ilegal - nielegalny
ilha - wyspa
Ilha de Man - Wyspa Man
Ilhas Marshall - Wyspy Marshalla
Ilhas Salomão - Wyspy Salomona
Ilhas Virgens Americanas - Wyspy Dziewicze Stanów Zjednoczonych
Ilhas Virgens Britânicas - Brytyjskie Wyspy Dziewicze
iluminar - oświetlać | oświecać
ilusão - iluzja | złudzenie
ilustração - ilustracja
ilustrar - ilustrować
ímã - magnes
imagem - obraz
imaginação - wyobraźnia
imaginário - urojony
imaturidade - niedojrzałość
imediatamente - natychmiast
imigração - imigracja
imitar - naśladować
imoral - niemoralny
imortalidade - nieśmiertelność
impaciente - niecierpliwy
ímpar - jedyny | niezrównany | nieparzysty | nierówny | jednostronny
imperador - imperator
imperar - władać | panować | rządzić | rozkazywać
imperativo - rozkazujący | nakazujący | obowiązek | imperatyw | tryb rozkazujący
imperfeição - niedoskonałość | wada
imperialismo - imperializm
império - imperium
impero - imperar
impetuoso - gwałtowny | porywczy | wybuchowy | popędliwy
importância - ważność | znaczenie | waga
importante - ważny
importo - importar
impossibilidade - niemożliwość
impossível - niemożliwy
imposto - podatek
impressão - wrażenie | zachwyt | nadruk | druk
impressionante - imponujący
impressionismo - impresjonizm
impressora - prasa drukarska | drukarka
imprestável - bezwartościowy
imprimir - drukować
impulsivo - żywiołowy | impulsywny
imunidade - odporność
imunologia - immunologia
imunologicamente - immunologicznie
imunológico - immunologiczny
inaceitável - nieakceptowalny
inadequado - nieadekwatny
inauguração - inauguracja
incauto - nierozważny | nierozsądny
incêndio - pożar
incenso - kadzidło
incerteza - niepewność
inchar - puchnąć
incidente - wypadek | wydarzenie | zajście
incline - inclinar
incluir - włączać | załączać | zawierać | obejmować
incompatibilidade - niezgodność | sprzeczność | niekompatybilność
incompatível - niezgodny | sprzeczny
incompetente - niekompetentny | nieudolny
incrível - niewiarygodny
independência - niepodległość
independente - niezależny | niepodległy
Índia - Indie
indiano - indyjski | indiański | Hindus | Indianin
indicação - wskazanie | wskazówka | wyjaśnienie
indicar - wskazywać | pokazywać | dowodzić | informować
Índico - Ocean Indyjski
indiferença - obojętność
índio - ind
indiretamente - pośrednio
indireto - pośredni
individualmente - indywidualnie
indivíduo - jednostka | osobnik | indywiduum | indywidualny | pojedynczy
indivisível - niepodzielny
Indonésia - Indonezja
indonésio - Indonezyjczyk | indonezyjski
indústria - przemysł
ineficácia - nieefektywność
ineficaz - nieskuteczny
inesquecível - niezapomniany
inexplicável - niewytłumaczalny
infame - niesławny
infarto - zawał | zawał serca | enfarte
infecção - zakażenie
infectar - zarazić | zakażać | zarażać
infeliz - nieszczęśliwy | nieszczęśnik | nieszczęśnica
inferior - gorszy | niższy | podwładny | podwładna
inferno - piekło
infinidade - nieskończoność
infinito - nieskończony
inflação - inflacja
inflamação - zapalenie
inflame - inflamar
influencia - influenciar
influência - wpływ
influenciar - wpływać | mieć wpływ
influente - wpływowy
influir - wpływać | mieć wpływ
informação - informacja | wiadomość
informalismo - informel | art informel
informar - informować
informática - informatyka
infortúnio - nieszczęście
infraestrutura - infrastruktura
Inglaterra - Anglia
inglês - angielski | Anglik
inhame - pochrzyn
inibido - onieśmielony | zamknięty w sobie
iniciar - inicjować | zapoczątkować
início - początek
inimiga - kobieta wróg | wroga | inimigo
inimigo - wróg | wrogi
inimizade - wrogość
injeção - zastrzyk
injetar - wstrzyknąć
injustamento - niesprawiedliwość
injustiça - niesprawiedliwość
injusto - niesprawiedliwy
inocência - niewinność
inocente - niewinny
inolvidável - niezapomniany
inorgânico - nieorganiczny
inovação - innowacja
insânia - szaleństwo
insecto - insekt | owad
insensibilidade - nieczułość | obojętność
inseparável - nierozłączny
inseticida - środek owadobójczy
inseto - insekt | owad
insípido - bez smaku | mdły
insistir - nalegać
inspiração - inspiracja
inspirar - inspirować | natchnąć | wdychać
instalação - instalacja | instalowanie
instalar - instalować
instante - chwila | moment
instituição - instytucja
instituidor - założyciel
instrução - instrukcja
instrumento - instrument | instrumentar
insulina - insulina
insultar - obrażać | znieważać | obrzucać obelgami
insulto - obraza | insultar
inteiro - cały | całkowity | pełny | niewykastrowany (o zwierzęciu) | pochodzący od tych samych rodziców (o rodzeństwie) | o nieskazitelnym charakterze | bez wad | nieskorumpowany | (o człowieku)
intelecto - intelekt | rozum
intelectual - intelektualny
inteligência - inteligencja
inteligente - inteligentny
intenção - zamiar
intensidade - intensywność
intensivamente - intensywnie | mocno
intensivo - intensywny
intenso - intensywny | silny
interação - interakcja
interacção - interakcja
interessar - interesować | interesować się
interjeição - wykrzyknik
interlíngua - interlingua
interna - internar | interno
internacional - międzynarodowy
internacionalismo - internacjonalizm
interno - wewnętrzny | mieszkaniec internatu
interplanetário - międzyplanetarny
interpretação - interpretacja
interpretativo - interpretacyjny
intérprete - tłumacz | tłumaczka
interruptor - wyłącznik
intervenção - interwencja | operacja (chirurgiczna)
intervencionismo - interwencjonizm
intestino - jelito
intimidar - zastraszać
intimo - intimar
introdução - wstęp | wprowadzenie
intuição - intuicja
inundação - zalew
inusitado - nietypowy | nieprzewidywalny
inútil - bezużyteczny | nieprzydatny | niepotrzebny | niezdatny
invariável - niezmienny
invasão - inwazja
inveja - zazdrość
invejoso - zazdrosny | zawistny
invenção - wynalezienie | wynalazek | wymyślenie | wymysł | urojenie
inverno - zima
inverso - odwrotny | przeciwny
investidor - inwestor
investigação - śledztwo
invito - przymusowy | wbrew czyjejś woli
invulgar - rzadko spotykany | niepospolity
iodo - jod
ioga - joga
iogurte - jogurt
ipsilon - ipsylon
ir - iść | jechać
ira - gniew
Irã - Iran
ir a Canossa - pójść do Canossy
Irão - Iran
Iraque - Irak
iridescência - iryzacja
irídio - iryd
Irlanda - Irlandia
irlandês - Irlandczyk m | Irlandka f | irlandzki
irlandesa - Irlandka | irlandzka | irlandês
irmã - siostra | siostra (zakonna)
irmandade - braterstwo | bractwo
irmão - brat
iro - irar
ironia - ironia
irrefutável - niepodważalny
irrelevante - nieważny | nieistotny
irresistível - nieodaprty
irreversível - nieodwracalny
irritação - irytacja | gniew | rozdrażnienie | podrażnienie
islâmico - islamski
islandês - Islandczyk | język islandzki | islandzki
islandesa - islandês | Islandka
Islândia - Islandia
-ismo - -izm | -yzm
isoladamente - oddzielnie
isótopo - izotop
isqueiro - zapalniczka
Israel - Izrael
isso - to
-ista - -ysta | -ista | -ystka | -istka | -ystyczny | -istyczny
istmo - przesmyk
Itália - Włochy
italiana - italiano | Włoszka
italiano - włoski | Włoch | włoski (język)
itérbio - iterb
ítrio - itr
Iugoslávia - Jugosławia
já - już
jacaré - krokodyl
jactar - chwalić się | pysznić się
jade - jadeit
jaguar - jaguar
Jamaica - Jamajka
jamais - nigdy
janeiro - styczeń
Janeiro - styczeń | janeiro
janela - okno
jantar - kolacja | jeść kolację
Japão - Japonia
japonês - Japończyk | japoński
japonesa - japonês | Japonka
jardim - ogród
jardim botânico - ogród botaniczny
jardineiro - ogrodnik
jargão - żargon
javali - dzik
jegue - osioł
jejum - post | poszczenie
jerico - osioł
Jerónimo - Hieronim
Jerusalém - Jerozolima
Jibuti - Dżibuti | Djibouti
Jó - Hiob
joaninha - biedronka
João - Jan | imię męskie
joelho - kolano | kolanko | przegub
jogador - gracz
jogar - grać
jogo - gra
jogo de abertura - mecz otwarcia
jogo de azar - hazard
joia - klejnot | biżuteria | wpisowe | skarb (osoba obdarzana dużym szacunkiem)
jóia - klejnot | wpisowe | skarb
jordana - jordano | Jordanka
Jordânia - Jordania
Jordão - rzeka Jordan
jornal - gazeta | dziennik | wiadomości (telewizyjne)
jornalismo - dziennikarstwo
jornalista - dziennikarz | dziennikarka
José - Józef
jovem - młody
jubileu - jubileusz
judaico - żydowski
judaísmo - judaizm
judeu - Żyd | żydowski
judo - judo | dżudo
judô - judo | dżudo
Jugoslávia - Jugosławia
juiz - sędzia
juízo - osąd | opinia
julgamento - sąd | osąd | wyrok | orzeczenie
julgar - sądzić | osądzić | osądzać
julho - lipiec
Julho - lipiec | julho
Júlia - Julia
jumento - osioł
junho - czerwiec
Junho - czerwiec | junho
Júpiter - Jowisz | Jupiter
juramento - przyrzeczenie | ślubowanie | przysięga
jurídico - prawny
jurisdição - jurysdykcja | sądownictwo
jurisprudência - jurysprudencja | prawoznawstwo
justamente - akurat | właśnie | dokładnie | sprawiedliwie | słusznie
justiça - sprawiedliwość
Justino - Justyn
justo - sprawiedliwy
juventude - młodość
Kilimanjaro - Kilimandżaro
krípton - krypton
Kuwait - Kuwejt
lá - tam | la
lã - wełna
labareda - flama | ogień | płomień
lábio - warga
labirinto - labirynt
laboratório - laboratorium | pracownia | laboratoryjny
laborioso - pracowity
Lácio - Lacjum
laço - lasso
lacónico - krótki | treściwy | zwięzły | lakoniczny
lacrar - lakować | pieczętować
lacrimejar - płakać
lado - strona | bok | forma | aspekt
ladrão - złodziej
ladrar - szczekać
ladro - ladrar | złodziej | złodziejski
lagarta - gąsienica
lagarto - jaszczurka
lago - jezioro
lagosta - homar
lágrima - łza
lágrimas de crocodilo - krokodyle łzy
laia - gatunek | typ | rodzaj | sposób
lamber - lizać
lamina - laminar
lâmpada - żarówka
lança - włócznia
lançar - rzucać
lantânio - lantan
Laos - Laos
laosiana - laosiano | Laotanka
laosiano - laotański | Laotańczyk
lápis - ołówek
lar - dom | mieszkanie
laranja - pomarańcza | pomarańczowy
lareira - kominek
largo - szeroki | plac
largura - szerokość
lariço - modrzew
laringe - krtań
lascou - lascar
latim - łacina
latinismo - latynizm
latinista - latynista | łacinnik | latynistka | łacinniczka
Laurindo - portugalskie imię męskie
lavagante - homar
lavar - myć
lavatório - umywalka
lavável - zmywalny
leal - lojalny | uczciwy
lealdade - lojalność
leão - lew
Leão - Lew
lebrão - zając
lebre - zając
lega - legar
legal - legalny | dobry | poprawny | właściwy | w porządku
legalização - legalizacja
legislativo - ustwodawczy
legume - warzywo
lei - prawo
Leila - Lejla
leilão - licytacja
leite - mleko
leito - łoże
leitura - czytanie
lema - motto
lembrar - przypominać
leme - ster
lenço - chusta | chustka
lençol - prześcieradło
lenda - legenda
lendário - legendarny
lenha - drewno na opał
lente - soczewka | profesor uniwersytecki | nauczyciel | mistrz
lentilha - soczewica
lento - wolny | powolny
leoa - lwica
leopardo - lampart
ler - czytać
lesão - uszkodzenie ciała | zranienie | obrażenie
Lesoto - Lesotho
leste - wschód
letargo - zmęczenie | ospałość | obojętność
Letónia - Łotwa
Letônia - Łotwa
letra - litera
letreiro - napis | szyld
leucemia - białaczka | leukemia
levantar - podnosić | podnieść | unosić | wznosić
levar - prowadzić
levedura - drożdże
léxico - słownictwo
lhama - lama
libanês - libański | Libańczyk
libanesa - libanês | Libanka
Líbano - Liban
libélula - ważka
liberalismo - liberalizm
liberdade - wolność
Libéria - Liberia
libertino - libertyński | rozpustny | rozwiązły | libertyn
líbia - libijska | líbio | Libijka
Líbia - Libia
líbio - libijski | Libijczyk
libra - funt
Libra - Waga
lição - lekcja
licença - pozwolenie
lichia - liczi chińskie
licitar - licytować
licopeno - likopen
licorne - jednorożec
líder - lider | szef | głowa
Lídia - Lidia (imię)
Liechtenstein - Liechtenstein
liechtensteiniano - liechtensteiński | listenstainiano | obywatel Liechtensteinu
ligação - łącze | połączenie | złączenie
ligar - łączyć
ligeiramente - lekko
lima - lima | limona | limonka | limetka | limeta kwaśna
limão - cytryna
limonada - lemoniada
limpar - czyścić
limpeza - czystość | sprzątanie
limpidez - klarowność | przejrzystość | czystość | przezroczystość
limpo - czysty | limpar
lince - ryś
lindo - śliczny | ładny | piękny
língua - język
linguagem - język
língua materna - język ojczysty
linguística - lingwistyka | językoznawstwo | linguístico
lingüística - językoznawstwo | lingwistyka
linha - linia
linho - len
líquido - płyn | ciecz | płynny
lírio - lilia
Lisboa - Lizbona
liso - gładki | miękki | płaski | równy
lisonjear - pochlebiać | schlebiać
lista - lista | listar
liste - listar
Listenstaine - Liechtenstein
literário - literacki
literatura - literatura
lítio - lit
litro - litr
Lituânia - Litwa
lituano - litewski | Litwin | litewski (język)
litúrgico - liturgiczny
livraria - księgarnia
livre - wolny | swobodny
livro - książka
livro-caixa - księga przychodów i rozchodów
livro-texto - podręcznik
lixar - szlifować | piłować | załatwić kogoś
lixeira - śmietnik
lixo - śmieć | odpad | lixar
loa - prolog | mowa pochwalna
lobo - wilk
lobo do mar - wilk morski
local - miejsce
localidade - miejscowość
localização - lokalizacja | położenie | usytuowanie
locatário - najemca
locomotiva - lokomotywa
lodo - bagno | błoto
logaritmo - logarytm
lógica - logika | lógico
logicamente - logicznie
lógico - logiczny
logo - niedługo | wkrótce | niebawem | natychmiast
loiro - blond
loja - sklep | warsztat
Lombardia - Lombardia
lombardo - lombardzki | Lombardczyk
Londres - Londyn
longe - daleko | odległy
longitude - długość geograficzna
longo - długi
lontra - wydra
lotaria - loteria
loteria - loteria
lótus - lotos ( Adans.) | lilia wodna | grzybień ( L.) | wiązowiec południowy ( L.)
louça - fajans | naczynia stołowe
louco - szalony | obłąkany | szaleniec | wariat
loucura - obłęd | obłąkanie | szaleństwo
louvar - chwalić
lua - księżyc
lua cheia - pełnia księżyca
luar - światło księżyca
lúcio - szczupak
lúcioperca - sandacz
lucrativo - zyskowny | korzystny | lukratywny
lucro - zysk | profit | dochód
lucroso - zyskowny | lukratywny
lugar - miejsce
lugarejo - wioska
lula - kalmar
lumbago - lumbago | postrzał
luminoso - jasny | świecący | świetlny | światły | świetny
lunar - księżycowy | znamię
lupa - lupa
lusófona - lusófono | kobieta mówiąca po portugalsku
lusófono - portugalskojęzyczny | mężczyzna mówiący po portugalsku
luta - walka | bitwa | zapasy
lutar - walczyć
lutécio - lutet
luto - żałoba | lutar
luva - rękawiczka
Luxemburgo - Luksemburg
luxemburguês - Luksemburczyk | luksemburski
luxo - luksus | przepych
luxuoso - luksusowy | wystawny
luz - światło
luzente - jasny | klarowny | pogodny | światły | wspaniały | zrozumiały | wyraźny
luzir - błyszczeć | lśnić | świecić
maca - nosze
maçã - jabłko
macaco - małpa
maçã-de-adão - jabłko Adama
maçante - nudny
Macau - Makau
Macedónia - Macedonia
Macedônia - Macedonia
macedónio - Macedończyk | macedoński
macedônio - Macedończyk | macedoński
machado - topór | siekiera
macho - samiec | muł | samczy
machucar - miażdżyć | kruszyć | deptać | ranić
maciço - masywny | gęsty | masyw górski | gąszcz (rzeczy)
macieira - jabłoń
macio - miękki w dotyku | delikatny | łagodny
macromolécula - makrocząsteczka
Madagáscar - Madagaskar
madeira - drewno
madre - matka | siostra (zakonnica) | macica
Madrid - Madryt
madrinha - matka chrzestna
maduro - dojrzały
mãe - matka
mágico - magik | magiczny
magnésio - magnez
magnético - magnetyczny
magnetismo - magnetyzm | przyciąganie | powab | czar | fascynacja
magnífico - wspaniały | znakomity
magnitude - wielkość | wspaniałość
magnólia - magnolia
mágoa - przykrość
magro - chudy (bez tłuszczu)
maio - maj
Maio - maj | maio
maionese - majonez
maioria - większość
maioritário - większość
mais - więcej | bardziej | ponadto | jeszcze
mais ou menos - mniej więcej | mniej lub bardziej
maiúscula - majuskuła | wielka litera | maiúsculo
majestoso - majestatyczny
majoritariamente - głównie
mal - zło | choroba | wada | źle
mala - walizka | bagaż
malabarista - żongler
malária - malaria
Malásia - Malezja
malato - jabłczan
maldição - przekleństwo
Maldivas - Malediwy
maléfico - zły | szkodliwy
Mali - Mali
maligno - zły | złośliwy
malsucedido - nieudany
Malta - Malta
maltês - Maltańczyk | maltański
mama - mamar
mamãe - mama
mamífero - ssak
mamilo - sutek | brodawka sutkowa
mamo - mamar
mamute - mamut
mancheia - garść | garstka | niewielka ilość
mandrágora - mandragora
manducar - jeść
maneira - sposób
manga - mango | rękaw | mangar
manganês - mangan
manhã - rano | poranek
manifestação - manifestacja | wyrażenie | ukazanie
manifestar - manifestować | okazywać
manifesto - manifest | manifestar | widoczny | wyraźny
manômetro - manometr
manso como um cordeiro - łagodny jak baranek
manteiga - masło
mão - ręka
Maomé - Mahomet
mapa - mapa
maquiavélico - makiaweliczny
máquina - maszyna
mar - morze
mar Adriático - Morze Adriatyckie
maratona - maraton
maravilha - cud | maravilhar
maravilhoso - cudowny
Mar Báltico - Morze Bałtyckie
mar Cáspio - Morze Kaspijskie
marcha - marsz | chód | marchar
março - marzec
Março - marzec | março
mar da Arábia - Morze Arabskie
mar de Barents - Morze Barentsa
mar do Norte - Morze Północne
marechal - marszałek
marfim - kość słoniowa
margarina - margaryna
margem - margines | brzeg | granica | krawędź
mariano - maryjny
marido - mąż
marina - marinar
marinha - flota | marynarka
marinheiro - marynarz | żeglarz
marino - marinar
mariposa - prostytutka | ćma
Mar Mediterrâneo - Morze Śródziemne
marmelo - pigwa | gatunek owoców | łamaga
marmo - wielki | ogromny
mármore - marmur | osoba obojętna | pozbawiona uczuć
Marrocos - Maroko
marrom - brązowy
marta - kuna
Marte - Mars
martelo - młotek
Martinica - Martynika
mas - lecz | ale | ale (jako przeszkoda, niedogodność, przeciwieństwo)
masca - mascar
máscara - maska | maseczka kosmetyczna | fałszywość
masculino - męski
masmorra - podziemne więzienie | loch
massacre - masakra | rzeź
massa crítica - masa krytyczna
mastigar - żuć | przeżuwać
mastro - maszt
mata - las | matar
matar - zabijać
matemática - matematyka | matemático
matemático - matematyczny | matematyk
material - materiał | tworzywo
materno - macierzyński | matczyny
Mateus - Mateusz
matrimonial - małżeński
matrimónio - małżeństwo
maturo - maturar
mau - kiepski | lichy | niedobry | zły | złośliwy
Maurícia - Mauritius
Mauritânia - Mauretania
maxila - szczęka
máxima - maksyma
mazurca - mazurek
me - mnie | mi
mecânica - mechanika | mecânico
mecânico - mechanik | mechaniczny
mecatrónica - mechatronika
mecatrônica - mechatronika
medalha - medal
medicamento - lekarstwo
medicamentoso - leczniczy
medicina - medycyna
médico - lekarz | medyczny
medieval - średniowieczny
medir - mierzyć | odmierzać | wymierzać
meditação - medytacja
meditar - medytować
meditativo - refleksyjny | kontemplacyjny | medytacyjny
medo - strach | lęk | obawa
medula - szpik | rdzeń | sedno sprawy
megalomania - megalomania | mania wielkości
megalômano - megalomański | megaloman
meia - skarpeta
meia-noite - północ
meigo - cichy | czuły | delikatny | łagodny | miękki | miły | misterny | wątły | słodki
meiguice - słodycz
meio - środek | środowisko | sposób | połówka
meio-dia - południe (pora dnia)
mel - miód
melancia - arbuz
melancolia - melancholia
melancólico - melancholijny
melão - melon
melatonina - melatonina
melhor - lepszy
melhoramento - poprawa | polepszenie
melhorar - polepszać | udoskonalać | wydobrzeć | wracać do zdrowia
melodia - melodia
meloeiro - melon
melro - kos
membrana - membrana | błona
membro - członek | organ ciała | np. stowarzyszenia | penis
memória - wspomnienie | pamięć
mencionar - wspomnieć | napomnknąć | wzmiankować
mendelévio - mendelew
mendiga - żebraczka
mendigar - żebrać o coś | żyć z żebrania
mendigo - żebrak
menina - dziewczynka | dziewczyna | młoda kobieta | panna | córka | prostytutka
menino - chłopiec
mensagem - wiadomość
menstruação - menstruacja
menstruar - miesiączkować
mentalidade - mentalność
mentalismo - mentalizm
mentir - kłamać | łgać | zwodzić
mentira - kłamstwo | oszustwo
mercado - targ | rynek
mercantil - handlowy | kupiecki
mercê - łaska | ułaskawienie | zmiłowanie
mercearia - sklep spożywczy | sklepik
mercúrio - rtęć
Mercúrio - Merkury
merda - gówno
merecer - zasługiwać | być godnym
meretriz - prostytutka | nierządnica
mergulhar - zanurzać | zanurzać się
meridional - południowy | mieszkaniec Południa | mieszkanka Południa
mérito - zasługa
mês - miesiąc | miesiączka
mesa - stół
mesmo - tak samo | taki sam
Mesopotâmia - Mezopotamia
mesquinho - małostkowy | skąpy
mesquita - meczet
metabólico - metaboliczny
metabolismo - metabolizm
metacarpo - śródręcze
metade - połowa
metafísica - metafizyka
metáfora - metafora | przenośnia
metaforicamente - metaforycznie | przenośnie
metafórico - metaforyczny | przenośny
metaforizar - metaforyzować
metal - metal
metamorfose - metamorfoza
metas - meter | meta
metempsicose - metempsychoza
meteorítica - meteorytyka
meteorito - meteoryt
meteoro - meteor
meteorológico - meteorologiczny
meti - meter
método - metoda
metodologia - metodologia
metro - metr
metrópole - metropolia
metropolitana - metropolitano
meu - mój
México - Meksyk
mexilhão - omułek jadalny
mia - miar
miara - miar
miastenia - miastenia
miçanga - koralik (szklany) | ozdoba wykonana z koralików
micela - micela
micologia - mikologia | mykologia
microfone - mikrofon
Micronésia - Mikronezja
microorganismo - mikroorganizm | drobnoustrój
microrganismo - mikroorganizm | drobnoustrój
microscópico - mikroskopowy
microscópio - mikroskop
migalha - okruch | okruszek
migração - migracja
Miguel - Michał
mijar - sikać
mil - tysiąc | 1000
milagre - cud
milagroso - cudowny
Milão - Mediolan
milénio - tysiąclecie | millenium
milha - mila
milhão - milion
milho - kukurydza
miligrama - miligram
milímetro - milimetr
mim - mnie
mina - kopalnia | kamieniołom | minar
minerador - górnik
mineral - minerał | mineralny
mineralogia - mineralogia
minhoca - dżdżownica
minimalismo - minimalizm | sztuka minimalna
minimalista - minimalista | minimalistka | minimalistyczny
ministério - ministerstwo
ministro - minister
minoria - mniejszość
minuto - minuta
miserando - godny pożałowania | opłakany | żałosny | marny | nędzny
misericórdia - miłosierdzie | litość
misoginia - mizoginia
missa - msza
missão - misja
mistério - tajemnica | sekret
misteriosamente - tajemniczo
misterioso - tajemniczy | zagadkowy
misturar - mieszać
mitologia - mitologia
mitose - mitoza
mitra - mitra
mobília - meble | umeblowanie
mobilidade - mobilność
moça - dziewczyna
Moçambique - Mozambik
mochila - plecak
mocho - sowa
moço - chłopak | młodzieniec
modernidade - nowoczesność
moderno - nowoczesny | nowożytny | niedawny
modifica - modificar
modificação - modyfikacja
modificar - modyfikować
modo - sposób
modo conjuntivo - tryb łączący
modo imperativo - tryb rozkazujący
moeda - waluta | moneta
Mogli - Mowgli
moinho - młyn
mola - sprężyna
Moldávia - Mołdawia
molécula - cząsteczka
molesto - dokuczliwy | uciążliwy | niewygodny | męczący | molestar
molhado - mokry
molho - sos | wiązka | pęk
molibdénio - molibden
molibdênio - molibden
momento - moment | chwila
Mónaco - Monako
monarquia - monarchia
monástico - zakonny | mnisi | monacal
monção - monsun
mondo - mondar
monetário - pieniężny
monge - mnich
mongol - mongolski | Mongoł | mongolski (język)
Mongólia - Mongolia
monografia - monografia
monótono - monotonny | jednostajny
monstro - potwór
montanha - góra
montanhoso - górzysty
monte - góra
Montenegro - Czarnogóra
montuoso - górzysty | montanhoso
moral - moralny
morango - truskawka
morangueiro - truskawka
morar - mieszkać
morava - morar
morcego - nietoperz
moreia - murena
morrer - umrzeć | umierać
morsa - mors
mortadela - mortadela
mortalidade - śmiertelność
morte - śmierć
morto - martwy | zmarły | nieboszczyk | matar | morrer
mosaico - mojżeszowy | mozaika
mosca - mucha
Moscou - Moskwa
Moscovo - Moskwa
mosquito - komar
Mostar - Mostar
mosteiro - klasztor
mostra - mostrar
mostrar - pokazywać
motivação - motywacja | uzasadnienie
motivo - motivar | motyw | przyczyna | powód
moto - motocykl | ruch
motor - napędowy | wprowadzający w ruch | silnik | motor
motor de busca - wyszukiwarka (internetowa)
motorista - motocyklista | motocyklistka
motorização - motoryzacja
mouro - Maur
móvel - ruchomy (także o świętach, dobrach materialnych) | lotny | pobudka | przyczyna | mebel | w : nieruchomości
mover - ruszać | wywoływać
movimentação - rozruch | poruszenie | ożywienie | ruch
movimentar - uruchamiać | poruszać | ożywiać
movimento - ruch
mu - muł
mucosa - śluzówka | błona śluzowa | mucoso
muçulmana - muzułmanka | muçulmano
muçulmano - muzułmański | muzułmanin
mudança - zmiana
mudar - zmieniać | modyfikować | przekształcać
mudo - niemy | mudar
muito - bardzo
mulher - kobieta | żona
multa - grzywna
multicolore - multicolorir
multicultural - wielokulturowy
multiculturalismo - wielokulturowość
multidão - tłum | masa | obfitość
multiplicação - multiplikacja
mundo - świat
município - ratusz | urząd gminy
muralha - mur obronny
murmurar - szeptać | szemrać
muro - ściana
músculo - mięsień
museu - muzeum
musgo - mech
música - muzyka
músico - muzyk | muzyczny
mutação - mutacja
mutilar - okaleczać | uszkadzać
mutua - mutuar
mutuamente - wzajemnie
mutuo - mutuar
na - em + a
nabo - rzepa | kutas | fiut
nação - naród
nacional - narodowy | krajowy
nacionalidade - narodowość
nada - nic | nicość | nieistnienie
nadar - pływać
náilon - nylon
naja - kobra
Namíbia - Namibia
namorada - narzeczona | dziewczyna | sympatia
namorado - chłopak | namorar
não - nie
não admira - nic dziwnego | nie dziwne
não há fumo sem fogo - nie ma dymu bez ognia
narcolepsia - narkolepsja
na realidade - de facto | faktycznie | w rzeczywistości
nariz - nos
narrativa - narracja | opowieść | opowiadanie | narrativo
narval - narwal
nascer - rodzić się
nascimento - urodzenie | narodziny
natação - pływanie
Natal - Boże Narodzenie
natural - naturalny | przyrodniczy | normalny | spontaniczny
naturalmente - naturalnie
natureza - natura
natureza morta - martwa natura (obraz)
Naum - Nahum
Nauru - Nauru
navegação - nawigacja | żegluga
navio - statek
neblina - mgła
nebulosidade - zachmurzenie
necessário - potrzebny
necessidade - potrzeba
necessitar - wymagać
néctar - nektar
neerlandês - holenderski | Holender
negação - negacja | zaprzeczenie
negócio - sprawa | biznes
negro - czarny | czarnoskóry
nenhum - żaden
neodímio - neodym
neoliberalismo - neoliberalizm
neologismo - neologizm
neonatologia - neonatologia
neónio - neon
neônio - neon
neorrealismo - neorealizm
Nepal - Nepal
nepotismo - nepotyzm
neptúnio - neptun
Neptuno - Neptun
nervo - nerw
nervoso - dotyczący nerwów | nerwowy | denerwujący się
nêspera - nieszpułka | miszpelnik japoński | nieśplik japoński (owoc)
nessa altura - wtedy w tamtym czasie
nestoriana - nestorianka | nestoriano
nestorianismo - nestorianizm
nestoriano - nestorianin | nestoriański
neta - wnuczka
neto - wnuk
netúnio - neptun
Netuno - Neptun
neurocirurgia - neurochirurgia
neurologia - neurologia
neurológico - neurologiczny
neurologista - neurolog
neuropatia - neuropatia
neurotoxina - neurotoksyna
neutralidade - neutralność
nevar - śnieżyć | padać (o śniegu)
neve - śnieg
névoa - mgła
niacina - niacyna
Nicarágua - Nikaragua
nicotina - nikotyna
Níger - Niger
Nigéria - Nigeria
niilismo - nihilizm
ninguém - nikt
ninguém é profeta na sua terra - nikt nie jest prorokiem we własnym kraju
ninho - gniazdo | miejsce do ukrywania się
nióbio - niob
níquel - nikiel | moneta
nitrogénio - azot
nitrogênio - azot
nível - poziom | klasa | pozycja
no - em + o
nó - węzeł
nobélio - nobel
noção - koncepcja | idea | pomysł | myśl
nogueira - orzech włoski
noite - noc
noiva - panna młoda | narzeczona
noivo - narzeczony | pan młody | zaręczeni | zaręczona para | młoda para | państwo młodzi | noivar
nome - imię | nazwa
nominalismo - nominalizm
nono - dziewiąty | jedna dziewiąta część
nora - noria
Norbert - Norbert
normalmente - normalnie
norte - północ
Noruega - Norwegia
norueguês - norweski
nos - nam
nós - my | nó
nosologia - nozologia
nosso - nasz
nostalgia - nostalgia
nostálgico - nostalgiczny
nota - uwaga
notável - godny uwagi | wybitny | znakomity | sławny | ważny
noticia - noticiar
notícia - wiadomość | nowina | wiadomości | dziennik telewizyjny
noticiar - ogłaszać
notório - powszechnie znany
Nova Iorque - Nowy Jork
novamente - znów | znowu | jeszcze raz | od nowa
Nova Zelândia - Nowa Zelandia
nove - dziewięć
novembro - listopad
Novembro - listopad | novembro
noventa - dziewięćdziesiąt | 90
novidade - nowość
novilha - jałówka
novo - nowy | świeży
noz - orzech włoski
nu - nagi | goły
Núbia - Nubia
nuca - kark
num abrir e fechar de olhos - w okamgnieniu
numeral - liczbowy | liczebnik
numerar - numerować
número - liczba | numer
numismática - numizmatyka
nunca - nigdy
nupcial - ślubny
nutrição - odżywianie
nuvem - chmura
o - m: jego | go | niego | jemu | mu
oásis - oaza
obediência - posłuszeństwo
obesidade - otyłość
obeso - otyły
objectividade - obiektywność
objetividade - obiektywność
oboé - obój
obrigação - obowiązek
obrigado - dziękuję!
observação - obserwacja | uwaga | komentarz
observar - obserwować | zaobserwować | zauważać | zauważyć | przestrzegać
observatório - obserwatorium
obsessão - obsesja
obsoleto - przestarzały
obtém - obter
obtenção - osiągnięcie | uzyskanie
obter - uzyskać
óbvio - oczywisty
oca - oco
ocapi - okapi
ocasião - okazja
occitano - język prowansalski
Oceania - Australia
Oceânia - Oceania
oceano - ocean
oceano Índico - Ocean Indyjski
oceano Pacífico - Ocean Spokojny
Oceano Pacífico - Pacyfik | Ocean Spokojny
ocidente - zachód
ocorrência - okoliczność | zjawisko | zdarzenie | wydarzenie
octogésimo - osiemdziesiąty
óculos - okulary
ocultismo - okultyzm
ocupação - zajęcie | okupacja | zawód | squat
ocupado - zajęty | ocupar
ocupo - ocupar
odiar - nienawidzić
ódio - nienawiść
odioso - nienawistny
odor - zapach | aromat
odore - odorar
oeste - zachód
oficial - oficjalny | urzędowy | rzemieślnik | pracownik | funkcjonariusz | urzędnik
oficialmente - oficjalnie
oi - cześć | hej!
oitavo - ósmy | 8.
oitenta - osiemdziesiąt | 80
oito - osiem
olá - cześć | hej
oleiro - garncarz
óleo - olej
olhar - patrzeć | spojrzenie
olho - oko | olhar
oliva - oliwka (owoc) | oliwka (drzewo)
oliveira - oliwka
olmo - wiąz
olvidar - zapomnieć
Omã - Oman
ombro - ramię
onça - uncja
oncologia - onkologia
onda - fala
onde - gdzie | w jakim miejscu | dokąd | skąd
ônibus - autobus | autokar
onicólise - onycholiza
ontem - wczoraj | w nieokreślonej | niedawnej przeszłości | dzień wczorajszy | nieokreślona | niedawna przeszłość
ontologia - ontologia
onze - 11 (jedenaście)
oologia - owologia | oologia
opção - opcja
operação - operacja
opinião - opinia | zdanie
ópio - opium
opor - stawiać opór | przeciwstawiać | przeciwstawiać się
oportunidade - sposobność | okazja | możność | szansa
oportuno - odpowiedni | korzystny | dogodny | właściwy
oposição - opozycja | przeciwstawienie się | opór | sprzeciw
opositor - oponent
opressão - opresja | ucisk | uciemiężenie
ora - teraz
oração - modlitwa
orar - modlić się
órbita - orbita | pole | zasięg działania | oczodół
orca - orka
orçamento - kosztorys | budżet
ordem - rozkaz
ordenar - porządkować | rozkazywać
ordinário - zgodny z określonym porządkiem | normalny | regularny | wulgarny | ordynarny
orelha - ucho
orfanato - sierociniec
órfão - sierota | sierocy
orgânico - organiczny
organismo - organizm
organização - organizacja | ład
organizar - organizować | urządzać | porządkować
organizo - organizar
organogênese - organogeneza
órgão - organ | organy | organ (organizacja, instytucja)
orgasmo - orgazm
orgia - orgia
orgulho - duma
orgulhoso - dumny
orientação sexual - orientacja seksualna
oriental - orientalny | wschodni | mężczyzna z jednego z krajów Orientu/Wschodu | Azji | kobieta z jednego z krajów Orientu/Wschodu
orifício - otwór | dziura
origem - pochodzenie
original - oryginał | oryginalny
orla - granica
ornamento - ornament | ozdoba
ornato - ornament
ornitologia - ornitologia
ornitológico - ornitologiczny
ornitorrinco - dziobak
orquestra - orkiestra | orquestrar
orquídea - orchidea
ortografia - ortografia
ortograficamente - ortograficznie
ortográfico - ortograficzny
orvalho - rosa
Osaca - Osaka
ósmio - osm
osso - kość
ostentar - pokazywać | wyświetlać | wykazywać | okazywać
Óstia - Ostia
ostra - ostryga
otário - naiwniak | frajer | głupek | naiwny | głupi
ótimo - doskonały | świetny | wspaniały
ou - lub | albo
ouriço - jeż
ouriço do mar - jeżowiec
ouro - złoto
ousadia - odwaga | śmiałość
ousado - śmiały | odważny | dzielny | prowokujący
outono - jesień
outro - inny (ktoś) | drugi | niektóry
outubro - październik
Outubro - październik | outubro
ouvido - ucho
ouvinte - słuchacz | słuchaczka
ouvir - słuchać
ovário - jajnik
ovelha - owca
ovino - owczy
ovo - jajko
ovocitação - owulacja | jajeczkowanie
ovulação - owulacja | jajeczkowanie
ovules - ovular
oxalá - oby! | daj Boże!
oxicoco - żurawina
oxigénio - tlen
oxigênio - tlen
ozônio - ozon
pá - łopata | łopatka | śmietniczka | kurczę!
pachorra - cierpliwość
paciência - cierpliwość
paciente - cierpliwy | pobłażliwy | pacjent | pacjentka
pacifista - pacyfista | pacyfistka | pacyfistyczny
pacote - paczka | pakunek | pakiet
pacto - pakt | umowa
padaria - piekarnia
padecer - cierpieć
padeiro - piekarz
padrasto - ojczym
padre - kapłan | ojciec
padrinho - ojciec chrzestny
pagamento - płatność
paganismo - pogaństwo
pagão - pogański | niewierzący | poganin | innowierca
pagar - płacić
página - strona
paginar - numerować strony | paginować
pai - ojciec | tata
país - kraj | ziemia | rejon | region | kraina | terytorium | miejsce urodzenia | ojczyzna
paisagem - krajobraz
Países Baixos - Holandia
paixão - namiętność | pasja | cierpienie | męka
paizinho - tata
palácio - pałac | zamek
paladar - podniebienie | gust | smak
paládio - pallad
Palau - Palau
palavra - słowo | wyraz
paleontologia - paleontologia
palerma - idiota | głupiec | idiotka
Palermo - Palermo
palestina - palestino | Palestynka
Palestina - Palestyna
palestiniana - palestiniano | Palestynka
palestiniano - palestyński | Palestyńczyk
palestino - palestyński | Palestyńczyk
palha - źdzbło słomy
palhaço - pajac
palíndromo - palindrom
palito - wykałaczka
palitos salgados - słone paluszki
palma - dłoń | palma | zwycięstwo | palmas: oklaski | aplauz | palmar
pálpebra - powieka
palpitação - palpitacja | drżenie | dygotanie | bicie serca
Panamá - Panama
Panchen Lama - panczenlama
pâncreas - trzustka
panda - panda
pandeísmo - pandeizm
pandemia - pandemia
pânico - panika
pansexualidade - panseksualizm
pântano - bagno | mokradło | moczary
panteísmo - panteizm
pantera - pantera | lampart
pão - chleb
pãozinho - bułka
papa - papież
papagaio - papuga
papar - jeść
papel - papier
páprica - papryka
Papua-Nova Guiné - Papua-Nowa Gwinea
Paquistão - Pakistan
para - dla | do
Pará - Pará
parabeno - paraben
parabéns - gratulacje | parabém
parábola - parabola | przypowieść
paradisíaco - rajski
paradoxo - paradoks
parafina - parafina
parafuso - śruba
paragrafo - paragrafar
parágrafo - paragraf
Paraguai - Paragwaj
paraíso - raj
parâmetro - parametr
paraquedas - spadochron
parar - zatrzymać | przerywać
parasita - pasożyt
parcialmente - częściowo
pardal - wróbel
parecer - przypominać (kogoś) | wydawać się podobnym
parede - ściana
parente - krewny | krewna
parentesco - pokrewieństwo | powinowactwo
parêntese - nawias
Paris - Paryż
parlamentar - parlamentarny | członek parlamentu
parlamento - parlament
parlemento - parlament
paróquia - parafia
parque - park
parte - rola | część | udział | strona
participação - uczestnictwo | udział | powiadomienie
participar - uczestniczyć | brać udział
particípio - imiesłów
particular - prywatny | indywidualny | osobisty | osoba | jednostka
particularmente - szczególnie
partida - odjazd | wyjazd | odejście | wyjście | partia | gra | mecz | rozgrywka
partido - partia | podzielony | potłuczony | złamany
partir - odjeżdżać | odchodzić | wyjeżdżać
parto - poród | połóg | wytwór | twór
Páscoa - Wielkanoc
passado - przeszłość | czas przeszły | przeszły
passageira - pasażerka
passageiro - pasażer | przejściowy | chwilowy | czasowy | tymczasowy
passagem - przejazd | przejście | pasaż
passaporte - paszport
passar - przechodzić | przebywać | przechodzić (np. przez myśl)
pássaro - ptak
passe - passar
passe-bem - do widzenia
passeio - przechadzka
passivação - pasywacja
passo - krok
pasta - pasta | masa | teczka | teka
pasta de dente - pasta do zębów
pasto - pastar
pata - kaczka | łapa
pateta - głupi
patetice - głupota
patinho - kaczątko
pato - kaczka
patologia - patologia
pátria - ojczyzna
patriarca - patriarcha
patriotismo - patriotyzm
paulatino - stopniowy
Paulo - Paweł
pavão - paw
pavilhão - pawilon
pavimento - podłoga | posadzka | nawierzchnia | bruk | pavimentar
paz - pokój
pé - stopa | noga | łapa | łodyga | statyw
pecado - grzech
peçonha - trucizna
pedaço - kawałek
pedes - pedir
pediatra - pediatra | pediatra (kobieta)
pediatria - pediatria
pedido - zamówienie | prośba | żądanie
pedir - pytać | prosić | żądać
pedofilia - pedofilia
pedófilo - pedofil
pedra - kamień
pedreira - kamieniołom
Pedro - Piotr
pega - pegar
pegar - kleić | łączyć | chwytać | brać do ręki | przylegać | zapuszczać korzenie | udać się
pegureiro - pasterz
peidar - pierdzieć
peito - pierś | klatka piersiowa | odwaga
peixe - ryba
peixe lua - samogłów
Peixes - Ryby
pele - skóra
pelicano - pelikan
pelo - per + lo = przez
peluche - plusz
pena - pióro
pene - prącie | penis | penar
penhasco - klif
península - półwysep
península Arábica - Półwysep Arabski
pênis - penis | prącie
pensamento - myśl | myślenie
pensar - myśleć
penso - pensar
pentágono - pięciokąt
pente - grzebień
penugem - puch
pepino - ogórek
pequeno - mały
Pequim - Pekin
pêra - gruszka
perca - okoń
perceber - spostrzec | uświadomić sobie
percentagem - wartość procentowa | prowizja | procent | odsetek
percevejo - pluskwa
percussão - perkusja
perda - strata
perdão - ułaskawienie | wybaczenie
perder - tracić
perdido - zaginiony | stracony
perdiz - kuropatwa
perdoar - wybaczać
peregrino - pielgrzym
perfeição - doskonałość
perfeito - doskonały | perfekcyjny
perfume - perfumy | perfumar
perfurar - przebijać | dziurawić | perforować
pergaminho - pergamin
pergunta - pytanie
perguntar - pytać | zapytać
periferia - peryferia
periférico - peryferyjny | obwodowy
perigo - niebezpieczeństwo
perigoso - niebezpieczny
periodicamente - okresowo | periodycznie
periódico - periodyczny | okresowy
período - okres | epoka | czas
perjúrio - krzywoprzysięstwo
permanecer - pozostawać | pozostać | wytrzymywać | znosić
permissão - pozwolenie | zezwolenie
permitir - pozwalać
perna - noga
pérola - perła
perseverança - wytrwałość
persiana - żaluzja
persiano - persa | pérsico
personalidade - osobowość
personificação - personifikacja
personificar - personifikować
perspectiva - perspektywa
pertencer - dotyczyć | odnosić się | należeć
perto - blisko | w pobliżu
peru - indyk
Peru - Peru
peruviano - peruwiański | peruano | Peruwiańczyk
perversão - perwersja
perverso - nikczemny | niegodziwy
pesadelo - koszmar
pesado - ciężki | ciężka praca
pesar - smutek | ważyć | mieć
pesca - pescar | łowienie | połów
pescada - morszczuk
pescador - rybak
pescar - łowić
pesco - pescar
pescoço - szyja
pêssego - brzoskwinia
pessoa - osoba
pessoal - osobisty
pesticida - pestycyd
pétala - płatek
petardo - petarda
petição - petycja
petróleo - ropa naftowa
pianista - pianista | pianistka
piano - fortepian
pica-pau - dzięcioł
piedade - pobożność | litość | miłosierdzie
pijama - piżama
pilha - stos | bateria
pilote - pilotar
piloto - pilot
pílula - pigułka
pimenta - pieprz | erotyzm | erotyczność | osoba niespokojna lub niegrzeczna
pimento - papryka
pincel - pędzel
pinga - pingar
pinguim - pingwin
pingüim - pingwin
pinheiro - sosna
pintar - malować
pintor - malarz
pintura - obraz | malarstwo
pinturesco - malowniczy
piolho - wesz
pior - gorszy | gorzej
piquenique - piknik
pirâmide - piramida
pirata - pirat
pisar - stąpać | deptać
Pisces - Ryby
piscina - basen
pisco - pisco
pitoresco - malowniczy
Pittsburgh - Pittsburgh (stolica Allegheny)
pizza - pizza
pizzaria - pizzeria
planejamento - planowanie
planejar - planować
planeta - planeta
planetário - planetarny
plano - płaski | plan
planta - roślina
plantar - sadzić
plástico - plastik | plastikowy
platina - platyna
plenamente - w pełni
pleocroísmo - pleochroizm
pleonasmo - pleonazm
plural - rozmaity | różnorodny | wieloraki | liczba mnoga
Plutão - Pluton
plutónio - pluton
pluvioso - deszczowy
pó - pył | proszek | kurz | proch
pobre - biedny | ubogi | nędzny | biedak | biedaczka | uboga
pobreza - bieda
poço - studnia | dół
poder - móc
poderoso - silny | mocny
podologia - podologia
poeira - kurz | pył
poema - wiersz
poesia - poezja
poesia concreta - poezja konkretna
poeta - poeta
poeticamente - poetycko
polaca - Polka | polaco
polaco - Polak | język polski | polski
polca - polka (taniec)
polegada - cal
polegar - kciuk | duży palec u nogi | paluch
poli- - poli-
polícia - policja
policial - policyjny | policjant | policjantka | pies rasy owczarek niemiecki
policromia - polichromia
polifenol - polifenol
poligamia - poligamia
polígamo - poligamista | poligamiczny
poliglota - poliglota | poliglotka
polígono - wielokąt
Polinésia Francesa - Polinezja Francuska
polissemia - polisemia | wieloznaczność
politeísmo - politeizm
política - polityka
político - polityk | polityczny
polonês - polski
Polónia - Polska
Polônia - Polska
polónio - polon
polônio - polon
polpa - miąższ
poltrona - fotel
polvo - ośmiornica
pólvora - proch strzelniczy
pomba - gołębica
pombo - gołąb
pomposo - wystawny | okazały | pompatyczny
ponte - most
ponteiro - wskazówka | strzałka
pontilhismo - puentylizm | pointylizm
ponto - punkt
ponto-e-vírgula - średnik
pontuação - interpunkcja
popa - rufa
população - populacja
popular - ludowy | popularny
popularidade - popularność
por - przez | na
pôr - umieszczać | położyć
por acaso - przypadkowo | niespodziewanie
por amor à arte - bezinteresownie
porão - piwnica
porção - porcja
porcelana - porcelana
porcento - procent
porco - świnia | świński
porco-espinho - jeżozwierz
porém - mimo to | jednak
pornografia - pornografia
pornográfico - pornograficzny
porque - dlatego że | ponieważ | bo
porquê - motyw | przyczyna | powód
porta - drzwi
portão - brama | wrota
portátil - przenośny
porto - port | przystań | wino porto | schronienie | portar
Port of Spain - Port of Spain
Porto Rico - Portoryko
Portugal - Portugalia
português - portugalski | Portugalczyk | język portugalski
portuguesa - português | Portugalka
posição - pozycja | położenie | okoliczność | opinia | punkt widzenia
pós-impressionismo - postimpresjonizm
possibilidade - możliwość | zdolność | umiejętność
possibilitar - umożliwiać
possível - możliwy
possivelmente - prawdopodobnie
pôster - plakat
postura - postura
potássio - potas
potência - moc
pouco - trochę | niewiele | niewielka ilość
poupa - poupar
povo - naród | lud
povoado - miejscowość
PP - Partia Rozwoju | Partia Ludowa | prywatny pilot | polipropylen
praça - plac | rynek | twierdza
pragmatismo - pragmatyzm
praia - plaża
Praia - Praia
praseodímio - prazeodym
prata - srebro
prateleira - półka
pratica - praticar
prática - praktyka | prático
praticar - praktykować
prático - przydatny | praktyczny | poręczny
prato - talerz
prazer - przyjemność
precedente - poprzedzający
precisamente - właściwie | precyzyjnie | dokładnie
precisão - dokładność | precyzja
precisar - potrzebować | precyzować | określać
preço - cena
predefinição - szablon
predestinação - predestynacja | przeznaczenie
predica - predicar
prédica - kazanie
preencher - wypełniać
prefeito - prefekt
preferência - preferencja
preferir - woleć
prefixo - prefiks | przedrostek
prego - gwóźdź | lombard | pedał gazu (w samochodzie) | pregar
preguiça - lenistwo
pré-história - prehistoria
preleção - wykład
preludio - preludiar
prelúdio - preludium
preocupação - zmartwienie
preparar - przygotowywać | przyrządzać | preparować | przygotowywać się
preposição - przyimek
prescrição - recepta | ograniczenie
presença - obecność
presente - obecny | prezent | teraźniejszość
preservar - zachowywać | chronić
presidente - prezydent
pressa - szybkość | pęd | pośpiech | pilna sprawa | dylemat | zakłopotanie
pressão - ciśnienie | nacisk | presja
presunto - szynka
pretérito imperfeito - czas przeszły (niedokonany) prosty trybu oznajmującego | czas przeszły (niedokonany) prosty trybu łączącego
pretexto - pretekst
preto - czarny | czerń | czarnoskóry
prima - primo | primar | premir
primavera - wiosna
primeiro - pierwszy
primo - kuzyn | pierwszy | główny | doskonały | premir | primar
primogenitura - primogenitura | pierworództwo | pierworodztwo
princesa - księżniczka
principal - szef | lider | główna rzecz | główny
principalmente - głównie
príncipe - książę
princípio - początek
prioridade - pierwszeństwo | priorytet | przywilej
prisão - więzienie
prisioneira - więźniarka
prisioneiro - więzień
privacidade - prywatność
privilégio - przywilej
privo - privar
probabilidade - prawdopodobieństwo
problema - problem
processo - proces | sprawa sądowa | processar
procissão - procesja
proclama - proclamar
procurar - szukać
produção - produkcja
produto - produkt | wytwór
produzir - produkować | wytwarzać | wydzielać
professor - profesor | nauczyciel
profeta - prorok
profiláctico - profilaktyczny
profissão - profesja | zawód
profissão liberal - wolny zawód
profundo - głębia | głęboki
programa - program
programação - programowanie
programador - programista
progresso - postęp | rozwój
proibição - zakaz | prohibicja
proibir - zakazywać
projecto - projekt
projeto - projekt
promécio - promet
promessa - obietnica
promulgar - ogłaszać | obwieszczać
pronome - zaimek
pronuncia - pronunciar
pronúncia - wymowa
pronunciar - wymawiać | wypowiadać | wygłaszać
propaganda - propaganda
propensão - skłonność | pociąg do czegoś
proporcional - proporcjonalny
proposta - propozycja | oferta
propriedade - własność
proprietário - właściciel | posiadacz
próprio - właściwy | prawidłowy | poprawny | własny
propus - propor
prosa - proza
prosperar - prosperować
prosperidade - dobrobyt | powodzenie | sukces
prospero - prosperar
prosseguir - kontynuować
prostituição - prostytucja
prostituta - prostytutka
protactínio - protaktyn
protão - proton
proteção - protekcja | ochrona
protecção - protekcja | ochrona
protector - protektor | obrońca | chroniący | opiekuńczy | ochronny
proteger - chronić | opiekować się
proteína - białko | proteina
protesto - protest | protestar
protocolo - protokół
próton - proton
prova - dowód
provar - próbować | sprawdzać
provavelmente - prawdopodobnie
Provença - Prowansja
provérbio - przysłowie
provitamina - prowitamina
próximo - bliski | pobliski | sąsiedni | przyszły | następny
prudência - roztropność | rozwaga
prudente - ostrożny
prudentemente - ostrożnie
pseudónimo - pseudonim
psicanálise - psychoanaliza
psicologia - psychologia
psicologicamente - psychologicznie
psicológico - psychologiczny
psicologismo - psychologizm
psiquiatria - psychiatria
Ptah - Ptah
publicação - publikacja
publicamente - publicznie
publicidade - reklama
público - publiczny
pulga - pchła
pulmão - płuco
pulmonar - płucny
pulseira - bransoletka
pulso - puls | nadgarstek | siła | wigor | pulsar
punhado - garść | garstka
punhal - sztylet
punho - pięść
punição - kara | karanie
punir - karać | ukarać
purgatório - czyściec
purificar - czyścić | oczyszczać
puro - czysty
púrpura - purpura | kolor purpurowy
puta - dziwka | kurwa
quadra - epoka
quadrado - kwadrat | kwadratowy
quadridimensional - czterowymiarowy
quadril - biodro
quadriplegia - tetraplegia
quadro - rama | obramowanie | obraz | quadrar
qualidade - jakość | zaleta | dobra cecha | przymiot
qualquer - ktokolwiek | cokolwiek | jakikolwiek
quando - kiedy
quantidade - ilość
quanto - ile
quarenta - czterdzieści | 40
quarta-feira - środa
quarto - czwarty
quase - prawie | niemal
quatorze - czternaście
quatro - cztery | 4
que - który | jaki | co | czego | jak | że | iż | żeby | aby | ponieważ
queda - quedar | quedo
queijo - ser
queimar - palić | spalać
queixar-se - narzekać
queixo - broda | podbródek
queixo duplo - podwójny podbródek
quem - kto
Quénia - Kenia
quente - ciepły | gorący
quer - querer
queratinócito - keratynocyt
quereis - querer
querem - querer
queremos - querer
querer - chcieć | lubić
queres - querer
quero - querer
questão - pytanie | kwestia | problem | temat
questionar - kwestionować | stawiać pod znakiem zapytania
quilograma - kilogram
quilómetro - kilometr
quilômetro - kilometr
quilowatt - kilowat
química - chemia | químico
químico - chemiczny | chemik
quimono - kimono
quinta-feira - czwartek
quinto - piąty | 5.
quinze - 15 (piętnaście)
Quirguistão - Kirgistan
Quirguizistão - Kirgistan
quis - querer
quiuí - kiwi
quivi - kiwi
quotidiano - codzienny | powszechny | dziennik
rã - żaba
rabino - rabin
rabo - ogon
raça - rasa
racional - racjonalny | rozumny | myślący
racionalidade - racjonalność
radão - radon
radiação - promieniowanie
radicalismo - radykalizm
rádio - radio | radiostacja
radioativo - radioaktywny
rádon - radon
raia - raja
rainha - królowa
raio - promień | promyk | raiar
raiva - złość | gniew | szał
raiz - korzeń
ramo - gałąź
rancor - uraza | żal
range - ranger
rapariga - dziewczyna | prostytutka
rapaz - chłopiec
rapidamente - szybko | prędko
rápido - szybki | prędki
raposa - lis
raramente - rzadko
raso - płytki | płaski
raspar - skrobać | oskrobywać | ścierać
ratazana - szczur
ratificação - ratyfikacja
rato - mysz
razão - rozum
reabilitação - rehabilitacja
reação - reakcja
reacção - reakcja
readquirir - odkupić | odzyskać
reagir - reagować
real - królewski
realidade - rzeczywistość | realność
realismo - realizm
realista - realistar | realista | realistka | realistyczny
realmente - rzeczywiście | naprawdę
rebelião - rebelia | bunt
recado - wiadomość
receber - przyjmować | odbierać | odebrać | dostać
receita - recepta
receituário - recepta
recentemente - niedawno | ostatnio
recepção - przyjęcie | odbiór
recomendação - rekomendacja
recomendar - rekomendować | polecać
recompensa - wynagrodzenie | recompensar
reconhecer - rozpoznawać
recrutamento - werbunek | rekrutacja
rede - siatka | hamak | sieć (np. wodna)
redondo - okrągły
redução - redukcja | skrócenie
reduzir - redukować | zmniejszać
reencarnação - reinkarnacja
refeição - posiłek
refém - zakładnik
referir - odnosić się | odwołać się | skierować
reflexão - refleksja | medytacja | kontemplacja | odbicie
reflexo - odruch | odruchowy
refúgio - schronienie | przytułek | schronisko | azyl
regente - regent
reger - rządzić | zarządzać | kierować
região - region | rejon | okolica
regional - regionalny
regista - registar
registrar - rejstestrować | tworzyć rejestr | spisywać
registro - rejestr
régua - linijka | prawidło
regular - regulować
regularidade - regularność
rei - król
reino - królestwo | reinar
Reino Unido - Zjednoczone Królestwo
relação - relacja
relâmpago - błyskawica | piorun
relatividade - względność
relativismo - relatywizm
religião - religia
religiosamente - religijnie
religioso - religijny
relógio - zegar | zegarek | licznik (do pomiaru zużycia wody, gazu)
remédio - lekarstwo | remedium
remo - wiosło | wioślarstwo
remoção - usunięcie | przenosiny | przeniesienie w inne miejsce
remover - usuwać
rena - renifer
rénio - ren
renta - rentar
rentável - korzystny
reparar - naprawiać | reperować
reparo - naprawa | reparar
repercutir - rozbrzmiewać | odzwierciedlać
repetidamente - wielokrotnie
repetir - powtórzyć | powtarzać
repolho - kapusta
representação - reprezentacja | reprezentowanie
representar - reprezentować | przedstawiać
reprisa - reprisar
reprodução - reprodukcja
réptil - pełzający | czołgający się | gad | łajdak | nikczemnik
república - republika
República Centro-Africana - Republika Środkowoafrykańska
República Checa - Republika Czeska
República Democrática do Congo - Demokratyczna Republika Konga
República Dominicana - Republika Dominikańska
República Federal da Alemanha - Republika Federalna Niemiec | Niemcy
reputação - reputacja
reservar - rezerwować | zarezerwować
resgate - ratunek | okup
residência - miejsce zamieszkania | rezydencja | dom | rezydencja (np. lekarza)
resignar - rezygnować
resistência - opór | rezystancja
resolução - rezolucja
resolver - rozwiązywać | znajdować rozwiązanie
respectivamente - odpowiednio
respeitar - szanować
respeito - respekt | szacunek
respeitoso - pełen szacunku
respiração - oddychanie | oddech
respirar - oddychać
respiro - respirar
responder - odpowiadać
respondo - responder
responsabilidade - odpowiedzialność
responsável - odpowiedzialny (który potrafi wziąć odpowiedzialność) | odpowiedzialny (powodujący coś, winny czemuś)
resposta - odpowiedź
ressonância - rezonans
restaurante - restauracja
restrito - ściśle określony | ograniczony
resultado - wynik | rezultat
resumi - resumir
retaliação - odwet
retângulo - prostokąt
retardamento - opóźnienie
retórica - retoryka | retórico
retrato - portret
reumatismo - reumatyzm
reunião - połączenie | zespolenie | zebranie | spotkanie
reverso - tył | rewers (odwrotna strona)
revisionismo - rewizjonizm
revista - magazyn | czasopismo
revitalização - rewitalizacja
revitalizar - rewitalizować | ożywiać
revolta - rewolta | bunt | revolto | revoltar
revolução - rewolucja | obrót
revólver - rewolwer
rezar - modlić się | odmawiać modlitwę
riacho - strumień
riboflavina - ryboflawina
ricaço - bogacz
ricina - rycyna
rico - bogaty | bogacz
rifle - karabin
rim - nerka
rima - rym | rimar
rinoceronte - nosorożec
rio - rzeka
riqueza - bogactwo
rir - śmiać się
risada - śmiech
risco - plan | szkic | niebezpieczeństwo | ryzyko | riscar
riso - śmiech | uśmiech
riso amarelo - wymuszony uśmiech
risotto - risotto | risoto
ritmo - rytm | ritmar
rivalidade - rywalizacja
rizoma - kłącze
Roberto - Robert
robô - robot
robusto - mocny | silny
rocha - skała
roda - koło
ródio - rod
rododendro - różanecznik | azalia | rododendron
roedor - gryzoń
roer - gryźć | ogryzać | obgryzać
rogar - błagać | modlić się | przeklinać
rola - penis
rolha - korek
Roma - Rzym
romã - granat
romance - powieść
romano - rzymski
romântico - romantyczny
Roménia - Rumunia
Romênia - Rumunia
romeno - rumuński | Rumun
rosa - róża | różowy
rosado - różowy
rosto - twarz | oblicze
rotatória - rondo
rotunda - rondo | rotunda (budynek)
roubar - kraść
roupa - odzież | ubrania
rouxinol - słowik
roxo - purpurowy | różowy | fioletowy
RS - Rio Grande do Sul
rua - ulica
Ruanda - Rwanda
rubi - rubin | kolor rubinowy | rubinowy
rubídio - rubid
rubis - rubi
rúgbi - rugby
rugby - rugby
ruim - podły | niegodziwy | nikczemny | zły | niedobry | marny
ruína - ruina
rum - rum
rural - wiejski
Rússia - Rosja
russo - rosyjski | język rosyjski
ruténio - ruten
rutherfórdio - roentgen
sábado - sobota
sabão - mydło
saber - wiedzieć
sábio - mądry
sabonete - mydło
sabor - smak | gust
saboroso - smaczny | smakowity | pyszny | dobry | przyjemny | miły | zabawny | śmieszny | jowialny
sacarina - sacharyna
sacerdote - kapłan | kleryk | ksiądz
saco - torba | worek
sacrifício - poświęcenie | ofiara
sacristia - zakrystia
sadio - zdrowy
safado - bezwstydny
safira - szafir
Sagitário - Strzelec
sagrado - święty
saia - spódnica
saída - wyjście
saintpaulia - sępolia
sair - wychodzić | wyjść | wylogowywać
sal - sól
sala - pomieszczenie | sala
salada - sałatka
salão - salon | sala
salário - wypłata
salgueiro - wierzba
salmão - łosoś
salsicha - kiełbasa | basset
saltar - skoczyć | skakać
salto - skok | saltar
Salvador - Salwador
salvar - ratować
samambaia - paproć
Samarcanda - Samarkanda
samário - samar
sanatório - sanatorium
sanção - sankcja
sandália - sandał
sanduíche - kanapka
saneamento - uzdrowienie | polepszenie | naprawienie
sangrar - krwawić
sangue - krew
sanguessuga - pijawka
sanita - toaleta
sano - sanar
Santa Lúcia - Saint Lucia
santo - święty
santola - krab pająkowaty
santuário - sanktuarium | świątynia
são - zdrowy | święty
são e salvo - cały i zdrowy
São Paulo - Sao Paulo
São Tomé e Príncipe - Wyspy Świętego Tomasza i Książęca
são-tomense - dotyczący Wyspy Świętego Tomasza | mieszkaniec Wyspy Świętego Tomasza | mieszkanka Wyspy Świętego Tomasza
sapateira - krab_kieszeniec
sapato - but | pantofel
sapo - ropucha
sarcasmo - sarkazm
sarcófago - sarkofag
sarcopenia - sarkopenia
Sardenha - Sardynia
sardinha - sardynka
sarraceno - gryka
satélite - satelita
sátiro - satyr
satisfação - zadośćuczynienie | satysfakcja | zaspokojenie | zadowolenie | wyjaśnienie | usprawiedliwienie
satisfatório - zadowalający
satisfazer - zadośćuczynić | satysfakcjonować | zadowalać | zaspokajać
satisfeito - zadowolony | usatysfakcjonowany
saudação - pozdrowienie
saudade - tęsknota | nostalgia | melancholia
saudar - witać
saudável - zdrowy | zdrowotny
saúde - zdrowie | na zdrowie!
saxofone - saksofon
sazão - właściwa pora | sezon
se - się | siebie | jeśli | czy | o ile
secção - sekcja
seco - suchy
secretamente - w sekrecie
secular - świecki
século - wiek | stulecie
seda - jedwab
sede - siedziba | miejsce | pragnienie
sedimento - osad
sedoso - jedwabisty
segredo - sekret | tajemnica
segregação - segragacja | oddzielanie
segue - seguir
seguinte - następny | kolejny
seguir - podążać za
segunda-feira - poniedziałek
segundo - sekunda | drugi | według | zgodnie
seguramente - na pewno
segurança - bezpieczeństwo
segurar - ubezpieczać
seguridade - bezpieczeństwo
seguro - pewny | wierny | segurar
seio - klatka piersiowa | pierś
seis - sześć
sela - siodło
seleção - selekcja | selekcjonowanie
selénio - selen
selo - znaczek
selva - dżungla
sem - bez
sem ambages - bez ogródek
semana - tydzień
semanalmente - co tydzień | tygodniowo
semântica - semantyka | semântico
semente - ziarno | nasienie | sperma
semicondutor - półprzewodnik
sempre - zawsze
senado - senat
Senegal - Senegal
senha - znak | sygnał | hasło
senhor - pan
senhora - pani
senhorita - panna
seno - sinus
sensação - uczucie | odczucie | wrażenie
sensualmente - zmysłowo
sentença - zdanie | sentencja | opinia
sentido - zmysł | wrażliwy | czuły
sentimento - uczucie | odczucie
sentir - czuć | odczuwać
sento - sentar
separação - separacja
separar - separować | oddzielać | rozdzielać | rozłączać
separatismo - separatyzm
sequência - sekwencja
ser - być
serenidade - spokój
ser humano - istota ludzka | człowiek
seriamente - poważnie | na serio | bardzo | ciężko
seringa - strzykawka
serio - seriar
sério - poważny
sermão - kazanie
serpente - wąż
serra - piła
Serra Leoa - Sierra Leone
serre - serrar
Sérvia - Serbia
serviço - obowiązek | zadanie | praca
sessenta - sześćdziesiąt | 60
seta - strzała | bełt | strzałka | strzałka wodna | wskazówka
sete - siedem | 7 | siódemka
setembro - wrzesień
Setembro - wrzesień | setembro
setenta - siedemdziesiąt | 70
sétimo - siódmy
seu - jego
severo - surowy | srogi | rygorystyczny | poważny
sexagésimo - sześćdziesiąty
sexo - płeć | genitalia
sexta-feira - piątek
sexto - szósty
sexual - seksualny | płciowy
sexualidade - seksualność | seksualizm
sexualmente - seksualnie
Shekhinah - Szechina
siciliano - Sycylijczyk | sycylijski
sífilis - syfilis | kiła
sigilo - tajemnica
significação - znaczenie
significado - znaczenie
significantemente - znacząco
significar - znaczyć | oznaczać | mieć znaczenie
significativamente - znacząco
significativo - znaczący
significo - significar
sikhismo - sikhizm
sílaba - sylaba
silêncio - milczenie | cisza
silencioso - cichy | milczący
silhueta - sylwetka
silício - silikon
sim - tak | zgoda | przyzwolenie
simbiótico - symbiotyczny
simbólica - symbolika | simbólico
simbolicamente - symbolicznie
simbólico - symboliczny
simbolismo - symbolizm | symbolika
simbolista - symbolista | symbolistka | symbolistyczny
simbolisticamente - symbolistycznie
simbolístico - symbolistyczny
simbolização - symbolizowanie | symbolizacja
simbolizar - symbolizować
símbolo - symbol
símio - małpa
simpaticamente - sympatycznie
simpático - sympatyczny | miły
simplificar - uprościć
simulação - symulacja
sina - bandera | flaga | sztandar | los | przeznaczenie
sinalização - sygnalizowanie | sygnalizacja
sinceridade - szczerość
sincero - szczery
sincronismo - synchroniczność | synchronizm
sindicato - związek zawodowy | związek | syndykat
sinfonia - symfonia
sino - dzwon
sinónimo - bliskoznaczny | synonim
sinônimo - synonim
sintaxe - składnia
síntese - synteza
sintético - syntetyczny
Síria - Syria
Sísifo - Syzyf
sismo - trzęsienie ziemi
sistema - system | układ | ustrój
sistema planetário - układ planetarny
sistemática - systematyka | f : sistemático
sítio - miejsce | oblężenie
situação - sytuacja | usytuowanie | położenie | kondycja | stan | pozycja społeczna | ekonomiczna
só - sam | jeden | tylko
soalheiro - słoneczny
sob - pod
sobrancelha - brew
sobre - na | nad | ponad
sobrenatural - nadprzyrodzony
sobrenome - nazwisko
sobretudo - płaszcz
sobrevida - przeżycie
sobrinha - siostrzenica
sobrinho - siostrzeniec
socialismo - socjalizm
sociedade - społeczeństwo
sociologia - socjologia
sociólogo - socjolog
socorro - ratunek | pomoc
soda - soda
sódio - sód
sofá - sofa
sofre - sofrer
sofrer - cierpieć
sofrimento - cierpienie
sogra - teściowa
sogro - teść
soja - soja
sol - słońce
Sol - Słońce
solar - słoneczny | rezydencja
solarengo - słoneczny
soldado - żołnierz
solde - soldar
solidão - samotność
solo - ziemia
Sólon - Solon
solstício - przesilenie
soltar - rozwiązywać | rozluźniać | poluźniać | rozsupływać | obluzować | puszczać | wypuszczać | uwalniać
solteira - panna (niezamężna)
solteiro - kawaler
solto - luźny | swobodny | nie związany
solução - rozwiązanie (problemu) | roztwór
soluçar - czkać
solucionar - rozpuszczać (w płynie) | rozstrzygnąć | rozwiązać
soluço - soluçar
solúvel - rozpuszczalny
som - dźwięk
soma - suma | somar
Somália - Somalia
sombra - cień
sombrinha - parasolka przeciwsłoneczna
sombrio - ciemny | mroczny | ocieniony
somente - jedynie | tylko
sonâmbulo - lunatyczny | lunatyk
sonata - sonata
sonda - sonda
sondagem - sondaż
sondar - sondować
sonde - sondar
soneto - sonet
sonhar - śnić | marzyć
sonho - sen
sonífero - środek nasenny | nasenny | usypiający
sono - sen
sopa - zupa
sopra - soprar
soprar - wiać | dmuchnąć | zdmuchnąć | dmuchać
sorrir - uśmiechać się
sorriso - uśmiech
sorte - przeznaczenie | los | przypadek | szczęście
sortudo - szczęśliwy
sorvete - lody (deser) | sorbet
sótão - strych
soviético - sowiecki
sozinho - samotny | sam
sua - jej | suar
suar - pocić się
suave - łagodny | miękki | delikatny
suavidade - miękkość
suavizar - zmiękczać | wygładzać | łagodzić
Suazilândia - Suazi
subir - wznosić się | wspinać się
súbito - nagle | nagły
subjectividade - subiektywność
subjectivo - subiektywny
submarino - podwodny | okręt podwodny
submergir - zatapiać | zalewać | zanurzać
submerso - zatopiony | zalany | zanurzony
subministrar - dostarczać | zaopatrywać
submisso - uległy | pokorny
subornar - przekupić
suborno - przekupstwo | łapówka
subsequente - kolejny | wynikający | następny
subsistência - trwanie | utrzymywanie się
subsistir - trwać | utrzymywać się
substância - substancja
substancial - istotny | podstawowy | treściwy | pożywny
substantivo - rzeczownik | rzeczownikowy | niezależny
substituição - substytucja | zastępstwo | zastępowanie | zamiana | podstawienie
substituto - substytut | zastępczy
subtil - subtelny
subtileza - subtelność | delikatność | cienkość | przenikliwość | wnikliwość
subtração - odejmowanie
subtropical - podzwrotnikowy
suburbano - podmiejski
subúrbio - przedmieście
subverter - obalać | przewracać | dokonywać przewrotu
suceder - następować | mieć miejsce | zdarzyć się
sucessão - następstwo | sukcesja
sucessivo - kolejny | sukcesywny
sucesso - sukces
sucessor - następca | spadkobierca
suculento - soczysty | esencjonalny
sucuri - anakonda
Sudão - Sudan
sudeste - południowy wschód
sudoeste - południowy zachód
sueca - sueco | Szwedka
Suécia - Szwecja
sueco - szwedzki | Szwed
sufi - wystarczająca ilość | wystarczająca umiejętność | zdolność
suficiente - wystarczający
suficientemente - wystarczająco
sufismo - sufizm
sufixo - przyrostek | sufiks
sufocar - dusić | dławić | tłumić
sugar - wsysać | ssać | wyssać
sugerir - sugerować | proponować
sugestão - sugestia | propozycja
Suíça - Szwajcaria
suicida - samobójca | samobójczyni | samobójczy
suicídio - samobójstwo
sujar - brudzić | plamić | skalać
sujeito - podległy | podlegający | uległy | podmiot
sujo - brudny | nieczysty | sprośny
sul - południe
sul-americano - południowo-amerykański | mieszkaniec Ameryki Południowej
sultão - sułtan
sumo - sok
sumô - sumo
suor - pot
superar - przezwyciężyć | przewyższyć
supercondutividade - nadprzewodnictwo
superficial - powierzchowny | powierzchniowy
superioridade - wyższość | przewaga | zwierzchność
superlativo - najlepszy | doskonały
supermercado - supermarket
supernova - supernowa
superstição - zabobon | przesąd
supersticioso - przesądny
suplementar - uzupełniający | dodatkowy
suplemento - uzupełnienie | dodatek
súplica - prośba | błaganie
suplicar - prosić | błagać
suposto - rzekomy | domniemany | supozycja
suprematismo - suprematyzm
supremo - najwyższy
suprimir - znosić | likwidować | uchylać | przemilczać
surdez - głuchota
surdo - głuchy | bezdźwięczny
surdo-muto - głuchoniemy
surgir - pojawiać się | wyłaniać się | powstawać
Suriname - Surinam
surpresa - zaskoczenie | niespodzianka
surrealismo - surrealizm
susceptível - wrażliwy | podatny | drażliwy
suspeita - podejrzenie | przypuszczenie
suspeitar - podejrzewać | przypuszczać
suspeito - podejrzany
suspensão - zawieszenie | przerwanie | wstrzymanie | zawiesina
suspirar - wzdychać
suspiro - westchnienie
susto - strach
sutiã - biustonosz
sutura - szew
suvenir - pamiątka
tabacaria - sklep tytoniowy
tabaco - tytoń
tábua - deska
tabuleiro de xadrez - szachownica
taça - puchar
tache - tachar
taciturno - małomówny | ponury
táctica - taktyka
Tadjiquistão - Tadżykistan
tagarelar - gawędzić | paplać | gadać | rozmawiać
tailandês - tajlandzki | Tajlandczyk
tailandesa - tailandés | Tajlandka
Tailândia - Tajlandia
Taiwan - Tajwan
Tajiquistão - Tadżykistan
talento - talent | dar
tálio - tal
talismã - talizman
talo - talar | plecha | szypułka | łodyżka | łodyga | badyl
talvez - pewnie | być może | prawdopodobnie
tamanduá - mrówkojad
tamanho - wielkość | rozmiar | skala | proporcja | wysokość | obfitość | rozległość | szerokość
tâmara - daktyl
também - także | też | również
tambor - bęben | bębenek
tamboril - żabnica | nawęd (gatunek ryby)
tangente - styczna
tanque - czołg
tantálio - tantal
tântalo - tantal
Tanzânia - Tanzania
taoista - taoista | tauista | taoistka | taoistyczny
tardar - odwlekać | opóźniać
tarde - wieczór | popołudnie | późno
tardiamente - późno | powoli
tarifa - taryfa
tarraxa - śruba
tartaruga - żółw
tasca - karczma | knajpa
tatra - polski owczarek podhalański | owczarek podhalański
tatu - pancernik
tatuador - tatuażysta
tatuadora - tatuażystka
tatuagem - tatuaż
tatuar - tatuować
taxa - taxar
táxi - taksówka | taxi | taryfa
taxidermia - taksydermia
taxímetro - taksometr | taksomierz
taxinomia - taksonomia
tchau - do widzenia
tcheco - język czeski
te - ty
tear - krosno | warsztat tkacki
teatral - teatralny
teatro - teatr
tecido - tkanina
tecla - klawisz
teclado - klawiatura
tecnécio - technet
técnica - technika | técnico
tecnicamente - technicznie
técnico - techniczny | technik
tecnologia - technologia
tecnologicamente - technologicznie
tecnológico - technologiczny
teimoso - uparty
tela - tkanina naturalna | płótno | obraz
telefonar - telefonować | dzwonić
telefone - telefon | telefonar
telefónico - telefoniczny
telefônico - telefoniczny
telegrafia - telegrafia
telegraficamente - telegraficznie
telegráfico - telegraficzny
telegrafista - telegrafista | telegrafistka
telegrafo - telegrafar
telégrafo - telegraf
telegrama - telegram | depesza
telescópio - teleskop
televisão - telewizja
televisor - telewizor
telha - dachówka
telhado - dach
telúrio - tellur
tema - temat
temer - bać się | obawiać się
temor - bojaźń | strach
temperamento - temperament | usposobienie
temperança - umiar | wstrzemięźliwość | powściągliwość
temperatura - temperatura
tempero - temperar
tempestade - burza | sztorm
templo - świątynia
tempo - czas | pogoda
têmpora - skroń
temporário - tymczasowy
tenaz - obcęgi
tenda - namiot
tendência - tendencja | skłonność
tenente - porucznik
ténis - tenis
tênis - tenis
tentar - próbować | wyzywać | kusić
teofania - teofania
teologia - teologia
teoria - teoria
teórico - teoretyczny | teoretyk
teorizar - teoretyzować
tepidez - ciepło
ter - mieć
ter a faca e o queijo na mão - mieć wszystkie atuty w ręku
terapeuta - terapeuta | terapeutka
terapia - terapia
teratologia - teratologia
térbio - terb
terça-feira - wtorek
terceiro - trzeci
terebintina - terpentyna
térmico - termiczny
terminal - końcowy | terminalny
terminar - kończyć
terminologia - terminologia
termo - kres | koniec | termin | wyrażenie | termos
termodinâmica - termodynamika | termodinâmico
termômetro - termometr
Termópilas - Termopile
terno - tkliwy | czuły | delikatny
ternura - tkliwość | czułość | delikatność
terra - ziemia | ląd
Terra - Ziemia
terramoto - trzęsienie ziemi | terremoto
terremoto - trzęsienie ziemi
terrestre - ziemski
território - terytorium
terrível - okropny
terror - strach | przerażenie | groza | postrach | terror
terrorismo - terroryzm
terrorista - terrorysta | terrorystka | terrorystyczny
tesoura - nożyczki
testa - czoło
testamento - testament
testar - świadczyć | zaświadczać | testować
teste - test | próba | badanie kontrolne
testemunha - świadek
testemunhar - być świadkiem | świadkować | poświadczać
testículo - jądro
teta - sutek
teto - sufit
tetraedro - czworościan
tetraplegia - tetraplegia
teu - twój
texto - tekst
texugo - borsuk
tia - ciotka | ciocia
tiamina - tiamina
Tibete - Tybet
tigela - miska
tigre - tygrys
tijolo - cegła
time - drużyna | ekipa
timidez - nieśmiałość
tímido - nieśmiały
Timor - Timor
Timor Leste - Timor Wschodni
Timóteo - Tymoteusz
tingir - farbować | barwić
tinta - atrament | farba | barwnik | ślad
tintura - farbowanie
tio - wuj | wujek
típico - typowy
tipo - rodzaj
tipografia - typografia | drukarstwo | drukarnia
tipografo - tipografar
tira - pas | pasek | policjant
tirania - tyrania
tiranicamente - tyrańsko
tirânico - tyrański
tiranizar - tyranizować
tirano - tyran
tirar - ciągnąć
tire - tirar
tiro - strzał | wystrzał | tirar
tiro com arco - łucznictwo
Tirol - Tyrol
tiro livre - rzut wolny
tiro penal - rzut karny
tirotear - strzelać
tiroxina - tyroksyna
titânio - tytan (pierwiastek)
título - tytuł
toalha - ręcznik
tocar - dotykać | poruszać
tocou - tocar
todo - jakikolwiek | ogół | zbiór | wszystko | cały
Togo - Togo
tolerar - tolerować | znosić
tomar - brać | wziąć | chwytać | zająć | zdobyć | pić | jeść | spożywać
tomar o véu - wstąpić do klasztoru
tomate - pomidor
tomateiro - pomidor
-tomia - -tomia
tomo - tomar
tonelada - tona
topázio - topaz
topo - szczyt | wierzchołek | najwyższy punkt | topar
topógrafo - topograf
topónimo - toponim
topônimo - toponim
toque - toczek | tocar
Tóquio - Tokio
toranja - grejpfrut
tórax - klatka piersiowa
tormento - męka | męczarnia | udręka
torneira - kran
torno - tornar
tornozelo - kostka u nogi
toronja - grejpfrut
torpedear - torpedować
torpedo - torpeda
torre - wieża
torso - tors | tułów
torta - ciasto
tortura - tortura | torturar
toscano - toskański | Toskańczyk
tosse - kaszel
tossir - kaszleć
total - całkowity | zupełny | suma
totalidade - całość | ogół
totalmente - całkowicie | totalnie
toucinho - boczek
toupeira - kret
touro - byk
Touro - Byk
toxicidade - toksyczność
tóxico - toksyczny | trujący | trucizna
toxicologia - toksykologia
trabalhador - robotnik
trabalhar - pracować
trabalho - dzieło | utwór | posada | zatrudnienie | praca | robota | interes | zarobek
traça - traçar
tradição - tradycja
tradicional - tradycyjny | tradycjonalny | zwyczajny
tradução - tłumaczenie | przekład
tradutor - tłumacz
traduzir - tłumaczyć | przeprowadzać tłumaczenie
tráfego - biznes | handel | przewóz | transport | tranzyt
tragédia - tragedia | nieszczęście
tragicomédia - tragikomedia
traição - zdrada
trair - zdradzać | zdradzać się
traja - trajar
traje - ubiór | strój | ubranie
trama - tramar
trame - tramar
tranquilidade - spokój
tranquilo - spokojny
transcendência - transcendencja
transe - transir
transformar - przekształcać
transliteração - transliteracja
transmigração - transmigracja
transmissão - transmisja | przekaz | przesłanie
transmitir - przekazywać | transmitować
transparente - przezroczysty | transparentny
transporta - transportar
transportar - transportować | przenosić | przewozić | przemieszczać
transporte - transport | przewóz
trás - za
tratado - traktat | pakt | tratar
travão - hamulec
trave - belka
travesseiro - poduszka
trazer - przynosić | przynieść
treinador - trener
trem - pociąg
tremer - drżeć
três - trzy
trevas - ciemność | mrok
trevo - koniczyna
treze - trzynaście | 13
triângulo - trójkąt
tríbade - lesbijka
tribo - plemię | kasta | klasa
tributo - danina | podatek | wyrazy uznania | hołd
tricologia - trychologia
tricotilomania - trichotillomania
trigo - pszenica
trilhão - bilion
trinta - trzydzieści
triplicar - potrajać | troić się
triste - smutny | nieważny | nieistotny
tristemente - smutno
tristeza - smutek
triunfar - tryumfować | zwyciężać
trivial - trywialny
troca - wymiana | zamiana
trocar - wymieniać | zamieniać
troféu - trofeum
tronco - pień | tułów
trono - tron
tropa - oddział | wojsko | tłum
tropical - tropikalny
troposfera - troposfera
trouxe - trazer
trovão - grzmot | piorun
trovoada - burza z piorunami
truta - pstrąg
tu - ty
tubarão - rekin
tubeira - dysza
tucano - tukan
tudo - całkiem | całkowicie | całość | wszystko | wszystek | cały | każdy
tuia - tuja | żywotnik
túlio - tul
tulipa - tulipan
túlipa - tulipan
tumba - grób
tumor - guz
túmulo - grób | kopiec | kurhan | miejsce spoczynku
tundra - tundra
túnel - tunel
tungsténio - wolfram
tungstênio - wolfram
Tunísia - Tunezja
turba - rzesza | tłum | hołota
turbante - turban
turca - turco | Turczynka
turco - turecki | turecki (język) | Turek
turismo - turystyka
turista - turysta | turystka
turno - kolej | zmiana | tura
Turquemenistão - Turkmenistan
Turquia - Turcja
tutor - opiekun | kurator
uba - wyć | płakać
Ucrânia - Ukraina
ucraniano - ukraiński | Ukrainiec
ufano - arogancki | butny | wyniosły
Uganda - Uganda
uísque - whisky
uivo - wycie | wrzask
úlcera - wrzód
ultimato - ultimatum
ultimo - ultimar
último - ostatni | końcowy | ostateczny
ultimogenitura - ultimogenitura
ulula - ulular
um - jeden | -
uma - jakaś | pewna
uma andorinha só não faz verão - jedna jaskółka wiosny nie czyni
umbigo - pępek
umbilical - pępkowy
umidade - wilgoć | wilgotność
úmido - wilgotny
um pouco - trochę
unânime - jednomyślny
unanimemente - jednomyślnie
unanimidade - jednomyślność
unha - paznokieć
união - związek | unia
União Europeia - Unia Europejska
União Européia - Unia Europejska
União Soviética - Związek Radziecki
único - jedyny | wyjątkowy | niezwykły
unicórnio - jednorożec
unidade - jednostka | pojedyńczość
unificar - łączyć | jednoczyć
uniforme - uniform | mundur | jednolity | jednakowy (dla wszystkich) | równomierny | jednostajny
unir - jednoczyć | łączyć
universal - powszechny | ogólny | uniwersalny
universalidade - powszechność | uniwersalność
universalismo - uniwersalizm
universalista - uniwersalista | uniwersalistka
universalizar - rozpowszechniać | upowszechniać | uogólniać
universidade - uniwersytet
universitário - uniwersytecki
universo - uniwersalny | powszechny | światowy | wszechświatowy | świat | wszechświat | kosmos | uniwersum
untar - smarować
urânio - uran
Urano - Uran
urbano - miejski
urgente - pilny | naglący
urgentemente - pilnie
urina - mocz | urinar
urinar - oddawać mocz | sikać
urologia - urologia
urso - niedźwiedź
urtiga - pokrzywa
urubu - sęp
Uruguai - Urugwaj
usar - używać | stosować | nosić (ubranie, część garderoby) | posługiwać się | mieć zwyczaj (w zwyczaju)
Usbequistão - Uzbekistan | Uzbequistão
usitadamente - zwykle
uso - zwyczaj
usual - zazwyczaj
usualmente - zwykle
usuário - użytkownik
usurpador - uzurpator
uterino - maciczny
útero - macica
útil - pomocny | celowy | pożyteczny | przydatny
utilidade - użyteczność
utilização - wykorzystanie | używanie
utilizar - używać | korzystać | wykorzystywać | posługiwać się
utopia - utopia
uva - winogrono
Uzbequistão - Uzbekistan
vaca - krowa
vacina - szczepionka | vacinar
vácuo - próżnia
vagão - wagon
vagina - pochwa
vago - vagar
vale - dolina
valente - dzielny | odważny | nieustraszony
valioso - cenny
valor - wartość | znaczenie | waga | doniosłość | cena | dzielność | męstwo | nieustraszoność
valore - valorar
valsa - walc
vampiro - wampir
vanádio - wanad
vandalismo - wandalizm
Vanuatu - Vanuatu
vão - pusty | próżny
vapor - para
vara - kij | kijek
varão - mężczyzna (dorosły) | męski
variante - wariant
variedade - różnorodność | typ | rodzaj
varrer - zamiatać
Varsóvia - Warszawa
varsoviano - warszawski | warszawiak | warszawianin
vasectomia - wazektomia
vassoura - miotła
vasto - rozległy | obszerny | ogromny
vate - wieszcz | prorok | przepowiadający | trubadur | poeta | bard
Vaticano - Watykan
vaticinar - przepowiadać przyszłość
vazar - opróżniać
vazio - pusty | denny | pustka | próżnia
veado - jeleń | o homoseksualiście
vegano - wegański | weganin
vegetal - roślina
vegetalismo - weganizm
vegetalista - weganin | osoba spożywająca pokarmy wyłącznie pochodzenia roślinnego | wegański
vegetariana - vegetariano | wegetarianka
vegetarianismo - wegetarianizm
vegetariano - wegetariański | wegetarianin
vegetarismo - wegetarianizm
veia - żyła
veículo - pojazd | wehikuł | środek transportu
vela - świeca | żagiel
velejar - żeglować
velha - starucha | staruszka | śmierć | matka | stara: velho
velho - stary
velocidade - prędkość
velocidade da luz - prędkość światła
veludo - aksamit | welwet
vem - vir
vêm - vir
vencer - zdobyć
venda - sprzedaż | vendar
vendaval - wicher | silny wiatr | wichura
vendedor - sprzedawca
vender - sprzedawać
veneno - trucizna | jad | toksyna
venenoso - trujący
Veneza - Wenecja
Venezuela - Wenezuela
venezuelana - Wenezuelka | venezuelano
venezuelano - wenezuelski | Wenezuelczyk
venho - vir
vens - vir
venta - nozdrze
vento - wiatr
ventre - brzuch
ventura - szczęście | pomyślność | los | ryzyko
Vénus - Wenus
Vênus - Wenus
ver - widzieć | zobaczyć
veramente - naprawdę
verão - lato
verbal - czasownikowy | werbalny
verbo - czasownik
verbo auxiliar - czasownik posiłkowy
verbo intransitivo - czasownik nieprzechodni
verbo reflexo - czasownik zwrotny
verdade - prawda
verdadeiramente - szczerze | prawdziwie
verdadeiro - prawdziwy | szczery
verde - zielony
verdolengo - zielonkawy
verdura - zieleń | jarzyna | zielenina
veredicto - wyrok | orzeczenie sądu | werdykt
vergel - sad
vergonha - wstyd | hańba | narządy płciowe człowieka
verificação - weryfikacja
verificar - sprawdzać | weryfikować | sprawdzać się | spełniać się
verme - robak
vermelho - czerwony
vermute - wermut
vero - prawdziwy
versão - wersja
verso - werset | wiersz
vertical - wertykalny | pionowy
verticalmente - pionowo
vesgo - zezowaty
vespa - osa
véspera - wigilia | dzień przed | przeddzień jakiegoś święta
vestido - sukienka | suknia
vestuário - odzież | ubiór
Vesúvio - Wezuwiusz
véu - welon | nakrycie głowy (także np. czepiec, kornet, podwika, podwiczka, podwijka) | woalka | zasłona | osłona | nakrycie | ciemność | zaciemnienie | mrok | pretekst | pozór coś | co ukrywa coś innego (np. prawdę) | określenie części warstwy podniebiennej jamy ustnej | véu do paladar  véu palatino
vexilologia - weksylologia
vez - raz | okazja | możliwość
via - droga | sposób
viagem - podróż
viajar - podróżować
Via Láctea - Droga Mleczna
víbora - żmija
vibrar - drgać | wibrować
vida - życie
videira - winorośl
vídeo - wideo
vidro - szkło | szyba | szklanka
Viena - Wiedeń
Vietnã - Wietnam
Vietname - Wietnam
vietnamita - wietnamski | Wietnamczyk | wietnamski (język) | Wietnamka
vigésimo - dwudziesty | 20
vigiar - obserwować | pilnować | strzec
vilarejo - wioska
Vilnius - Wilno
vimos - vir
vinagre - ocet
vinda - przybycie
vindes - vir
vingança - zemsta
vinha - winorośl
vinho - wino
vinte - dwadzieścia
violação - naruszenie | pogwałcenie (np. prawa) | gwałt | zniewolenie | uwiedzenie
violão - gitara
violência - przemoc
violento - violentar | gwałtowny
violeta - fiołek
violino - skrzypce
vir - przychodzić | przyjść
vir ao mundo - przyjść na świat
virar - odwracać | wywracać | zmieniać
virgem - dziewica
Virgem - Panna | Maria | matka Jezusa
vírgula - przecinek
viril - męski
virilmente - po męsku | męsko
virtude - cnota | wartość moralna | czystość | niewinność
virtudes cardinais - cnoty kardynalne
vírus - wirus
visão - widzenie | oko | widok | wizja
visibilidade - widoczność
visita - gość | wizyta | visitar
visitar - odwiedzać
vista - widok | wzrok | zmysł wzroku | widzenie
visto - wiza
Vístula - Wisła (rzeka)
visual - wizualny
vitamina - witamina
vítima - ofiara
vitória - zwycięstwo
vitorioso - zwycięski
viúva - wdowa | viúvo
viúvo - wdowiec | wdowi
vive - viver
vivência - doświadczenie
viver - żyć
vivi - viver
vivo - viver | żywy
vizinhança - sąsiedztwo | bliskość
vizinho - bliski | pobliski | niedaleki
voar - latać
vocabulário - słownictwo
vocábulo - słowo | wyraz
você - pan | pani | ty | wy
vocês - wy
vodca - wódka
vogal - samogłoska
volante - kierownica
voleibol - siatkówka
volfrâmio - wolfram
volta - zwrot | skręt
voltagem - napięcie elektryczne
volto - voltar
vomitar - wymiotować
vontade - wola
vôo - lot
vos - wy | wam | was
vós - wy
vosso - wasz | pański | pana | pani
votação - głosowanie
votar - głosować | ślubować | przysięgać
vovó - babcia
voz - głos
vulcânico - wulkaniczny
vulcão - wulkan
vulgar - pospolity | prosty | gminny | wulgarny | prostacki | powszedni | banalny | trywialny
vulgarizar - wulgaryzować
vulnerável - wrażliwy | podatny | nieodporny | który może być skrzywdzony
Wikcionário - Wikisłownik
Wikipédia - Wikipedia
xadrez - szachy | areszt | więzienie
xaile - szal
xamã - szaman | szamanka
xamane - szaman | xamã | szamanka
xamanismo - szamanizm
xarope - syrop
xenão - ksenon
xenofobia - ksenofobia
xénon - ksenon
xenónio - ksenon
xerife - szeryf
xícara - filiżanka | kubek
xilitol - ksylitol
xixi - siki | mocz | uryna | oddawanie moczu | sikanie | siusianie
yttérbio - iterb
Zâmbia - Zambia
zanga - niechęć | złość | kłótnia | gniew
zangado - zły | rozgniewany
zangão - truteń
zaragata - bałagan | bajzel
zebra - zebra | głupek | osoba mało inteligentna | zebrar
zé-povinho - prostaczek
zero - zero | 0
ziguezague - zygzag
Zimbabué - Zimbabwe
zinco - cynk | cynkowy
zircónio - cyrkon
zircônio - cyrkon
zodíaco - zodiak
zombar - kpić | szydzić | drwić
zona - zonar
zona erógena - strefa erogenna
zoo- - zoo-
zôo - zoo
zoófilo - lubiący zwierzęta | miłośnik zwierząt
zoofobia - zoofobia
zoolatria - zoolatria
zoologia - zoologia
zoológico - zoologiczny | ogród zoologiczny | to samo co jardim zoológico
zoologista - zoolog | zoólogo | kobieta zoolog
zoólogo - zoolog
zoomorfismo - zoomorfizm
zooplâncton - zooplankton
zoroastrismo - zaratusztrianizm
zumbido - brzęk | brzęczenie | dzwonienie
zunzum - szmer | pogłoska | plotka
Zurique - Zurych
