a - do, i, ale
abajur - klosz
abandon - opuszczenie, zaniedbanie
abate - opat
abces - ropień, wrzód
abdica - abdykować
Abhazia - Abchazja
abiogeneză - abiogeneza
absent - nieobecny
absolutism - absolutyzm
absorbi - absorbować
abstract - abstrakcyjny
abundență - obfitość
ac - igła
academic - akademicki
accelerație - przyspieszenie
accesibilitate - dostępność
accidental - przypadkowy
acest - ten
achiu - seler
acolo - tam
acoperiș - dach
acord - traktat, układ, porozumienie
acru - kwaśny
actiniu - aktyn
actor - aktor
actriță - aktorka
acum - teraz, obecnie
acumula - gromadzić
acumulator - akumulator
acuza - oskarżać
acvatic - wodny
acvilă - orzeł
adăpost - schronienie
adăsta - czekać
adăuga - dodać
Adelaida - Adelajda (imię)
adevăr - prawda
adevărat - prawdziwy
adjectiv - przymiotnik
administrație - administracja
adora - uwielbiać, czcić
adresă - adres
aduce - przyprowadzić, przynieść
adult - osoba dorosła, dorosły
aduna - zebrać
adunare - dodawanie
adverb - przysłówek
adverbial - przysłówkowy
adversar - adwersarz, przeciwnik
aeronautic - aeronautyczny, lotniczy
aeronautică - aeronautyka, lotnictwo, aeronautic
aeroport - lotnisko
afară - na zewnątrz
Afganistan - Afganistan
afină - borówka amerykańska
Africa - Afryka
Africa de Sud - Republika Południowej Afryki
afrikaans - język afrykanerski
agale - powoli
agentă - agentka
agenție - agencja
agnosticism - agnostycyzm
agresor - agresor, napastnik
agricultură - rolnictwo
aici - tutaj
aisberg - góra lodowa
ajuta - pomagać
ajutor - pomoc
alanină - alanina
albanez - albański
albaneză - albański, Albanka, albanez
Albania - Albania
albastru - niebieski, błękitny
albeață - biel
albină - pszczoła
alchimic - alchemiczny
alege - wybrać
alegere - wybory, elekcja
alergie - alergia
alfabet - alfabet
algebră - algebra
algebric - algebraiczny
aliat - sojusznik
aligator - aligator
altminteri - inaczej, w przeciwnym razie
aluat - ciasto
aluminiu - glin
amărăciune - gorycz
ambasadă - ambasada
ambasador - ambasador
ambiție - ambicja
amenința - grozić
amenințare - groźba, zagrożenie
America - Ameryka
America de Nord - Ameryka Północna
America de Sud - Ameryka Południowa
american - Amerykanin, amerykański
americiu - ameryk
amestec - mieszanka
amețeală - zawroty głowy
amiază - południe
amic - przyjaciel
amică - przyjaciel
amor - miłość
amu - teraz
an - rok
anal - analny
analogie - analogia
anarhie - anarchia
Anatolia - Anatolia
anatomie - anatomia
Andaluzia - Andaluzja
Andorra - Andora
anghilă - węgorz
Anglia - Anglia
animal - zwierzę
animalitate - zwierzęcość
anin - olcha
aniversare - rocznica, urodziny
Antarctica - Antarktyka
anterior - poprzedni
antic - stary
antologie - antologia
antropologie - antropologia
Anul Nou - Nowy Rok
apă - woda
apă minerală - woda mineralna
apăra - bronić
apărător - obrońca
apărea - pojawić się
apatie - apatia
apocalips - apokalipsa
apostol - apostoł
apostrof - apostrof
aprilie - kwiecień
ara - orać
Arabia Saudită - Arabia Saudyjska
Aragon - Aragonia
aramă - miedź
arăta - pokazać, wykazać, wskazać, okazać się
arătos - przystojny
arbaletă - kusza
arbore - drzewo
arbust - krzak
arcaș - łucznik
argint - srebro
argintiu - srebrny
argon - argon
arhitect - architekt
arhitectură - architektura
arin - olcha
aritmetică - arytmetyka
armă de foc - broń palna
armată - armia
Armenia - Armenia
arogant - arogancki
aroganță - arogancja
aromânesc - arumuński
arsen - arsen
artă - sztuka
arteră - arteria
articol - artykuł
artist - artysta
artistic - artystyczny
artroză - artretyzm
arunca - rzucić
asară - zeszłej nocy
asculta - słuchać
aseară - zeszłej nocy
asemenea - podobny, taki
asexualitate - aseksualność
Asia - Azja
asociație - stowarzyszenie
aspirină - aspiryna
astatiniu - astat
astăzi - dziś, dzisiaj
aștepta - czekać, oczekiwać
asteroid - asteroida
astmă - astma
astronom - astronom
atac - atak
atacant - napastnik
ateism - ateizm
ateist - ateistyczny
atletică ușoară - lekkoatletyka
atmosferă - atmosfera
atom - atom
atrage - przyciągać
atringe - dotknąć, sięgnąć
atrocitate - okrucieństwo
atrofie - atrofia
august - sierpień
aur - złoto
auriu - złoty
auroră - świt
Australia - Australia
Austria - Austria
austriacă - Austriaczka
Austro-Ungaria - Austro-Węgry
autobuz - autobus
autogară - dworzec autobusowy
automobil - samochód
automobilistic - automobilowy, samochodowy
autor - autor, pisarz
autostradă - autostrada
auzi - słyszeć
avalanșă - lawina
avantajos - korzystny
avea - mieć
avion - samolot
Avraam - Abraham
azer - Azer, Azerbejdżanin, azerski, azerbejdżański
Azerbaidjan - Azerbejdżan
azi noapte - zeszłej nocy
azot - azot
babă - staruszka
babuin - pawian
bac - prom
bacă - jagoda
Bahrain - Bahrajn
băiat - chłopak
bălai - blond
balaur - smok, potwór
balenă - wieloryb
băltoacă - kałuża
ban - pieniądz, ban
banană - banan
bancă - bank, ławka
bancnotă - banknot
bandaj - bandaż
baraj - tama
Barbados - Barbados
bărbat - mężczyzna
bărbătesc - męski
barcă - łódź
bariu - bar
barză - bocian
baschet - koszykówka
basma - chusteczka do nosa
bată - pas
bătălie - bitwa
bate fierul cât e cald - kuj żelazo, póki gorące
batistă - chusteczka do nosa
bătrân - stary
bătrânețe - starość
bâzdâc - kaprys
bea - pić
bec - żarówka
Belgia - Belgia
Belize - Belize
belșug - obfitość
bengalez - bengalski
Benin - Benin
benzină - benzyna
bere - piwo
beriliu - beryl
berkeliu - berkel
bibliotecă - biblioteka
bicicletă - rower
bilă - żółć
binecuvânta - błogosławić, chwalić
biochimie - biochemia
biogeneză - biogeneza
biograf - biograf
biografic - biograficzny
biolog - biolog
biologic - biologiczny
biologie - biologia
birou - biuro
biserică - kościół, cerkiew, zbór
bisexualitate - biseksualizm
bismut - bizmut
blană - futro
blond - blond
boar - pasterz
boboc - pąk
bogat - bogaty
bohriu - bohr
boia - farba
Bolivia - Boliwia
bolnav - chory
bor - bor
Bosnia și Herțegovina - Bośnia i Hercegowina
Botswana - Botswana
bou - wół
box - boks
brad - jodła
brânză - ser
brav - odważny
Brazilia - Brazylia
brici - brzytwa
britanic - brytyjski
broască râioasă - ropucha
broască țestoasă - żółw
brom - brom
bronz - brąz
brutal - brutalny
bucătărie - kuchnia
București: - Bukareszt
bucuros - zadowolony
Budapesta - Budapeszt
budism - buddyzm
bufnă - sowa
bufniță - sowa
bujor - piwonia
bulgar - Bułgar
bulgară - bułgarski, Bułgarka, bulgar
Bulgaria - Bułgaria
bulgur - bulgur
bună dimineața - dzień dobry
bună seara - dobry wieczór
bună ziua - dzień dobry
bunic - dziadek
bunică - babcia
Burgogne - Burgundia
Burkina Faso - Burkina Faso
burtă - brzuch
buruiană - chwast
Burundi - Burundi
că - że, iż
cacao - kakao
cădea - upaść, spaść
cadmiu - kadm
cadou - prezent
cafea - kawa
cafeă - kawa
câine - pies (rodzaj zwierzęcia), pies (samiec psa)
Câinele Mare - Wielki Pies
caisă - morela
cal - koń
călărie - jeździectwo, jazda konna
călătorie - podróż
calculator - komputer
caldarâm - chodnik
căldare - wiadro
căldură - ciepło
cale - aleja
Calea Lactee - Droga Mleczna
calendar - kalendarz, almanach
californiu - kaliforn
cămașă - koszula
Cambodgia - Kambodża
cameră de zi - pokój gościnny, duży pokój
cămilă - wielbłąd
cămin - komin
câmp - pole
Canada - Kanada
cancer - rak
cânepă - konopie
cangur - kangur
cânta - śpiewać
cântec - piosenka, pieśń
cap - głowa
capabil - zdolny
capabilitate - zdolność
Capernaum - Kafarnaum
capitală - stolica
căpșună - truskawka
Capul Verde - Republika Zielonego Przylądka
cărămidă - cegła
carbon - węgiel
cărbune - węgiel
cârd - stado, chmara
cardamom - kardamon
cârmă - ster
carmin - szkarłatny, bordo
cârnat - kiełbasa
carte - książka, karta
cartof - ziemniak
casă - dom
căsca - ziewać
castra - kastrować
castravete - ogórek
cât - ile
cățea - suka, samica psa, dziwka
categorie - kategoria
cățel - szczeniak, szczenię
catifea - aksamit
catran - smoła
căuta - szukać
caută - wyszukiwanie
cauza - powodować
caz genitiv - dopełniacz
ce - co
ceai - herbata
ceapă - cebula
ceață - mgła
Cehia - Czechy
celar - spiżarnia
cel puțin - przynajmniej
central - centralny
centură - pas
cenzura - cenzurować, cenzură
cer - niebo, firmament, niebiosa, raj, Bóg, opatrzność
cerb - jeleń
cerc - kółko
cercel - kolczyk
cerceta - szukać
cercetare - szukanie, poszukiwanie
cerință - potrzeba
ceriu - cer
cerși - błagać
certificat - certyfikat
cesiu - cez
cetate - cytadela, forteca
ceva - coś
CFR - Koleje Rumuńskie
cheie - klucz
chel - łysy
chiloți - bielizna
chimic - chemiczny
China - Chiny
chirurg - chirurg
chitară - gitara
chitosan - chitozan
cicatrice - blizna
ciclism - kolarstwo
cifră - cyfra, liczba
ciment - cement
cimitir - cmentarz
cincea - piąty
cinci - pięć, 5
cincilea - piąty
cincisprezece - piętnaście
cincisprezecea - piętnasty
cincisprezecelea - piętnasty
cincizeci - pięćdziesiąt, 50
cinematic - kinematograficzny, filmowy, kinowy
cingătoare - pas
cinzeci - pięćdziesiąt
cioacă - kawka
cioban - pasterz
cioc - dziób
ciocănitoare - dzięcioł
ciocolată - czekolada
Cipru - Cypr
Ciprul de Nord - Cypr Północny
circuit - obwód
circula - krążyć
circumcide - obrzezać
circumcizie - obrzezanie
circumstanță - okoliczność
cisternă - cysterna
citi - czytać
citologie - cytologia
ciudat - cudaczny, dziwny
civilizație - cywilizacja
clădi - budować
clădire - budynek, budowanie
clei - klej
clinică - klinika
clipă - chwila, moment
clopot - dzwon
clor - chlor
coasă - kosa
coase - zszyć
coastă - żebro
cobalt - kobalt
cocină - chlew
cocor - żuraw
cocoș - kogut
coiot - kojot
colină - pagórek
coloană - kolumna
colonel - pułkownik
colonie - kolonia
colorat - kolorowy
Columb - Kolumb (odkrywca)
comanda - rozkazywać
comandă - rozkaz, polecenie
combatant - bojownik, wojownik, bojowniczy, walczący
combate - walczyć
combativ - bojowy, wojowniczy
combustibil - paliwo
cometă - kometa
comoară - skarb
compara - porównać
comparare - porównanie
comparație - porównanie
compasiune - współczucie, miłosierdzie, litość
complet - kompletny, całkowicie
complex - złożony
complexitate - złożoność
compozitor - kompozytor
comunicație - komunikacja
comunism - komunizm
comunitate - społeczność
concavitate - wklęsłość
conflict - konflikt, niezgoda, spór
conform - według
coniac - koniak
consoană - spółgłoska
constelație - gwiazdozbiór, konstelacja
constituție - konstytucja
construi - konstruować
continent - kontynent
controla - kontrolować, sprawdzać, przeprowadzać inspekcję, weryfikować, testować
convențional - konwencjonalny
coopera - współpracować
copac - drzewo
Copenhaga - Kopenhaga
copia - kopiować
copil - dziecko, wilk, hak
corb - kruk
Coreea - Korea
Coreea de Nord - Korea Północna
Coreea de Sud - Korea Południowa
corn - róg
Coroana Australă - Korona Południowa
coroziune - korozja
corp - ciało
cort - namiot
coșmar - koszmar
cosmic - kosmiczny
costa - kosztować
Costa Rica - Kostaryka
coțofană - sroka
Crăciun - Boże Narodzenie
crâng - zagajnik, zarośla, gąszcz
craniu - czaszka
crăpa - rozbić, rozłamać, rozpołowić, rozłupać, pęknąć, rozpęknąć się, rozerwać się
cravată - krawat
crea - tworzyć
creangă - gałąź
creativ - kreatywny
creativitate - kreatywność
creatură - stworzenie
crede - wierzyć
credibil - wiarygodny
creier - mózg, inteligencja
creion - ołówek
creștinism - chrześcijaństwo
crevetă - krewetka
crimă - morderstwo
crin - lilia
cripton - krypton
crizantemă - chryzantema
croată - Chorwatka, chorwacki, chorwacka, f  croat
Croația - Chorwacja
croitor - krawiec
crom - chrom
cromozom - chromosom
cruciadă - krucjata
cu - z, z (razem)
cub - sześcian, kostka
cubism - kubizm
cucerire - podbój
cugeta - myśleć
cuib - gniazdo
culoare - barwa, kolor
cultură - kultura
cumnat - szwagier
cumnată - szwagierka
cumpăra - kupować
cumpărător - nabywca
cuplu - para
cuprins - zawartość
cupru - miedź
curajos - odważny
curat - czysty
curăța - czyścić
curbă - zakręt
curcan - indyk
curcubeu - tęcza
curge - płynąć (o płynie lub z prądem)
curiu - kiur
curte - sąd
curvă - kurwa
cuțit - nóż
cuvânt - słowo, wyraz
da - dawać
dacă - język dacki
daltă - dłuto
Danemarca - Dania
dans - taniec
dansa - tańczyć
dânsa - ona
dânsul - on
dar - prezent, dar, podarunek, wtedy, ale
darmstadtiu - darmsztadt
dativ - celownik
deal - pagórek
de ce - dlaczego
decembrie - grudzień
deceniu - dekada
decide - decydować
declarație - deklaracja
declinare - deklinacja
de exemplu - na przykład
definire - definicja
definiție - definicja
deget - palec
deism - deizm
delicat - delikatny
delicios - pyszny
democratic - demokratyczny
democrație - demokracja
demografie - demografia
densitate - gęstość
deschide - otworzyć
deschis - jasny
descoperi - odkryć
descoperire - odkrycie
descrie - opisać
descripție - opis
desculț - bosy
despre - o
detaliu - szczegół
deveni - stać się
dezgust - obrzydzenie
dialect - dialekt
diamant - diament
dictator - dyktator
dictatură - dyktatura
dicționar - słownik
diferență - różnica
dificil - trudny
dificultate - trudność
digestie - trawienie
dimensiune - wymiar
dimineață - ranek
din - z, na, w
din cauză că - ponieważ
din nou - znowu, znów
dinte - ząb
dintre - wśród
dirijor - dyrygent
discret - dyskretny
discuție - dyskusja
dispărea - zniknąć
disprosiu - dysproz
distanță - odległość
distruge - zniszczyć
diversitate - różnorodność, zróżnicowanie
divorț - rozwód
divorța - rozwodzić się
doi - dwa
doișpelea - dwunasty
doisprezece - dwanaście
doisprezecelea - dwunasty
dolmen - dolmen
domestic - domowy
dor - tęsknota
dori - pragnąć, życzyć
dormi - spać
dormitor - sypialnia
două - dwa
douăsprezece - dwanaście
douăzecea - dwudziesty
douăzeci - dwadzieścia, 20
douăzecilea - dwudziesty
dovedi - udowodnić
dovleac - dynia
drac - diabeł
dragoste - miłość
dramatic - dramatyczny
drapel - flaga
drept - prawo
drojdie - drożdże
drum - droga
dubniu - dubn
duce - nieść, prowadzić, wieść
dulce - słodki
duminică - niedziela
dumneavoastră - wasz, należeć do Państwa
dumnezeu - Bóg
Dumnezeu - Bóg
după - po
durată - czas trwania
dureros - bolesny
duș - prysznic
dușman - nieprzyjaciel, wróg
dușmăni - nienawidzić
ea - ona
echinocțiu - równonoc
echipă - zespół, drużyna
economie - gospodarka
ecosistem - ekosystem
ecran - ekran
educa - edukować
educație - edukacja
efort - wysiłek
Egipt - Egipt
ei - wy
einsteiniu - einstein
el - on
electromagnetic - elektromagnetyczny
electron - elektron
elefant - słoń
elimina - eliminować, likwidować
Elveția - Szwajcaria
embrion - embrion, zarodek
Emilia - Emilia
emisferă - półkula
emoție - emocja, uczucie
emoțional - emocjonalny
empiric - empiryczny, doświadczalny
enciclopedie - encyklopedia
energie - energia
engleză - język angielski
enigmă - zagadka
enigmatic - enigmatyczny
episcop - biskup
epocă - epoka, okres
erbiu - erb
Eritrea - Erytrea
erotic - erotyczny
erou - bohater
escalator - schody ruchome
Esop - Ezop
Esperanto - esperanto
est - wschód
estetică - estetyka
Estonia - Estonia
eternitate - wieczność
eterogen - niejednorodny
etimologie - etymologia
eu - ja
Europa - Europa
Europa Centrală - Europa Środkowa
europiu - europ
evacuare - ewakuacja
evanghelie - ewangelia
eveniment - wydarzenie, ewenement
evlavios - pobożny
evoluție - ewolucja
exagera - przesadzać
exagerație - przesada
excepție - wyjątek
excepțional - wyjątkowy
exemplu - przykład
exista - istnieć
exotic - egzotyczny
expedia - wysyłać
explica - wyjaśniać
explicație - wyjaśnienie
exportator - eksporter
extern - zewnętrzny
face - robić, wykonywać
fagure - plaster
faimos - słynny
făină - mąka
falcă - szczęka
faleză - klif
falus - penis
familie - rodzina
fân - siano
fanatism - fanatyzm
fără - bez
farmacologie - farmakologia
fată - dziewczyna, córka
față - twarz, oblicze
februarie - luty
federație - federacja
femeie - kobieta
fenix - feniks
fereastră - okno
fericit - szczęśliwy
ferigă - paproć
fermă - farma
fermecător - uroczy
fesă - pośladek
fi - być, istnieć
fiară - zwierzę
fibră - włókno
fier - żelazo
fierar - kowal
fiică - córka
Fiji - Fidżi
filantropic - dobroczynny
filantropie - filantropia
film - film
finisa - skończyć
Finlanda - Finlandia
firesc - naturalny
fiu - syn
fiu vitreg - pasierb
fizic - fizyczny
fizică - fizyka, fizic
fizician - fizyk
fiziolog - fizjolog
fiziologie - fizjologia
flacără - płomień
flaut - flet
flexibilitate - elastyczność
floare - kwiat
fluiera - gwizdać
fluor - fluor
fluture - motyl
fluviu - rzeka
foame - głód
foarfecă - nożyczki
foarte - bardzo
foc - ogień
folosi - używać
folosire - używanie
folositor - przydatny
fonetic - fonetyczny
forja - wykuwać
forță - siła, moc
fortăreață - forteca
fosfor - fosfor
fost - były, dawny
fotbal - piłka nożna
fotbalist - piłkarz
foto - zdjęcie
fotograf - fotograf
fotoliu - fotel
frână - hamulec
franciu - frans
Franța - Francja
franțuzesc - francuski
frate - brat
fraternitate - braterstwo
frățesc - braterski
frecvent - częsty
frecvență - częstotliwość
frică - strach
fricțiune - tarcie
frontieră - granica
fruct - owoc
frumos - ładny, piękny, śliczny, piękno (kategoria estetyczna)
fugi - uciekać
fum - dym
fumar - komin
funcție - funkcja
funcționalitate - funkcjonalność
fundamental - podstawowy, zasadniczy
funie - lina, sznur
fura - kraść
furculingură - łyżkowidelec
furculiță - widelec
furios - wściekły
furnică - mrówka
furnicătură - swędzenie
furt - kradzież, rabunek
fustă - spódnica
Gabon - Gabon
gâdila - łaskotać
gadoliniu - gadolin
găină - kura
galben - żółty
Galileea - Galilea (kraina)
galiu - gal
gândac - żuk, karaluch
gândi - myśleć
gară - stacja, dworzec
garaj - garaż
gard - płot
Gargantua - Gargantua
gâscă - gęś
găsi - znaleźć
gât - gardło, szyja
găti - gotować
gâtlej - gardło
gaură - dziura
gazelă - gazela
gazon - trawnik
general - generał
genetic - genetyczny
genitiv - dopełniacz
genunchi - kolano
geografie - geografia
geometrie - geometria
George - Jerzy
ger - mróz
Germania - Niemcy
germaniu - german
gest - gest
gheară - pazur
gheață - lód
ghețar - lodowiec
ghionoaie - dzięcioł
gimnastică - gimnastyka
ginere - zięć
girafă - żyrafa
gladiolă - mieczyk
glandă - gruczoł
glonț - pocisk
glonte - pocisk
glumi - żartować
gnosticism - gnostycyzm
Godzilla - Godzilla
gogoașă - pączek
golf - zatoka
goli - opróżniać
gospodină - gospodyni domowa
grabă - pośpiech
grăbi - przyspieszać, pospieszać
grădină - ogród
grafit - grafit
gram - gram
gramatică - gramatyka
grânar - spichlerz
grapă - brona
gravitațional - grawitacyjny
grecesc - grecki
Grecia - Grecja
greșeală - pomyłka
greu - ciężki, trudny
Guatemala - Gwatemala
gură - buzia, usta
gustos - smaczny
gutuie - pigwa
guvern - rząd
guvernamental - rządowy
hafniu - hafn
halucinație - halucynacja
hamac - hamak
handbal - piłka ręczna
haos - chaos
haotic - chaotyczny
hârciog - chomik
harpă - harfa
hartă - mapa
hassiu - has
helio- - helio-
heliu - hel
heterosexualitate - heteroseksualizm
hidrogen - wodór
hidrologie - hydrologia
hidromel - miód pitny
histologie - histologia
hochei - hokej
holmiu - holm
homar - homar
homosexualitate - homoseksualność, homoseksualizm
hormon - hormon
Horus - Horus
hoț - złodziej
hotărî - zdecydować
hotel - hotel
hoție - rabunek
hrană - jedzenie
hrăni - karmić
Hristos - Chrystus
Iacob - Jakub
Iacov - Jakub
iad - piekło
ianuarie - styczeń
iapă - klucz
iarbă - trawa
iarnă - zima
iederă - bluszcz
ieftin - tani
iepure - zając, królik
ierarhie - hierarchia
ieri - wczoraj
ierta - wybaczać
ieșire - wyjście
iluminație - oświetlenie
iluzie - iluzja
imagina - wyobrazić sobie
imaginație - wyobraźnia
imagine - wizerunek, obraz
imaturitate - niedojrzałość
îmbrăcăminte - odzież
îmbrățișare - uścisk, objęcie
imediat - natychmiast
imperialism - imperializm
important - ważny, doniosły
imposibil - niemożliwy
imposibilitate - niemożliwość
împreună - razem
împrumut - pożyczka
in - len
în - w
înalt - wysoki
înălțime - wysokość
inamic - wróg
incendiu - pożar
începe - zacząć
încheietura mâinii - nadgarstek
închide - zamknąć
închiria - wynająć
închis - zamknięty
închisoare - więzienie
include - zawierać
inclus - załączony, włączony
înconjur - objazd
încorona - koronować
încredere - wiara, ufność
încuia - zamknąć na klucz
independență - niezależność, niepodległość
indicator - znak, wskaźnik
indicator rutier - znak drogowy
indiscret - niedyskretny
indispensabil - nieodzowny
indiu - ind
Indonezia - Indonezja
indoneziană - indonezyjski, Indonezyjka, indonezian
îndrăzni - ośmielić się, odważyć się
inexplicabil - niewytłumaczalny
infinitate - nieskończoność
inflație - inflacja
influență - wpływ
informație - informacja
înger - anioł
înghețată - lody (deser)
inginer - inżynier
inginerie - inżynieria
inimă - serce
inimiciție - wrogość
înmulțire - mnożenie
înot - pływanie
înota - pływać
însărcinată - w ciąży
insectă - owad
instabilitate - niestabilność
instrument - instrument
insulă - wyspa
întâietate - priorytet
întâmpla - zdarzyć się, wydarzyć się
înțelege - rozumieć
inteligent - inteligentny
intensitate - intensywność
intenționa - zamierzać
interacțiune - interakcja
interesant - interesujący
intern - wewnętrzny
internațional - międzynarodowy
interzice - zabronić
întotdeauna - zawsze
intra - wejść
între - między
întreba - pytać
întrebare - pytanie
întrebuința - używać
întrucât - ponieważ
învârti - kręcić, obracać, kręcić się, obracać się
invazie - inwazja
inventa - wynaleźć
înverzi - pomalować na zielono, zazielenić, zazielenić się
investitor - inwestor
invidie - zazdrość
invincibil - niezwyciężony
invita - zaprosić
iod - jod
Iordania - Jordania
ipocrizie - hipokryzja
Irak - Irak
Iran - Iran
iridiu - iryd
ironie - ironia
iscăli - podpisać
Israel - Izrael
Isus - Jezus
Italia - Włochy
iubire - miłość
iubitor - miłośnik
iudaism - judaizm
iulie - lipiec
iunie - czerwiec
izvor - źródło (wody)
jaguar - jaguar
jeg - brud
jertfă - ofiara
joc - gra
joi - czwartek
jongler - żongler
jos - dolny
juca - grać
jucărie - zabawka
jug - jarzmo
jumătate - połowa
juncă - jałówka
kaliu - potas
Kazahstan - Kazachstan
Kenya - Kenia
Kirgizstan - Kirgistan
koala - koala
Kuweit - Kuwejt
la - u
lac - jezioro
lacrimă - łza
lăcustă - szarańcza, konik polny
lalea - tulipan
lămâie - cytryna
lână - wełna
lance - włócznia
lantan - lantan
laolaltă - razem
lapte - mleko
lăptos - mleczny
la revedere - do widzenia
larg - szeroki
lăsa - puścić, pozwolić
latin - łaciński
lăuda - chwalić, wysławiać
lawrențiu - lorens
lebădă - łabędź
lecție - lekcja
legatură - link, hiperłącze
legendar - legendarny
legiune - legion
legumă - warzywo
lemn - drewno
leoaică - lwica
lesbiană - lesbijka
leșina - zemdleć
leton - łotewski
Letonia - Łotwa
leu - lew, lej
Liban - Liban
libertate - wolność, swoboda
librar - księgarz
librărie - księgarnia
limbă - język
lindic - łechtaczka
lingură - łyżka
linguriță - łyżeczka do herbaty
lingvistic - językowy
lingvistică - lingwistyka
linte - soczewica
lipici - klej
lipitoare - pijawka
literar - literacki
literat - literat, pisarz
literatură - literatura
litiu - lit
Lituania - Litwa
liturgic - liturgiczny
loc - miejsce
locomotivă - lokomotywa
locotenent - porucznik
locțiitor - porucznik
locuitor - mieszkaniec
logaritm - logarytm
Londra - Londyn
lopată - łopata
lor - ich, im
loterie - loteria
lotus - lotus
lovi - uderzać
lubeniță - arbuz
lucra - pracować
lucrare - praca
lucru - rzecz, sprawa
lumânare - świeca, świeczka, dziewanna kutnerowata
lume - świat
lumină - światło
lună - księżyc, miesiąc
lunar - księżycowy, miesięczny
lung - długi
lungime - długość, czas trwania
luni - poniedziałek
lup - wilk
lutețiu - lutet
mac - mak
Macedonia - Macedonia
măcelar - rzeźnik
macromoleculă - makromolekuła, makrocząsteczka
macrou - makrela
măgar - osioł
magazin - magazyn, czasopismo, skleo
maghiar - węgierski, Węgier
maghiară - Węgierka, węgierski, f  maghiar
magneziu - magnez
măgură - pagórek
mai - maj
maică - matka
maimuță - małpa
mâine - jutro
maioneză - majonez
majoritate - większość
mamă - matka
mamă vitregă - macocha
mamifer - ssak
mamut - mamut
mână - ręka
mânca - jeść
mâncare - jedzenie
mânecă - rękaw
mangan - mangan
mănușă - rękawiczka
măr - jabłko
mărar - koper
mare - wielki, morze
Marea Britanie - Wielka Brytania
Marea Mediterană - Morze Śródziemne
Marea Neagră - Morze Czarne
mărgăritar - perła
marijuana - marihuana
marinar - żeglarz
marți - wtorek
martie - marzec
martir - męczennik
masă - stół
mașină - samochód
măslină - oliwka
mașteră - macocha
mâță - kot
mătase - jedwab
matematic - matematyczny
matematică - matematyka
matematician - matematyk
matur - dojrzały
mătura - zamiatać
mătură - miotła
mătușă - ciotka
Mauritania - Mauretania
mecanic - mechaniczny
medical - leczniczy, medyczny
medicină - medycyna
mediocru - mierny
meduză - meduza
meitneriu - meitner
melc - ślimak
mendeleeviu - mendelew
mentă - mięta
mențiune - wzmianka
Mercur - Merkury
metal - metal
meteorit - meteoryt
Mexic - Meksyk
mic - mały
microbiologie - mikrobiologia
microorganism - mikroorganizm
micuț - maleńki
midie - małż
miercuri - środa
mijloc - środek
milimetru - milimetr
milion - milion
militar - żołnierz
mineralog - mineralog
mineralogie - mineralogia
ministru - minister
minoritate - mniejszość
miracol - cud
mire - pan młody
mirosi - pachnieć
mișcare - ruch
misterios - tajemniczy
moale - miękki, słaby
moarte - śmierć
model - szablon
moft - kaprys, drobnostka
moldovenească - mołdawska, Mołdawianka, język mołdawski
molibden - molibden
molie - ćma
monarhie - monarchia
mondial - światowy
monedă - moneta, waluta, środek płatniczy
monogamie - monogamia
monstru - potwór
moped - motorower
morcov - marchew
morfologie - morfologia
mormânt - grób
mormoloc - kijanka
mort - martwy
moșteni - dziedziczyć
motocicletă - motocykl
mugur - pąk
muiere - kobieta
mulge - doić
multicultural - wielokulturowy
mulțime - tłum
mulțumesc - dziękuję
mumă - matka, królowa pszczół
muncă - praca
munci - pracować
munte - góra
Muntenegru - Czarnogóra
muntos - górzysty
murdar - brudny
muri - umrzeć
musafir - gość
mușca - gryźć
muscă - mucha
mușchi - mięsień, mech
mustață - wąsy
mutație - mutacja
muzeu - muzeum
muzică - muzyka
muzical - muzyczny
muzician - muzyk
nădejde - nadzieja
nadir - nadir
Nairobi - Nairobi
nămol - błoto
nară - nozdrze
narcotic - narkotyczny, narkotyk
nas - nos
naș - ojciec chrzestny
nașă - matka chrzestna, położna
născut - urodzony
natație - pływanie
Națiunile Unite - Organizacja Narodów Zjednoczonych
natriu - sód
natură - natura
naturalitate - naturalność
navă - statek
navigare - nawigacja
neadecvat - nieadekwatny
neașteptat - nieoczekiwany
necesar - potrzebny
necesitate - potrzeba
necinstit - nieuczciwy
necunoscut - nieznany
negru - czarny
nemțesc - niemiecki
neodim - neodym
neologism - neologizm
neon - neon
Nepal - Nepal
nepot - bratanek
nepotism - nepotyzm
neprietenos - nieprzyjazny
neptuniu - neptun
nereal - nierealny
neuitabil - niezapomniany
nevăstuică - łasica
nicăieri - nigdzie
nichel - nikiel
nicicând - nigdy
nicidecum - w żadnym wypadku
niciodată - nigdy
nimeni - nikt
ninge - śnieżyć
niobiu - niob
nisip - piasek
noapte - noc
noapte bună - dobranoc
nobeliu - nobel
nobil - szlachetny, arystokrata
nocturn - nocny
noi - my
noiembrie - listopad
nominativ - mianownik
nor - chmura, obłok
noră - synowa
Norbert - Norbert
nord - północ, północny (tylko w złożeniach)
noroc - szczęście, szczęśliwy los
norocos - szczęśliwy, mający szczęście
noroi - błoto
Norvegia - Norwegia
norvegian - norweski, Norweg
norvegiană - norweski, Norweżka, norvegian
nou - nowy
noua - dziewiąty
nouă - dziewięć
nouălea - dziewiąty
nouăsprezece - dziewiętnaście
nouăsprezecea - dziewiętnasty
nouăsprezecelea - dziewiętnasty
nouăzecea - dziewięćdziesiąty
nouăzeci - dziewięćdziesiąt
nouăzecilea - dziewięćdziesiąty
nu - nie
nud - nagi
numai - tylko
număr - numer, liczba, cyfra
număr de telefon - numer telefonu
nume - imię, nazwa, nazwisko
numi - nazywać, nazywać się
nuntă - ślub
oaie - owca
oaspete - gość
obez - otyły
obicei - zwyczaj, obyczaj
obosit - zmęczony
obrăznicie - bezczelność
obscen - obsceniczny
obsedare - obsesja
observa - obserwować
observator - obserwator
obsesie - obsesja
obține - uzyskać
ocean - ocean
Oceania - Oceania
Oceanul Arctic - Ocean Arktyczny
ochelari - okulary
ochi - oko
o clipă - jeszcze chwilę, za moment
octombrie - październik
oculistic - okulistyczny, oftalmologiczny
oficial - urzędowy, oficjalny
ofta - wzdychać
oglindă - lustro
olar - garncarz
olog - kulawy
Olympia - Olimpia (miasto w Grecji)
om - mężczyzna, człowiek
om de afaceri - przedsiębiorca
omenesc - ludzki
omenos - ludzki
omogen - jednolity
omor - morderstwo
omorî - zabić
operă - dzieło, utwór, praca, opera
opiu - opium
opt - osiem
opta - ósmy
opțiune - opcja
optsprezece - osiemnaście
optsprezecea - osiemnasty
optsprezecelea - osiemnasty
optulea - ósmy
optzeci - osiemdziesiąt
oră - godzina
Oradea - Oradea - miasto w Rumunii
oranj - pomarańczowy
oraș - miasto
orchestră - orkiestra
orez - ryż
organism - organizm
Organizația Națiunilor Unite - Organizacja Narodów Zjednoczonych
organizație - organizacja
orgasm - orgazm
orgolios - dumny, zarozumiały
orhidee - orchidea
orientare - orientacja
orientare sexuală - orientacja seksualna
orz - jęczmień
os - kość
osmiu - osm
ostaș - żołnierz
Ostia - Ostia
oțel - stal
otrăvi - otruć
ovăz - owies
oxid - tlenek
oxigen - tlen
ozon - ozon
pa - na razie
păcat - grzech
pace - pokój
pact - pakt, układ
păcurar - pasterz
păduche - wesz
pădure - las
pagină - strona
păianjen - pająk
paie - słoma
pâine - chleb
paisprezece - czternaście
paisprezecea - czternasty
paisprezecelea - czternasty
paladiu - pallad
palat - pałac, podniebienie
pâlnie - lejek
pământ - ziemia (planeta), ziemia, ląd, kraj
Pământ - Ziemia
pană - pióro
pandeism - pandeizm
pansexualitate - panseksualizm
panteism - panteizm
pantof - but
papuc - kapeć
pară - gruszka, płomień
paradox - paradoks
parazit - pasożyt
parazitar - pasożytniczy
părea - wydawać się, wyglądać
parfum - perfumy
părinte - rodzic
parlament - parlament
parolă - hasło
particulă - cząstka
pașaport - paszport
pasăre - ptak
Pasărea Paradisului - Ptak Rajski
Paști - Wielkanoc
păstor - pasterz
păstrăv - pstrąg
pat - łóżko
patinaj - łyżwiarstwo
patologie - patologia
patra - czwarty
pătrat - kwadrat
patru - cztery, 4
patrulea - czwarty
patruzecea - czterdziesty
patruzeci - czterdzieści
patruzecilea - czterdziesty
păun - paw
pavăză - tarcza
pe curând - na razie
pedeapsă - kara
peninsulă - półwysep
Peninsula Arabică - Półwysep Arabski
pentru - do, za
pentru că - ponieważ
pepene verde - arbuz
percheziție - poszukiwanie, szukanie
pereche - para
periodic - okresowy, periodyczny
perlă - perła
pernă - poduszka
persoană - człowiek, osoba
personalitate - osobowość
pescar - rybak
pescui - łowić
pește - ryba
Peștele de Aur - Złota Ryba
peșteră - jaskinia
piaf - piaff
pian - pianino
piață - plac
piatră - kamień
picior - noga
pictor - malarz
pictură - malarstwo
pieptene - grzebień
pierde - stracić, zgubić
pilot - pilot
pin - sosna
piscină - basen
pisică - kot, kotka
pistrui - pieg
pitoresc - malowniczy
Pittsburgh - Pittsburgh (stolica Allegheny)
pivniță - piwnica
pizdă - pizda
plăcere - przyjemność
plajă - plaża
plămân - płuco
planetă - planeta
planetar - planetarny
planetarium - planetarium (obiekt)
plânge - płakać
planta - sadzić
plantă - roślina
plăti - płacić
pleoapă - powieka
plesni - rozłamać, rozłupać, uderzyć, łupnąć, smagnąć, pęknąć, rozpęknąć się, rozłamać się
pleșuv - łysy
plicticos - nudny
plictiseală - nuda
plin - pełny
ploaie - deszcz
plop - topola
ploșniță - pluskwa
plugări - orać
plumb - ołów
plută - tratwa
pluti - płynąć na powierzchni
Pluto - Pluton
plutoniu - pluton
poamă - owoc
pod - most, strych
poet - poeta
poetă - poetka
poetic - poetycki
poezie - poezja
poftă - apetyt
poftă bună - smacznego
policar - kciuk
poliță - półka
politeism - politeizm
politic - polityczny
politică - polityka
politician - polityk
poliție - policja
polițist - policjant
politologie - politologia
poloneză - język polski, polonez
Polonia - Polska
poloniu - polon
pom de Crăciun - choinka
Pomerania - Pomorze
popice - kręgle
popularitate - popularność
porc spinos - jeżozwierz
porni - uruchomić, zapuścić
pornografic - pornograficzny, obsceniczny
pornografie - pornografia
porție - porcja
portocală - pomarańcza
portocaliu - pomarańczowy
portret - portret
Portugalia - Portugalia
portugheză - portugalski, Portugalka
porumb - kukurydza, gołąb
porumbel - gołąb
porunci - rozkazać
posibil - możliwy, prawdopodobnie, możliwość
posibilitate - możliwość
poștă - poczta
potasiu - potas
potcoavă - podkowa
prag - próg
Praia - Praia
praseodim - prazeodym
prăvălie - sklep
predicat - orzeczenie
prefera - woleć
prefix - przedrostek
pregăti - przygotować
preistoric - prehistoryczny
preistorie - prehistoria
prenatal - prenatalny
preot - ksiądz
prepoziție - przyimek
președinte - prezydent
preț - cena
prețios - cenny
pretutindenea - wszędzie
pretutindeni - wszędzie
prevedea - przewidzieć
prezentare - prezentacja
prezervativ - prezerwatywa
prieten - przyjaciel
prietenie - przyjaźń
prietenos - przyjazny
primăvară - wiosna
primejdie - niebezpieczeństwo
primejdios - niebezpieczny
primi - dostać, otrzymać
prinț - książę
prințesă - księżniczka
prioritate - priorytet
privi - patrzeć
priză - gniazdko
prizonier - więzień
problemă - problem
productivitate - produktywność, wydajność
profesoară - profesor
profesor - profesor
profitabil - korzystny
promețiu - promet
promisiune - obietnica
pronume - zaimek
pronunție - wymowa
proporțional - proporcjonalny
propoziție - zdanie
prostituată - prostytutka
protactiniu - protaktyn
protector de persoane - ochroniarz
proteja - chronić
protesta - protestować
protocol - protokół
psihiatrie - psychiatria
psihologie - psychologia
Ptah - Ptah
public - publika, publiczny
publicitate - rozgłos, reklama
pugilat - boks
pulă - chuj
pulpană - spódnica
punct și virgulă - średnik
purgatoriu - czyściec
purice - pchła
puritate - czystość
puroi - ropa
purpură - purpurowy
purta - nieść, nosić (ubranie), zachowywać się
pușcă - karabin
pușcărie - więzienie
putea - móc
putere - moc
puternic - silny, mocny
răbdare - cierpliwość
răceală - przeziębienie
rădăcină - korzeń
râde - śmiać się
radiație - promieniowanie
radio - radio
radiu - rad
radon - radon
rareori - rzadko
răspunde - odpowiadać
răstigni - ukrzyżować
raton - szop
rău - źle
râu - rzeka
război - wojna
războinic - wojownik
real - prawdziwy
realism - realizm
realitate - rzeczywistość
rece - zimny
rechin - rekin
reconciliere - pojednanie
reducere - zniżka
refuza - odmawiać
regat - królestwo
Regatul Unit - Wielka Brytania, Zjednoczone Królestwo
rege - król
regim - reżim
regină - królowa
regiune - region
religie - religia
religios - religijny
reniu - ren
renova - odnawiać
reprezentant - przedstawiciel, reprezentant
reproducere - reprodukcja
republica - republika
republică - republika
Republica Cehă - Republika Czeska
Republica Federală Germania - Republika Federalna Niemiec
respinge - odrzucać
respira - oddychać
respirație - oddech, oddychanie
Reunion - Reunion
reuniune - spotkanie
revoluție - rewolucja
rezultat - rezultat, skutek, wynik
ridica - podnieść, unieść, wznieść
roată - koło
rob - niewolnik
robinet - kran
rodiu - rod
roi - rój
Roma - Rzym
română - język rumuński, Rumunka, român
românesc - rumuński
România - Rumunia
roșu - czerwony, czerwień
rotire - obrót
rotund - okrągły
rozător - gryzoń
Ruanda - Rwanda
rubidiu - rubid
rugăciune - modlitwa
rugină - rdza
rumeguș - trociny
rusesc - rosyjski
rușine - wstyd, zażenowanie, nieśmiałość
ruteniu - ruten
rutherfordiu - rutherford
rutier - drogowy
șa - siodło
sabie - miecz
sac - worek
șacal - szakal
sacru - święty
safir - szafir
săgetător - łucznik
șaisprezece - szesnaście
șaisprezecea - szesnasty
șaisprezecelea - szesnasty
șaizecea - szesnasty
șaizeci - sześćdziesiąt
șaizecilea - szesnasty
șal - szal
salată - sałata, sałatka
salivă - ślina
saltea - materac
salut - cześć
samariu - samar
sâmbătă - sobota
sân - pierś
sănătate - zdrowie
sănătos - zdrowy
sandviș - kanapka
sânge - krew
sângera - krwawić
São Tomé și Príncipe - Wyspy Świętego Tomasza i Książęca
sapă - motyka, oskard
săptămână - tydzień
săptămînă - tydzień
șapte - siedem
șaptea - siódmy
șaptelea - siódmy
șaptesprezece - siedemnaście
șaptesprezecea - siedemnasty
șaptesprezecelea - siedemnasty
șaptezeci - siedemdziesiąt
săpun - mydło
sărbători - świętować, obchodzić
sare - sól
sări - skoczyć
săritură - skok
șarpe - wąż
sărut - pocałunek
săruta - całować
șase - sześć
șasea - szósty
șaselea - szósty
sat - wieś
satiră - satyra
satisfacție - satysfakcja
Saturn - Saturn
sau - lub, albo
scai - oset
scandiu - skand
scaun - krzesło, siedzenie
schi - narta
schimba - zmieniać
schiță - szkic
schiuri - narciarstwo
schizofrenie - schizofrenia
sclav - niewolnik
sclavă - niewolnik
școală - szkoła
scorpion - skorpion
scorțișoară - cynamon
scrie - pisać
scriere - pismo
scriitor - pisarz
scrisoare - list
scroafă - maciora, locha
scrotal - mosznowy
scrumieră - popielniczka
sculptor - rzeźbiarz
sculptură - rzeźba
scump - drogi
scurt - krótki
scut - tarcza
seaborgiu - seaborg
seară - wieczór
secară - żyto
secetă - susza
secol - wiek, stulecie
secție de poliție - komisariat policji
secundă - sekunda
securitate - bezpieczeństwo
șef - szef
seleniu - selen
semna - podpisać
semnal - sygnał
semnătură - podpis
semnificanță - znaczenie
semnificație - znaczenie
senator - senator
separa - oddzielić
separatist - separatysta, separatystyczny
septembrie - wrzesień
ser - serum, surowica
serv - chłop pańszczyźniany, niewolnik
sete - pragnienie
șevalet - sztaluga
sex oral - seks oralny
sexual - seksualny
sexualitate - seksualność
sferă - sfera
sferă cerească - sfera niebieska
sfinx - sfinks
sforăi - chrapać
și - i
Sibiu - miasto Sybin, okręg Sybin
sicriu - trumna
silabă - sylaba
silabic - sylabiczny
siliciu - krzem
simbol - symbol
simetrie - symetria
simfonie - symfonia
simplifica - uprościć
simulare - symulacja
șină - tor
sinagogă - synagoga
sinceritate - szczerość
Singapore - Singapur
sinonim - bliskoznaczny, synonim
sinteză - synteza
sinucidere - samobójstwo
sista - przerwać
sistem - system
sistem planetar - układ planetarny
sistem solar - Układ Słoneczny
situat - położony, usytuowany
situație - sytuacja
slang - slang
sloven - słoweński, Słoweniec
slovenă - Słowenka, słoweński, sloven
Slovenia - Słowenia
smârc - bagno
soacră - teściowa
șoaptă - szept
soare - słońce
șobolan - szczur
socialism - socjalizm
socru - teść
sodiu - sód
șoim - sokół
solar - słoneczny
șold - biodro
soldat - żołnierz
Solon - Solon
solstițiu - przesilenie
șomaj - bezrobocie
somn - sen, spanie
sonet - sonet
șopti - szeptać
soră - siostra
șosea - autostrada
sosi - przybyć
soț - mąż
soție - żona
spadă - miecz
spadice - kolba
spanac - szpinak
Spania - Hiszpania
spațiu - przestrzeń
spațiu-timp - czasoprzestrzeń
specialitate - specjalność
spera - mieć nadzieję
speranță - nadzieja
sperare - nadzieja
spermă - sperma
spin - cierń
spiritual - duchowy
spital - szpital
sport - sport
spovedi - spowiadać się, wyznać
sprânceană - brew
spumă - piana
spune - powiedzieć
Sri Lanka - Sri Lanka
stânga - lewo, lewa strona, stâng
staniu - cyna
stat - państwo
Statele Unite - Stany Zjednoczone, USA
Statele Unite ale Americii - Stany Zjednoczone Ameryki
statuie - posąg, statua
staul - stoisko, stajnia
stea - gwiazda
steag - flaga
Ştefan - Stefan
șterge - usunąć
șters - wycieranie, wymazanie
stibiu - antymon
sticlă - szkło
știință - nauka, wiedza
științific - naukowy
stimul - bodziec
stol - chmara
străbunic - pradziadek
stradă - ulica
strâmb - zgięty
strămoș - przodek
strănepoată - prawnuczka
strănuta - kichnąć
stronțiu - stront
strugure - winogrono
strungă - kanion
stup - ul
stupiditate - głupota
SUA - USA, Stany Zjednoczone Ameryki
subiect - podmiot
submarin - okręt podwodny
substanță - substancja
substantiv - rzeczownik
subtil - subtelny
suburban - podmiejski
suc - sok
succes - sukces
sud - południowy (tylko w złożeniach), południe
sudic - południowy
sudoare - pot
Suedia - Szwecja
suficient - wystarczający, wystarczająco
sufix - przyrostek
sufla - dmuchać, dąć
suflet - dusza, duch
sufletește - duchowo
sufragerie - jadalnia
sughița - czkać
sulă - szydło
sulf - siarka
suliță - włócznia
sunet - dźwięk
supă - zupa
supermagazin - supermarket
surâs - uśmiech
surd - głuchy
sursă - źródło
șurub - śruba
susura - szeptać
suta - setny
sută - sto, 100
sutălea - setny
suveranitate - suwerenność
tabără - obóz
tăcea - milczeć
Tailanda - Tajlandia
taină - tajemnica
tainic - tajny
taliu - tal
tălmaci - tłumacz
tâmplar - stolarz
tantal - tantal
țânțar - komar
țară - kraj, wieś
Țările de Jos - Holandia
tastatură - klawiatura
tată - ojciec, tata
tată vitreg - ojczym
tatuaj - tatuaż
taxi - taksówka
teamă - strach
teatru - teatr
tehnician - technik
tehnologic - techniczny
tehnologie - technika
telefon - telefon
televiziune - telewizja
telur - tellur
temniță - więzienie
temperatură - temperatura
templu - świątynia
temporar - tymczasowy
terapie - terapia
terbiu - terb
termina - skończyć
terminare - zakończenie, ukończenie
Termopile - Termopile
te rog - proszę cię
testicul - jądro
testosteron - testosteron
țigară - papieros
Timorul de Est - Timor Wschodni
timp - czas
timpul înseamnă bani - czas to pieniądz
ținc - cynk
țintirim - cmentarz
țipar - węgorz
tiran - tyran
titan - tytan
toamnă - jesień
țol - cal
tomată - pomidor
tonă - tona
topor - topór
Tora - Tora
toriu - tor
toscan - Toskańczyk
totdeauna - zawsze
tovarăș - towarzysz
toxic - trujący
toxicologie - toksykologia
trabuc - cygaro
trădător - zdrajca
traduce - tłumaczyć, przekładać
traducere - tłumaczenie
trăi - żyć, mieszkać
traiectorie - tor, trajektoria
trandafir - róża
translator - tłumacz
transmisie - transmisja
Transnistria - Naddniestrze, Republika Naddniestrzańska
transporta - transportować, przenosić
tratat - traktat, układ, pakt
treabă - praca
trebui - potrzebować
trebuință - potrzeba
trei - trzy, 3
treia - trzeci
treilea - trzeci
treișpelea - trzynasty
treisprezece - trzynaście
treisprezecelea - trzynasty
treizecea - trzydziesty
treizeci - trzydzieści
treizecilea - trzydziesty
tren - pociąg
tridimensional - trójwymiarowy
trimite - wysyłać
trist - smutny
trofeu - trofeum
trombon - puzon
tron - tron
trunchi - pień
trup - ciało
tuberculoză - gruźlica
țugui - szczyt
tuliu - tul
tuna - grzmieć
tunel - tunel
Turcia - Turcja
turcoaz - turkusowy
Turkmenistan - Turkmenia
turn - wieża
turna - lać, wlać
țurțur - sopel
tuse - kaszel
tuși - kaszleć
tutun - tytoń
Ucraina - Ukraina
uita - zapomnieć
ulcer - wrzód
ulm - wiąz
umbră - cień
umbrelă - parasol
un - jakiś, pewien, któryś, jeden
unchi - wuj, wujek
undă - fala
unde - gdzie
undeva - gdzieś
unealtă - narzędzie
ungar - węgierski
Ungaria - Węgry
unghie - paznokieć
uniform - jednolity
unitate - jedność
uniune - związek, unia
Uniunea Europeană - Unia Europejska
universitate - uniwersytet
unșpelea - jedenasty
unsprezece - jedenaście
unsprezecea - jedenasty
unsprezecelea - jedenasty
unt - masło
unu - jeden
ununbiu - ununbium
ununhexiu - ununhexium
ununoctiu - ununoctium
ununpentiu - ununpentium
ununquadiu - ununquadium
ununseptiu - ununseptium
ununtriu - ununtrium
unununiu - unununium
urâciune - brzydota, strach, potwór
uraniu - uran
Uranus - Uran
ureche - ucho
urî - nienawidzić
urina - sikać
urs - niedźwiedź
Ursa Mare - Wielka Niedźwiedzica
ursuleț spălător - szop
urzică - pokrzywa
ușă - drzwi
usca - suszyć
usturoi - czosnek
util - pomocny, przydatny
utilizator - użytkownik
vacă - krowa
vaccină - szczepionka
vad - bród
văduvă - wdowa
vale - dolina
valoare - wartość
valoros - cenny
vampir - wampir
vanadiu - wanad
vânătaie - siniak
vânător - myśliwy
vandalism - wandalizm
vânt - wiatr
vânzător - sprzedawca, zdrajca
vară - lato
vă rog - proszę
Varșovia - Warszawa
varză - kapusta
vâsc - jemioła
veac - wiek, stulecie
vedea - widzieć
vegetarianism - wegetarianizm
vehicul - pojazd
venă - żyła
verb - czasownik
verde - zieleń, zielony
versiune - wersja
vesel - zadowolony
vest - zachód
vesti - ogłosić
vestibul - korytarz
viață - życie
victimă - ofiara
victorie - zwycięstwo
vid - pusty
viezure - borsuk
viguros - energiczny
vinde - sprzedawać
vindeca - uleczyć
vineri - piątek
vioară - skrzypce
violă - wiola
violoncel - wiolonczela
viperă - żmija
virgulă - przecinek
virus - wirus
vis - sen
visa - śnić
vitamină - witamina
viteză - szybkość, prędkość
vizibil - widoczny
vizibilitate - widoczność
vizită - wizyta
viziune - wizja
voce - głos
vodcă - wódka
voi - wy
voiaj - podróż
Voivodina - Wojwodina
volan - kierownica
volum - objętość
vomita - wymiotować
vorbă - słowo
vorbi - mówić, rozmawiać
vot - głosowanie
votcă - wódka
vrabie - wróbel
vrăjitorie - sztuka magiczna, uprawianie magii
vrea - chcieć
vulcan - wulkan
vulpe - lis
vutcă - votcă
Wikipedia - Wikipedia
wolfram - wolfram
xenon - ksenon
yterbiu - iterb
ytriu - itr
zăcământ - złoże
zadarnic - daremny
zahăr - cukier
zaharină - sacharyna
zaharoză - sacharoza
zâmbet - uśmiech
zâmbitor - uśmiechnięty
zăpadă - śnieg
zară - maślanka
zăvor - zasuwa, rygiel
zbor - lot
zbura - lecieć
zeamă - wywar
zebră - zebra
zece - dziesięć
zecelea - dziesiąty
zeiță - bogini
zelos - żarliwy
zenit - zenit
zer - serwatka
zestre - posag
zeu - bóg
zgaibă - pęcherz, bąbel
zgomotos - hałaśliwy
zi - dzień
zice - powiedzieć
zi de naștere - urodziny
zinc - cynk
zirconiu - cyrkon
zlot - złoty
zmeură - malina
zonă - strefa
zonă erogenă - strefa erogenna
zoo- - zoo-
zoologie - zoologia
zooplancton - zooplankton
zor - pośpiech
