abažur - klosz | abażur
abdicirati - abdykować
abdikacija - abdykacja
abdomen - brzuch
abdomenski - brzuszny
abdominalan - brzuszny
abhaski - abchaski
Abhazija - Abchazja
abnormalan - nienormalny
abnormalnost - nienormalność
abonos - heban
abortus - poronienie
abrevijacija - skrót
adaptacija - adaptacja
adekvatan - adekwatny
administrator - administrator
admiral - admirał
adolescencija - dojrzewanie
adopcija - adopcja
adresa - adres
adresat - adresat
adverb - przysłówek
adverban - przysłówkowy
adverbijalan - przysłówkowy
aerogliser - poduszkowiec
aforizam - aforyzm
afrički - afrykański
afrikans - język afrykanerski
agencija - agencja
agitator - agitator
aglomeracija - aglomeracja
agnosticizam - agnostycyzm
agonija - agonia
agrarni - rolny
agresija - agresja
agresor - agresor | napastnik
agrikultura - rolnictwo
agronomija - agronomia
ahat - agat
ajkula - rekin
ajnštajnij - einstein
akademija - akademia
akcionar - udziałowiec
aksiom - aksjomat
aksioma - aksjomat
aktinij - aktyn
aktivacija - aktywacja
aktivizam - aktywizm
akumulacija - nagromadzenie
akumulator - akumulator
akupunktura - akupunktura
akustičan - akustyczny
akustički - akustyczny
akvadukt - akwedukt
akvarij - akwarium
akvedukt - akwedukt
alabastar - alabaster
alabaster - alabaster
alatka - narzędzie | instrument
albatros - albatros
albin - albinos
albino - albinos
album - album
alegorija - alegoria
alergičan - alergiczny
alergija - alergia
aleutski - aleucki
alfa - alfa (nazwa greckiej litery α)
alfabet - alfabet
alga - alga | glon
algebra - algebra
algoritam - algorytm
aligator - aligator
aliteracija - aliteracja
alkemičar - alchemik
alkemija - alchemia
alkohol - alkohol
alkoholija - alkoholizm
alkoholizam - alkoholizm
alkoholni - alkoholowy
alkoholno - alkoholowy
almanah - almanach
almoštvo - jałmużna
almuštvo - jałmużna
alrauna - mandragora
alternativan - alternatywny
altimetar - wysokościomierz
altituda - wysokość
altruizam - altruizm
aluminij - glin
aluzija - aluzja
amajlija - amulet
amandman - poprawka
amater - amator
ambicija - ambicja
ambiciozan - ambitny
ambigvitet - niejednoznaczność
ameba - ameba
americij - ameryk
Amerika - Ameryka
ametist - ametyst
amfiteatar - amfiteatr
amfora - amfora
amnestija - amnestia
amnezija - amnezja
amonijak - amoniak
ampermetar - amperomierz
amputacija - amputacja
amulet - amulet
anakonda - anakonda
analiza - analiza
analni - analny
analogan - analogiczny
analogija - analogia
ananas - ananas
anarhija - anarchia
anarhist - anarchista
anarhizam - anarchizm
anatomija - anatomia
anđelski - anielski
andivija - endywia
Andora - Andora
andorski - andorski
anegdota - anegdota
anglikan - anglikanizm
anglikanac - anglikanin
Angola - Angola
animozitet - antypatia
anis - anyż
anketni listić - kwestionariusz
anoda - anoda
anomalija - anomalia
anoniman - anonimowy
anorganski - nieorganiczny
antibiotik - antybiotyk
Antigva i Barbuda - Antigua i Barbuda
antika - starożytność
antilopa - antylopa
antimon - antymon
antisocijalan - aspołeczny
antitelo - antyciało
antiteza - antyteza
antitijelo - antyciało
antologija - antologia
antonim - antonim
antropolog - antropolog
antropologija - antropologia
aorta - aorta
apatičan - apatyczny
apatija - apatia
apetit - apetyt
aplauz - oklaski | aplauz
apokrifan - apokryficzny
apostol - apostoł
apostrof - apostrof
april - kwiecień
apsolutizam - absolutyzm
apstinencija - abstynencja
apstrakcija - abstrakcja
apstraktan - abstrakcyjny
apsurdan - absurdalny
arbitraran - arbitralny
arena - arena
argo - slang
argon - argon
arhiepiskop - arcybiskup
arhipelag - archipelag
arhitekt - architekt
arhitektura - architektura
arhiv - archiwum
aristokracija - arystokracja
Aristotel - Arystoteles
aritmetika - arytmetyka
arogantan - arogancki
artičoka - karczoch
artikulacija - artykulacja
artiljerija - artyleria
Aruba - Aruba
aseksualnost - aseksualność
asimilacija - asymilacja
aspirin - aspiryna
astat - astat
asteroid - asteroida
astma - astma
astrologija - astrologia
astronaut - astronauta
astronom - astronom
astronomski - astronomiczny
ateist - ateista
atentat - zamach | morderstwo
Atlantski ocean - Ocean Atlantycki
atom - atom
atomski - atomowy
atribut - atrybut
atrofija - atrofia
august - sierpień
australijanski - australijski
australijski - australijski
autentičan - autentyczny
autentičnost - autentyczność
auto - auto | samochód
autobiografija - autobiografia
autobus - autobus
autokracija - autokracja
autokratizam - autokracja
automatski - automatyczny | automatycznie
autonoman - niezależny
autonomija - autonomia
autoput - autostrada
autor - autor
autostrada - autostrada
avenija - aleja
avijacija - lotnictwo
Azerbajdžan - Azerbejdżan
azerbajdžanski - azerbejdżański
Azerbejdžan - Azerbejdżan
azijski - azjatycki
azil - azyl
azimut - azymut
babica - położna
babun - pawian
Bahami - Bahamy
bajonet - bagnet
bajunet - bagnet
bajuneta - bagnet
baka - babcia
bakterija - bakteria
bakteriologija - bakteriologia
balega - obornik | gnój | łajno
balet - balet
balkon - balkon
balon - balon
balta - topór | siekiera
banana - banan
bandit - bandyta
bandoglav - uparty
bankar - bankier
banket - bankiet
banknota - banknot
bankrot - bankructwo
bara - kałuża
Barbados - Barbados
barbar - barbarzyńca
barij - bar
barijera - bariera
barikada - barykada
barometar - barometr
barut - proch strzelniczy
basna - bajka
bašta - ogród | bastion
baštinik - spadkobierca
bazalt - bazalt
baza podataka - baza danych
bazen - basen
bedast - głupi
bedro - udo
behar - kwiat
bejzbol - baseball
bela - biały | blady
belance - białko jajka
belančevina - białko
belanjak - białko jajka
belilo - wybielacz | biel
beli luk - czosnek
Beliz - Belize
Belize - Belize
Belorusija - Białoruś
beneficija - korzyść
Benin - Benin
berilij - beryl
berilijum - beryl
berkelij - berkel
besan - wściekły
beskonačnost - nieskończoność
beskoristan - bezużyteczny
beskrupulozan - pozbawiony skrupułów
beskućnički - bezdomny
besmrtan - nieśmiertelny
bespomoćan - bezradny
bespravan - nielegalny
besprizoran - bezdomny
besraman - bezwstydny
bestidan - bezwstydny
besvestan - nieprzytomny
besvjestan - nieprzytomny
bežati - uciec
bezbožje - ateizm
bezbožnik - ateista
bezbožništvo - ateizm
bezbožnost - ateizm
bezmalo - prawie
beznačajan - nieistotny
bezopasan - niegroźny | nieszkodliwy
bezvredan - bezwartościowy
bezvrijedan - bezwartościowy
biblioteka - biblioteka
bič - bicz
bičak - nóż
bicikal - rower
bicikl - rower
bigot - bigot
bijeg - ucieczka
bijela - biały | blady
bijeli luk - czosnek
bijesan - wściekły
bilingvalan - dwujęzyczny
biljojed - roślinożerca
biljožder - roślinożerca
biograf - biograf
biografija - biografia
biokemija - biochemia
biolog - biolog
biologija - biologia
biseksualnost - biseksualizm
biser - perła
bitka - bitwa
bizaran - dziwaczny
bizmut - bizmut
biznismen - przedsiębiorca
bizon - bizon
bjelance - białko jajka
bjelančevina - białko
bjelanjak - białko jajka
bjelilo - wybielacz | biel
bjelina - biel
Bjelorusija - Białoruś
bježati - uciec
blasfemija - bluźnierstwo
blato - błoto
blizanac - bliźniak
blog - blog
blokada - blokada
bluza - bluzka
Bocvana - Botswana
bodež - sztylet
Bog - Bóg
bogalj - kaleka
bogatstvo - bogactwo
boginja - bogini
boj - bitwa
bojkot - bojkot
bolan - bolesny
bolestan - chory
bolivijski - boliwijski
bolnica - szpital
bomba - bomba
bor - sosna | bor
bordel - burdel
borovnica - borówka amerykańska | borówka czarna | borówka
bos - bosy
Bosna i Hercegovina - Bośnia i Hercegowina
bosonog - bosy
bova - boja | pława
božanski - boski
božanstven - boski
božica - bogini
božur - piwonia
bradat - brodaty
bradva - topór ciesielski
brana - tama | brona
branilac - obrońca
branitelj - obrońca
bratstvo - bractwo
bravar - ślusarz
brazgotina - blizna
Brazil - Brazylia
brazilski - brazylijski
brdo - wzgórze
brendi - brandy | winiak
breskva - brzoskwinia
brest - wiąz
brežuljak - pagórek
brijest - wiąz
Brisel - Bruksela
britanski - brytyjski
britva - brzytwa
brk - wąsy
broj - liczba
brojan - liczny
brokula - brokuł
brom - brom
broš - broszka
Brunej - Brunei
brutalan - brutalny
brz - szybki
brzo - szybko
brzojav - telegram
bubanj - bęben
budilica - budzik
budilnik - budzik
budizam - buddyzm
budućnost - przyszłość
budžet - budżet
Bukurešt - Bukareszt
bukva - buk
bukvalno - dosłownie
bumbar - trzmiel
bundeva - dynia
bunilo - delirium
bunovina - mandragora
Burkina Faso - Burkina Faso
Burma - Birma
burnica - albatros
Burundi - Burundi
Butan - Bhutan
čačkalica - wykałaczka
Čad - Czad
čađ - sadza
čagalj - szakal
čaj - herbata
čak - nawet
čalma - turban
čam - jodła
čama - tęsknota
čamotinja - tęsknota
čaplja - czapla
carevina - imperium
čarobnik - czarodziej
čarobnjak - czarodziej
čavka - kawka
ceh - cech
čekinja - szczecina
celer - seler
celibat - celibat
čelo - czoło
cement - cement
čempres - cyprys
cena - cena | wartość
centimetar - centymetr
Centralnoafrička Republika - Republika Środkowoafrykańska
centrifuga - wirówka | centryfuga
cenzura - cenzura
cepivo - szczepionka
ceremonija - ceremonia
cerij - cer
češalj - grzebień
češljugar - szczygieł
česma - fontanna | kran
češnjak - czosnek
čestitati - gratulować
često - często
četrdeset - czterdzieści
četrnaest - czternaście
četvrtak - czwartek
četvrti - czwarty
cevanica - goleń
cezij - cez
čežnja - tęsknota
cicija - skąpiec
cigareta - papieros
cigla - cegła
cijena - cena | wartość
čileanski - chilijski
cimbal - talerz | czynel
cimbalo - talerz | czynel
čimbenik - czynnik
ciničan - cyniczny
činilac - czynnik
činitelj - czynnik
činjenica - fakt
čip - chip | układ scalony
cipela - but
čir - wrzód
ćirilički - cyrylicki
ćirilični - cyrylicki
ćirilski - cyrylicki
cirkonij - cyrkon
čitak - czytelny
čitanje - czytanie
čitljiv - czytelny
citologija - cytologia
cjelivati - całować
cjelovati - całować
cjepivo - szczepionka
cjevanica - goleń
čmarni - analny
čoban - pasterz
čokolada - czekolada
col - cal
ćorav - ślepy
Crna Gora - Czarnogóra
crtež - rysunek
crv - robak
crvenkast - czerwonawy
čudotvoran - cudowny
čudovište - potwór
cunami - tsunami
cvetača - kalafior
cvjetača - kalafior
dabar - bóbr
dabogme - oczywiście
dabome - oczywiście
dagnja - małż
đakon - diakon
dalek - odległy
daljina - odległość
Damask - Damaszek
dan - dzień
danas - dziś | dzisiaj
darčin - cynamon
darmstadij - darmsztadt
dativ - celownik
đavao - diabeł
đavo - diabeł
daždevnjak - salamandra
decembar - grudzień
decenija - dekada
dečko - chłopak
ded - dziad
deda - dziadek
dedukcija - dedukcja
defektan - uszkodzony
definicija - definicja
definitivno - zdecydowanie | bez wątpienia
deizam - deizm
dekada - dekada
deklaracija - deklaracja
dekret - dekret
delatnica - pracownik
delatnik - pracownik
delomice - częściowo
delomično - częściowo
deminutiv - zdrobnienie
demokrat - demokrata
demon - demon
dermatologija - dermatologia
dešavati - zdarzyć się
desert - deser
desiti - zdarzyć się
deskriptivan - opisowy
destrukcija - zniszczenie
destruktivan - destrukcyjny
detalj - szczegół
detaljan - szczegółowy
detao - dzięcioł
detektiv - detektyw
detektivka - detektyw
detektor - detektor
detelina - koniczyna
detinjstvo - dzieciństwo
detlić - dzięcioł
devedeset - dziewięćdziesiąt | 90
devedeseti - dziewięćdziesiąty
devetnaest - dziewiętnaście
devetnaesti - dziewiętnasty
devojka - dziewczyna
diftong - dyftong
difuzan - rozproszony
digitalni - cyfrowy
dijabetes - cukrzyca
dijagnoza - diagnoza
dijagram - diagram
dijalekat - dialekt
dijalekt - dialekt
dijalog - dialog
dijamant - diament
dijareja - biegunka
dikobraz - jeżozwierz
diktator - dyktator
diktatura - dyktatura
dilema - dylemat
dim - dym
dimenzija - wymiar
dina - wydma | diuna
dinamit - dynamit
dinamo - prądnica
dinastija - dynastia
dinosaurus - dinozaur
dioničar - udziałowiec
diplomacija - dyplomacja
diplomirati - ukończyć studia
dirati - dotykać
dirnuti - dotykać
diskusija - dyskusja
disprozij - dysproz
distorzija - deformacja
diverzitet - różnorodność
divji - dziki
divljan - cyklop
divlji - dziki
diza - dysza
dizajner - projektant
dizna - dysza
djed - dziadek
djelatnica - pracownik
djelatnik - pracownik
djelomice - częściowo
djelomično - częściowo
djetao - dzięcioł
djetelina - koniczyna
djetinjstvo - dzieciństwo
djetlić - dzięcioł
dleto - dłuto
dlijeto - dłuto
dȍbar dȃn - dzień dobry | dzień dobry (po południu)
dobit - zysk
dobitnik - zwycięzca
doboš - bęben
dobročinac - dobroczyńca
dobročinitelj - dobroczyńca
dobrota - dobroć
dobrovoljac - wolontariusz
dodatan - dodatkowy
dodirivati - dotykać
dodirnuti - dotykać
dogma - dogmat
dohodak - dochód
doktrina - doktryna
dokument - dokument
dolar - dolar
domaća zadaća - praca domowa
dometak - przyrostek
dominacija - dominacja
domoljublje - patriotyzm
domovina - ojczyzna
donje rublje - bielizna
dopuštati - pozwolić
dopustiti - pozwolić
doručak - śniadanie
dosada - nuda
dosadan - nudny
doseljenik - imigrant
doslovno - dosłownie
dostojanstvo - godność
doviđenja - do widzenia
dovoljno - wystarczająco
drama - dramat
dramatičan - dramatyczny
dramski - dramatyczny
drastičan - drastyczny
drobnjak - szczypiorek
drug - przyjaciel | towarzysz
drugačije - inaczej
drugde - gdzie indziej
drugdje - gdzie indziej
drukčije - inaczej
drum - droga
drvo - drzewo | drewno
drvodelja - stolarz
drvodjelja - stolarz
državljanstvo - obywatelstwo
dubnij - dubn
dubok - głęboki
dudov svilac - jedwabnik
dug - długi | dług
duga - tęcza
dugačak - długi
dugo - od dawna
dugovečan - długowieczny
dugovječan - długowieczny
duhovni - duchowy | religijny
duhovno - duchowo | religijnie
duljina - długość
dupin - delfin
dušek - materac
dužnik - dłużnik
dvadeset - dwadzieścia
dvanaest - dwanaście
dvaput - dwa razy
dvoboj - pojedynek
dvoglas - dyftong
dvoličnik - hipokryta
dvorac - zamek
džak - worek
džamija - meczet
džentlmen - dżentelmen
džep - kieszeń
džez - jazz
Džibuti - Dżibuti
džip - dżip | jeep
džudo - judo | dżudo
džungla - dżungla
ebanovina - heban
egoizam - egoizm
egzaktno - dokładnie
egzistencija - egzystencja
egzotičan - egzotyczny
einsteinij - einstein
eklipsa - zaćmienie
ekologija - ekologia
ekosistem - ekosystem
ekosustav - ekosystem
ekscentričan - ekscentryczny
ekskluzivno - wyłącznie
ekskrement - kał | wydalina
eksplozija - wybuch | eksplozja
eksploziv - materiał wybuchowy
eksplozivan - wybuchowy
ekspresivan - ekspresyjny
ekstreman - skrajny
ekvator - równik
Ekvatorska Gvineja - Gwinea Równikowa
ekvinocij - równonoc
ekvivalentan - równoważny
elastičan - elastyczny
elegantan - elegancki
elegija - elegia
električar - elektryk
elektroda - elektroda
elektromagnetni - elektromagnetyczny
elektromagnetski - elektromagnetyczny
elektronika - elektronika
eliksir - eliksir
eliminacija - eliminacja
emancipacija - emancypacja
embrio - embrion
embrion - embrion | zarodek | embrio
emigracija - emigracja
emigrant - emigrant
emocija - emocja | uczucie
emocionalan - emocjonalny
emotivan - emocjonalny
empirijski - empiryczny | doświadczalny
enciklopedija - encyklopedia
endivija - endywia
energija - energia
entomologija - entomologia
entuzijastičan - entuzjastyczny
entuzijazam - entuzjazm
epidemija - epidemia
epidemijski - epidemiczny
epilepsija - padaczka | epilepsja
epilog - epilog | zakończenie
epistemologija - epistemologia
epitaf - epitafium
epitet - epitet
epoha - epoka
era - era
erbij - erb
Eritreja - Erytrea
erupcija - erupcja
eskalator - schody ruchome
esperantski - esperanto
Estonija - Estonia
estuarij - ujście
etimologija - etymologia
Etiopija - Etiopia
etnologija - etnologia
eufemizam - eufemizm
euforija - euforia
europij - europ
eutanazija - eutanazja
evakuacija - ewakuacja
evanđelje - ewangelia
evidentan - ewidentny
evolucija - ewolucja
fagot - fagot
fajt - walka
faktor - czynnik
falus - penis
familija - rodzina
fanatik - fanatyk
fantastičan - fantastyczny
farma - farma
farmakologija - farmakologia
farmer - farmer
fascinacija - fascynacja
fazan - bażant
februar - wtorek
federacija - federacja
federativan - federalny
feniks - feniks
fenjer - latarnia
fenomen - zjawisko
fermij - ferm
festival - festiwal
fetus - płód
filantropija - filantropia
Filipini - Filipiny
filolog - filolog
filozof - filozof
filozofija - filozofia
Finska - Finlandia
fizičar - fizyk
fizika - fizyka
fiziologija - fizjologia
flaša - butelka
flauta - flet
fleksibilan - elastyczny
fletno - szybko
flora - flora
flota - flota
fluktuacija - fluktuacja
fluor - fluor
fobija - fobia
folklor - folklor
fonem - fonem
fonetički - fonetyczny
fonetika - fonetyka
fonetski - fonetyczny
fonologija - fonologia
formalno - formalnie
fortifikacija - fortyfikacja
forum - forum
fosfor - fosfor
fotelja - fotel
fotograf - fotograf
foton - foton
fragilan - delikatny
francij - frans
Francuska - Francja
fregata - fregata
frekventan - częsty
freska - fresk
frivolan - frywolny
frontalan - przedni
fruštik - śniadanie
frustracija - frustracja
funkcija - funkcja
furiozan - wściekły
Gabon - Gabon
gadolinij - gadolin
gaj - zagajnik
galaksija - galaktyka
galeb - mewa
galicijski - galicyjski
galij - gal
Gambija - Gambia
Gana - Ghana
garantirati - gwarantować
garantovati - gwarantować
gavran - kruk
gazela - gazela
gdekad - czasami
gdjekad - czasami
genealogija - genealogia
genetički - genetyczny
genetika - genetyka
genij - geniusz
genitiv - dopełniacz
genocid - ludobójstwo
geografija - geografia
geometrija - geometria
geometrijski - geometryczny
germanij - german
geslo - hasło
gibanje - ruch
gigantski - gigantyczny
gimnastika - gimnastyka
gitara - gitara
glad - głód
gladak - gładki
gladan - głodny
gladijator - gladiator
glagol - czasownik
glasač - wyborca
glasina - plotka
glasnik - posłaniec
glasonoša - posłaniec
glasovit - słynny
glavobolja - ból głowy
glečer - lodowiec
glista - dżdżownica
globalan - globalny
glosar - glosariusz
glumac - aktor
glumica - aktorka
glupav - głupi
gnezdo - gniazdo
gnijezdo - gniazdo
gnojivo - nawóz
gnosticizam - gnostycyzm
godina - rok
godišnjica - rocznica
gojazan - otyły
gojaznost - otyłość
golenjača - goleń
golf - golf
golicati - łaskotać
goljenjača - goleń
golub - gołąb
gora - góra
gord - dumny | arogancki
gospodarstvenik - przedsiębiorca
gost - gość
gostoljubiv - gościnny
gotov - gotowy | skończony
govedina - wołowina
govorništvo - retoryka
gozba - uczta
graciozno - wdzięcznie
graditeljica - budowniczy
gradivo - materiał
gradonačelnica - burmistrz
gradonačelnik - burmistrz
gramatičar - gramatyk
gramatika - gramatyka
grana - gałąź
granit - granit
Grčka - Grecja
grd - brzydki
grdan - brzydki
greh - grzech
grejpfrut - grejpfrut
Grenland - Grenlandia
grešnik - grzesznik
grijeh - grzech
grle - jelonek
grm - krzak
grob - grób
groblje - cmentarz
grobnica - grób
grofica - hrabina
groteskan - groteskowy
grupa - grupa
guba - trąd
gubav - trędowaty
gusar - pirat
guska - gęś
gušter - jaszczurka
guverner - gubernator
Gvatemala - Gwatemala
Gvineja - Gwinea
Gvineja Bisau - Gwinea Bissau
gvozd - las
habitat - habitat | środowisko
hafnij - hafn
halif - kalif
halucinacija - halucynacja
hamajlija - amulet
harfa - harfa
haringa - śledź
harmoničan - harmonijny
harmonija - harmonia
harmonika - akordeon
harpun - harpun
hašiš - haszysz
hassij - has
hefta - tydzień
hegemonija - hegemonia
helij - hel
helijum - hel
heraldika - heraldyka
hereza - herezja
hernija - przepuklina
heroin - heroina
heroj - bohater
heterogen - niejednorodny
heteroseksualnost - heteroseksualizm
hidrauličan - hydrauliczny
hijerarhija - hierarchia
hiljada - tysiąc
himna - hymn
hipnoza - hipnoza
hipokrit - hipokryta
hipoteka - hipoteka
hipoteza - hipoteza
hir - kaprys
histerija - histeria
historija - historia
hitan - nagły | pilny
hladan - zimny
hobotnica - ośmiornica
hodočašće - pielgrzymka
hodočasnik - pielgrzym
holmij - holm
homogen - jednolity
homonim - homonim
homoseksualan - homoseksualny
homoseksualnost - homoseksualizm
Honduras - Honduras
Hongkong - Hongkong
Hong Kong - Hongkong
horda - horda
horizont - horyzont
horizontalan - poziomy
hormon - hormon
horoskop - horoskop
hotel - hotel
hotimičan - zamierzony
hoverkraft - poduszkowiec
hrabrost - odwaga
hrana - jedzenie
hrčak - chomik
hren - chrzan
hrid - klif
Hrist - Chrystus
Hristos - Chrystus
hrpa - sterta
hrsuz - złodziej | rabuś | bandyta
hrt - chart
hrvač - zapaśnik
Hrvatska - Chorwacja
hula - bluźnierstwo
huligan - chuligan
huljenje - bluźnierstwo
humanitaran - humanitarny
humanizam - humanizm
hurikan - huragan
huškalo - agitator
hvalisav - chełpliwy
hvaljenje - pochwała
hvastav - chełpliwy
ideal - ideał
idealan - idealny
idealizam - idealizm
identičan - identyczny
identifikacija - identyfikacja
ideologija - ideologia
idiom - idiom
idiomatski - idiomatyczny
idiot - idiota
idol - idol
idući - następny
igla - igła
igračka - zabawka
igralište - plac zabaw
ihtiolog - ichtiolog
ilegalan - nielegalny
iluminacija - oświetlenie
ilustracija - ilustracja
iluzija - iluzja
imaginacija - wyobraźnia
imaginaran - urojony
imela - jemioła
imenica - rzeczownik
imigracija - imigracja
imigrant - imigrant
imitacija - imitacja
imperijalizam - imperializm
impresivan - imponujący
imunitet - odporność
inače - inaczej | w przeciwnym razie | już
inadekvatan - nieadekwatny
inč - cal
incest - kazirodztwo
incident - wydarzenie | incydent | epizod
indij - ind
Indija - Indie
Indijski okean - Ocean Indyjski
indirektan - pośredni
indirektno - pośrednio
indiskretan - niedyskretny
individualno - indywidualnie
Indonezija - Indonezja
industrija - przemysł
inercija - bezwładność | inercja
infekcija - infekcja
informacija - informacja
infracrven - podczerwony
infrastruktura - infrastruktura
infuzija - napar
inicijalan - początkowy
inicijalno - początkowo
inje - szron
inkarnacija - inkarnacja
inovacija - innowacja
insekt - owad
insekticid - środek owadobójczy
inspekcija - inspekcja
instalacija - instalacja
institucija - instytucja
institut - instytut
integracija - integracja
intelekt - intelekt
intelektualan - intelektualny
inteligentan - inteligentny
intenzitet - intensywność
intenzivan - intensywny
interakcija - interakcja
interesantan - interesujący
internacionalan - międzynarodowy
interni - wewnętrzny
interpretacija - interpretacja
interpreter - tłumacz
intervencija - interwencja
intriga - intryga
invazija - inwazja
investicija - inwestycja
investitor - inwestor
inženjer - inżynier
inženjerstvo - inżynieria
iracionalan - irracjonalny
Irak - Irak
Iran - Iran
irealan - nierealny
iregularan - nieregularny
ireverzibilan - nieodwracalny
iridij - iryd
ironija - ironia
Irska - Irlandia
isceliti - uleczyć
isceljivati - uleczyć
iscijeliti - uleczyć
iscjeljivati - uleczyć
isključivo - wyłącznie
iskra - iskra
iskustvo - doświadczenie
islam - islam
Island - Islandia
ismejati - wyśmiewać | uśmiać się
ismejavati - wyśmiewać | uśmiać się
ismijati - wyśmiewać | uśmiać się
ismijavati - wyśmiewać | uśmiać się
isprljati - pobrudzić
isterati - wypędzić
isteravati - wypędzić
isterivati - wypędzić
istina - prawda
istjerati - wypędzić
istjeravati - wypędzić
istjerivati - wypędzić
istočni - wschodni
Istočni Timor - Timor Wschodni
istodobno - równocześnie | w międzyczasie
istok - wschód
istoznačan - bliskoznaczny
Isus - Jezus
Italija - Włochy
itekako - zdecydowanie | bez wątpienia
i te kako - zdecydowanie | bez wątpienia
iterbij - iterb
itrij - itr
izabirati - wybierać
izabrati - wybierać
izbeglica - uchodźca
izbeživ - do uniknięcia
izbežljiv - do uniknięcia
izbjeglica - uchodźca
izbježiv - do uniknięcia
izbježljiv - do uniknięcia
izdaja - zdrada
izdavač - wydawca
izjutra - rano
izlaz - wyjście
izmeničan - zmienny
izmet - kał | wydalina
izmisliti toplu vodu - na nowo odkryć koło
izmišljati toplu vodu - na nowo odkryć koło
izmjeničan - zmienny
iznebuha - nagle
iznenada - nagle
iznenadan - nagły
izniman - wyjątkowy
iznimka - wyjątek
iznova - od nowa
iznovice - od nowa
izobilan - obfity
izobilje - obfitość
Izrael - Izrael
izumitelj - wynalazca
izuzetak - wyjątek
izuzetan - wyjątkowy
izvešće - raport
izveštaj - raport
izvestan - pewny
izvinite - przepraszam
izvješće - raport
izvjestan - pewny
jabuka - jabłko
jadan - żałosny
jadovan - żałosny
jadovit - żałosny
jaganjac - jagnię
jagoda - truskawka
jaguar - jaguar
jahta - jacht
jajnik - jajnik
jamac - gwarant
Jamajka - Jamajka
janjac - jagnię
jantar - bursztyn
januar - styczeń
Japan - Japonia
jarebica - kuropatwa
jastog - homar
jastuk - poduszka
javna kuća - burdel
javni - publiczny
javor - klon
ječam - jęczmień
jedanaest - jedenaście
jedincat - jedyny
jediniti - jednoczyć się
jednakost - równość
jednoboštvo - monoteizm
jednodušan - jednomyślny
jednoglasan - jednomyślny
jednook - jednooki
jednorog - jednorożec
jednoženstvo - monogamia
jedrilo - maszt
jeftin - tani
jegulja - węgorz
jeka - echo
jela - jodła
jelovnik - menu
Jemen - Jemen
jer - ponieważ
Jerusalim - Jerozolima
jestiv - jadalny
jež - jeż
jezero - jezioro
jezikoznalac - filolog
jezikoznanstvo - filologia
jod - jod
joha - olcha
jova - olcha
jučašnji - wczorajszy
jučeranji - wczorajszy
jučerašnji - wczorajszy
judaizam - judaizm
jug - południe
Jugoslavija - Jugosławia
juli - lipiec
junaštvo - heroiczny czyn | bohaterstwo
juni - czerwiec
junica - jałówka
jurisdikcija - jurysdykcja
jutrom - rano
Južna Afrika - Republika Południowej Afryki
Južna Amerika - Ameryka Południowa
Južna Koreja - Korea Południowa
južni - południowy
Južnoafrička Republika - Republika Południowej Afryki
kadikad - czasami
kadikada - czasami
kadmij - kadm
kafa - kawa
Kafarnaum - Kafarnaum
kahva - kawa
Kairo - Kair
kajak - kajak
kajgana - omlet
kajsija - morela
kakofonija - kakofonia
kal - błoto
kalcij - wapń
kaleidoskop - kalejdoskop
kalendar - kalendarz
kalif - kalif
kalifornij - kaliforn
Kalifornija - Kalifornia
kalij - potas
kalijum - potas
kaliti - hartować
kaljuga - błoto | kałuża
kaljuža - błoto | kałuża
Kambodža - Kambodża
kameleon - kameleon
Kamerun - Kamerun
kamila - wielbłąd
kampanja - kampania
Kanada - Kanada
kanadski - kanadyjski
kandža - pazur
kanibal - kanibal
kanibalizam - kanibalizm
kaotičan - chaotyczny
kapela - kaplica
Kapernaum - Kafarnaum
kapitalizam - kapitalizm
kapriciozan - kapryśny | zmienny
karakterističan - charakterystyczny
karantena - kwarantanna
karfiol - kalafior
karijera - kariera
karmin - szminka
kaša - owsianka
kašalj - kaszel
kašika - łyżka
kasno - późno
kasta - kasta
katamenije - miesiączka
katanac - kłódka
katapult - katapulta
Katar - Katar
katastrofa - katastrofa
katedrala - katedra
kategorija - kategoria
katekizam - katechizm
katkad - czasami
katkada - czasami
katoda - katoda
katolički - katolicki
katran - smoła
kauboj - kowboj
kava - kawa
kavana - kawiarnia
kavijar - kawior
Kazahstan - Kazachstan
kćer - córka
kći - córka
kečap - keczup
Keltsko more - Morze Celtyckie
kengur - kangur
Kenija - Kenia
kenjac - osioł
keramički - ceramiczny
kesten - kasztan
kibernetika - cybernetyka
kihati - kichnąć
kihnuti - kichnąć
kijati - kichnąć
kikiriki - orzech ziemny
kiklop - cyklop
kiks - gafa
kila - przepuklina
kilogram - kilogram
kino - kino
kinuti - kichnąć
kip - posąg | statua
Kipar - Cypr
Kirgistan - Kirgistan
Kirgizstan - Kirgistan
kiša - deszcz
kišan - deszczowy
kisel - kwaśny
kiselina - kwas
kišobran - parasol
kišovit - deszczowy
kit - wieloryb
kititi - zdobić
kivi - kiwi
klijent - klient
klima - klimat
klimatologija - klimatologia
klinika - klinika
klinjo - dzieciak
klinka - dzieciak
klip - tłok
kljova - kieł
klon - klon
kneginja - księżniczka
knez - książę
knjiga - książka
knjižar - księgarz
književni - literacki
književnost - literatura
knjižnica - biblioteka
kobalt - kobalt
kobasica - kiełbasa
kobra - kobra
kockar - hazardzista
kofa - wiadro
kofein - kofeina
kofer - walizka
koincidencija - zbieg okoliczności
kokos - kokos
kokosov orah - kokos
koktel - koktail
kolajna - medal | naszyjnik
kolektivan - zbiorowy
kolevka - kołyska
kolibri - koliber
kolibrić - koliber
kolijevka - kołyska
kolino - kolano
kolokvijalni - kolokwialny | potoczny
kolonija - kolonia
kolonizacija - kolonizacja
kolosalan - kolosalny
Kolumbija - Kolumbia
kolumbijski - kolumbijski
komarac - komar
komarica - komar
komedija - komedia
komentar - komentarz
komercijalan - komercyjny
kometa - kometa
komforno - wygodnie
komičar - komediant
komitet - komitet
Komori - Komory
komparacija - porównanie
kompetentan - kompetentny
kompjuter - komputer
kompjutor - komputer
kompleksan - złożony
kompleksnost - złożoność
kompletan - kompletny
kompletno - całkowicie
kompozicija - kompozycja
komšija - sąsiad
komšiluk - sąsiedztwo
komunikacija - komunikacja
koncizan - zwięzły
kondom - prezerwatywa
konferencija - konferencja
konflikt - konflikt
kongres - kongres | konferencja
konjak - koniak
konjaništvo - kawaleria | konnica
konjica - kawaleria | konnica
konkavan - wklęsły
konkubina - konkubina
konkurent - konkurent
konobarica - kelnerka
konop - lina | sznur
konopac - lina | sznur
konoplja - konopie
konopljarka - szczygieł
konotacija - konotacja | skojarzenie
konsenzus - konsensus | zgoda
konsonant - spółgłoska
konstantan - stały
konstantno - ciągle
konstelacija - gwiazdozbiór
kontakt - kontakt
kontekst - kontekst
kontinuirano - bezustannie
kontroverzan - kontrowersyjny
konveksan - wypukły
konvencionalan - konwencjonalny
konvoj - konwój
konzervativan - konserwatywny
konzul - konsul
kooperacija - współpraca | kooperacja
kopar - koper
koplje - włócznia
kopriva - pokrzywa
Koreja - Korea
korektno - poprawnie
korelacija - korelacja
koridor - korytarz
korisnik - użytkownik
kornjača - żółw
korozija - korozja
korpa - kosz
korporacija - korporacja
koš - kosz
košara - kosz
košnica - ul
Kosovo - Kosowo
kost - kość
Kostarika - Kostaryka
kovač - kowal
kovačica - kowal
koza - koza
kozmički - kosmiczny
krađa - kradzież
kradljivac - złodziej
krajnost - skrajność
kraljević - książę
kraljevina - królestwo
kraljevna - księżniczka
kraljevski - królewski
krap - karp
krasiti - zdobić
krastača - ropucha
krastavac - ogórek
krater - krater
kravar - pasterz
krčag - dzban
krcat - pełny
kreativan - kreatywny
kreativnost - kreatywność
kreditor - wierzyciel
kremen - krzemień
kresnica - świetlik
kretanje - ruch
kretenast - idiotyczny
kretnja - ruch
krevet - łóżko
krhak - delikatny
krijesnica - świetlik
krijumčar - przemytnik
kriminalan - przestępczy | kryminalny
kriomice - w sekrecie
kripton - krypton
krišom - w sekrecie
kristal - kryształ
kriti - ukryć
kritičar - krytyk
krivovjerje - herezja
krivovjerstvo - herezja
kriza - kryzys
krizmati - potwierdzać
kroasan - croissant
krokodil - krokodyl
krštenje - chrzest
kruna - korona
ksenofobija - ksenofobia
ksenon - ksenon
ksilofon - ksylofon
Kuba - Kuba
kubanski - kubański
kubizam - kubizm
kuća - dom
kućanica - gospodyni domowa
kufer - walizka
kuk - biodro
kukavica - kukułka | figurka ptaka w ściennych zegarach | wysuwająca się ze środka w równych odstępach czasu | tchórz
kukavičluk - tchórzostwo
kukuruz - kukurydza
kuloar - korytarz
kult - kult
kupaonica - łazienka
kupatilo - łazienka
kupina - jeżyna
kupler - alfons | sutener
kupus - kapusta
kurij - kiur
kurjak - wilk
kurkumin - kurkumina
kurtoazan - uprzejmy
kurtoazija - uprzejmość
kušin - poduszka
Kuvajt - Kuwejt
kvalitativan - jakościowy
kvantitativan - ilościowy
kvantitet - ilość
kvantiteta - ilość
kvasac - drożdże
labirint - labirynt
labud - łabędź
lagumdžija - górnik
laguna - laguna
lajkati - lubić
lakat - łokieć
lakoničan - lakoniczny
lala - tulipan
lampa - lampa
lan - len
lani - w zeszłym roku
lantan - lantan
Laos - Laos
laser - laser
lasica - łasica
lateks - lateks
latentan - ukryty
latica - płatek
Latvija - Łotwa
lauta - lutnia
lavica - lwica
lavina - lawina | osuwisko
lawrencij - lorens
lažac - kłamca
lažljivac - kłamca
lažov - kłamca
lebdelica - poduszkowiec
lebdjelica - poduszkowiec
led - lód
ledenjak - lodowiec
legendaran - legendarny
legija - legion
legislativan - ustwodawczy
legura - stop
lekcija - lekcja
leksikon - leksykon
lenj - leniwy
lenost - lenistwo
leopard - lampart
lepeza - wachlarz
lepilo - klej
lešinar - sęp
lešnik - orzech laskowy
Lesoto - Lesotho
let - lot
letargija - letarg
Letonija - Łotwa
leut - lutnia
Libanon - Liban
liberalan - liberalny
liberalizam - liberalizm
Liberija - Liberia
Libija - Libia
licemer - hipokryta
licemerje - hipokryzja
licemjer - hipokryta
licemjerje - hipokryzja
licemjerstvo - hipokryzja
lična imenica - nazwa własna
lično - osobiście
lignja - kalmar
Lihtenštajn - Liechtenstein
lihvarenje - lichwa
lijen - leniwy
lijenost - lenistwo
lijes - trumna
lijevak - lejek
liker - likier
likopen - likopen
limunada - lemoniada
lingvist - językoznawca
lingvista - językoznawca
lira - lira
listonoša - listonosz
literaran - literacki
literatura - literatura
litica - klif
litij - lit
litijum - lit
liturgija - liturgia
Litvanija - Litwa
livada - łąka
ljepilo - klej
lješnik - orzech laskowy
ljiljan - lilia
ljubav - miłość | zakochanie
ljubomora - zazdrość
ljubomoran - zazdrosny | zawistny
ljudožder - kanibal
ljutnja - gniew
lobanja - czaszka
logaritam - logarytm
logičan - logiczny
logičar - logik
logičarka - logik
logički - logiczny
logika - logika
logor - obóz
lojalnost - lojalność
lokalan - lokalny
lokot - kłódka
lokva - kałuża
lončar - garncarz
London - Londyn
lorensij - lorens
losos - łosoś
lotos - lotos
lovor - wawrzyn
lozinka - hasło
ložnica - sypialnia | łóżko
lubanja - czaszka
lubenica - arbuz
lud - szalony
ludilo - szaleństwo
lug - ług
lukav - przebiegły | chytry
luksus - luksus
luksuz - luksus
luksuzan - luksusowy
lunaran - księżycowy
lupež - złodziej
lutalac - wędrowiec | wędrownik
lutalica - wędrowiec | wędrownik
lutecij - lutet
lutnja - lutnia
lutrija - loteria
mač - miecz
maćeha - macocha
Madagaskar - Madagaskar
Mađarska - Węgry
mađioničar - magik
madrac - materac
Madžarska - Węgry
magarac - osioł
magičan - magiczny
magičar - magik
magija - magia
magla - mgła
magnetičan - magnetyczny
magnetizam - magnetyzm
magnetni - magnetyczny
magnezij - magnez
mahovina - mech
maj - maj
majestetičan - majestatyczny | królewski
majka - matka
majoneza - majonez
mak - mak
Makao - Macau
makar - przynajmniej
makro - alfons | sutener
maksimum - maksimum
mal - mały
malarija - malaria
Malavi - Malawi
Maldivi - Malediwy
malen - mały
maler - malarz
malešan - mały
Malezija - Malezja
Mali - Mali
maliciozan - złośliwy
maliciozno - złośliwie
Malta - Malta
malter - moździerz
mandragora - mandragora
mangan - mangan
manipulacija - manipulacja
manjina - mniejszość
manuskript - rękopis | manuskrypt
marelica - morela
Maroko - Maroko
mart - marzec
masakr - masakra
maslac - masło
mašta - wyobraźnia
matematika - matematyka
materijal - materiał
mȁti - matka
mator - stary | starszy
matrica - macierz
Mauretanija - Mauretania
Mauricijus - Mauritius
Mauritanija - Mauretania
maz - maść
medijator - mediator
meditacija - medytacja
međunarodni - międzynarodowy
međusoban - wzajemny
meduza - meduza
mehaničar - mechanik
mehanizam - mechanizm
meitnerij - meitner
mek - miękki
meksički - meksykański
melek - anioł
mendelevij - mendelew
menstruacija - miesiączka | menstruacja
meriti - mierzyć
mesar - rzeźnik
mȅsēc - księżyc | miesiąc
mesečar - lunatyk
mesečina - światło księżyca
meso - mięso
meštanin - mieszczanin
meštanka - mieszczanka
meta - cel
metabolizam - metabolizm
metafizika - metafizyka
metak - pocisk
metamorfoza - metamorfoza | przeobrażenie
meteorit - meteoryt
meteorologija - meteorologia
metla - miotła
metoda - metoda
metropolis - metropolia
mezarje - cmentarz
mikrobiologija - mikrobiologia
mikrofon - mikrofon
Mikronezija - Mikronezja
mikroorganizam - mikroorganizm
mikroskop - mikroskop
milja - mila
mimar - architekt | budowniczy
minaret - minaret
minđuha - kolczyk
minđuša - kolczyk
mineral - minerał
mineralog - mineralog
miraz - posag
mirođija - koper
miš - mysz
mišar - myszołów
mišić - mięsień
mišica - mysz | ramię
misija - misja
misirski - egipski
mislilac - myśliciel
mišljenje - opinia
misteriozan - tajemniczy
misteriozno - tajemniczo
mit - mit
mito - łapówka
mitologija - mitologia
mjed - mosiądz
mjeriti - mierzyć
mjesec - księżyc | miesiąc
mjesečar - lunatyk
mjesečina - światło księżyca
mjesni - lokalny
mještanin - mieszczanin
mještanka - mieszczanka
mlȃd - młody
mlatiti - uderzyć
mlinar - młynarz
mobilnost - mobilność
močvara - bagno
mȍdar - niebieski
modem - modem
moderan - nowoczesny | współczesny
mogranj - granat
mogućnost - możliwość
moj - mój
mokraća - mocz
Moldavija - Mołdawia
molitva - modlitwa
moljac - ćma
monarhija - monarchia
monetarni - pieniężny
Mongolija - Mongolia
monogamija - monogamia
monoteizam - monoteizm
monstrum - potwór
monsun - monsun
moralan - moralny
more - morze
morfologija - morfologia
mornar - żeglarz
morski pas - rekin
morski šipak - granat
mortalitet - śmiertelność
morž - mors
mošeja - meczet
Mostar - Mostar
motivacija - motywacja
motocikl - motocykl
Mozambik - Mozambik
možda - może
mračan - ponury
mrak - ciemność
mrav - mrówka
mrkva - marchew
mržnja - nienawiść
mučenica - męczennik
mučenik - męczennik
mudar - mądry
mudrost - mądrość
mukom - cicho
munara - minaret
municija - amunicja
murva - morwa
mušičav - kapryśny | zmienny
muslimanski - muzułmański
mutacija - mutacja
mužar - moździerz
muzej - muzeum
muzika - muzyka
načelo - zasada | reguła
nacionalizam - nacjonalizm
nada - nadzieja
nadimak - przydomek
nadležnost - jurysdykcja | kompetencja
nadliška - mandragora
nag - nagi
naizmeničan - zmienny
naizmjeničan - zmienny
najaviti - ogłaszać
najavljivati - ogłaszać
najednom - nagle | niespodziewanie
nameniti - zamierzać
namenjivati - zamierzać
nameravati - mieć zamiar | planować
nametnik - pasożyt
Namibija - Namibia
namijeniti - zamierzać
namjenjivati - zamierzać
namjeravati - mieć zamiar | planować
naočit - przystojny
napadač - napastnik
napadačica - napastnik
napijati - upić | upić się
napiti - upić | upić się
napolje - na zewnątrz
naposletku - w końcu
naposljetku - w końcu
na primer - na przykład
na primjer - na przykład
nar - granat
narativan - narracyjny
naravno - oczywiście
narečje - dialekt
narječje - dialekt
narkotik - narkotyk
narodnost - narodowość
narukvica - bransoletka
naslediti - dziedziczyć
nasleđivati - dziedziczyć
naslepo - ślepo
naslijediti - dziedziczyć
naslijepo - ślepo
nasljeđivati - dziedziczyć
naslonjač - fotel
naslovnik - adresat
nasmešiti - uśmiechać się
nasmiješiti - uśmiechać się
nasrnuti - atakować
nasrtati - atakować
naštancati - drukować
naterati - zmusić
nateravati - zmusić
naterivati - zmusić
natjerati - zmusić
natjeravati - zmusić
natjerivati - zmusić
natrag - wstecz
nauka - nauka
naumiti - mieć zamiar | planować
naušnica - kolczyk
naveče - wieczorem
navečer - wieczorem
nazad - wstecz
nazalni - nosowy
nažalost - niestety
neadekvatan - nieadekwatny
nebriga - lekkomyślność
nečitak - nieczytelny
nečitljiv - nieczytelny
nedavno - ostatnio
neđe - gdzieś
nedelja - niedziela | tydzień
nedeljiv - niepodzielny
nedjelja - niedziela
nedjeljiv - niepodzielny
nedostatak - niedobór | defekt | wada
nedužnost - niewinność
neefikasan - nieskuteczny
negde - gdzieś
negđe - gdzieś
negdje - gdzieś
neimar - architekt | budowniczy
neimaština - bieda
neizlečiv - nieuleczalny
neizlječiv - nieuleczalny
neizvesnost - niepewność
neizvestan - niepewny
neizvjesnost - niepewność
neizvjestan - niepewny
nejače - niemowlę
nejak - słaby
nejednak - nierówny
nejednakost - nierówność
nekamo - gdzieś
neko - około | ktoś
nekoristan - bezużyteczny
nektar - nektar
nekud - gdzieś
nekuda - gdzieś
nelegalan - nielegalny
neljudski - nieludzki
nelojalan - nielojalny
Nemačka - Niemcy
nemoguć - niemożliwy
nemoral - niemoralność
nemoralan - niemoralny
nenadano - nagle | niespodziewanie
nenazočan - nieobecny
neobjašnjiv - niewytłumaczalny
neočekivan - nieoczekiwany
neočekivano - niespodziewanie
neodgovoran - nieodpowiedzialny
neodimij - neodym
neodoljiv - nieodaprty
neologizam - neologizm
neon - neon
neorganski - nieorganiczny
Nepal - Nepal
nepažnja - lekkomyślność
nepismen - niepiśmienny
nepobediv - niezwyciężony
nepobitan - niepodważalny
nepobjediv - niezwyciężony
nepodmitljiv - nieprzekupny
neporeciv - niepodważalny
neposlušan - nieposłuszny
nepotpun - niekompletny
nepotreban - niepotrzebny
nepoznat - nieznany
nepravda - niesprawiedliwość
nepravilan - nieregularny
nepredviđeno - niespodziewanie
nepredvidljiv - nieprzewidywalny
neprihvatljiv - nieakceptowalny
neprijatan - nieprzyjemny
neprijatelj - wróg
neprisutan - nieobecny
neprovidan - nieprzezroczysty
neproziran - nieprzezroczysty
neptunij - neptun
neracionalan - irracjonalny
nerazdruživ - nierozłączny
nerazdvojan - nierozłączny
neredovit - nieregularny
neregularan - nieregularny
neshvatljiv - niezrozumiały
neškodljiv - niegroźny | nieszkodliwy
nesmisao - absurd
nestabilnost - niestabilność
nestanak - zniknięcie
nešto - coś
nestrpljenje - niecierpliwość
nestrpljiv - niecierpliwy
nestrpljivost - niecierpliwość
nestvaran - nierealny
netko - ktoś
neudoban - niewygodny
neugodan - nieprzyjemny | niewygodny
neuobičajen - nietypowy
neurologija - neurologia
neuspeo - nieudany
neuspešan - nieudany
neuspio - nieudany
neuspješan - nieudany
neustavan - niekonstytucyjny
neutešan - niepocieszony
neutešiv - niepocieszony
neutješan - niepocieszony
neutješiv - niepocieszony
neutralan - neutralny
neutralnost - neutralność
nezaboravljiv - niezapomniany
nezakonski - nielegalny
nezaposlen - bezrobotny
nezaposlenost - bezrobocie
nezdrav - niezdrowy
neznan - nieznany
neznatan - nieistotny
nezreo - niedojrzały
nigde - nigdzie
nigdje - nigdzie
Nigerija - Nigeria
nihilizam - nihilizm
nijedanput - nigdy
nikad - nigdy
nikal - nikiel
nikamo - nigdzie
Nikaragva - Nikaragua
niko - nikt
ništa - nic
nitko - nikt
nitkov - łajdak
Nizozemska - Holandia
njegov - jego
Njemačka - Niemcy
njezin - jej
njihalo - wahadło
nobelij - nobel
noć - noc
noćna mora - koszmar
noga - noga
noj - struś
nomenklatura - nomenklatura
normalno - normalnie
Norveška - Norwegia
nosorog - nosorożec
nostalgija - nostalgia
novac - pieniądze
novačiti - rekrutować
novčani - finansowy | pieniężny
novčanica - banknot
novčanik - portfel
novčić - moneta
novembar - listopad
Novi Zeland - Nowa Zelandia
novotvorenica - neologizm
nozdrva - nozdrze
nuklearni - jądrowy | nuklearny
nukleus - jądro
nutrašnji - wewnętrzny
nužan - potrzebny
nužda - potrzeba | konieczność
nuždan - potrzebny
nužnik - toaleta
nužnost - konieczność
obalni - przybrzeżny
obećanje - obietnica
obelisk - obelisk
obelodaniti - ujawniać
obelodanjivati - ujawniać
obijač - włamywacz
objašnjenje - wyjaśnienie
objelodaniti - ujawniać
objelodanjivati - ujawniać
oblak - chmura
obmana - oszustwo
oboa - obój
obrazovan - wykształcony
obrazovni - edukacyjny
obred - rytuał
obrva - brew
obućar - szewc
obući - ubierać się
obzor - horyzont
obzorje - horyzont
očaj - rozpacz
očajanje - rozpacz
ocat - ocet
očekivanje - oczekiwanie
oceniti - ocenić | oceniać
ocenjivati - ocenić | oceniać
očigledno - oczywiście
ocijeniti - ocenić | oceniać
očito - oczywiście
ocjenjivati - ocenić | oceniać
očuh - ojczym
odabirati - wybierać
odabrati - wybierać
odeća - odzież
odeliti - oddzielać
odeljivati - oddzielać
odenuti - ubierać się
odevati - ubierać się
odgovoran - odpowiedzialny
odgovornost - odpowiedzialność
odijeliti - oddzielać
odijevati - ubierać się
odjeća - odzież
odjedanput - nagle | niespodziewanie
odjednom - nagle | niespodziewanie
odjeljivati - oddzielać
odjenuti - ubierać się
odluka - decyzja
odmeravati - odważyć | mierzyć
odmeriti - odważyć | mierzyć
odmjeravati - odważyć | mierzyć
odmjeriti - odważyć | mierzyć
odobrenje - akceptacja
odsutan - nieobecny
odvratnost - wstręt | odraza
odžak - komin
ofarbati - malować
oganj - ogień
ogledalo - lustro
ogrejati - ogrzewać
ogrejavati - ogrzewać
ogrijati - ogrzewać
ogrijavati - ogrzewać
ohol - arogancki | wyniosły | zarozumiały
ojzder - tutaj
Okeanija - Oceania
okoliš - środowisko
okolnost - okoliczność
okoločep - mandragora
okrutan - okrutny
okrutno - okrutnie
oksid - tlenek
oktobar - październik
oligarhija - oligarchia
oltar - ołtarz
olujni - burzliwy
Oman - Oman
omlet - omlet
on - on
onda - wówczas | potem
onde - tam
ondje - tam
onesposobiti - uniemożliwić
onesposobljavati - uniemożliwić
onesposobljivati - uniemożliwić
onkologija - onkologia
onomatopeja - onomatopeja
opasan - niebezpieczny
opasnost - niebezpieczeństwo
opat - opat
opatica - przeorysza
opcija - opcja
opera - opera
opet - znowu | znów
opijati - upić | upić się
opis - opis
opiti - upić | upić się
oponent - oponent
opredeliti - zdecydować
opredeljivati - zdecydować
opredijeliti - zdecydować
opredjeljivati - zdecydować
opresija - ucisk
oprost - przebaczenie
oprostite - przepraszam
opscen - obsceniczny
opsedati - oblegać | nie dawać spokoju
opsesija - obsesja
opsesti - oblegać | nie dawać spokoju
opsjedati - oblegać | nie dawać spokoju
opsjesti - oblegać | nie dawać spokoju
optimizam - optymizm
orah - orzech włoski
oralni seks - seks oralny
orangutan - orangutan
orao - orzeł
organizacija - organizacja
organizam - organizm
organski - organiczny
orgazam - orgazm
orgija - orgia
orkan - huragan
orkestar - orkiestra
ornitologija - ornitologia
ortodoksan - ortodoksyjny
ortografija - ortografia
oruđe - narzędzie
oružje - broń
os - oś
osamdeset - osiemdziesiąt
osamljenost - samotność
osamnaest - osiemnaście
osmeh - uśmiech
osmij - osm
osmijeh - uśmiech
osmjehnuti - uśmiechać się
osnivač - założyciel
osnivačica - założyciel
osnivati - ustanowić | ufundować
osnovati - ustanowić | ufundować
osoba - osoba
osobito - szczególnie | zwłaszcza
osobna imenica - nazwa własna
osovina - oś
ostava - spiżarnia
oštriti - ostrzyć
osumnjičenik - podejrzany
osvajanje - podbój
osveta - zemsta
osvežavati - odświeżać
osvežiti - odświeżać
osvježavati - odświeżać
osvježiti - odświeżać
otac - ojciec
otapati - roztopić się
otkriće - odkrycie
otkriti toplu vodu - na nowo odkryć koło
otkrivati toplu vodu - na nowo odkryć koło
otkupnina - okup
otopiti - roztopić się
otrov - trucizna | jad
ovalan - owalny
ovarij - jajnik
ovas - owies
ovde - tutaj
ovdje - tutaj
ozbiljan - poważny
ozbiljno - poważnie
ožiljak - blizna
ozlediti - ranić
ozleđivati - ranić
ozlijediti - ranić
ozljeđivati - ranić
pačić - kaczątko
pacijent - pacjent
pacijentica - pacjent
pacijentkinja - pacjent
padati - upaść
padavica - padaczka | epilepsja
padobran - spadochron
pakao - piekło
Pakistan - Pakistan
pakosno - złośliwie
pakostan - złośliwy
paladij - pallad
palata - pałac | rezydencja
Palestina - Palestyna
palindrom - palindrom
Panama - Panama
panda - panda
pandža - pazur
panika - panika
panorama - panorama
panseksualnost - panseksualizm
pant - zawias
panteizam - panteizm
papagaj - papuga
papiga - papuga
paprat - paproć
papuča - kapeć
par - para
paradajz - pomidor
paradoks - paradoks
Paragvaj - Paragwaj
parazit - pasożyt
pare - pieniądze
parfem - perfumy
Pariz - Paryż
park - park
parlament - parlament
parlamentaran - parlamentarny
parodija - parodia
participacija - uczestnictwo
partner - partner
pasoš - paszport
pastir - pasterz
pastuh - ogier
pastuv - ogier
patologija - patologia
patrijarh - patriarcha
patriotizam - patriotyzm
pauk - pająk
paun - paw
pavijan - pawian
pčelinjak - pasieka
pećina - jaskinia
pedeset - pięćdziesiąt
pega - pieg
pekar - piekarz
pekara - piekarnia
pekarica - piekarz
pekarna - piekarnia
pekarnica - piekarnia
pena - piana
pepeljara - popielniczka
perina - poduszka
peršin - pietruszka
personalan - osobisty
personifikacija - personifikacja
Peru - Peru
perverzija - perwersja
pesak - piasek
pešice - pieszo
peške - pieszo
peškir - ręcznik
pesnik - poeta
pesnikinja - poetka
petak - piątek
petao - kogut
peti - piąty
petljancija - intryga
petnaest - piętnaście
pevac - kogut
pigment - barwnik
pijan - pijany
pijanac - pijak
pijanica - pijak
pijano - pianino
pijanstvo - pijaństwo
pijavica - pijawka
pijesak - piasek
pijetao - kogut
pijevac - kogut
pile - pisklę
pingvin - pingwin
pirat - pirat
pirinač - ryż
pisac - pisarz | autor
pismohrana - archiwum
pismonoša - listonosz
pitanje - pytanie
pitoreskan - malowniczy
pivo - piwo
pjega - pieg
pjena - piana
pješice - pieszo
pješke - pieszo
pjesnik - poeta
pjesnikinja - poetka
pjesništvo - poezja
pjevanje - śpiew
plaćenica - najemnik
plaćenik - najemnik
plan - plan
planet - planeta
planeta - planeta
planina - góra
plantaža - plantacja
plastika - plastik | tworzywo sztuczne
platina - platyna
plavičast - niebieskawy
plaža - plaża
plemenit - szlachetny
plemenitaš - szlachcic
plemić - arystokrata
pleonazam - pleonazm
ples - taniec
plitak - płytki
plivalište - basen
plivanje - pływanie
pljačka - rabunek
pločnik - chodnik
plod - owoc
plovućac - pumeks
plovučac - pumeks
plutača - boja | pława
plutonij - pluton
pobačaj - poronienie
pobeći - uciec
pobeda - zwycięstwo
pobednik - zwycięzca
pobjeći - uciec
pobjeda - zwycięstwo
pobjednik - zwycięzca
početak - początek
početnik - początkujący
podgrejati - ogrzewać | ożywić
podgrejavati - ogrzewać | ożywić
podgrijati - ogrzewać | ożywić
podgrijavati - ogrzewać | ożywić
podijeliti - podzielić
podmićivati - przekupić
podmititi - przekupić
podmornica - łódź podwodna
podne - południe
podnevni - południe
podražaj - bodziec
podstrek - bodziec
poezija - poezja
pogovor - epilog | zakończenie
pogrešan - błędny | zły
pohvala - pochwała
pojačalo - wzmacniacz
pojedinačno - indywidualnie
poklon - prezent
pokop - pogrzeb
pokrajinski - regionalny
polagan - powolny | stopniowy
polagano - powoli | stopniowo
polako - powoli
polica - półka
policajac - policjant
policija - policja
poligamija - poligamia
poligon - wielokąt
politeizam - politeizm
politički - polityczny
polje - pole
Poljska - Polska
poljubac - pocałunek
polni akt - akt seksualny
polni čin - akt seksualny
polonij - polon
polonijum - polon
polovina - połowa
polubrat - brat przyrodni
poluga - dźwignia
poluotok - półwysep
pomagač - pomocnik | asystent
pomisao - pomysł
pomoć - pomoc
pomoćnik - asystent
ponaosob - indywidualnie
ponašanje - zachowanie
ponedeljak - poniedziałek
ponedjeljak - poniedziałek
ponekad - czasami
ponestajati - wyczerpać
ponestati - wyczerpać
poni - kucyk
poniženje - upokorzenie
ponoć - północ
ponos - duma
ponosan - dumny
ponosit - dumny
ponosito - dumnie
ponosno - dumnie
poplava - powódź
popodne - popołudnie
pora - por
poraz - porażka
porcelan - porcelana
poriluk - por
pornografski - pornograficzny
portret - portret
Portugal - Portugalia
Portugalija - Portugalia
poruka - wiadomość
posaditi - sadzić
posađivati - sadzić
posetilac - gość
posetitelj - gość
posjetilac - gość
posjetitelj - gość
posjetiteljica - gość
poslepodne - popołudnie
poslijepodne - popołudnie
poslodavac - pracodawca
poslovica - przysłowie
pospan - śpiący | senny
posramljen - zawstydzony
poštar - listonosz
postelja - łóżko
postiđen - zawstydzony
postojanje - egzystencja
postupan - stopniowy
postupno - stopniowo
posudba - pożyczka
posve - całkowicie | kompletnie
posvema - całkowicie | kompletnie
pot - pot
poteg - ruch
potencijal - potencjał
potencijalan - potencjalny
potkova - podkowa
potkovica - podkowa
potkupiti - przekupić
potkupljivati - przekupić
potok - strumyk
potomak - potomek
potpis - podpis
potplaćivati - przekupić
potplatiti - przekupić
potreba - potrzeba
potreban - potrzebny
potrošač - konsument
povećalo - lupa
povest - historia
povijesni - historyczny
povlastica - przywilej
povraćati - wymiotować
povrh - nad
poželjan - pożądany
praded - pradziadek
pradjed - pradziadek
praktičan - praktyczny
prapovijesni - prehistoryczny
prase - prosię
praseodimij - prazeodym
prašnjav - zakurzony
pravda - sprawiedliwość
pravokutnik - prostokąt
pravopis - ortografia
pravoveran - ortodoksyjny
pravovjeran - ortodoksyjny
praziluk - por
praznoveran - przesądny
praznoverje - przesąd
praznovernost - przesąd
praznovjeran - przesądny
praznovjerica - przesąd
praznovjerje - przesąd
praznovjernost - przesąd
prćija - posag
predavač - wykładowca
predgrađe - przedmieście
predmet - przedmiot
predmetak - przedrostek
predstavnik - reprezentant
predvidljiv - przewidywalny
prefiks - przedrostek
pregrejati - przegrzać się
pregrejavati - przegrzać się
pregrijati - przegrzać się
pregrijavati - przegrzać się
prehlada - przeziębienie
premijer - premier
preporuka - rekomendacja
prepreka - przeszkoda
prerija - preria
presecati - rozciąć | użyć skrótu
preseći - rozciąć | użyć skrótu
presijecati - rozciąć | użyć skrótu
presjeći - rozciąć | użyć skrótu
prestiž - prestiż
presto - tron
prestolje - tron
pretilost - otyłość
pretio - otyły
pretjeranost - przesada
pretnja - groźba
pretpovijesni - prehistoryczny
pretpovijest - prehistoria
pretražiti - szukać
pretraživati - szukać
prevod - tłumaczenie
prevodilac - tłumacz
prezervativ - prezerwatywa
prezir - pogarda
prhut - łupież
približan - przybliżony
približno - około
pridev - przymiotnik
pridevni - przymiotnikowy
pridevski - przymiotnikowy
pridjev - przymiotnik
pridjevni - przymiotnikowy
pridjevski - przymiotnikowy
prihvatljiv - do przyjęcia | zadowalający
prijatan - przyjemny
prijatelj - przyjaciel
prijateljski - przyjazny
prijateljstvo - przyjaźń
prijesto - tron
prijestol - tron
prijestolje - tron
prijetnja - groźba
prijevod - tłumaczenie
prijezir - pogarda
prilagodba - adaptacja
priložni - przysłówkowy
primećivati - zauważyć | komentować
primeniti - zastosować | użyć
primenjivati - zastosować | użyć
primerice - na przykład
primetan - dostrzegalny
primetiti - zauważyć | komentować
primetljiv - dostrzegalny
primetljivo - zauważalnie
primetno - zauważalnie
primijeniti - zastosować | użyć
primijetiti - zauważyć | komentować
primjećivati - zauważyć | komentować
primjenjivati - zastosować | użyć
primjerice - na przykład
primjetan - dostrzegalny
primjetljiv - dostrzegalny
primjetljivo - zauważalnie
primjetno - zauważalnie
princ - książę
princeza - księżniczka
princip - zasada | reguła
prioritet - priorytet
pripovedati - opowiadać
pripovediti - opowiadać
pripovest - opowieść
pripovetka - opowieść
pripovijedati - opowiadać
pripovijest - opowieść
pripovijetka - opowieść
pripovjediti - opowiadać
pripravan - gotowy | przygotowany
prirodan - naturalny
prirodno - naturalnie
prisega - przysięga
prišt - krosta
privatni - prywatny
privilegij - przywilej
privilegija - przywilej
prljav - brudny
prljavština - brud
probitačan - korzystny
problem - problem
procedura - procedura
procena - ocena | oszacowanie
proceniti - oceniać | szacować
procenjivati - oceniać | szacować
proces - proces
procijeniti - oceniać | szacować
procjena - ocena | oszacowanie
procjenjivati - oceniać | szacować
prodaja - sprzedaż
produkcija - produkcja
profesor - profesor
profit - zysk
profitabilan - korzystny
prognanica - uchodźca | wygnaniec
prognanik - uchodźca | wygnaniec
programska podrška - oprogramowanie
progres - postęp
proizvoljan - arbitralny
proizvoljno - dowolnie
projekcija - projekcja
proleće - wiosna
proliv - biegunka
proljeće - wiosna
proljev - biegunka
prolog - prolog
promer - średnica
prometij - promet
promjer - średnica
promocija - promocja
pronalazač - wynalazca
propaganda - propaganda
propoved - kazanie
propovedaonica - ambona
propovednik - kaznodzieja
propovijed - kazanie
propovjedaonica - ambona
propovjednik - kaznodzieja
prosečan - przeciętny
prosjak - żebrak
prosječan - przeciętny
proslov - prolog
prosperitet - pomyślność | dobrobyt
prostitucija - prostytucja
prostitutka - kurwa | prostytutka
protaktinij - protaktyn
protest - protest
protivnica - oponent | konkurent
protivnik - oponent | konkurent
protokol - protokół
proton - proton
protuznačnica - antonim
provalnik - włamywacz
providan - przeźroczysty
provizoran - tymczasowy
provokacija - prowokacja
prozor - okno
prsluk - kamizelka
prtljag - bagaż
prtljaga - bagaż
prvi - pierwszy
pšenica - pszenica
pseudonim - pseudonim
psihijatar - psychiatra
psihijatrija - psychiatria
psiholog - psycholog
psihologija - psychologia
psihoterapija - psychoterapia
ptȉca - ptak
publicitet - rozgłos | reklama
publikacija - publikacja
pudl - pudel
pudla - pudel
puh - popielica
punktualan - punktualny
punoglavac - kijanka
pustinja - pustynia
pustinjak - pustelnik
pustolov - poszukiwacz przygód
pustolovina - przygoda
putanja - tor | trajektoria
puter - masło
putir - kielich
putnik - pasażer | podróżnik
putovanje - podróż
puž - ślimak
rabin - rabin
račić - krewetka
racionalizam - racjonalizm
računalna znanost - informatyka
računarska znanost - informatyka
računovođa - księgowy
radar - radar
radij - rad
radijacija - promieniowanie
radio - radio
radioaktivan - radioaktywny
radionica - warsztat
radon - radon
radost - radość
radoznalost - ciekawość
ragbi - rugby
raketa - rakieta
ran - wczesny | przedwczesny
rana - rana
rano - wcześnie
rasizam - rasizm
raspoloživ - dostępny
rastava - rozwód
rat - wojna
ratifikacija - ratyfikacja
ratnik - wojownik
raž - żyto
razarač - niszczyciel
razdaljina - odległość
razglednica - pocztówka
razlika - różnica
raznolikost - różnorodność
raznovrsnost - różnorodność
razočarenje - rozczarowanie
razređivač - rozpuszczalnik
razrjeđivač - rozpuszczalnik
razumeti - rozumieć | chwytać
razumevati - rozumieć | chwytać
razumijevati - rozumieć | chwytać
razumjeti - rozumieć | chwytać
razvod - rozwód
rđa - rdza
reakcija - reakcja
realan - realistyczny | prawdziwy
realizam - realizm
realnost - rzeczywistość
rečnik - słownik
redovno - regularnie
referat - raport
reforma - reforma
registracija - rejestracja
rehabilitacija - rehabilitacja
reinkarnacija - reinkarnacja
reka - rzeka
rekreacija - rekreacja
relativno - względnie
religija - religia
religiozan - religijny
religiozno - religijnie
ren - chrzan
rendgenij - rutherford
renij - ren
renome - reputacja
rep - ogon
reprodukcija - reprodukcja
reptil - gad
republika - republika
republikanizam - republikanizm
republikanstvo - republikanizm
reputacija - reputacja
rešeto - sito
restoran - restauracja
retko - rzadko
retkost - rzadkość | ciekawość
revolucija - rewolucja
revolucionaran - rewolucyjny
revolver - rewolwer
rezanac - makaron
rezonancija - rezonans
rezultat - rezultat
ribar - rybak
ribolovac - rybak
riglati - zamknąć na klucz
rigorozan - rygorystyczny
rijeka - rzeka
rijetko - rzadko
rijetkost - rzadkość | ciekawość
Rim - Rzym
ripa - rzepa | burak
ris - ryś
ritam - rytm
ritual - rytuał
rivijera - wybrzeże
riža - ryż
rizik - ryzyko
rječnik - słownik
rob - niewolnik
robot - robot
roda - bocian
rođen - urodzony
rođendan - urodziny
rodij - rod
roditelj - rodzic
rodjen - urodzony
rodoljuban - patriotyczny
rodoljubiv - patriotyczny
rodoljublje - patriotyzm
rodoslovlje - genealogia
roj - rój
rojen - urodzony
romantičan - romantyczny
ronilac - nurek
ropstvo - niewolnictwo
rotacija - obrót
rotkva - rzodkiewka
Ruanda - Rwanda
rubidij - rubid
ručnik - ręcznik
rudar - górnik
ruho - ubranie
ruj - sumak
rukav - rękaw
runo - runo owcze
ruralan - wiejski
Rusija - Rosja
rutenij - ruten
rutherfordij - roentgen
ruž - szminka
ružan - brzydki
rvač - zapaśnik
sablazan - skandal
saborski - parlamentarny
sabotaža - sabotaż
saditi - sadzić
sadizam - sadyzm
safir - szafir
šafran - szafran
sag - dywan
saga - saga
sakriti - ukryć
sakrivati - ukryć
saksofon - saksofon
šal - szalik
salata - sałatka
šaman - szaman
samarij - samar
samoća - samotność
samoglas - samogłoska
samoglasnik - samogłoska
samoubojstvo - samobójstwo
šampanjac - szampan
šampon - szampon
sandala - sandał
sanjiv - śpiący | senny
sankcija - sankcja
San Marino - San Marino
santa - góra lodowa
šapat - szept
sapun - mydło
sarajevski - sarajewski
šaran - karp
sardina - sardynka
sarkastičan - sarkastyczny
sarkazam - sarkazm
sarkofag - sarkofag
šarmantan - uroczy
saruk - turban
sasma - całkowicie | kompletnie
sastajati - spotkać się
sastati - spotkać się
sasvim - całkowicie
satelit - satelita
šator - namiot
Saudijska Arabija - Arabia Saudyjska
sauna - sauna
savetodavac - doradca
saveznica - sojusznik
saveznik - sojusznik
savjetodavac - doradca
seaborgij - seaborg
sebičan - samolubny
šećer - cukier
sedamdeset - siedemdziesiąt
sedamnaest - siedemnaście
sedati - usiąść | siedzieć
sediment - osad
sekira - topór
seksizam - seksizm
seksualan - seksualny
seksualna orijentacija - orientacja seksualna
seksualnost - seksualność
sekta - sekta
sektor - sektor
sekularan - świecki
sekund - sekunda
selen - selen
selenij - selen
selenijum - selen
semenik - jądro
seminar - seminarium
senat - senat
senator - senator
sendvič - kanapka
senilan - starczy
seno - siano
senzualan - zmysłowy
separatan - oddzielny
septembar - wrzesień
šerif - szeryf
seriozan - poważny
seriozno - poważnie
serum - serum | surowica
šesnaest - szesnaście
sesti - usiąść
ševa - skowronek
Severna Amerika - Ameryka Północna
Severna Koreja - Korea Północna
severni - północny
šezdeset - sześćdziesiąt
sferičan - sferyczny
shizofrenija - schizofrenia
Sicilija - Sycylia
sićušan - maleńki
sidro - kotwica
sifilis - syfilis | kiła
signal - sygnał
sijalica - żarówka
siječanj - styczeń
sijeno - siano
Sijera Leone - Sierra Leone
silabičan - sylabiczny
silicij - krzem
silicijum - krzem
šilo - szydło
silueta - sylwetka
simbol - symbol
simboličan - symboliczny
simetrija - symetria
simfonija - symfonia
simulacija - symulacja
simultano - równocześnie
sinagoga - synagoga
Singapur - Singapur
sinonim - synonim
sinoniman - bliskoznaczny
sintaksa - składnia
sintetičan - syntetyczny
sinteza - synteza
šipražje - zarośla | gąszcz
šiptarski - albański
sir - ser
sirće - ocet
siroče - sierota
siromaštvo - bieda
sirotište - sierociniec
sirup - syrop
sisar - ssak
sistem - system
sistematičan - systematyczny
sito - sito
situacija - sytuacja
sjedati - usiąść
sjediniti - jednoczyć się
sjedinjavati - jednoczyć się
Sjedinjene Američke Države - Stany Zjednoczone Ameryki
sjekira - topór
sjekirčetina - topór
sjekiretina - topór
sjemenik - jądro
sjesti - usiąść
Sjeverna Amerika - Ameryka Północna
Sjeverna Koreja - Korea Północna
sjeverni - północny
skakavac - konik polny
skandal - skandal
skandij - skand
skandijum - skand
skela - prom
skija - narta
sklonidba - deklinacja
skok - skok
škola - szkoła
skorbut - szkorbut
škorpion - skorpion
Škotska - Szkocja
skraćenica - skrót
skrivati - ukryć
skulptura - rzeźba
skuša - makrela
skut - spódnica
slab - słaby
slabeti - słabnąć
slabjeti - słabnąć
slabost - słabość
slad - słód
sladoled - porcja lodów
slana - szron
šlapa - kapeć
slavan - słynny
sleđ - śledź
sledeći - następny
slednik - następca
sleng - slang
slep - ślepy
slepilo - ślepota
slepoća - ślepota
šleski - śląski
sličan - podobny
slijep - ślepy
slitina - stop
sljedeći - następny
sljednik - następca
sljepilo - ślepota
sljepoća - ślepota
sloboda - wolność
slogotvoran - sylabiczny
slon - słoń
Slovačka - Słowacja
Slovenija - Słowenia
složan - harmonijny
sluz - śluz
službeno - oficjalnie
smaragd - szmaragd
smeđ - brązowy
smeh - śmiech
smeniti - zastąpić | dymisjonować
smenjivati - zastąpić | dymisjonować
smeo - odważny
smeon - odważny
smerati - mieć zamiar | planować
smešak - uśmiech
smešan - śmieszny
smešiti - uśmiechać się
smijeh - śmiech
smijeniti - zastąpić | dymisjonować
smiješak - uśmiech
smiješan - śmieszny
smiješiti - uśmiechać się
smio - odważny
smion - odważny
smirna - mirra
smisao - znaczenie | sens
smjenjivati - zastąpić | dymisjonować
smjerati - mieć zamiar | planować
smokva - figa
smreka - świerk
smȑt - śmierć
smrtan - śmiertelny
smrtnost - śmiertelność
smučka - narta
snajperist - snajper
snažan - silny | potężny
snegovit - śnieżny
snen - śpiący | senny
snijeg - śnieg
šnitlah - szczypiorek
šnitling - szczypiorek
snjegović - bałwan śniegowy
snjegovit - śnieżny
sob - renifer
sočan - soczysty
sociolog - socjolog
sociologija - socjologia
šogor - szwagier
sojka - sójka
šojka - sójka
sok - sok
sokna - skarpeta
solarni vetar - wiatr słoneczny
solarni vjetar - wiatr słoneczny
solidarnost - solidarność
som - sum
Somalija - Somalia
somnambul - lunatyk
sonet - sonet
sopstven - własny
sova - sowa
špajza - spiżarnia
Španija - Hiszpania
Španjolska - Hiszpania
specifično - szczególnie
specifikacija - specyfikacja
spektakularan - spektakularny
sperma - sperma
špijun - szpieg
spilja - jaskinia
špilja - jaskinia
spirala - spirala
spiritualan - duchowy
spiritualno - duchowo
spisatelj - pisarz
spisateljica - pisarz
spletka - intryga
spolni akt - akt seksualny
spolni čin - akt seksualny
spomenik - pomnik
spontan - spontaniczny
sponzor - sponsor
sport - sport
spreman - gotowy
šprica - strzykawka
sprovod - pogrzeb
spužva - gąbka
sramežljivost - nieśmiałość
Srbija - Serbia
srditost - oburzenie | gniew
srebren - srebrny
srebrn - srebrny
srebrna - srebrny
srebroljubac - skąpiec
središte - centrum
Srednjoafrička Republika - Republika Środkowoafrykańska
srednjovekovni - średniowieczny
srednjovjekovni - średniowieczny
Šri Lanka - Sri Lanka
srnče - jelonek
srp - sierp
šta - co
stabilan - stabilny
stabljika - łodyga
stagnacija - stagnacja
staja - stajnia
štaka - kula
staklenka - słoik
stampedo - popłoch | panika
stanar - najemca
štancati - drukować
standardizacija - standaryzacja
stanište - habitat | środowisko
star - stary
starac - starzec
starica - staruszka
staromodan - staromodny
statistika - statystyka
štaviše - ponadto
stečaj - bankructwo
stegno - udo
štekdoza - gniazdko
stenica - pluskwa
stenj - knot
stepa - step
stidan - nieśmiały
stidljiv - nieśmiały
stidljivost - nieśmiałość | wstydliwość
štiglic - szczygieł
štiglić - szczygieł
stijeg - flaga
stijenj - knot
stil - styl
štit - tarcza
stjenica - pluskwa
stoga - dlatego
stoleće - wiek | stulecie
stoljeće - wiek | stulecie
stolnjak - obrus
stonoga - stonoga
štoviše - ponadto
stranac - obcokrajowiec
strašilo - strach na wróble
strašiti - przestraszyć
strategija - strategia
strateški - strategiczny
strelac - łucznik
streljivo - amunicja
stričak - oset
strijelac - łucznik
štrik - lina | sznur
stroncij - stront
strop - sufit
strpljiv - cierpliwy
strpljivost - cierpliwość
stršljen - szerszeń
stručnjak - ekspert | specjalista
struja - elektryczność | prąd | rzeka strumień
strvinar - sęp
stvar - rzecz
stvaran - prawdziwy
stvarnost - rzeczywistość
subota - sobota
sudac - sędzia
Sudan - Sudan
sudija - sędzia
sufiks - przyrostek
sugestija - sugestia
suglas - spółgłoska
suglasnik - spółgłoska
suicid - samobójstwo
sujetnost - próżność
sujeveran - przesądny
sujeverje - przesąd
sujevjeran - przesądny
sujevjerje - przesąd
suknja - spódnica
sukob - konflikt
sultan - sułtan
šuma - las
sumah - sumak
sumak - sumak
sumnjati - wątpić
sumnjivac - podejrzany
sumnjivost - wątpliwość
sunčan - słoneczny
sunce - słońce
Sunce - Słońce
sunčev vetar - wiatr słoneczny
sunčev vjetar - wiatr słoneczny
suncokret - słonecznik
sunovrat - żonkil
sup - sęp
supa - zupa
šupa - szopa
suparnik - konkurent | rywal
suprotnica - antonim
supstanca - substancja
supstancija - substancja
suptilan - subtelny
suša - susza
suseda - sąsiad
susedstvo - sąsiedztwo
susjeda - sąsiad
susjedstvo - sąsiedztwo
susnežica - deszcz ze śniegiem
susnježica - deszcz ze śniegiem
sutkinja - sędzia
suvenir - pamiątka
suvišak - nadmiar
svađa - kłótnia
svagde - wszędzie
svagdje - wszędzie
Švajcarska - Szwajcaria
svanuće - świt
sveća - świeca
svedok - świadek
Švedska - Szwecja
svest - świadomość
svetiljka - lampa
Sveti Toma i Princip - Wyspy Świętego Tomasza i Książęca
svetlo - światło
svež - świeży
Švicarska - Szwajcaria
švicarski - szwajcarski
svijeća - świeca
svijest - świadomość
svijet - świat
svila - jedwab
svilast - jedwabisty
svinjetina - wieprzowina
svjedok - świadek
svjedokinja - świadek
svjetiljka - lampa
svjetlo - światło
svjež - świeży
svladati - pokonać | przezwyciężyć
svladavati - pokonać | przezwyciężyć
svodnik - alfons | sutener
svojeglav - uparty
svraka - sroka
svud - wszędzie
svuda - wszędzie
tabor - obóz
tabu - tabu
tad - wówczas
tada - wówczas
Tadžikistan - Tadżykistan
taht - tron
tajfun - tajfun
Tajland - Tajlandia
tajna - tajemnica
tajno - w sekrecie
tajnost - tajemnica
Tajvan - Tajwan
takmac - rywal
taknuti - dotykać
taksi - taksówka
taktika - taktyka
talac - zakładnik
talas - fala
talent - talent
talij - tal
talog - osad
talpa - deska
tama - ciemność
tamnina - ciemność
tane - pocisk
tantal - tantal
Tanzanija - Tanzania
tapeta - tapeta
tarčin - cynamon
taština - próżność
tata - tata
tautologija - tautologia
tavan - strych
taze - świeży
tegla - słoik
tegotan - trudny
tehnecij - technet
tehničar - technik
tehnologija - technika
tekst - tekst
telegraf - telegraf
telegram - telegram
teletina - cielęcina
televizija - telewizja
telo - ciało
telohranitelj - ochroniarz
telur - tellur
telurij - tellur
temeljito - dokładnie | gruntownie
temperatura - temperatura
tenje - cień
teorija - teoria
tepih - dywan
terapija - terapia
terbij - terb
terminologija - terminologia
termometar - termometr
tesar - stolarz
tešiti - pocieszać
teškoća - trudność
testo - ciasto
testosteron - testosteron
tetka - ciotka
tetovaža - tatuaż
tetreb - głuszec
tetrijeb - głuszec
teža - grawitacja
Tihi okean - Ocean Spokojny
tihost - cisza
tijelo - ciało
tijenje - cień
tijesto - ciasto
tikva - dynia
tipičan - typowy
tiranija - tyrania
tiranin - tyran
tišina - cisza
titanij - tytan
titula - tytuł
tjelohranitelj - ochroniarz
tjelovježba - gimnastyka
tješiti - pocieszać
toalet - toaleta
točir - lejek
Togo - Togo
toksikologija - toksykologia
tolerancija - tolerancja
tolerantnost - tolerancja
topao - ciepły
toplina - ciepło
toplomer - termometr
toplomjer - termometr
toplota - ciepło
toranj - wieża
torij - tor
tortura - tortura
tovariš - towarzysz
tradicija - tradycja
tradicijski - tradycyjnie
tradicionalno - tradycyjnie
trag - ślad
tragičan - tragiczny
trajekt - prom
traktor - traktor
transakcija - transakcja
transmisija - transmisja
transparentan - przeźroczysty
tranzistor - tranzystor
trbušni - brzuszny
trend - trend
trenje - tarcie
trepavica - rzęsa
treset - torf
trešnja - czereśnia
trezan - trzeźwy
triangularan - trójkątny
tribunal - trybunał
tricikl - pojazd na trzech kołach | trójkołowiec
trideset - trzydzieści
trigonometrija - trygonometria
trijezan - trzeźwy
trijumf - triumf
trinaest - trzynaście
trivijalan - trywialny
trodimenzionalan - trójwymiarowy
trofej - trofeum
troposfera - troposfera
truba - trąbka
trudnoća - ciąża
tržnica - bazar
tuberkuloza - gruźlica
tuđin - obcokrajowiec
tulij - tul
tulipan - tulipan
tumač - tłumacz
tumačenje - interpretacja
tumačiti - wyjaśniać
tunel - tunel
tunika - tunika
tupež - nonsens
Turkmenistan - Turkmenia
turnir - turniej
Turska - Turcja
tuš - prysznic
tužaljka - lament
tužan - smutny
tvrdina - twardość
tvrdoća - twardość
tvrdoglavost - upór
ubistvo - morderstwo
ubog - biedny | nędzny | nieszczęsny
ubrzanje - przyspieszenie
ucena - szantaż
uceniti - szantażować
ucenjivati - szantażować
ucijeniti - szantażować
učionica - klasa
učitelj - nauczyciel
učiteljica - nauczycielka
ucjena - szantaż
ucjenjivati - szantażować
udaljenost - odległość
udovac - wdowiec
udovica - wdowa
udžbenik - podręcznik
Uganda - Uganda
uglavnom - głównie
ugljenik - węgiel
ugljik - węgiel
uhoda - szpieg
ujediniti - jednoczyć się
ujedinjavati - jednoczyć się
Ujedinjeni Arapski Emirati - Zjednoczone Emiraty Arabskie
Ujedinjeno Kraljevstvo - Zjednoczone Królestwo
ujutro - rano
ukor - reprymenda
ukoravati - ganić
ukoriti - ganić
ukraj - na bok
Ukrajina - Ukraina
ukrašavati - zdobić
ukrasiti - zdobić
ukratko - zwięźle
ulepšati - upiększać
ulepšavati - upiększać
ulica - ulica
uljepšati - upiększać
uljepšavati - upiększać
ulog - inwestycja
ultimatum - ultimatum
uludo - na próżno
umanjenica - zdrobnienie
umesto - zamiast
umetati - włożyć
umetnost - sztuka
umetnuti - włożyć
umjesto - zamiast
umjetnost - sztuka
umoran - zmęczony
unatrag - wstecz
unazad - wstecz
uništenje - zniszczenie
univerzitet - uniwersytet
univerzum - wszechświat
unuče - wnuk / wnuczka
unuk - wnuk
unuka - wnuczka
unutra - wewnątrz
upala - zapalenie
uposlenik - pracownik
upozorenje - ostrzeżenie
uragan - huragan
uran - uran
uranij - uran
urban - miejski
urgentan - nagły | pilny
urin - uryna
Urugvaj - Urugwaj
uš - wesz
usisivač - odkurzacz
uspavanka - kołysanka
uspeh - sukces
uspešno - skutecznie
uspeti - osiągnąć cel
uspevati - osiągnąć cel
uspijevati - osiągnąć cel
uspjeh - sukces
uspješno - skutecznie
uspjeti - osiągnąć cel
usud - przeznaczenie
uteći - uciec
utešiti - pocieszać
utješiti - pocieszać
utopija - utopia
utorak - wtorek
uveče - wieczorem
uvečer - wieczorem
uvek - zawsze
uvijek - zawsze
uvjetovan - warunkowy
uzajaman - wzajemny
uzalud - na próżno
uzaman - na próżno
Uzbekistan - Uzbekistan
uzbuđenje - ekscytacja
uzbuđenost - ekscytacja
uzdah - westchnienie
uzglavlje - poduszka
užitak - przyjemność
uzletati - startować
uzleteti - startować
uzletjeti - startować
uzlijetati - startować
uzrečica - przysłowie
uzrok - powód | przyczyna
uzrokovati - powodować
uzurpator - uzurpator
vakcina - szczepionka
vakum - próżnia
vakuum - próżnia
val - fala
valcer - walc
valuta - waluta
vampir - wampir
vanadij - wanad
vandalizam - wandalizm
varvarin - barbarzyńca
Vatikan - Watykan | Państwo Watykańskie
vatra - ogień
vatrogasac - strażak
vaza - wazon
vazal - wasal
već - już
veće - rada
veče - wieczór
vȅčēr - wieczór
večnost - wieczność
vedro - wiadro
veker - budzik
vekerica - budzik
velegrad - metropolia
veleposlanstvo - ambasada
velik - duży
Velika Britanija - Wielka Brytania
venčanje - ślub
Venecija - Wenecja
Venecuela - Wenezuela
veran - wierny
verifikacija - weryfikacja
vermut - wermut
vernik - wierzący
veroispoved - religia
verojatan - prawdopodobny
verovnik - wierzyciel
vertikalan - pionowy
verzija - wersja
veselo - szczęśliwie
veslo - wiosło
veštački - sztuczny
vetar - wiatr
veteran - weteran
veterinar - weterynarz
veterinarka - weterynarz
vetrenjača - wiatrak
veverica - wiewiórka
Vezuv - Wezuwiusz
videti - widzieć
vidljiv - widoczny
vidra - wydra
vijeće - rada
Vijetnam - Wietnam
vikend - weekend
vilinski konjic - ważka
vime - wymię
vino - wino
violina - skrzypce
violončelo - wiolonczela
vir - wir
visinomer - wysokościomierz
visinomjer - wysokościomierz
viza - wiza
vječnost - wieczność
vjeđa - powieka
vjedro - wiadro
vjenčanje - ślub
vjera - wierzenie | religia
vjeran - wierny
vjernik - wierzący
vjeroispovijed - religia
vjerojatan - prawdopodobny
vjerovatno - prawdopodobnie
vjerovnik - wierzyciel
vještački - sztuczny
vjetar - wiatr
vjetrenjača - wiatrak
vjeverica - wiewiórka
vlada - rząd
vlakno - włókno
vlasac - szczypiorek
vlasnica - właściciel
vlasnik - właściciel
vlastita imenica - nazwa własna
vlasulja - peruka
vlažan - wilgotny
vo - wół
voćnjak - sad
vodoinstalater - hydraulik
vodomar - zimorodek
vodopad - wodospad
vodoravan - poziomy
vojak - żołnierz
vojnički - wojskowy | militarny
vojnikinja - żołnierz
vojvotkinja - księżna
volan - kierownica
volfram - wolfram
voljno - chętnie | dobrowolnie
volt - wolt
vosak - wosk
votka - wódka
vozilo - wehikuł | środek transportu
vrag - diabeł
vrana - wrona
vrat - szyja
vreća - worek
vrednost - wartość
vres - wrzos
vrijednost - wartość
vrisak - krzyk
vrlo - bardzo
vrt - ogród
vuga - wilga
vuk - wilk
vukodlak - wilkołak
vuna - wełna
žaba - żaba
zaboravan - zapominalski
zaceliti - uzdrawiać
zaceljivati - uzdrawiać
zacelo - na pewno
zacijeliti - uzdrawiać
zacijelo - na pewno
zacjeljivati - uzdrawiać
zadovoljstvo - przyjemność
zagrljaj - uścisk | objęcie | przytulenie
zahvalan - wdzięczny
zahvaliti - dziękować
zajam - pożyczka
Zajednica Neovisnih Država - Wspólnota Niepodległych Państw
zajedno - razem
zajutrak - śniadanie
zakašnjenje - opóźnienie
zakletva - przysięga
zaključak - wniosek
žaljenje - żal
žalo - plaża
zaludu - na próżno
zambak - lilia
Zambija - Zambia
zamka - pułapka
zanimljiv - interesujący
žanr - gatunek | rodzaj
zao - zły
Zapadna Sahara - Sahara Zachodnia
zaposlenik - pracownik
zapovedati - rozkazywać
zapovediti - rozkazywać
zapovijedati - rozkazywać
zapovjediti - rozkazywać
zapreka - przeszkoda
zaprljati - pobrudzić
žargon - żargon
zariglati - zamknąć na klucz
žar-ptica - feniks
zasada - zasada | reguła
zasaditi - sadzić
zasađivati - sadzić
zaseda - zasadzka
zasjeda - zasadzka
zastava - flaga
zaštitni - ochronny
zastrašiti - przestraszyć
zastrašivati - przestraszyć
zato što - ponieważ
zatvorenik - więzień
zavazda - na zawsze
zavera - konspiracja
zavidljiv - zazdrosny | zawistny
zavist - zawiść
zavjera - konspiracja
završen - skończony
zbivati - zdarzyć się
zbogom - do widzenia
žbun - krzew
ždral - żuraw
zdrav - zdrowy
ždrebe - źrebię
ždrijebe - źrebię
zebra - zebra
zec - zając
žeđ - pragnienie
žedan - spragniony
zelenkast - zielonkawy
Zelenortska Republika - Republika Zielonego Przylądka
železnica - kolej
željeznica - kolej | transport kolejowy
Zemlja - Ziemia
zemljopis - geografia
zemljoradnik - rolnik
zemljoradnja - rolnictwo
zemljotres - trzęsienie ziemi
zena - źrenica
žena - kobieta | żona
zenica - źrenica
zenit - zenit
zerdelica - morela
zev - ziewnięcie
zevati - ziewać
zevnuti - ziewać
zgrada - budynek
zgrejati - ogrzewać
zgrejavati - ogrzewać
zgrijati - ogrzewać
zgrijavati - ogrzewać
zijev - ziewnięcie
zijevati - ziewać
zijevnuti - ziewać
žila - żyła | ścięgno
Zimbabve - Zimbabwe
zipka - kołyska
živica - żywopłot
život - życie
životinja - zwierzę
životopis - biografia
zjena - źrenica
zjenica - źrenica
zlatan - złoty
zlato - złoto
žlezda - gruczoł
žlica - łyżka
žlijezda - gruczoł
zloban - złośliwy | pełen złej woli
zločinac - przestępca
zločinski - przestępczy | kryminalny
zlonameran - złośliwy
zlonamerno - złośliwie
zlonamjeran - złośliwy
zlonamjerno - złośliwie
zmija - wąż
zmijuljica - minóg
značajan - znaczący
značajno - znacząco
znamenit - słynny
znatiželja - ciekawość
znoj - pot
zob - owies
zodijak - zodiak
žongler - żongler
zoolog - zoolog
zoologica - zoolog
zoologinja - zoolog
zoološki - zoologiczny
zoološki vrt - zoo
zora - świt
zračenje - promieniowanie | emisja
zračna luka - lotnisko
zrakoplovstvo - lotnictwo
zrcalo - lustro
zreo - dojrzały
žrtvenik - ołtarz
zub - ząb
zubobolja - ból zęba
žuč - żółć
žućkast - żółtawy
žumance - żółtko
žumanjak - żółtko
žuna - dzięcioł
žurnalistika - dziennikarstwo
žurnalizam - dziennikarstwo
žut - żółty
žvaka - guma do żucia
zvezda - gwiazda
zvijezda - gwiazda
zviždaljka - gwizdek
zviždati - gwizdać
zvučati - brzmieć
zvučiti - brzmieć
zvučnik - głośnik
новинарство - dziennikarstwo
