а - a, ale
абдикација - abdykacja
Авганистан - Afganistan
август - sierpień
аврамски - abrahamowy, abrahamiczny
агломерација - aglomeracja
адреса - adres
Азербејџан - Azerbejdżan
азербејџански - azerbejdżański
Азија - Azja
акумулатор - akumulator
албански - albański
алфабетски - alfabetyczny
амонијак - amoniak
Амстердам - Amsterdam
амфитеатар - amfiteatr
амхарски - amharski
анаболизам - anabolizm
анархија - anarchia
анархистички - anarchistyczny
Андора - Andora
анђел - anioł, cherubin
Анђела - Aniela
Анкара - Ankara
антитело - przeciwciało
апатија - apatia
апатит - apatyt
апостроф - apostrof
април - kwiecień
Арабија - Arabia
арапски - arabski
арија - aria
аристократија - arystokracja
арханђел - archanioł
астериск - asterysk, *
Аустралија - Australia
Аустрија - Austria
аустријски - austriacki
ауто - auto
аутомобил - samochód, auto
аутор - autor
Африка - Afryka
баба - babcia
Багдад - Bagdad
базен - basen
бакрорез - miedzioryt
балван - głaz
Бангкок - Bangkok
Бангладеш - Bangladesz
бара - kałuża
Барселона - Barcelona
баскијски - baskijski
Бахреин - Bahrajn
бацити - rzucić
безбедност - bezpieczeństwo
Бејрут - Bejrut
Белорусија - Białoruś
Бенин - Benin
Београд - Belgrad
бибер - pieprz
Бик - Byk
биографија - biografia
биологија - biologia
бистрина - jasność, przejrzystość, bystrość umysłu, inteligencja
бити - być, istnieć
Близанци - Bliźnięta
болест - choroba
Боливија - Boliwia
Борис - Borys
босански - bośniacki
бретонски - bretoński
број - cyfra, liczba, ilość
будизам - buddyzm
будућност - przyszłość
Бутан - Bhutan
Вага - Waga
вагина - pochwa
важно - znacząco, doniośle
ваздух - powietrze
вебсајт - strona internetowa
Везув - Wezuwiusz
век - wiek
вексилологија - weksylologia
Велика Британија - Wielka Brytania
Венецуела - Wenezuela
вештац - czarownik
вештица - wiedźma
видети - widzieć
Вијетнам - Wietnam
Википедија - Wikipedia
висок - wysoki
витализам - witalizm
Водолија - Wodnik
водоник - wodór
вук - wilk
галаксија - galaktyka
Гаргантуа - Gargantua
глобализација - globalizacja
говно - gówno
година - rok
голем - golem
голуб - gołąb
гравитација - grawitacja
град - miasto
градски - miejski
граматика - gramatyka
грегоријански - gregoriański
Грузија - Gruzja
гутати - połykać
Дамаск - Damaszek
дан - dzień
дан рођења - urodziny, dzień narodzin
два - dwa, 2
Девица - Panna
деклинација - deklinacja
демократија - demokracja
демократски - demokratyczny
де̏сетљеће - dziesięciolecie
деспотизам - despotyzm
дефиниција - definicja
деформација - deformacja
децембар - grudzień
деценија - dekada
дијаман - diament
диктатура - dyktatura
дистрикт - dystrykt
дифракција - dyfrakcja
до - do
добар - dobry
добар дан - dzień dobry
досада - nuda
дуга - tęcza
дух - duch
душа - dusza
ђакон - diakon
ђус - sok
е - siódma litera serbskiego alfabetu
екипа - ekipa, drużyna
емоција - emocja, uczucie
емпатија - empatia
енглески - angielski
ентузијазам - entuzjazm
енциклопедија - encyklopedia
естетика - estetyka
етимологија - etymologia
жељезо - żelazo
жена - żona, kobieta
живео - niech żyje
живети - żyć
живот - życie
животиња - zwierzę
забава - rozrywka
Замбија - Zambia
звук - dźwięk
згужвати - gnieść, miąć, zgnieść
зелен - zielony
зима - zima
Зимбабве - Zimbabwe
злато - złoto
значити - znaczyć, oznaczać, mieć dane znaczenie
и - i
играч - gracz, zawodnik
идеологија - ideologia
извините - przepraszam, proszę
Израел - Izrael
имати - mieć
име - imię
империјализам - imperializm
имуноглобулин - immunoglobina
Индија - Indie
Индонезија - Indonezja
интерференција - interferencja
интуиција - intuicja
искреност - szczerość
исламски - islamski, muzułmański
историја - historia
Исус - Jezus
италијански - włoski
јава - jawa
Јаков - Jakub
јантар - bursztyn
јануар - styczeń
Јапан - Japonia
Јарац - Koziorożec
јебати - jebać (uprawiać seks)
јеврејски - żydowski
језеро - jezioro
језик - język
Јемен - Jemen
Јерменија - Armenia
Јерусалим - Jerozolima
је̏се̄н - jesień
Јордан - Jordania
Јосиф - Józef
још - jeszcze
југ - południe
Јужна Америка - Ameryka Południowa
Јужна Кореја - Korea Południowa
Јужноафричка Република - Republika Południowej Afryki
јул - lipiec
јулијански - juliański
јун - czerwiec
Кабул - Kabul
Казахстан - Kazachstan
календар - kalendarz
Каљари - Cagliari
Камбоџа - Kambodża
камен - kamień
Капернаум - Kafarnaum
капитализам - kapitalizm
караван - karawana, konwój
кардиологија - kardiologia
Каталонија - Katalonia
Катар - Katar
категорија - kategoria
катињски масакр - zbrodnia katyńska
Квебек - Québec
Кенија - Kenia
Кипар - Cypr
киргиски - kirgiski
Киргистан - Kirgistan
класификација - klasyfikacja
класицизам - klasycyzm
кожа - skóra
који - jaki
кокош - kura
коментар - komentarz
комунизам - komunizm
континент - kontynent
корејски - koreański
корен - korzeń
корунд - korund
коса - włosy
кофеин - kofeina
кош - kosz, koszyk
крв - krew
креолски - kreolski
кретање - ruch
криза - kryzys
круг - koło, okrąg
Кувајт - Kuwejt
кула - wieża
Куран - Koran
курва - prostytutka, kurwa
кућа - dom
кухиња - kuchnia
лав - lew
Лав - Lew
лавина - lawina
лан - len
Лаос - Laos
Ласа - Lhasa
латински - łaciński
лексикологија - leksykologia
лето - lato
Летонија - Łotwa
Либан - Liban
либански - libański
Либерија - Liberia
литература - literatura
лов - polowanie
лук - łuk, cebula
љубав - miłość
љубити - kochać
људи - ludzie
магнолија - magnolia
Мађарска - Węgry
маздаизам - mazdaizm
мај - maj
македонски - macedoński
Малезија - Malezja
малина - malina
Манама - Manama
март - marzec
математика - matematyka
Мауританија - Mauretania
мачка - kot
мегахерц - megaherc
медитација - medytacja
међународни - międzynarodowy
меланхолија - melancholia
менструација - menstruacja
месец - miesiąc
метаболизам - metabolizm
метар - metr
метод - metoda
микробиологија - mikrobiologia
микрофон - mikrofon
милион - milion
минерал - minerał
мислити - myśleć
миш - mysz
Млечни пут - Droga Mleczna
множење - mnożenie
мобилни - mobilny
Молдавија - Mołdawia
молдавски - mołdawski
молитва - modlitwa
монархија - monarchia
Монголија - Mongolia
морски - morski
мотив - motyw
мотивација - motywacja
мотор - motor, silnik
Најроби - Nairobi
Намибија - Namibia
напад - napad, atak, napaść
наука - nauka
Наум - Nahum
нација - nacja, naród
небо - niebo
недеља - niedziela
немачки - niemiecki
неопагански - neopogański
Непал - Nepal
неучтив - nieuprzejmy
Никарагва - Nikaragua
Никозија - Nikozja
Никола - Mikołaj
Нова Гвинеја - Nowa Gwinea
новембар - listopad
новинарство - dziennikarstwo
норвешки - norweski
ноћ - noc
Њујорк - Nowy Jork (miasto)
о - o (czymś)
објашњење - objaśnienie, wyjaśnienie
облак - obłok, chmura
Ован - Baran
одбојка - siatkówka
око - oko
октобар - październik
олигарх - oligarcha
олуја - burza, sztorm, wiatr
Оман - Oman
он - on
органогенеза - organogeneza
ортографија - ortografia
острво - wyspa
осцилација - drganie
паганизам - pogaństwo
Пакистан - Pakistan
пас - pies
пацов - szczur
Пекинг - Pekin
период - okres
петак - piątek
Петар - Piotr
писати - pisać
писмо - pismo (system znaków)
пити - pić
по - po
површина - powierzchnia
под - pod, podłoga, podłoże
политика - polityka
пољопривреда - rolnictwo
Пољска - Polska
пољски - polski
помоћ - pomoc, ratunek, wsparcie
понедељак - poniedziałek
поноћ - północ
постеља - łóżko
почетак - początek
правда - sprawiedliwość
правопис - pisownia, ortografia
Праг - Praga
први - pierwszy
пријатељ - przyjaciel
пријатељство - przyjaźń
про̀леће - wiosna
прољев - biegunka
протокол - protokół
радост - radość
разум - rozum, mądrość
Рак - Rak, ♋
револуција - rewolucja
регистарска таблица - tablica rejestracyjna
реинкарнација - reinkarnacja
религијски - religijny
република - republika
риба - ryba
Рибе - Ryby
римски - rzymski
рођење - urodzenie, narodziny
рука - ręka
рукомет - piłka ręczna
Румунија - Rumunia
Русија - Rosja
Савезна Република Немачка - Republika Federalna Niemiec, Niemcy
самотник - samotnik, pustelnik
санскрт - sanskryt, санскрит
Сао Томе и Принципе - Wyspy Świętego Tomasza i Książęca
Сарајево - Sarajewo
Сардинија - Sardynia
са̑т - godzina
сателитски - satelitarny
Саудијска Арабија - Arabia Saudyjska
сахароза - sacharoza
светски - światowy
свиња - świnia
Северна Кореја - Korea Północna
секс - seks
секунда - sekunda, секунд
село - wieś
семе - ziarno
семитски - semicki
Сенегал - Senegal
септембар - wrzesień
сѐпте̄мбарскӣ - wrześniowy
сестра - siostra, pielęgniarka, sanitariuszka, mniszka, zakonnica
Сибир - Syberia
симбол - symbol
симпатија - sympatia
симпатичан - sympatyczny, miły, serdeczny
Сингапур - Singapur
синоним - synonim
сир - ser
Сирија - Syria
сиријски - syryjski
сисар - ssak
систем - system
сито - sito
Сицилија - Sycylia
скроб - skrobia
словачки - słowacki
слово - litera
слон - słoń
Сомалија - Somalia
социјализам - socjalizm
социологија - socjologia
Србија - Serbia
Сребреница - Srebrenica
среда - środa
срећа - szczęście, zadowolenie
српски - serbski
срце - serce
Стеван - Stefan
сто̀леће - stulecie
Стрелац - Strzelec
субота - sobota
Сузана - Zuzanna
Сумер - Sumer
Сунце - Słońce
суперхерој - superbohater
сфера - sfera
Тајван - Tajwan
Тајланд - Tajlandia
талас - fala
Танзанија - Tanzania
тата - tata, tatuś
Таџикистан - Tadżykistan
Ташкент - Taszkent
телевизија - telewizja
телефонија - telefonia
Теодор - Teodor
теорија - teoria
термин - termin, pojęcie
тесто - ciasto
Техеран - Teheran
технологија - technologia
тимски - drużynowy
типографија - typografia
тисућљеће - tysiąclecie
Тихи океан - Ocean Spokojny
тихо - cicho
тоалет - ubikacja, toaleta
топао - ciepły
Тоскана - Toskania
трамвај - tramwaj
транспорт - transport
трансформација - transformacja, przekształcenie
трг - targ, plac, forum
троцкизам - trockizm
тугрик - tugrik
Туркменистан - Turkmenistan
Турска - Turcja
ћерка - córka
ћирилица - cyrylica
ћирилични - związany z cyrylicą
у - w, we
Уганда - Uganda
угљеник - węgiel
Узбекистан - Uzbekistan
Уједињени Арапски Емирати - Zjednoczone Emiraty Arabskie
Украјина - Ukraina
уље - olej
унија - unia
урбанизација - urbanizacja
уста - usta
уторак - wtorek
учтив - uprzejmy
фебруар - luty
Фениција - Fenicja
феномен - zjawisko, fenomen
филозофија - filozofia
филологија - filologia
фински - fiński
фотосинтеза - fotosynteza
француски - francuski
фреквенција - częstotliwość
фрустрација - frustracja
футуризам - futuryzm
халитоза - halitoza, cuchnący oddech
Харков - Charków
хашиш - haszysz
хвала - dzięki!
хебрејски - hebrajski
хедонизам - hedonizm
херц - herc
Хималаји - Himalaje
хипотеза - hipoteza
хладан - zimny
холандски - niderlandzki, holenderski
хомеопатија - homeopatia
Хонгконг - Hong Kong
хор - chór
хотел - hotel
хришћанство - chrześcijaństwo
цврчак - świerszcz
целофан - celofan
цивилизација - cywilizacja
Црна Гора - Czarnogóra
четвртак - czwartek
Чехословачка - Czechosłowacja
чешки - czeski
чудо - cud
Џакарта - Dżakarta
џез - jazz
џеназа - pogrzeb
џихад - dżihad
џунгла - dżungla
шаховска табла - szachownica (plansza do gry)
Швајцарска - Szwajcaria
Шведска - Szwecja
шест - sześć
шећер - cukier
шећерна репа - burak cukrowy
Шкорпија - Skorpion
шпански - hiszpański
Шри Ланка - Sri Lanka
