abiri - przejeżdżać (przez jakieś miejsce), podróżować
abudu - czcić
acha - zostawiać, porzucać
ada - opłata
adhibu - karać, karcić, dręczyć
adhimisha - świętować
adhuhuri - pora dnia między godziną 12.00 a 13.00
adili - uczciwy
adui - wróg, przeciwnik
afadhali - lepiej, bardziej, raczej
Afrika - Afryka
afya - zdrowie
aga - żegnać
agana - pożegnać się, uzgodnić
Agano Jipya - Nowy Testament
Agano la Kale - Stary Testament
agiza - zamówić, rozkazywać
Agosti - sierpień
aina - rodzaj
aisikrimi - lody
ajabu - zadziwiająca rzecz, cud
ajali - wypadek
ake - jego
-a kijani - zielony
akili - umysł, rozum, rozsądek, inteligencja, świadomość
akina - kina
akiwa - gdy, podczas
ako - twój
ala - narzędzie
alasiri - popołudnie, pora dnia między godziną 14.00 a 17.00
alfabeti - alfabet
alfajiri - świt, pora dnia między godziną 3.00 a 6.00 rano
alhamisi - czwartek
alika - zaprosić
amani - pokój, ład wewnętrzny, ten, który niesie pokój innym
amba- - który
ambia - powiedzieć, informować
ambukiza - zarażać
ami - wujek
amini - wiara, wierzyć
amka - budzić się, wstawać
amua - decydować
andaa - przygotować
andamana - towarzyszyć sobie
Andes - Andy
andika - pisać
angalia - uważać, dbać, obserwować
angu - mój
angua - wykluć się
anguka - spaść
anwani - adres
anza - zaczynać
Aprili - kwiecień
ardhi - ziemia
arobaini - czterdzieści
asali - miód
asante - dziękuję
asili - pochodzenie, nigdy
asimilia - procent
askari - mundurowy, żołnierz
askofu - biskup
asubuhi - ranek
au - lub
aya - paragraf
Azerbaijan - Azerbejdżan
azima - pożyczyć
baa - bar
baada - po
baada ya - po
baadaye - później
baba - ojciec, tata
badala - substytut, zastępstwo
badala ya - zamiast
badili - zmieniać
bado - wciąż, jeszcze
bafu - łazienka, wanna
bahari - morze, ocean
baharia - żeglarz
Bahari ya Hindi - Ocean Indyjski
bahasha - koperta
bahati - szczęście
bahati mbaya - pech
bahati nzuri - szczęście
bahiri - skąpy
baina ya … na - pomiędzy … i …
baisikeli - rower
baiskeli - rower
baki - zostać
bakshishi - napiwek
bali - ale, lecz
balozi - ambasador
banda - chata
bangili - bransoletka
bao - deska
bara - kontynent, ląd
barabara - droga
barafu - lód
baraka - błogosławieństwo, szczęście
baridi - zimno, chłód, zimny, chłodny
bariki - błogosławić
barua - list
barua umeme - e-mail
basi - autobus
bata mzinga - indyk
baya - zły
beba - nieść
bee - odpowiedź kobiety na wezwanie
bega - ramię, bark
bei - cena
bendera - flaga, chorągiew
benki - bank
betri - bateria
bi - kobieta niezamężna
bia - piwo
biashara - handel
bibi - kobieta, żona
bichi - niedojrzały, nieugotowany
bidi - musieć, trzeba
bikari - kompas, busola
bila - bez
bilauri - szklanka
bin - syn
binadamu - człowiek, istota ludzka
binti - córka
bisha hodi - "pukać do drzwi" okrzykiem
bivu - dojrzały, świeży
blauzi - bluzka
bomba - rura
bombo - przeziębienie
bora - doskonały, lepszy, najlepszy
Bosporus - Bosfor
bozibozi - głupi, bezużyteczny
breki - hamulec
Brussels - Bruksela
buibui - pająk, czarna płachta do obwiązywania się
buluu - niebieski
bunduki - strzelba
bunge - parlament
bure - na próżno, na darmo, darmo, gratis, za darmo
busara - mądrość
bustani - ogród
bwana - pan, mężczyzna, mąż
bwawa - bagno
chache - mało, niewiele
chafu - brudny
chagua - wybierać
chai - herbata
chaki - kreda
chakula - jedzenie, potrawa, pożywienie
chakula cha jioni - kolacja
chama - partia
changamfu - pogodny, szczęśliwy
chanjo - szczepionka
chapa - bić, uderzać
chawa - wesz
cheche - iskra
cheka - śmiać się
chelewa - spóźnić się
chemka - wrzeć
chemsha - gotować
cheo - stopień, rząd, ranga, miara, rozmiar
cheza - grać, bawić się
cheza karata - grać w karty
chini - spód
chini ya - pod
choka - zmęczyć się
chokaa - gips
chokoleti - czekolada
choma - wkłuwać
chombo - naczynie, narzędzie, sprzęt, żaglówka
chomoa - wykłuwać
chomoka - wyjść poza
choo - toaleta
chosha - męczyć
chotara - mieszaniec
chozi - łza
chubuko - siniak
chui - leopard
chuki - nienawiść
chukia - nienawidzić, nie lubić
chukua - brać
chuma - żelazo, zbierać
chumba - pokój
chumbia - zaręczyć się
chumvi - sól
chungu - mnóstwo
chungu nzima - całe mnóstwo
chungwa - pomarańcza
chuo - szkoła, książka
chuo kikuu - uniwersytet
chupa - butelka
chupi - majtki
chura - żaba
dada - siostra
daftari - książka rachunków, zeszyt
daha - duma
dakika - minuta
daktari - lekarz
daktari wa meno - dentysta
daladala - autobus
damu - krew
danganya - oszukać
dansa - taniec
daraja - most
daraka - odpowiedzialność
darasa - klasa (szkolna), lekcja
dawa - lekarstwo
dawati - biurko
dereva - kierowca
Desemba - grudzień
dhahabu - złoto
dhakari - penis
dhambi - grzech
dhamiri - świadomość
dharau - obraza, pogarda, obrażać, gardzić, lekceważyć
dhidi ya - przeciwko, przeciw
dhulumu - traktować niesprawiedliwie
dirisha - okno
doa - plama
dobi - pracz, praczka
dogo - mały, młody/młodszy
dondoka - spaść
doti - para (o ubraniu), komplet
dua - modlitwa, prośba
dubu - niedźwiedź
duka - sklep
duka la dawa - apteka
duka la vitabu - księgarnia
duma - gepard
dumisha - podtrzymywać
dunda - bić, uderzać, tętnić
dunia - świat
dura - papuga
edashara - jedenaście
ekundu - czerwony
elekea - udać się (dokądś), kierować się
elewa - rozumieć
elfu - 1000, tysiąc
elimu - wiedza, nauka, wykształcenie
elimu ya afya - higiena, medycyna
ema - dobry
embamba - wąski
embe - mango
enda - iść, jechać, posuwać się do przodu, rozwijać się
endea - udać się
endelea - kontynuować
endesha - kierować
eneza - rozpowszechniać, szerzyć, propagować, rozprzestrzeniać
enyewe - sam
epesi - lekki, szybki
epuka - unikać
epukana na - unikać
Estonia - Estonia
eti - określenie na wątpliwość, określenie na zdziwienie
eupe - biały
eusi - czarny
fa - umrzeć
fagia - zamiatać
fahali - byk
fahamisha - wyjaśnić
fahamu - rozumieć, znać, pamiętać, przypominać sobie
faida - zysk
falaki - astronomia
familia - rodzina
fanya - robić
farasi - koń
fasihi - literatura
fataki - fajerwerki
Februari - luty
fedha - srebro, pieniądze
ficha - chować, ukrywać
fika - przybywać
fikiri - myśleć
fisi - hiena
fizikia - fizyka
fomu - formularz
fora - sukces
fu - martwy
fua - prać
fuata - podążać, iść za kimś
fuatana - przebywać w towarzystwie
fufua - wskrzesić, ożywiać, przywracać do życia
fujo - chaos
fulani - pewien, jakiś
fumba - zamykać, zakrywać
fumbua - otwierać
fundi - mistrz, rzemieślnik
fundisha - uczyć kogoś, pouczać, instruować
fundi ya saa - zegarmistrz
funga - zamykać, wiązać, zawiązywać
funga mizigo - pakować się
funga safari - rozpocząć podróż
fungua - otwierać, odwiązać
fupi - niski
fura - puchnąć
furahi - cieszyć się
futa - wycierać, ścierać
gani - jaki, który
gari - samochód
gauni - sukienka
gavana - gubernator
gawanya - dzielić
gazeti - gazeta
gereza - więzienie
geuka - obracać się, zmieniać się
ghali - drogi, rzadki
ghere - zazdrość, zawiść
ghorofa - piętro
giza - ciemność
glasi - szklanka
gomba - kłócić się
gonga - uderzać, pukać
gonjwa - chory
goti - kolano
gumu - twardy, trudny
haba - mało
habari - wiadomość
hadi - do (aż)
hadithi - opowiadanie, bajka
hai - być żywym, przeżyć
Haiti - Haiti
haja - potrzeba
hakuna matata - brak problemów, brak zmartwień
halafu - później, potem
halisi - naturalny
hamaki - złość
hamsini - 50, pięćdziesiąt
hamu - chęć, potrzeba
hapa - tu, tutaj
hapana - nie, nie ma
hapo - właśnie wtedy
hara - wypróżniać się
haraka - pośpiech
haribu - niszczyć, psuć, rujnować
hasa - dokładnie, wyraźnie, właśnie, całkowicie
hata - aż
hata hivyo - pomimo to
hata kidogo - wcale, ani trochę
hatari - niebezpieczeństwo, ryzyko
hatua - krok
hawala - przelew, weksel, czek, trata
hawili - wymieniać, przelewać (o funduszach)
haya - wstyd, skromność, dobrze!, w porządku!
hekalu - świątynia
hekima - mądrość
hereni - kolczyk
heri - dobro
hesabu - liczenie, matematyka, rachunki
heti - czapka
himiza - popędzać, poganiać
hisabati - matematyka
historia ya kisasa - historia współczesna
hitaji - potrzebować
hitajika - być potrzebnym
hivi - ci, te
hivi hivi - tak sobie, trochę
hivi karibuni - zaraz, niedawno
hivyo - tak, w ten sposób
hodari - zdolny
hodi! - czy mogę? (przy pukaniu)
hofu - strach, trwoga
hoji - wypytywać, przepytywać
homa - gorączka
homa ya manjano - żółta febra
hospitali - szpital
hoteli - hotel
huba - miłość
hudhuria - uczestniczyć, być obecnym
huduma - usługa, służba
hudumia - obsługiwać
hujumu - sabotować
huko - tam
humu - tu, tutaj
hundi - czek
huru - wolny, uwolniony
huzuni - smutek
huzunika - zasmucić się
iba - kraść
idara - biuro, oddział, katedra (na uczelni)
iga - imitować, naśladować
ijumaa - piątek
ikiwa - czy (w zdaniach podrzędnych), jeśli
imba - śpiewać
inama - schylić
ingawa - chociaż
ingi - wiele, dużo
ingia - wchodzić
ingine - niektóry/niektórzy, inny
Inglandi - Anglia
insha - wypracowanie
inuka - wstawać, powstać
inzi - mucha
ipi - który
isha - skończyć, przestać
ishara - sygnał, znak
ishi - żyć, trwać
ishirini - 20
isimu - charakter, istota
isimu ya lugha - lingwistyka
ita - wołać, nazywać
ja - przychodzić
jaa - być pełnym
jahanamu - piekło
jamaa - kolega, duża rodzina
jambo - sprawa, rzecz
jamhuri - republika
jana - wczoraj
janga - kłopot
jani - liść
Januari - styczeń
jaribu - próba, próbować
jawabu - sprawa, odpowiedź, produkt
jaza - wypełniać
je - czy
jela - więzienie
jembe - motyka
jengo - budynek
jiandaa - przygotowywać się
jibini - ser
jibu - odpowiadać
jicho - oko
jifanya - udawać
jifungua - urodzić, mieć rozwiązanie
jifunza - uczyć się
jiko - kuchnia
jikwaa - potknąć się
jina - imię, nazwisko, nazwa
jinamizi - koszmar
jino - ząb
jinsi - sposób
jiografia - geografia
jioni - wieczór
jipokeza - zgubić się
jirani - sąsiad
jitahidi - starać się
jitu - ogr, olbrzym
jiunga - dołączyć
jiuzulu - podać się do dymisji
jivuna - popisywać się
jiwe - kamień
joho - płaszcz
joto - ciepło, gorączka
jua - słońce, wiedzieć, umieć
juha - idiota, prostak, głupiec
juishana - informować się nawzajem, powiadamiać się
juisi - sok
Julai - lipiec
juma - tydzień
jumamosi - sobota
jumanne - wtorek
jumapili - niedziela
jumatano - środa
jumatatu - poniedziałek
jumba - duży dom, duży pokój, budynek
jumba la umeme - elektrownia
jumbe - szef, wódz, przodownik
jumlisha - dodawać
Juni - czerwiec
juu ya - na, nad, o
juzi - przedwczoraj
kaa - mieszkać, żyć, siedzieć
kabati - szafa, kredens
kabisa - całkowicie, gruntownie
kabla - po
kabla ya - przed (czasowe)
kaburi - grób
kadhaa - kilka, niewiele
kadi - kartka pocztowa, kartka z życzeniami
kahawa - kawa
Kaidi - Kaidi, imię żeńskie
kaka - brat
kali - surowy, okrutny, ostry, gorzki, mocny
kama - jak, jakby, tak jak, jeśli, czy, doić, wygniatać, wyciskać
kamera - aparat fotograficzny
kamili - dokładnie
kampuni - przedsiębiorstwo
kampuni ya ndege - linie lotnicze (przedsiębiorstwo)
kamusi - słownik
kana - zaprzeczać
kanda - ugniatać, masować
kando ya - obok, na brzegu, na skraju
kanisa - kościół
kantini - stołówka
kanzu - sukienka męska
kaptura - krótkie spodnie
karamu - impreza
karani - urzędnik
karata - karty
karatasi - kartka, papier
karibia - zbliżać się
karibisha - zaprosić
karibu - proszę! (w odpowiedzi na pukanie do drzwi), blisko
karibu na - blisko
karimu - chojny
karne - wiek, stulecie
kasa - żółw
kasi - szybko
kasirika - rozzłościć się
kaskazini - północ
kata - ciąć, rąbać
kataa - odmawiać, odrzucać, wzbraniać się
kata shauri - powziąć decyzję
kata tamaa - tracić nadzieję
katibu - sekretarz
katika - w, z, do, podczas
katikati ya - pośrodku
katlesi - kotlet
katoni - karton
kaunta - okienko, lada
kavu - suchy
kawaida - system
kazi - praca, działanie
kebeji - kapusta
kebichi - kapusta
keki - ciasto
kemea - krzyczeć, ganić
kenda - dziewięć
Kenya - Kenia
kesho - jutro
kesho kutwa - pojutrze
keti - siadać
kheri - powodzenie, szczęście
kiatu - but
kiazi - ziemniak
kibanda - chata, szopa
kiberiti - zapałka, paczka zapałek
kibidhi - wręczyć, dać
kiboko - hipopotam
kichaa - szaleniec
kicheko - uśmiech
kichorochoro - zaułek
kichwa - głowa
kidani - naszyjnik
kidole - palec
kidonge - tabletka, pastylka
kifaa - narzędzie
kifaranga - kurczaczek
Kifaransa - język francuski
kifaru - nosorożec, czołg
kifo - śmierć
kifua - pierś, klatka piersiowa
kifurushi - paczka
Kiholanzi - język holenderski
kijana - młodzieniec
kijani - liść
kijiji - miasteczko
kijiko - łyżka
kikapu - kosz
kiko - fajka
kikombe - filiżanka, kubek
kila - każdy
kilabu - klub, bar
kilabu cha mazoezi - klub fitness
kilema - kaleka
kilemba - turban
kilima - góra
kilio - płacz
kilo - kilogram
kilometa - kilometr
kima - pulpet, mięso mielone
kimeza - stolik
kimo - wysokość
kimya - cisza
kinembe - łechtaczka
kinga - obrona, polano, bronić, chronić
kingajua - daszek u czapki
kiniozi - fryzjer, golibroda
kinu - moździerz
kinywaji - napój
kiongozi - przewodniczący
kioo - lustro
Kiositani - prowansalski (język)
kiowevu - płyn
kipande - kawałek
kipepeo - motyl
kipindi - chwila, okres
kipindupindu - cholera
kipungu - orzeł
Kirusi - język rosyjski
kishujaa - odważnie, bohatersko
kisima - studnia
kisingino - łokieć, kolano
kisiwa - wyspa
Kisiwa cha Krismasi - Wyspa Bożego Narodzenia
kisu - nóż
Kiswahili - język suahili
kitabu - książka
kitako - pośladek
kitambaa - chustka, obrus
kitambo - krótki odcinek czasu, krótki odcinek drogi
kitambulisho - legitymacja
kitana - grzebień
kitanda - łóżko
kitenge - materiał, którym okrywają się kobiety
kitivo - wydział
kito - biżuteria
kitu - rzecz, coś
kitunguu - cebula
kitunguu saumu - czosnek
kituo cha basi - przystanek autobusowy
kiu - pragnienie
kiulizi - pytajnik
kivuko - przejście
kivuli - cień
kiwanda - fabryka
kiwanja cha mpira - boisko
kiwanja cha ndege - lotnisko
kizibau - kamizelka
kiziwi - głuchy, osoba niesłysząca
kodi - podatek
kofi - dłoń, klaskanie
kofia - czapka w stylu muzułmańskim
kohoa - kaszleć
koma - przestać
kompyuta - komputer
kona - róg
koo - gardło
kopa - pożyczyć, dać kredyt
kope - rzęsa
korongo - żuraw
kosa - błądzić, brakować
Kosovo - Kosowo
koti - palto, płaszcz
koti la mvua - płaszcz przeciwdeszczowy
Krismasi - Boże Narodzenie
Kristo - Chrystus
Kroatia - Chorwacja
kuandika - pisać
kubali - zgodzić się
kubwa - duży, wielki, ciężki, mocny, ważny, stary
kuchukia - nienawidzić
kuenda - iść
kufanya - robić
kugawa - dzielenie
kuhara - biegunka
kuhusu - dotyczący
kujumlisha - dodawanie
kukinga - chronić
kuku - kurczak
kukuja - przyjść
kukula - jeść
kukunywa - pić
kulala - spać
kulia - prawa strona
kumbuka - pamiętać, przypominać sobie
kumi - dziesięć, 10
kumi na tisa - dziewiętnaście, 19
kuna - jest, są, znajduje się, znajdują się
kunde - bób
kundi - stado
kunguni - pluskwy
kuni - drewno
kununua - kupić
kupe - kleszcz bydlęcy lub psi
kupika - gotować
kushoto - lewa strona
kusimama - zatrzymać
kusini - południe
kusoma - czytać
kuta - spotykać
kutahamaki - nagle
kutaka - chcieć
kutana - spotykać się (z…)
kutapika - wymiotować
kutoa - odejmowanie
kutoka - z
kutua - jak
kuu - główny
kuuza - sprzedać
kuvaa - nosić
kuza - uprawiać
kuzidisha - mnożenie
kwa ajili - z powodu, dla dobra …
kwa bahati mbaya - niestety
kwa bidii - pilnie
kwa heri - do widzenia
kwa jumla - w sumie
kwa kila hali - w każdym razie
kwako - dla ciebie, twój, u ciebie
kwamba - że
kwa moyo - na pamięć
kwa nini - dlaczego
kwanza - najpierw, przede wszystkim
kwa vile - ponieważ
kweli - naprawdę, rzeczywiście, prawda
kwenye - w
la - jeść
laanifu - przeklęty
labda - być może
lahaja - dialekt
laini - gładki, delikatny, łagodny, miękki
lakini - ale, lecz
lala - spać
lango - brama
Lasembagi - Luksemburg
laza - usypiać
lazima - potrzeba, konieczność
lea - wychowywać
Lebanoni - Liban
lenga - lać się, zalewać się
lengo - cel
leo - dzisiaj
leta - przynosić
lewa - upić się
lia - płakać
likizo - ferie
lilia - opłakiwać
lima - uprawiać rolę
limau - cytryna
lini - kiedy
lipa - płacić
lori - ciężarówka
lugha - język (środek komunikacji)
maafa - przerażenie, groza, terror
maana - znaczenie
maana yake - to znaczy
maandishi - literatura
Machi - marzec
madawa - farmacja, apteka
maelfu - tysiące
maendeleo - rozwój
mafua - przeziębienie
mafuta - tłuszcz, olej
magharibi - zachód, zachód słońca, pora wieczornej modlitwy muzułmańskiej
mahali - miejsce
maharagwe - fasola
maili - mila
maisha - życie
maiti - trup
maji - woda
majivu - popiół
maji ya kifuu bahari ya chungu - woda w kokonie jest oceanem dla mrówki
maji ya machungwa - sok pomarańczowy
majuto - żal
makala - artykuł
makini - uwaga, spokój, godność
maktaba - biblioteka
makumi - dziesiątki
malaika - anioł
mali - majątek, bogactwo
maliza - kończyć, niszczyć
mama - matka, mama
mamba - krokodyl
mamia - setki
mamilioni - miliony
mamoja - jednakowo, podobnie
manjano - kurkuma, żółty
maoni - opinie
mapema - wcześnie
mapinduzi - rewolucja, przewrót
mapokezi - recepcja
mapwa - brzeg
mapwaji - brzeg
mara - raz, natychmiast
maradhi - choroba
mara moja - nagle
marehemu - nieboszczyk
marikiti - supermarket, duży sklep
marudio - powtórzenie
marufuku - zakaz, zakazany
masafa - odległość
Masedonia - Macedonia
mashairi - poezja, wiersze, od shairi
mashariki - wschód
mashine - maszyna
maskini - biedak, żebrak, biedny
masomo - studia
matata - kłopoty, problemy, powikłania
mate - ślina
matembezi - spacer, przechadzka
matokeo - wyniki
matope - błoto
matumizi - użycie, wydatki
maumivu - ból
mauti - śmierć
mawasiliano - komunikacja
maya - gniew
mazingira - środowisko
mazishi - pogrzeb
maziwa - mleko, dla ziwa, piersi
mba - łupież
mbaazi - groch
mbali na - daleko
mbao - deska, tablica
mbati - dachówka
mbaya - źle, zły
mbayuwayu - jaskółka
mbele ya - przed (miejscowe)
Mbelgiji - Belg, Belgijka
mbili - dwa, 2
mbili tatu - parę, kilka
mbio - bieg, szybko
mboga - warzywa
mbona - dlaczego, z jakiego powodu, określenie na zdziwienie
mboo - penis
mbu - komar, moskit
mbuga - park, sawanna
mbuni - struś
mbuyu - baobab
mbuzi - koza
mbwa - pies
mbwa mwitu - dziki pies afrykański, wilk
mbwawa - basen, jeziorko
mchana - popołudnie
mchanga - piasek
mchawi - czarodziej, czarownik, czarownica
mchele - ryż niegotowany łuskany
mchezo - gra, zabawa
mchumba - narzeczony, kochanek
mchungwa - drzewko pomarańczowe
mchuzi - sos
mdahalo - debata
mdali - medalik
mdogo wa kike - młodsza siostra
mdogo wa kiume - młodszy brat
mdomo - usta, warga, dziób ptaka
mdudu - owad
Mei - maj
meli - statek
mende - karaluch
meneja - dyrektor, kierownik
meza - połykać, stół
mfalme - król
mfa maji haishi kutapatapa - człowiek, który się topi, walczy do upadłego
mfanyakazi - robotnik, pracownik
Mfaransa - Francuz, Francuzka
mfasiri - tłumacz
mfereji - kanał, wodociąg
mfuko - torba, worek, kieszeń
mfupa - kość
mgahawa - kawiarnia
mganga - zielarz, znachor
mgeni - gość, obcy
mgongo - grzbiet, plecy
mgonjwa - chory
mguu - stopa, noga
mhadhara - lektura, lektorat
mhuni - łobuz
mhusika - bohater (książki)
mia - sto, 100
miadi - randka
miaka - wiek (liczba lat)
milele - wieczność, zawsze, wiecznie
mimi - ja
miongoni kwa - pomiędzy
miwani - okulary
mizizi - korzeń
mjamzito - ciężarna, kobieta w ciąży
mjanja - mędrzec
mji - miasto
mji mkuu - stolica
mjinga - ignorant, głupiec
mjomba - wuj, wujek
mjumbe - posłaniec, poseł
mkahawa - kawiarnia
mkate - chleb, placek
mkazi - mieszkaniec
mke - żona, kobietaUżywane samodzielnie oznacza dokładnie żona
mkeka - mata
mkesha - wigilia, czuwanie
mkia - ogon
mkoa - okręg
mkoba - torebka
mkojo - mocz
mkono - ramię, ręka
mkopo - pożyczka
Mkristo - chrześcijanin
mkuki - dzida, oszczep
mkulima - rolnik
mkunga - położna, węgorz
mkutano - zebranie, spotkanie
mlango - drzwi, wejście, brama, rozdział książki
mla watu - ludożerca, kanibal
mlevi - pijak
mlia - pasek
mlima - góra
mlio - krzyk, ryk, trzask
mmea - roślina, roślinność
mnazi - palma kokosowa
mnunuzi - klient, kupiec
mnururisho - promieniowanie
mnyama - zwierzę
moja - jeden
moja kwa moja - prosto, bezpośrednio, od razu
moshi - dym, para
mosi - jeden
moto - ogień
motokaa - samochód, motocykl
moyo - serce, dusza, charakter, odwaga
mpaka - granica, aż do
mpando - górka
mpigapicha - fotograf
mpiga picha - fotograf
mpira - piłka, guma
mpishi - kucharz
mpokeaji - recepcjonista
mrembo - piękna kobieta, ślicznotka
msaada - pomoc, ratunek
msalaba - krzyż
mshangao - zdziwienie
mshenzi - barbarzyńca
mshikaki - szaszłyk
mshonaji - krawiec
mshumaa - świeca
msiba - nieszczęście, katastrofa, smutek, troska
msichana - dziewczyna
msikiti - meczet
msitu - las
msumari - gwóźdź
mswaki - szczoteczka do zębów
mtafsiri - tłumacz
mtalii - turysta
mtama - proso
mtego - pułapka, sidła
mtengenezaji nywele - fryzjer
mteremko - dołek
mti - drzewo, drewno
mtihani - egzamin
mto - rzeka, strumień, poduszka
mtoto - dziecko, potomek
mtu - człowiek, osoba
mtume - prorok
mtumishi - kelner, służący, posłaniec
mtumwa - niewolnik
muda - okres
muhtasari - podsumowanie
mume - mąż
mungu - bóg, przeznaczenie
Mungu - Bóg
muziki - muzyka
mvi - siwizna
mvinyo - wino, alkohol
mviringo - koło, okrąg
mvua - deszcz
mvulana - chłopak
mvungu - spód, podłoga, na podłodze
mvuvi - rybak
mwaga - wylać
mwaka - rok
mwaliko - zaproszenie
mwalimu - nauczyciel
mwamvuli - parasol
mwana - dziecko, syn, córka
mwanachama - członek
mwanadamu - człowiek
mwana elimu nafsi - psycholog
mwanafunzi - uczeń, student
mwanaharamu - łajdak, bękart
mwanamke - kobieta
mwanamume - mężczyzna
mwananchi - rodak, obywatel
mwandishi - pisarz
mwanga - światło
mwangaza - światło
mwanzo - początek
mwaridi - krzak róży
mwenda wazimu - wariat
mwendo - prędkość, ruch
mwenyeji - człowiek stąd, miejscowy, gospodarz
mwenyekiti - kierownik
mwenzi - przyjaciel, kompan, towarzysz
mwezi - miesiąc, księżyc
mwiko - łyżka
mwili - ciało
mwisho - koniec, w końcu
Mwislamu - muzułmanin
mwitu - las
mwizi - złodziej
mwoga - tchórz
mwongo - kłamca, oszust
mwuguzi - pielęgniarz, pielęgniarka
mwungano - federacja
mzazi - rodzic
mzee - starsza osoba, przodek
mzigo - bagaż, ciężar
mzizi - korzeń
Mzungu - Europejczyk, człowiek rasy białej
mzuri - dobrze
na - i, a
nabii - prorok
nafuu - korzystny
Nairobi - Nairobi
namba - liczba
nambari - liczba
nanasi - ananas
nane - osiem
nani - kto, jaki (o człowieku), który (o człowieku)
nauli - opłata za przejazd
nawa - myć ręce / twarz / stopy
nawisha - moknąć, nasiąkać
nazi - orzech kokosowy
nchi - kraj, państwo
ndani ya - wewnątrz
ndege - ptak, samolot, omen, wróżba, znak
ndimu - cytryna
ndini - religia
ndiyo - tak
ndizi - banan
ndogo - młody
ndovu - słoń
ndugu - krewny, kuzyn, przyjaciel, rodzeństwo, brat, siostra
nenepa - utyć
neno - słowo, wypowiedź, stwierdzenie, wyrażenie
nesi - pielęgniarka
ngamia - wielbłąd
ngano - ziarno, żyto, pszenica
ngao - tarcza
ngapi - ile
nge - skorpion
ng'oa - wyrywać
ngoja - czekać
ngoma - bęben
ng'ombe - krowa, bydło
ngozi - skóra
ngumi - pięść
nguo - ubranie, tkanina, materiał
nguruwe - świnia
nguvu - siła
ngware - świt, poranek
nia - chęć, zamierzenie
nini - co
njaa - głód
nje - na zewnątrz
nje ya - na zewnątrz od…
njia - droga, ścieżka, ulica, metoda
njia panda - skrzyżowanie, rozwidlenie, rozgałęzienie dróg
nne - 4, cztery
noti - banknot
Novemba - listopad
nta - wosk
nukta - kropka, chwila
nunua - kupić
nusu - pół
nyama - mięso, zwierzę
nyamaza - być cicho, milczeć
nyani - małpa
nyanya - pomidor
nyati - bawół
nyesha - deszczyć
nyima - odmawiać, nie dać
nyinyi - wy
nyoa - ogolić
nyoka - wąż
nyonge - słaby, marny
nyota - gwiazda
nyuki - pszczoła
nyuma - tył, od uma - widelce
nyumba - dom, budynek
nyusi - brew
nywa - pić
nywele - włosy
nzi - mucha
oa - ożenić się
oda - zamówienie
ofisi - biuro
oga - myć się, brać prysznic
ogelea - pływać
ogopa - bać się
oka - piec
oksijeni - tlen
Oktoba - październik
omba - prosić, modlić się o…
ona - patrzeć, widzieć, postrzegać, uważać
onana - widzieć się nawzajem, postrzegać się nawzajem
ondoa - usunąć, zabrać
ondoka - wyjechać, odejść, umrzeć
onekana - być widzianym
ongeza - dołożyć
onya - ostrzegać
onyesha - pokazywać
onyesho - scena (w sztuce), wystawa, scena (w teatrze)
o -ote - jakakolwiek/jakikolwiek
orodha - lista
orodha ya vyakula - menu
osha - myć
ote - wszyscy
pa - dawać
paa - gazela, antylopa
pacha - bliźniak
pafu - płuco
pahali - miejsce
paja - udo
paka - malować, kot
pakacha - koszyk z liści palmy kokosowej
pakua - rozładować, rozpakować
pa lifti - podwieść
pamoja na - razem z
pana - szeroki
panda - wchodzic pod górę, wchodzić na / do
pande - kierunek
panga - miecz
pangusa - wycierać
panza - wnosić do góry/pod górę
papa - papież, rekin
papai - papaja
papasa - dotykać
papasi - kleszcz
pasua - rozerwać
pasuka - rwać
paswa - musieć, być wymaganym
pata - otrzymać, znaleźć
patana - dogadać się, pogodzić się
patikana - być dostępnym, być złapanym, być znalezionym
pazia - zasłona
pekua - przeszukiwać
peleka - zawieść, przewieść, wysłać
penda - lubić, kochać, chcieć
pendekeza - zaproponować
pendelea - woleć
penseli - ołówek
pesa - pieniądz/e
pete - krąg, obręcz, pierścień
pia - także
picha - zdjęcie, obrazek
piga - bić, ciosać, uderzać
piga bunduki - strzelać z karabinu
piga deki - myć podłogę
piga hodi - pukać (do drzwi), pytać o wejście
piga miayo - ziewać
piga pasi - prasować
piga picha - robić zdjęcia, fotografować
piga simu - dzwonić (telefonem)
piga sindano - zrobić zastrzyk
pika - gotować
pikipiki - motocykl
pili - dwa
pima - mierzyć, ważyć
pima joto - mierzyć temperaturę
pinda - skręcić
pinki - różowy
pipa - beczka
pita - przejść, wpaść (gdzieś lub do kogoś)
Polandi - Polska
pole - ochłonąć
polici - policja
pombe - drink, piwo
pombe kali - alkohol
pona - wyzdrowieć
ponda - miażdżyć, gnieść
ponga - potrącić
pori - step
porini - las
posta - poczta
pote - wszędzie
potea - zgubić się
poteza - tracić, gubić
pua - nos
pumbavu - głupi
pumua - oddychać
pumzika - odpoczywać, iść na emeryturę
punda - osioł
punda milia - zebra
punde - moment, chwila
punga - machać
punguza - obniżyć
pwani - wybrzeże
pya - nowy
radhi - wybaczenie
rafiki - przyjaciel
rahisi - tani, łatwy, prosty
rais - prezydent, przewodniczący, prezes
ramani - mapa
rangi - kolor
rasmi - oficjalny
redio - radio
rejesta - list polecony
rekebisha - wyregulować, naprawić, uzupełnić
resheni - przydział
risasi - grafit
robo - ćwierć
roho - dusza, duch
rudi - wracać
rudia - powtarzać, zawracać
ruhusa - pozwolić
ruhusu - pozwolić
ruka - latać, skakać
saa - godzina, zegarek
saba - siedem
sababisha - powodować
sababu - motyw
sabini - 70, siedemdziesiąt
sabuni - mydło
safari - podróż
safi - czysty
safiri - podróżować
safisha - czyścić, sprzątać
sahani - talerz
sahau - zapomnieć
sahihi - właściwy, poprawny, prawdziwy
sala - modlitwa
salaam - pozdrowienie
salale - o Boże!
salama - spokojny
salamu - pozdrowienie
sali - modlić się
salimia - pozdrowić
salimu - powitać, pozdrowić, ocalić, poddać się
samahani - przepraszam
samaki - ryba
samawati - niebo
sambusa - pieróg
sana - bardzo
sanaa - sztuka
sanamu - rzeźba, posąg
Sao Tome na Principe - Wyspy Świętego Tomasza i Książęca
sare - mundurek
sarufi - gramatyka
sasa - teraz
sasa hivi - natychmiast, od zaraz
sauti - głos
sawa - równy, w porządku
sawa sawa - równa się
sayansi - nauka ścisła
sayari - planeta
sehemu - część
sekunde - sekunda
sema - mówić
Septemba - wrzesień
seremala - stolarz
serikali - rząd
seyfu - miecz
shabiki - wachlarz
shairi - wiersz
shaka - wątpliwość
shamba - wieś, pole
shanga - paciorki
sharti - jest konieczne, trzeba
shati - koszula, bluzka
shehena - ładunek
shemeji - szwagier, szwagierka
sherehe - święto
sherehekea - świętować
shiba - najeść się, być sytym
shibe - sytość
shida - kłopot, problem
shika - trzymać
shilingi - pieniądze
shimo - dziura
shinda - pokonać, wygrywać
shingo - szyja
shirika - spółka, przedsiębiorstwo
shoga - przyjaciółka kobiety, homoseksualista, gej
shona - szyć
shtuka - być zaskoczonym, przerazić się, wzdrygnąć się
shujaa - bohater
shuka - schodzić
shukuru - dziękować, być wdzięcznym
shule - szkoła
shule ya chini - szkoła podstawowa
shule ya msingi - szkoła podstawowa
shule ya sekondari - liceum
shusha - wysadzić, sprawić by ktoś wyszedł
si - nie
siafu - mrówka
siagi - masło
siasa - polityka
sidiria - stanik
sifuri - zero
sigara - papieros
sikia - słyszeć
sikiliza - słyszeć
sikio - ucho
sikitika - żałować
siku - dzień
siku zote - zawsze
simama - stać
simba - lew
simba wa bara hindi - tygrys
simu - telegram, telefon
simu ya mkononi - telefon komórkowy
sindano - zastrzyk
sindikiza - towarzyszyć, odprowadzać
sinema - kino
siri - sekret
sisi - my
sita - wahać się, sześć, 6
sitini - 60, sześćdziesiąt
siyo - nie
skafu - szalik
sketi - spódnica
soko - targ
soksi - skarpetki
sokwe - pawian
soma - uczyć się, czytać
somesha - uczyć kogoś
somo - lekcja
somu - czosnek
songa mbele - iść naprzód
staajabu - zadziwiać
stakabadhi - rachunek, pokwitowanie
starehe - rozrywka
stempu - znaczek
stesheni - stacja
stimu - elektryczność
stovu - kuchenka
subiri - oczekiwać, czekać cierpliwie
sufu - wełna
sufuri - zero
sufuria - garnek (metalowy)
sukari - cukier
sukuma - prowadzić
sultani - sułtan
sulubu - prześladować
sumbua - męczyć
sumu - trucizna
sungura - zając, królik
sura - wygląd
suruali - spodnie
suti - garnitur
swahiba - przyjaciel
swali - pytanie
sweta - sweter
taa - lampa
taabani - wyczerpany
taaluma - nauka, kształcenie
taarifa - informacja
taa za stimu - światło elektryczne
tabasamu - uśmiechać się
tabibu - lekarz
tabu - kłopot, problem
tafadhali - proszę
tafauti - różnica
tafrija - impreza, przyjęcie
tafsiri - tłumaczenie, przekład, interpretacja, przekładać, tłumaczyć
tafuta - szukać
tahadhari - być ostrożnym
tai - orzeł
taifa - naród
tajiri - bogacz
taka - chcieć
tako - pośladek
talaka - rozwód
talizo - kłopot, problem
tamaa - pożądanie, chciwość, tęsknota, nadzieja
tambua - zorientować się
tamu - słodki
tandu - stonoga
tanga - chodzić bez celu
tangaza - ogłosić
tango - ogórek
tangu - od
tangulia - iść przodem
tano - pięć
Tanzania - Tanzania
tarakimu - cyfra
tarehe - data
tata - problem
tatu - trzy
tatua - rozwiązać problem
tawa - pobożny, święty
tazama - oglądać
tega - zastawiać pułapki
tegua - uwalniać z pułapki
tele - wiele, dużo
teleza - ślizgać się, pośliznąć się
tembea - spacerować
tembelea - odwiedzić
tembo - słoń
tena - poza tym, jeszcze, znowu
tenda - robić
tende - daktyl
tengeneza - przygotować
teremka - schodzić
teso - grzech
tetemeka - trząść się
thelathini - 30
theluji - śnieg
themanini - 80, osiemdziesiąt
thenashara - dwanaście
thiata - teatr
thumu - czosnek
tia - nalać, położyć, wkładać
tiba - medycyna, opieka medyczna, leczenie, kuracja
timiza - wypełniać
tisa - dziewięć
tisha - przerażać, przestraszać
tisini - 90, dziewięćdziesiąt
toa - układać, wykładać, wyjmować, odejmować
toa damu - pobrać krew
toa oda - składać zamówienie
tofali - cegła
tofauti - różnica
toka - iść skądś, wychodzić, pochodzić
tokea - zdarzyć się, pojawić się
tope - błoto
toroka - uciec
tosha - wystarczać
toweka - zniknąć, zaginąć
tu - tylko
tua - wylądować
tuama - stać
tufaa - jabłko
tukana - obrażać się
tuli - cichy
tuliza - uspokoić się, zatrzymać (np. wzrok)
tuma - wysyłać
tumaini - mieć nadzieję, spodziewać się
tumbo - brzuch
tumia - używać, stosować
tumika - być używanym
tumikia - służyć komuś
tunda - owoc
tundu - dziura, gniazdo
tunza - opiekować się, troszczyć się
tupa - rzucać
tupu - nagi, pusty
tuta - grządka
twiga - żyrafa
ua - zabijać
Uajemi - Iran
ubalozi - ambasada
ubao - deska, tablica
ubavu - żebro
Ubelgiji - Belgia
ubishi - spór, kłótnia
uchi - nagi
Uchina - Chiny
uchumi - handel, ekonomia
udevu - włos z brody
udhi - urazić, zranić
udongo - glina
ufa - dziura
ufagio - miotła
Ufalme wa Muungano - Zjednoczone Królestwo (Wielkiej Brytanii i Irlandii Północnej)
Ufalme wa Muungano wa Britania na Eire ya Kaskazini - Zjednoczone Królestwo Wielkiej Brytanii i Irlandii Północnej
Ufaransa - Francja
ufuko - brzeg
ufunguo - klucz
ufupi - skrót, krótkość
ufupisho - streszczenie
ugali - ugali
Uganda - Uganda
ugawaji - dystrybucja
ugonjwa - choroba
Uhindi - Indie
Uhispania - Hiszpania
Uholanzi - Holandia
uhuru - wolność
uhusiano - stosunek, relacja, związek
Uingereza - Anglia, Wielka Brytania, Zjednoczone Królestwo Wielkiej Brytanii i Irlandii Północnej
Uislamu - islam
ujamaa - wspólnota, socjalizm
ujasiri - odwaga
Ujerumani - Niemcy
uji - rzadka kaszka
ujinga - ignorancja, głupota
ukarimu - grzeczność, szacunek
Ukristo - chrześcijaństwo
ukubwa - wielkość
ukucha - paznokieć
ukulima - rolnictwo
ukurasa - strona, numer strony
ukuta - ściana
Ulaya - Europa
ulimwengu - świat
uliza - pytać
ulizana hali - pytać się nawzajem o zdrowie
uma - widelec, ugryźć, boleć
umande - mgła
umaskini - bieda
umbali - odległość
umbo - kształt, postać
umbu - brat kobiety, siostra mężczyzny
umeme - elektryczność
umoja - jedność
Umoja wa Ulaya - Unia Europejska
umri - wiek
unga - mąka, kokaina, heroina
ungamana - połączyć się
unganisha - połączyć
Unguja - Zanzibar
unyenyekevu - skromność
unyevunyevu - wilgotność
unywele - włos
upande - strona, część
upanga - miecz
upepo - wiatr
upesi - szybko
upumbavu - głupota, bezmyślność
urefu - długość
Ureno - Portugalia
Urusi - Rosja
usaha - ropa
ushairi - poezja
ushindi - zwycięstwo
usiku - noc
usiku wa manane - pora dnia między godziną 24.00 a 3.00, środek nocy
usingizi - senność
uso - twarz
ustawi - dobro
Uswidi - Szwecja
Uswisi - Szwajcaria
utajiri - bogactwo, skarb
utamu - słodycz
uthibitisho - pewność, przekonanie, dowód
utoto - dzieciństwo
utu - człowieczeństwo
utumbo - jelito
utungaji - wypracowanie
Uturuki - Turcja
uuzaji - sklep
uvumba - kadzidło
uvumilivu - tolerancja, cierpliwość
uwivu - zazdrość
uza - sprzedawać
uzima - zdrowie
uzua - abdykować
uzuri - piękno
vaa - ubrać się
vagi - brzuch
vazi - ubrania
vibaya - źle
vilevile - też, tak samo
vimba - puchnąć
vinywaji vikali - mocne alkohole
vipi - jak
vita - wojna
vitabu - książka
vivu - leniwy
vua - łowić, rozbierać
vuka - przekroczyć
vumbi - kurz
vunja - złamać
vunjika - rozbić się
vurugika - być pomieszanym
vuta - palić (papierosy), ciągnąć
vyombo - środki
wa - być
wadi - wąwóz
wahi - zdążyć, mieć okazję
waka - palić się
wakati - czas
wala - ani
wali - gotowany ryż
wa na - mieć
wao - oni
wapi - gdzie
waridi - róża
Warshawa - Warszawa
washa - zapalać
wasiwasi - niepokój
wastani - przeciętny
waza - myśleć, rozmyślać, rozważać
wazi - otwarty, wolny, pusty, oczywisty
wazimu - szaleństwo
waziri - minister
wazo - myśl, pogląd
weka - położyć, postawić
Welisi - Walia
wema - dobroć
wembe - brzytwa
weupe - biel
wewe - ty
weza - móc
wezekana - być możliwym
wia radhi - wybaczyć
wifi - szwagierka
wiki - tydzień
wili - dwa
wimbo - piosenka
winda - polować
wino - atrament
wivu - zazdrosny
wizara - ministerstwo
wizi - kradzież
yaani - to znaczy
yai - jajko
yakhe - brat (zwrot do dobrego znajomego)
yetu - nasz
yeye - on, ona, ono
yeyuka - rozpuścić się, roztopić się
yumba - chwiać się
zabibu - winogrona
zaburi - psalm
zaidi - więcej, bardziej
zamani - kiedyś, dawno
zambarau - śliwka
zamu - zmiana
zawadi - prezent
zee - stary
zero - zero
ziara - wizyta
ziba - zatkać, zamknąć
zidi - powiększać, zwiększać, kontynuować
zidisha - zwiększać, mnożyć
zika - grzebać
zima - cały
zima taa - zgasić światło
zindua - ocknąć się, zbudzić się
zito - ciężki
ziwa - jezioro, staw
zizi - obora
zoea - przyzwyczaić się
zoezi - ćwiczenie
zua - dziurawić
zuia - przeszkadzać
zulia - dywan
zungumza - rozmawiać
zuri - ładny, dobry
zuru - odwiedzić
