AA - Agencja Turecka (Anatolijska)
AB - Unia Europejska
abajur - abażur
abaküs - abakus
abanoz - heban, drzewo hebanowe
abartı - przesada
abartma - przesada
abartmak - przesadzać, wyolbrzymiać
Abazaca - język abazyński, abazyjski
abazan - głodny, wygłodniały, napalony, podniecony, głodny seksu
ABD - USA, Stany Zjednoczone Ameryki
abdest - abdest
Abdullah - tureckie imię męskie
abece - alfabet
abes - niepotrzebny, zbędny, bezużyteczny, absurdalny, absurd, nonsens
Abhazca - język abchaski
abi - starszy brat
abide - monument, pomnik
abla - starsza siostra, pani (zwrot grzecznościowy do kobiety)
ablak - pucołowaty, okrągły
abluka - blokada
abstre - abstrakcyjny
absürd - absurdalny
Abu Dabi - Abu Zabi
abur cubur - przekąska
abus - posępny, zgryźliwy, wściekłystrony=1
acaba - wątpliwość, podejrzenie, czyżby, czy, naprawdę
acar - dzielny, odważny, wytrzymały
acayip - dziwaczny, przedziwny, groteskowy
acele - prędki, pospieszny, szybki, w pośpiechu
acele etmek - spieszyć się
acele işe şeytan karışır - gdy się człowiek spieszy, to się diabeł cieszy
acente - agent
acı - gorzki, ostry, pieprzowy
açı - kąt
açık - otwarty, swobodny, nieograniczony, nagi, odkryty, widoczny, pusty, wolny, niezajęty, otwarty (na coś), jasny, zrozumiały
açıkça - otwarcie, szczerze
açıklamak - wyjaśniać
acıklı - tragiczny, dramatyczny, poruszający
acıkmış - głodny
açış - otwarcie, inauguracja, otwieranie
acısız - bezbolesny, bez ostrych przypraw, łagodny
aciz - bezradny
açlık - głód
açmak - otwierać
acun - kosmos, wszechświat
ad - imię
ada - wyspa
adale - mięsień
adalet - sprawiedliwość, równość
Adalet - tureckie imię żeńskie
adam - człowiek
Adam - Adam
adamotu - mandragora
adaş - imiennik
Adel - tureckie imię męskie
Adem - tureckie imię męskie, odpowiednik imienia Adam
âdemelması - grdyka, jabłko Adama
Adigece - język adygejski
adres - adres
afet - katastrofa
Afganistan - Afganistan
afiş - afisz
afiyet olsun - smacznego!
Afrika - Afryka
afyon - opium
ağaç - drzewo
ağaçkakan - dzięcioł
ağaçlık - zagajnik
ağılı - trujący
ağır - ciężki, żmudny, poważny
ağız - usta
ağızdan - ustnie, oralnie, werbalnie
ağızdan ağıza - z ust do ust, z plotek, pogłosek
ağız tadı - spokój, harmonia
ağkatman - siatkówka oka
ağlamak - płakać, rozpaczać, ronić łzy
agnostisizm - agnostycyzm
agoni - agonia
ağrı - ból
ağustos - sierpień
ağzını topla - uważaj na swoje słownictwo! nie przeklinaj!
ahali - ludzie, ludność, mieszkańcy
ahbap - przyjaciel, kumpel, kolega, kompan
ahbaplık - znajomość, przyjaźń
ahçıbaşı - szef
aheste - wolny, nieprędki, delikatny, łagodny, spokojny
ahlak - moralność
ahlaki - etyczny, moralny
ahlaksal - etyczny, moralny
ahlaksızlık - niemoralność
ahlamak - wzdychać, westchnąć
ahmak - głupi, głupiec
ahşap - drewniany
ahtapot - ośmiornica
ahududu - malina
aile - rodzina
ajans - agencja
ak - biały, czysty, uczciwy
akademi - akademia
akademik - akademicki
akal - różowy
akanyıldız - meteor
akarsu - strumień, rzeka
akasya - akacja
Akatça - język akadyjski
akbaba - sęp
akçe - pieniądz, srebrna moneta, jednostka monetarna z czasów imperium osmańskieego
akciğer - płuco
Akdeniz - Morze Śródziemne
akdoğan - białozór
akik - agat
akıl - rozum, umysł
akılsızlık - głupota
akıtmak - lać, wlać, nalać, przelać, uronić (np.: krew, łzy)
akordiyon - akordeon
akraba - krewny, krewni
akrabalık - pokrewieństwo, relacja
aks - oś
akşam - wieczór, wieczorny
akşam yemeği - kolacja
aksan - akcent
akşın - albinos
aksiseda - echo
aktin - aktyna
aktör - aktor
aktris - aktorka
aktüel - faktyczny
akustik - akustyka, akustyczny
akvaryum - akwarium
akyuvar - leukocyt
ala ala - tylko
alabalık - pstrąg
alacakaranlık - zmierzch
alaka - relacja, związek
Alan - Alan
alçak gönüllü - skromny
aldırmaz - obojętny
aldırmazlık - apatia, obojętność
alerji - alergia
alet - narzędzie, instrument, aparat
alev - płomień
alfabe - alfabet
alfabetik - alfabetyczny
alıcı - klient, kupujący
alıklık - głupota, debilność
alımlı - uroczy, czarujący
alımlılık - atrakcyjność
alımsız - nieatrakcyjny
alımsızlık - nieatrakcyjność
alın - czoło
alıngan - łatwo obrażający się, drażliwy, przewrażliwiony
alınganlık - łatwe obrażanie się, drażliwość, przewrażliwienie
alıntılamak - cytować, zacytować
alkış - aplauz, aklamacja
alkol - alkohol
Allah - Allah, Bóg
Allah acısın - niech Bóg ma nad nim litość, niech się nad nim Bóg zlituje
Allah'a ısmarladık - do widzenia
Allah aşkına - na miłość boską!, na litość boską!
Allahsız - ateistyczny, bezbożny, bezlitosny
almak - kupować, brać
almanak - almanach
Almanca - język niemiecki
Almanya - Niemcy
Almanya Federal Cumhuriyeti - Republika Federalna Niemiec, Niemcy
Alpler - Alpy
alşimi - alchemia
altbilinç - podświadomość
altı - sześć
altın - złoto, złotego koloru
altıncı - szósty
altıntop - grejpfrut
altmış - sześćdziesiąt
altmışıncı - sześćdziesiąty
alt tür - podgatunek
alüminyum - aluminium
alyuvar - erytrocyt
amaç - cel
amaçsız - bezsensowny, bezcelowy
amaçsızca - bez celu
ambulans - ambulans, karetka
amca - wujek ze strony ojca
ame - matka, mama
amele - pracownik, robotnik
Amerika Birleşik Devletleri - Stany Zjednoczone Ameryki
Amharca - język amharski
amilopektin - amylopektyna
amiral - admirał
amonyak - amoniak
amper - amper
ampirik - empiryczny
an - moment
ana - matka, mama (człowieka, zwierzęcia), fundament, podstawa, baza, matka (kobieta starsza stopniem, doświadczeniem, w jakiejś strukturze)
anabolizma - anabolizm
anadili - język ojczysty ( język matki)
Anadolu - Anatolia
anahtar - klucz
anakara - kontynent
analık - macierzyństwo, bycie matką
analiz - analiza
analjezi - analgezja
analoji - analogia
anamal - kapitał
anamalcı - kapitalista
anamalcılık - kapitalizm
ananas - ananas
anane - tradycja
ananevi - tradycyjny
anaokulu - przedszkole
anapara - kapitał
anarşi - anarchia
anarşist - anarchista
anarşizm - anarchizm
anasoycu - rasista
anasoyculuk - rasizm
anatomi - anatomia
anatomik - anatomiczny
anavatan - ojczyzna
anayasa - konstytucja
anayasacı - konstytucjonalista
anayasal - konstytucyjny
anayol - główna droga
anayurt - ojczyzna
andavallı - głupi, idiotyczny
Andorra - Andora
anekdot - anegdota
anemi - anemia, niedokrwistość
anestezi - znieczulenie, anestezja
angın - sławny, słynny, znany
Angola - Angola
aniden - nagle
anık - gotowy
animasyon - animacja, film animowany
animizm - animizm
anket - kwestionariusz
anksiyete - lęk
anlamak - rozumieć
anlaşılır - zrozumiały, jasny
anlatmak - wyjaśnić, wytłumaczyć, opowiedzieć, zrelacjonować
anmak - przypominać sobie, wspominać, mówić o, uczcić pamięć
anne - matka
anonim - anonimowy
anöplodi - aneuploidia
anormal - anormalny, nienormalny, nieprawidłowy
anormallik - nienormalność
ansiklopedi - encyklopedia
ant - przysięga
anten - antena
Antigua ve Barbuda - Antigua i Barbuda
antik - antyczny
antika - antyk
antikapitalizm - antykapitalizm
antikomünizm - antykomunizm
antikor - antyciało, przeciwciało
antilop - antylopa
antipati - antypatia
antiseptik - antyseptyczny, antyseptyk
antropoloji - antropologia
aptallık - głupota
araba - samochód, wóz, pojazd
arabesk - arabeska
araf - czyściec
Aragonca - język aragoński
aral - archipelag, wyspa
aralık - grudzień
aramak - szukać, poszukiwać
Aramice - język aramejski
Arap - arabski
Arapça - język arabski
Arap Yarımadası - Półwysep Arabski
argo - żargon, slang
argon - argon
arı - pszczoła
Aristo - Arystoteles
aristokrasi - arystokracja
aritmetik - arytmetyczny, arytmetyka
Arjantin - Argentyna
arkadaş - przyjaciel
arkadaşlık - przyjaźń
arkeoloji - archeologia
arkeolojik - archeologiczny
arketip - archetyp
armağan - prezent
armut - gruszka
armut dibine düşer - niedaleko pada jabłko od jabłoni
Arnavutça - język albański
Arnavutluk - Albania
arpa - jęczmień, forsa
arşidük - arcyksiążę
arşiv - archiwum
artık yıl - rok przestępny
arzu - życzenie
aşçı - kucharz
aseksüellik - aseksualność
asfalt - asfalt
aşık olmak - zakochać się (w kim - )
asır - wiek, stulecie
asit - kwas
aşk - miłość
asker - żołnierz
askeri - militarny
askı - wieszak
aşkım - kochanie
asla - nigdy
aslan - lew
asmak - wieszać, zawieszać
asterisk - gwiazdka, asterysk
asteroit - asteroida
astrolog - astrolog
astroloji - astrologia
astronom - astronom
astronomi - astronomia
astronot - astronauta
Asturyasça - język asturyjski
Asya - Azja
Asyalı - Azjata
at - koń
ateist - ateista
ateizm - ateizm
ateş - gorączka
Atina - Ateny, Atena
Atlantik - Atlantyk
Atlas Okyanusu - Ocean Atlantycki
atmaca - jastrząb
atmak - rzucać, uderzać
atmosfer - atmosfera
Augeas - Augiasz
av - polowanie, zdobycz
avantür - przygoda
Avarca - język awarski
avcı - myśliwy
avlamak - polować
avlu - dziedziniec, podwórze
avokado - awokado
Avrupa - Europa
Avrupa Birliği - Unia Europejska
avukat - adwokat
avunç - pociecha, pocieszenie
avundurmak - pocieszać, rozpraszać smutek
avunmak - pocieszać się, znajdować pocieszenie
avuntu - pocieszenie, pociecha
Avustralya - Australia
Avusturya - Austria
ay - miesiąc, księżyc
ayak - stopa, noga (mebla)
ayakkabı - but
ayaz - mróz
ayçiçeği - słonecznik
aygıt - urządzenie, aparat, sprzęt
ayı - niedźwiedź
ayırmak - oddzielić
ay ışığı - światło księżyca
aylık - pensja
ayna - lustro
aynştaynyum - einstein
ayrıntılı - szczegółowy
ayvar - ajwar
az - mało
Azerbaycan - Azerbejdżan
Azerice - język azerski
azık - prowiant, jedzenie na drogę
azınlık - mniejszość
azot - azot
baba - ojciec, tata
baca - komin
bacak - noga
badem - migdał
bagaj - bagaż
bağımsızlık - niepodległość, niezależność, samodzielność, bezpartyjność, niezależność zmiennych losowych
bağırtı - krzyk
Bahamalar - Bahamy
bahar - wiosna
baharat - przyprawa
bahçe - ogród
bahıs - dyskusja
Bahreyn - Bahrajn
bakan - minister
bakanlık - ministerstwo
bakılmaksızın - niezależnie od
bakir - dziewiczy, nietknięty
bakır - miedź
bakirelik - dziewictwo
baklava - baklawa
baklavacı - osoba wyrabiająca lub sprzedająca baklawę
baklavacılık - wyrabianie lub sprzedawanie baklaw
bakmak - patrzeć (na coś)
bakteri - bakteria
bakteriyolog - bakteriolog
bakteriyoloji - bakteriologia
Bakü - Baku
bal - miód
bale - balet
balık - ryba
balıkçı - rybak
balık kavağa çıkınca - na świętego nigdy, nigdy
balina - wieloryb
bal kabağı - dynia
balon - balon
balta - siekiera
balyoz - młot oburęczny
bambu - bambus
bandaj - bandaż
Bangladeş - Bangladesz
banker - bankier
banliyö - przedmieście
Barbados - Barbados
barınak - schronienie, azyl
barış - pokój, zgoda
Barış - tureckie imię męskie
bariton - baryton
Barselona - Barcelona
barut - proch strzelniczy
baş - głowa, szef, lider, początek, baza, fundament, podstawa, czubek, szczyt
Başar - tureckie imię męskie
başbakan - premier
başıboş - nieskrępowany, nieograniczony, bezcelowy, dowolny
basınç - ciśnienie
başka - drugi, alternatywny, inny
başkan - prezydent
Baskça - język baskijski
başkent - stolica
Başkurtça - język baszkirski
başlamak - zaczynać
başparmak - kciuk
Basra Körfezi - Zatoka Perska
başşehir - stolica
batı - zachód
batmak - zatopić się, zanurzyć się
bayat - czerstwy, nieświeży
baykuş - sowa
bayrak - flaga, sztandar
bayram - święto
Bayram - tureckie imię męskie
baytar - weterynarz
baz - baza
bebek - dziecko
bebek bakıcısı - opiekunka do dziecka, baby sitterka
becerikli - sprytny
bedava - bezpłatny, za darmo
bedbaht - nieszczęśliwy, pechowy
bedbin - pesymistyczny
bedbinlik - pesymizm
beden - ciało
begonya - begonia
Behçet - tureckie imię męskie
behişt - raj
bej - beżowy kolor
bekaret - dziewictwo
beklemek - czekać, wyczekiwać, oczekiwać
bekleme odası - poczekalnia
Belarusça - język białoruski
Belçika - Belgia
belde - miasto
belge - dokument, certyfikat
belgelemek - udokumentować, potwierdzić, udowodnić
belirteç - przysłówek
belirtik - wyraźny, jasny
Belize - Belize
bellek - pamięć
Beluci - język beludżi
ben - ja, pierwsza osoba liczby pojedynczej
bencil - egoistyczny, samolubny
bencillik - egoizm
Bengalce - język bengalski
bengi - wieczny
Benin - Benin
bent - tama
benzen - benzen
benzer - podobny
benzerlik - podobieństwo
benzin - benzyna
beraber - razem, wspólnie
beraberce - razem, z, wraz z
berber - fryzjer
berberlik - fryzjerstwo
bereketli - owocny, obfity
bergamot - bergamota, bergamotka
berhudar - szczęśliwy, pomyślny
berilyum - beryl
berkemal - skończony, doskonały, pełny
berkitmek - wzmacniać
berklik - moc, solidność, trwałość, masywność
berzah - stan barzakh, barzach, przesmyk
beş - pięć, 5
besbelli - oczywisty, jasny, ewidentny
beşeriyet - ludzkość
beşgen - pięciokąt
beşik - kolebka, kołyska
beşinci - piąty
beter - gorszy
beton - beton, betonowy
beyaz - biały
Beyaz Rusça - język białoruski
Beyaz Rusya - Białoruś
beygir - koń
beyin - mózg
beyinsiz - bezmózgi, głupi
beynelmilel - międzynarodowy
beyzbol - baseball
bez - gruczoł
beze - gruczoł
bezek - ornament, dekoracja
bezenmek - dekorować, ozdabiać
bezmek - zmęczyć się, znudzić się
Bhutan - Bhutan
biber - pieprz
bibliyografya - bibliografia
bıçak - nóż
bıçaklamak - dźgnąć, pchąć nożem
biçim - kształt, forma, sposób
bikir - dziewictwo
bıkkınlık - frustracja
bıldır - w zeszłym roku
bıldırcın - przepiórka
bildiri - anons, manifest, ogłoszenie, komunikat
bilet - bilet
bilezik - bransoletka
bilge - mędrzec
bilgi - wiedza
bilgisayar - komputer
bilgisizlik - ignorancja, niewiedza
bilim - nauka
bilim adamı - naukowiec
bilimcilik - scjentyzm
bilimdışı - nienaukowy
bilim kurgu - fantastyka naukowa
bilimsel - naukowy
bilimsiz - nienaukowy
bilinç - świadomość
bilinçaltı - podświadomość
bilinemezci - agnostycki, agnostyczny, agnostyk
bilinemezcilik - agnostycyzm
bilişim - informacja
bilmek - wiedzieć
bina - budynek
binyıl - tysiąclecie, millenium
bir - jeden, 1, ten, -
bira - piwo
birader - brat
biraz - mały
birimiz hepimiz, hepimiz birimiz için - jeden za wszystkich, wszyscy za jednego
birinci - pierwszy
birleme - unia, łączenie, jednoczenie
birlemek - jednoczyć, łączyć
birlenmek - być zjednoczonym
Birleşik Arap Emirlikleri - Zjednoczone Emiraty Arabskie
Birleşik Krallık - Zjednoczone Królestwo (Wielkiej Brytanii i Irlandii Północnej)
birleşmek - łączyć, jednoczyć
Birleşmiş Milletler - Organizacja Narodów Zjednoczonych
birleştirmek - kombinować
birlik - stowarzyszenie, unia, federacja
birlikte - razem, wspólnie
birliktelik - jedność, współpraca, unia, związek, stowarzyszenie
Birmanca - język birmański
Birmanya - Birma
bir şey - coś
bir taşla iki kuş vurmak - upiec dwie pieczenie na jednym ogniu
biseksüellik - biseksualizm, biseksualność
bisiklet - rower
bitaraf - neutralny, bezstronny
bitirmek - skończyć, zakończyć
bitişik - przyległy
bitki - roślina
bitki bilimi - botanika
bitkisel - roślinny
bitmek - skończyć się
bıyık - wąsy
biyografik - biograficzny
biyokimya - biochemia
biyoloji - biologia
biz - my
bluz - bluzka
böbrek - nerka
böcek - insekt, robak
böcekbilim - entomologia
boğa - byk
Boğa - Byk
boğaz - gardło
böğürtlen - jeżyna
bol - obfity
Bolivya - Boliwia
bölmek - dzielić
bön - głupi
bor - bor
borç - kredyt, zobowiązanie
bordür - krawężnik
boşamak - rozwodzić się
boşanma - rozwód
Bosna - Bośnia
Bosna-Hersek - Bośnia i Hercegowina
Boşnakça - język bośniacki
botanik - botanika, botaniczny
Botsvana - Botswana
boya - farba, barwnik
boyacı - malarz (pracownik zamalowywujący dane powierzchnie)
boyamak - kolorować, barwić, malować
boyun - kark
boyunbağı - krawat
Brezilya - Brazylia
Britanya - Brytania
brom - brom
Brüksel - Bruksela
buğday - pszenica
bugün - dziś
Bükreş - Bukareszt
bulaşık - brudny
bülbül - słowik
buldozer - buldożer, spychacz
Bülent - tureckie imię męskie
Bulgarca - język bułgarski
Bulgaristan - Bułgaria
bulgur - bulgur
bulmak - znaleźć
buluşmak - spotkać
bulut - chmura
bulutlu - pochmurny
burç - wieża, zodiak, konstelacja zodiakalna, znak zodiaku
Burkina Faso - Burkina Faso
Burmaca - język birmański
büro - biuro
bürokrasi - biurokracja
bürokrat - biurokrata
burun - nos
Burundi - Burundi
but - udo
bütçe - budżet
büyük - duży, wielki, ogromny
büyük baba - dziadek
büyükelçi - ambasador
büyüleyici - uroczy
büyülü - magiczny
büyümek - rosnąć
büyütmek - powiększać, przesadzać, wyolbrzymiać, wychowywać, utrzymywać (dzieci)
buz - lód
buzdolabı - lodówka
çabuk - szybki
çabukluk - przyspieszenie
Çad - Czad
cadde - aleja, ulica
cadı - czarownica
çadır - namiot
Cafer - tureckie imię męskie
çağ - epoka, era
çakal - szakal
çalar saat - budzik
çalgı - instrument muzyczny
çalışkanlık - pracowitość
çalışmak - działać, pracować, operować, funkcjonować, prowadzić, studiować
çam - sosna
cami - meczet
çamur - błoto
çapa - motyka
çar - car
çarmıha germek - ukrzyżować
çarpışma - walka, konflikt, kolizja
çarşamba - środa
carta - pierdnięcie
cartayı çekmek - kopnąć w kalendarz, wykorkować
casus - szpieg
casusluk - szpiegostwo
çatal - widelec
çatalağız - delta
çatı - dach
çat pat - odrobinę, trochę
çavdar - żyto
çay - herbata
Çeçence - język czeczeński
Çeçenya - Czeczenia
cehennem - piekło
çehre - twarz, oblicze, wygląd
Çek - Czechy
Çekçe - język czeski
Çek Cumhuriyeti - Czechy
çekememezlik - zazdrość
çekiç - młot, młotek
çekingenlik - nieśmiałość
çekmek - ciągnąć
Çekya - Czechy
Celal - tureckie imię męskie
çelik - stal
Çelik - tureckie imię męskie
Celile - Galilea
çello - wiolonczela
çember - obwód, okrąg, obręcz, krążek
çemberlemek - obijać, opasywać obręczami
Cemil - tureckie imię męskie
çene - broda, szczęka
çeneli - rozmowny, gadatliwy
Cenevre - Genewa
Cengiz - tureckie imię męskie
cennet - niebo, raj
cep - kieszeń
cephane - amunicja
çeri - żołnierz
cesaret - dzielność, odwaga
ceset - ciało, zwłoki
çeşit - gatunek, rodzaj, typ
çeşitli - różnorodny
çeşme - fontanna
cesur - dzielny, odważny
Çetin - tureckie imię męskie
cevap - odpowiedź
cevaplamak - odpowiedzieć
cevap vermek - odpowiedzieć
Çevik - tureckie imię męskie
çeviri - tłumaczenie
çevirici - tłumacz
çevirmen - tłumacz
ceviz - orzech włoski
çevre - środowisko
çevre bilimi - ochrona środowiska, ekologia
çevren - horyzont
ceza - kara
cezalandırmak - karać
Cezayir - Algieria, Algier
Cibuti - Dżibuti
çiçek - kwiat
çift - podwójnie, dwukrotnie, dwa razy
çiftçi - rolnik, farmer
çiftçilik - rolnictwo
çiftlik - farma, rola, uprawa, plantacja
çığ - lawina
çığlık - krzyk
çiğnemek - żuć, przeżuwać
cihad - dżihad
cihan - wszechświat, świat
çıkış - wyjście
Çıkış - Księga Wyjścia
ciklet - guma do żucia
çikolata - czekolada
çil - pieg
çilek - truskawka, truskawka (owoc)
çılgın - szalony, dziki
çilingir - ślusarz
çilli - piegowaty
çimento - cement
çimentolamak - cementować
cimri - skąpy
Çin - Chiny
Çince - chiński
Çingene - Cygan
Çingene pembesi - jaskrawy różowy, kolor intensywnie różowy
çinko - cynk
cinsel - seksualny, płciowy
cinsel birleşme - stosunek seksualny
cinsel ilişki - seks, stosunek płciowy
cinsellik - seksualność
cinsel yönelim - orientacja seksualna
çıpa - kotwica
çıplak - nagi, goły, bez czegoś, pozbawiony czegoś, pusty
çıplaklık - nagość
çirkin - brzydki
çirkinlik - brzydota
çiş - siusiu
çita - gepard
cıva - rtęć
çizim - rysunek
çoban - pasterz
çoban köpeği - pies pasterski
çocuk - dziecko
çocukça - dziecinnie, dziecinny
çocukluk - dzieciństwo
çocuksu - dziecinny
coğrafya - geografia
coğrafyacı - geograf, nauczyciel geografii
çoğunluk - większość
çok - dużo, wiele
çokça - dużo
çokgen - wielokąt
çöl - pustynia
çorap - skarpeta
çorba - zupa, bałagan, bajzel
çörek - drożdżówka
coşkulu - entuzjastyczny
coşmak - zachwycić się, ekscytować się
coşturucu - ekscytujący
coşu - zachwyt
coşumcu - romantyk, pisarz romantyczny, romantyczny
coşumculuk - romantyzm
çözüm - rozwiązanie (problemu), rozwiązanie
çözümleme - analiza
çözümlemek - analizować
çukur - dziura, wgłębienie, dół, grób, odbyt
cuma - piątek
cumartesi - sobota
cumhuriyet - republika
Çuvaşça - język czuwaski
dadaizm - dadaizm, ruch dada
dağ - góra
dağcı - alpinista, wspinacz
dağlık - górzysty
daha - bardziej
daima - zawsze, ciągle
dakik - precyzyjny, rygorystyczny
dakika - minuta
Dakka - Dhaka
daktilo - maszyna do pisania
dal - gałąź
dalak - śledziona
dalgalı - falisty
Dalmaçyaca - język dalmatyński
dalmak - zanurkować
dam - dach
damak - podniebienie
damıtma - destylacja
damla - kropla
Danca - język duński
Danimarka - Dania
dans - taniec
dar - wąski, ciasny, skąpy, niewystarczający, ledwie, z trudem
darağacı - szubienica
darbe - uderzenie
darbımesel - przysłowie
dari - kukurydza
darı - proso
dar sokak - uliczka
davranış - zachowanie, postępowanie
davul - bęben
davulcu - bębniarz
davulun sesi uzaktan hoş gelir - trawa jest bardziej zielona po drugiej stronie
dayanıklı - wytrzymały, wytrwały, silny, twardy (psychicznie lub fizycznie), odporny (np. na działanie ognia)
dayanıklılık - trwałość
dayanışma - solidarność
dayı - wujek
dede - dziadek
dedikodu - plotka
dedikodu etmek - plotkować
dedikodu yapmak - plotkować
defter - zeszyt, notes
değer - wartość
değişiklik - zmiana, modyfikacja, odmiana, wariacja
değişmek - zmieniać
değme - kontakt, dotyk, dotknięcie
dehşetli - straszny, straszliwy, niesamowity
deizm - deizm
dejenerasyon - degeneracja
dejenere - degenerat
dek - sztuczka, podstęp
dekadanlık - dekadencja, dekadentyzm
dekan - dziekan
dekatlon - dekatlon
deklarasyon - deklaracja
dekorasyon - dekoracja, dekorowanie, udekorowanie
dekoratör - dekorator
delik - dziura
delil - dowód (na coś)
delmek - przedziurawić, przekłuć
dem - oddech
demeç - oświadczenie, deklaracja
demek - powiedzieć, nazwać
demir - żelazo
Demir - tureckie imię męskie
demografi - demografia
demokrasi - demokracja
demokratik - demokratyczny
denemek - próbować, spróbować
deneyim - doświadczenie
denge - równowaga, stabilność
deniz - morze
denizanası - meduza
deniz feneri - latarnia morska
deniz hıyarı - strzykwa
deniz kızı - syrena
denizyıldızı - rozgwiazda
deprem - trzęsienie ziemi
depresyon - depresja
derece - stopień
derece derece - stopniowo
derhal - od razu, naraz, natychmiast
deri - skóra
derişmek - koncentrować się, być skoncentrowanym, koncentrować
dermatolog - dermatolog
dermatoloji - dermatologia
derya - morze, uczony, mądry człowiek
desen - rysunek
despotizm - despotyzm
detaylı - szczegółowy
deva - lekarstwo, lek, remedium
devalüasyon - dewaluacja
devam - kontynuacja, ciągłość
devam etmek - kontynuować
devamlı - ciągły
deve - wielbłąd, struś
deve kuşu - struś
devingenlik - mobilność
devlet - państwo
devrim - rewolucja, przemiana
dijital - cyfrowy
dikdörtgen - prostokąt
diken - cierń
dikey - pionowy
dikilitaş - obelisk
dikine - wertykalnie, pionowo
dikkat - uwaga, atencja
dikkate almak - wziąć pod uwagę, zauważać
dikkat etmek - zwracać uwagę, uważać
dikkat toplaşımı - koncentracja (uwagi)
dikmek - sadzić, szyć
diktatörlük - dyktatura
dil - język
dilbilgisi - gramatyka
dilbilim - językoznawstwo
dilci - lingwista, językoznawca
dilenci - żebrak
din - wiara, religia
dinamit - dynamit
dindar - pobożny
dinî - religijny
dinlemek - słuchać
dinozor - dinozaur
dinsel - religijny, dotyczący religii
diphallia - difalia
diplomasi - dyplomacja
diplomat - dyplomata
diplomatik - dyplomatyczny
diri - żywy
dirsek - łokieć
diş - ząb
diş fırçası - szczoteczka do zębów
disiplin - dyscyplina, karność
dışkı - kał, wydalina
diş macunu - pasta do zębów
disprosyum - dysproz
diyabet - cukrzyca
diyafram - przepona
diyalekt - dialekt
diyalektik - dialektyka
diyalog - dialog
diyet - dieta
diz - kolano
doğa - natura
doğal - naturalny
doğal gaz - gaz ziemny
doğaüstü - nadnaturalny, nadprzyrodzony
doğru - właściwy, prawidłowy, poprawny, dobry, odpowiedni
doğru açı - kąt rozwarty (180°)
doğrucu - prawdomówny
doğruculuk - prawdziwość, szczerość, prawdomówność
doğrudan - bezpośrednio, prosto
doğrudan doğruya - bezpośrednio
doğrulama - weryfikacja
doğrulamak - potwierdzać
doğrulanmak - być zweryfikowanym, potwierdzonym
doğrultu - dyrektor
doğruluk - prawda, szczerość, uczciwość, prostolinijność
doğrusal - linearny
doğu - wschód
doğubilim - studia orientalistyczne, orientalistyka
Doğu Bloku - blok wschodni
doğum günü - urodziny
doğuştan - wrodzony
dökmek - lać, nalewać, ronić, sypać
doksan - dziewięćdziesiąt
doksanıncı - dziewięćdziesiąty
doktor - doktor
doku - tkanka
dokunmak - dotykać
dokuz - dziewięć
dokuzuncu - dziewiąty
dolmak - być pełen, napełniony
dolma kalem - wieczne pióro
dolmen - dolmen
dolunay - pełnia księżyca
domates - pomidor
domuz - świnia, wieprz
don - majtki, mróz
donanım - hardware
dondurma - lód, deser lodowy
dönence - zwrotnik
dönüş - powrót
dördüncü - czwarty
dört - cztery, 4
dost - przyjaciel
dostluk - przyjaźń
dövme - tatuaż
dövmek - bić
dua - modlitwa
dudak - warga
dudak boyası - szminka
düdük - gwizdek
duman - mgła
dün - wczoraj
dünkü - wczorajszy
dünya - świat
Dünya - Ziemia
durdurmak - zatrzymać
durmak - zatrzymać się, stać, pozostawać, być (w jakim stanie lub miejscu - )
duru - czysty
durum - stan, warunki, kondycja, położenie, pozycja
dürüm - coś zwiniętego, zawiniętego, kawałek bardzo cienkiego ciasta, którym owija się jakąś porcję jedzenia
duş - prysznic
düş - sen, marzenie, pragnienie, aspiracja
düşerge - obóz
düşes - księżna
düşkün - gorliwy, zapalony
düşman - wróg, przeciwnik
düşmek - spadać, spaść
düşün - myśl
düşünmek - myśleć
düşünür - myśliciel, intelektualista
duvar - mur
duyarlı - wrażliwy
duyarlılık - emocjonalność, uczuciowość, wrażliwość
duygu - emocja
duymak - czuć, słyszeć
düzine - tuzin
düzlem - płaszczyzna
ebe - położna
ebedî - wieczny
ecel şerbeti içmek - umrzeć
Eçmiadzin - Eczmiadzyn
eczacı - aptekarz, farmaceuta
eczane - apteka
edat - przyimek
edebiyat - literatura
edep - kultura, dobre maniery
edepi kelam - eufemizm
efendim - szanowny panie, proszę pana, słucham?, proszę?
efsane - legenda
efsanevi - bajeczny, mityczny, legendarny, baśń, legenda
Ege denizi - Morze Egejskie
eğitici - edukacyjny, oświatowy
eğitim - szkolnictwo, edukacja
eğitimci - wychowawca
eğitimli - wykształcony
eğitimsel - pedagogiczny
eğitmek - edukować, kształcić, szkolić, wychowywać
eğitmen - instruktor
eğitsel - edukacyjny
eğlendirmek - bawić, zabawiać, rozbawiać
egoizm - egoizm
eğrelti otu - paproć
egzistansiyalist - egzystencjalista, egzystencjalistka
egzistansiyalizm - egzystencjalizm
ejder - smok
ejderha - smok
ejekülasyon - wytrysk, ejakulacja
ekim - październik
ekinoks - równonoc
ekliptik - ekliptyka
ekmek - chleb
ekoloji - ekologia
ekonomi - ekonomia
ekonomik - ekonomiczny
ekonomist - ekonomista
ekosistem - ekosystem
Ekrem - tureckie imię męskie
ekşi - cierpki, kwaśny
eksper - ekspert
Ekvador - Ekwador
el - ręka, obcokrajowiec, kraj
elastik - elastyczny
eldiven - rękawiczka
elektroliz - elektroliza
elektromanyetik - elektromagnetyczny
elektromıknatıs - elektromagnes
elektronik - elektronika, elektroniczny
elektronik beyin - komputer
elin - pięćdziesiąt
elinci - pięćdziesiąty
elips - elipsa
elitizm - elityzm
elli - pięćdziesiąt, 50
elma - jabłoń, jabłko (owoc)
elmas - diament
El Salvador - Salwador
elzem - nieodzowny
embriyo - embrion
emin - bezpieczny, pewny
Emine - Emilia
emmek - ssać
empati - empatia
en - szerokość
endişeli - niespokojny
Endonezya - Indonezja
Endonezyalı - Indonezyjczyk, Indonezyjka
Endülüs - Andaluzja
enerji - energia
enerjik - energiczny
enfeksiyon - infekcja
enflasyon - inflacja
enformasyon - informacja
engel - bariera
Engin - tureckie imię męskie
enginar - karczoch
engizisyon - inkwizycja
enişte - szwagier
ense - szyja, kark
ensest - kazirodztwo
enstitü - instytut
entegrasyon - integracja
entelektüel - intelektualny
entellektüel - intelektualista, intelektualny
enteresan - interesujący
enternasyonal - międzynarodowy
entomoloji - entomologia
entrika - intryga
epidemiyoloji - epidemiologia
epilepsi - epilepsja, padaczka
Erdal - tureckie imię męskie
erdemli - cnotliwy
ereksiyon - erekcja
erik - śliwa, śliwka
Eritre - Erytrea
eritrosit - erytrocyt
Erivan - Erywań
erkek - mężczyzna, samiec, męski, odważny, dzielny
erkek organ - pręcik, męski organ, członek męski
Ermenistan - Armenia
eroin - heroina
erojen bölge - strefa erogenna
Erol - tureckie imię męskie
erotik - erotyczny
Ertan - tureckie imię męskie
Erzurum - Erzurum
eş - małżonek, mąż lub żona
eşcinsellik - homoseksualizm
eşek - osioł
eşek arısı - szerszeń
eşkenar dörtgen - romb
eski - dawny, stary, starożytny
eskimiş - przestarzały, stary
Eski Mısır - starożytny Egipt
esnemek - ziewać
espresso - espresso (kawa)
esrarengiz - tajemniczy
estetik - estetyka
Estonca - język estoński
Estonya - Estonia
et - mięso
etek - spódnica
etik - etyka
etimoloji - etymologia
etki - działanie
etkili - efektywny
etkin - aktywny
etkisiz - nieskuteczny
etmek - robić, czynić (słowo raczej nieużywane samotnie, lecz jako czasownik posiłkowy jest zestawiane z rzeczownikiem i daje wyrażenie czasownikowe), robić (dobrze lub źle), równać się, wynosić, dawać, kosztować, być wartym
etnik - etniczny
etnografya - etnografia
ev - dom
evet - tak
evlenmek - poślubić
evli - żonaty, zamężny, po ślubie
evlilik - małżeństwo, stan bycia mężem i żoną
evrim - ewolucja
Evrim - tureckie imię męskie
evsiz - bezdomny
eylemcilik - aktywizm
eylül - wrzesień
eziyet - tortura
Ezop - Ezop
faal - aktywny
faaliyet - aktywność
fabrika - fabryka
Fahir - tureckie imię męskie
fahişe - dziwka, kurwa, prostytutka
fakülte - fakultet
familya - rodzina, żona
fanatiklik - fanatyzm
fâni - śmiertelny
fare - mysz, mysz komputerowa
fark - różnica
farklı - inny, różny, niepodobny
Farsça - język perski
Fas - Maroko
faşist - faszystowski
faşizm - faszyzm
Faslı - Marokańczyk, Marokanka, marokański
fatalist - fatalista, fatalistyczny
fatalizm - fatalizm
fatura - faktura
faul - faul
faydacılık - utylitaryzm
faydalı - użyteczny, pożyteczny, przydatny
faydasız - bezużyteczny
fayton - faeton
Fazıl - Fazil, tureckie imię męskie
fazilet - cnota (zaleta)
fazlalık - nadmiar, przepełnienie
feci - tragiczny, katastrofalny, okropny
federasyon - federacja
felsefe - filozofia
felsefeci - filozof
femur - kość udowa
fen - nauka
feodalizm - feudalizm
feribot - prom
fermuar - suwak, zamek błyskawiczny
festival - festiwal
Fevzi - tureckie imię męskie
Feyyaz - tureckie imię męskie
fiil - czasownik
Fiji - Fidżi
fikir - myśl, koncepcja
fıkra - anegdota
fil - słoń, goniec, laufer
Filistin - Palestyna
Filistinli - Palestyńczyk
filogenetik - filogeneza
filoloji - filologia
filozof - filozof
finans - finanse
Fince - język fiński
fındık - orzech laskowy
Finlandiya - Finlandia
Fırat - tureckie imię męskie
firavun - faraon
fırsat - okazja, możliwość
fırtına - burza
firuze - turkus
fıtık - przepuklina
fizik - fizyka
fizyoloji - fizjologia
fizyolojik - fizjologiczny
flütçü - flecista, flecistka
fobi - fobia
fonetik - fonetyka
formasyon - formacja
fotoğraf - fotografia
fotoğrafçı - fotograf
fotojenik - fotogeniczny
fotokopi çekmek - kserować (co - )
fotokopi yapmak - kserować (co - )
fotosentez - fotosynteza
Fransa - Francja
fransiyum - frans
Fransız - francuski
Fransızca - język francuski
fren - hamulec
Frenk - Europejczyk, europejski
fresk - fresk (technika), fresk (dzieło)
fruktoz - fruktoza
funda - krzew
Furkan - tureckie imię męskie
futbol - futbol, piłka nożna
Gabon - Gabon
gadolinyum - gadolin
gaga - dziób
galaksi - galaktyka
galaktik - galaktyczny
galiba - prawdopodobnie, widocznie, zapewne, przypuszczalnie
Galiçyaca - język galicyjski
gamsız - pogodny, beztroski
Gana - Ghana
garaj - garaż
garanti - gwarancja, poręczenie
Gargantua - Gargantua
garip - dziwaczny, dziwny
Gaskonca - język/dialekt gaskoński
Gaskonya - Gaskonia
gaz - gaz
gazete - gazeta
gazeteci - dziennikarz
gebe - w ciąży
gebelik - ciąża
geç - późno
gece - noc
geçici - tymczasowy
geçimsiz - trudny, marudny
geçirmek - geçmek, przebywać, spędzić (coś gdzieś)
geçmek - przejść, przejechać, przelecieć (przez lub obok czegoś - ), mijać, przemijać
geçmiş - przeszłość
gelenek - tradycja
geleneksel - tradycjonalny, tradycyjny
gelincik - łasica, mak
gelişme - progres, rozwój, wzrost, rozwijanie się
gelişmek - rozwijać się
gelmek - przychodzić, przyjść
gemi - statek
gemi adamı - marynarz
genç - młody
gençlik - młodość
geometri - geometria
gerçek - prawda, rzeczywistość, prawdziwy
gerçekçi - realistyczny, realny, przyziemny
gerçeklik - rzeczywistość
gerdan - szyja
gerdanlık - naszyjnik
gerekli - potrzebny, niezbędny
gerekmek - być konieczny, być niezbędny
gereksiz - niepotrzebny
gergedan - nosorożec
germanyum - german
germek - rozciągać, wyciągać, naciągać (coś lub coś na coś - )
gerontokrasi - gerontokracja
getirmek - przynosić, przynieść
geyik - jeleń
geyşa - gejsza
gezegen - planeta
girdap - wir
giriş - dostęp
girmek - wejść, wjechać, wlecieć itd.
gitar - gitara
gitmek - iść
giymek - nosić
gizemli - tajemniczy
gizlemek - ukryć, schować
gizli - sekretny
gluten - gluten
göbek - pępek
göç - migracja
göçebe - nomada, migrant, migracyjny, wędrowny (człowiek, zwierzę)
göçmen - emigrant, migracyjny, emigracyjny
Godzilla - Godzilla
göğüs - klatka piersiowa, biust
gök - niebo, firmament, sklepienie niebieskie
gökbilim - astronomia
gökbilimci - astronom
gökdelen - wieżowiec
gökgürültüsü - piorun
Gökhan - tureckie imię męskie
gök kandil - pijany w sztok, bardzo pijany
gök kubbe - wszechświat
gökkuşağı - tęcza
göktaşı - meteoryt
gökyakut - szafir
göl - jezioro
gölge - cień
göndermek - wysyłać, przesłać, odesłać
gondol - gondola
gönüllü - dobrowolny, chętny
goril - goryl
görmek - widzieć, patrzeć, oglądać
görünmek - wydawać się
görüntü kartı - karta graficzna
görüşmek - spotkać, zobaczyć się z kimś lub odwiedzić kogo, przeprowadzić z kimś wywiad, przedyskutować, porozmawiać o
göstermek - pokazać, wskazać, pokazać na co, wykazać, przejawiać
gotik - gotycki
götürmek - zabrać, przenieść, zanieść, przetransportować, odprowadzić, zaprowadzić (kogo gdzie)
götveren - pedał, ciota
gövde - tułów
göz - oko
gözbebeği - źrenica
gözde - ulubiony, ulubieniec
gözden kaybolmak - zniknąć
gözetlemek - obserwować, zerkać (zazwyczaj skrycie)
gözlemci - obserwator
gözlemlemek - obserwować, przyglądać się, oglądać uważnie
gözyaşı - łza
grafit - grafit
gramer - gramatyka
greyfurt - grejpfrut
Grönland - Grenlandia
Grönlandca - język grenlandzki
grup - grupa
Guatemala - Gwatemala
güçlük - trudność
gül - róża
güldürmek - rozśmieszać, doprowadzać do śmiechu, zabawić, rozbawić, ucieszyć, uszczęśliwić
güldürü - komedia, farsa
güle güle - do widzenia, pa pa
gül gibi - piękny, różany, bardzo dobry, doskonały
gülmek - śmiać się, uśmiechać
gülümsemek - uśmiechać się
gülünç - śmieszny, zabawny, niedorzeczny
gülüş - uśmiech
gümüş - srebro
gün - dzień, doba
günahsızlık - bezgrzeszność, niewinność, stan łaski
günaydın - dzień dobry
gün bilgisi - kalendarz
gündöndü - słonecznik
gündüz - dzień
günebakan - słonecznik
güneş - słońce
güneş çarpması - poparzenie słoneczne, udar słoneczny
güneş şemsiyesi - parasol (od słońca)
güney - południe
Güney Afrika - Republika Południowej Afryki
Güney Amerika - Ameryka Południowa
Güney Kore - Korea Południowa
Gürcistan - Gruzja
Gürcüce - język gruziński
güreş - zapasy
güreşçi - zapaśnik
gürültü - hałas
gürültülü - hałaśliwy
gurup - zachód słońca
gurur - duma, próżność
güve - ćma
güvenli - bezpieczny
güvenlik - bezpieczeństwo, porządek, ład
güvenmek - ufać
güvenmemek - nie ufać
güvercin - gołąb, gołębica
güvey - zięć
güz - jesień
güzel - piękny, ładny, słodki, wspaniały, doskonały, pięknie, ładnie, zupełnie, w pełni, z pasją, piękność (piękna kobieta)
haç - krzyż, krucyfiks
hacı - hadżi, pielgrzym
hacısı hocası - wszyscy
haçlamak - ukrzyżować
hadım - eunuch
hafif - lekki, cienki, delikatny, łagodny
hafıza - pamięć
hafniyum - hafn
hafta - tydzień
haftalık - tygodniowy
hafta sonu - weekend
haham - rabin
Haiti - Haiti
hakikat - fakt, prawda, rzeczywistość
hakiki - prawdziwy
hakim - sędzia
halhal - bransoletka lub łańcuszek na nogę
halı - dywanik
ham - surowy
hamam böceği - karaluch
hamile - w ciąży, ciężarna, spodziewająca się dziecka
hamilelik - ciąża
hamsi - sardela
hamt - dziękczynienie, podzięka składana Bogu, chwalenie Boga
hamur - ciasto
Hamza - Hamza, tureckie imię męskie
hançer - sztylet
hane - dom
hanım - dama, kobieta, pani
hap - pigułka
hapis - więzienie
hapşu - apsik!, a psik!
harabe - ruiny
hararetli - gorący, rozpalony, żarliwy
hardal - musztarda
hareket - akcja, działanie, ruch
hareketlilik - mobilność
harf - litera
harfiyen - literalnie, dosłownie
harita - mapa
haşere - robak
hasım - adwersarz, przeciwnik
haşiş - haszysz
hassas - delikatny, wrażliwy, drażliwy
hassasiyet - delikatność, wrażliwość, precyzja
hasta - chory
hastalanmak - zachorować
hastalık - choroba, dolegliwość
hastane - szpital
hata - błąd
hatalı - błędny
hatır - rozum, umysł, pamięć, wpływ, znaczenie, waga
hatırlamak - pamiętać
hatun - kobieta, żona
hava - pogoda, powietrze
havaalanı - lotnisko
havacılık - lotnictwo, awiacja
Havai - Hawaje
havai fişek - fajerwerk
havaküre - atmosfera
hava kuvvetleri - lotnictwo
havalimanı - lotnisko
havlamak - szczekać
havlayan köpek ısırmaz - szczekający pies nie gryzie, krowa, która dużo ryczy, mało mleka daje
havlu - ręcznik
havra - synagoga
havuç - marchew
havuz - basen
havuz balığı - karaś pospolity
Havva - Ewa
havyar - kawior
hayal - wizja, wyobrażenie, fantazja, sen, obraz
hayalet - duch
hayalî - urojony
hayal kırıklığı - rozczarowanie
hay anasını - jaka szkoda!
hayat - życie
haydut - bandyta
hayıf - niesprawiedliwość
hayır - nie (zaprzeczenie, negacja)
hayır sahibi - dobroczyńca, ofiarodawca, filantrop
hayırsever - dobroczyńca
hayvan - zwierzę
hayvanat bahçesi - zoo
hayvan hakları - prawa zwierząt
haz - radość
hazcılık - hedonizm
hazine - skarb
haziran - czerwiec
hazırlık - przygotowanie
hece - sylaba
hecin - wielbłąd
hedef - cel
hediye - prezent, podarek, podarunek
hediyelik eşya - pamiątka
hedonizm - hedonizm
hegemonya - hegemonia
hektar - hektar
helikopter - helikopter
helva - chałwa
helyum - hel
hematoloji - hematologia
hemhudut - przyległy
hemşire - pielęgniarka
hepten - całkowicie, w pełni, całościowo
her - każdy
herkes hata yapar - mylić się rzeczą ludzką, mylić się, rzecz ludzka, każdy popełnia błędy
Hersek - Hercegowina
her şey - wszystko
her zaman - zawsze
heteroseksüellik - heteroseksualizm
hevesli - gorliwy, zapalony
heykel - statua, rzeźba
heykeltıraş - rzeźbiarz, rzeźbiarka
hıçkırık - czkawka
hidrojen - wodór
higori çamı - sosna oścista
hijyen - higiena
hijyenik - higieniczny
hilaf - przeciwieństwo, odrotność, kłamstwo
hilafet - kalifat
Hindistan - Indie
hindistan cevizi - kokos
hinduizm - hinduizm
hırsız - złodziej
Hırvatça - język chorwacki
Hırvatistan - Chorwacja
hisar - zamek, fort
hissetmek - czuć, odczuć, odczuwać
hissî - emocjonalny, uczuciowy
histeri - histeria
hitap - apel, zwrócenie się do kogoś
hıyar - ogórek
hiyerarşi - hierarchia
hız - szybkość, prędkość, tempo, dynamiczność, moc, siła, gwałtowność, entuzjazm, żywość, wigor, energia, zapał, życie, głośność
hızlı - szybki, prędki
hizmet - misja, obowiązek, zadanie
hodan - ogórecznik lekarski
Hollanda - Holandia
Hollandaca - język niderlandzki, język holenderski
holmiyum - holm
homeostaz - homeostaza
homoseksüellik - homoseksualizm
hoplamak - skakać, podskakiwać
hoppa - lekkomyślny, frywolny, kapryśny, rozkapryszony, rozpuszczony
horlamak - chrapać
hormon - hormon
horoz - kogut
Horus - Horus
hoş - miły
hoşgörülü - liberalny, tolerancyjny, wyrozumiały
hücre - komórka
hücre çekirdeği - jądro komórkowe
hücre duvarı - ściana komórkowa
hücum - atak
hudutsuz - nieograniczony, bezgraniczny
hukuk - prawo
hukukçu - prawnik
hukuki - prawny, dotyczący prawa
hükümdar - monarcha, suzeren, władca
hükûmet - rząd
hümanist - humanistyczny, humanista
Hun - Hun
huy - temperament
hüzün - smutek, melancholia
İber Yarımadası - Półwysep Iberyjski
iblis - demon
İblis - diabeł, Lucyfer
İbranice - język hebrajski
iç çamaşırı - bielizna
içecek - napój, picie
içerik - treść (zawartość)
içermek - zawierać
için - aby
içmek - pić
iç savaş - wojna domowa
ideal - ideał
idealizm - idealizm
ideoloji - ideologia
ideolojik - ideologiczny
iflas - bankructwo
iğne - igła
iğrenç - obrzydliwy, odrażający, paskudny, oburzający, przykry
iğrenme - wstręt
ihtiras - pasja, silne pragnienie
ihtiyaç - potrzeba
ikaz etmek - ostrzegać
iki - dwa
ikinci - drugi
ikiz - bliźniak
İkizler - Bliźnięta
iklim - klimat
iklimsel - klimatyczny
iktisadi - gospodarczy, ekonomiczny
iktisat - gospodarka, ekonomia
ileti - wiadomość
ilgeç - cząstka
ilginç - interesujący
ilik - szpik
ilişki - połączenie, stosunek, kontakt, relacja
ilk - pierwszy, podstawowy, elementarny
ilkbahar - wiosna
ilmî - naukowy
ima - podpowiedź, aluzja
imkansız - niemożliwy
immateryalizm - immaterializm
immün sistem - system immunologiczny
imparator - imperator
imparatorluk - imperium
imzalamak - podpisać
inanç - wiara
inandırmak - przekonać, sprawić by kto w co uwierzył
inanmak - wierzyć (w coś lub komuś)
inç - cal
incelik - subtelność, delikatność, takt, elegancja, precyzja
inci - perła
İncil - Nowy Testament, ewangelia, Ewangelia
incir - figa
indiyum - ind
inek - krowa
İngiliz - mieszkaniec Anglii, Anglik, angielski
İngilizce - język angielski
İngiltere - Anglia
inovasyon - innowacja
insan - człowiek
insanbilim - antropologia
insancılık - humanizm
insanlık - człowieczeństwo, ludzkość
insansı maymun - małpa
intihar - samobójstwo
intikam - zemsta
ipek - jedwab
iplik - przędza
Irak - Irak
ırak - daleki, odległy
İran - Iran
İranlı - irański, Irańczyk
iribaş - kijanka
iridyum - iryd
ırkçılık - rasizm, etnocentryzm
İrlanda - Irlandia
İrlandalı - Irlandczyk, Irlandka
ırmak - rzeka
ironi - ironia
irrasyonel - irracjonalny
iş - praca, zadanie
İsa - Jezus
işaret - znak, oznaka
işçi - pracownik, robotnik
ışık - światło
isim - imię, nazwa, rzeczownik
ışın - promień, promień słoneczny, promień światła
ısırmak - gryźć
ısıtmak - ogrzewać, grzać, podgrzewać
işitmek - usłyszeć
İskandinav - skandynawski
İskandinavya - Skandynawia
İskandinav Yarımadası - Półwysep Skandynawski
iskelet - szkielet
iskemle - krzesło
işkence - męczarnia, tortura
İskenderiye - Aleksandria
İskoçya - Szkocja
ıslah - ulepszenie, udoskonalenie
ıslak - mokry
İslam - islam
ıslık çalmak - gwizdać
İsmet - tureckie imię męskie
ıspanak - szpinak
İspanya - Hiszpania
İspanyolca - język hiszpański
ispat etmek - dowieść
ispatlamak - dowieść
İsrail - Izrael
israilli - izraelski
ısrarla - uporczywie, uparcie
işsizlik - bezrobocie
iştah - apetyt
ıstakoz - homar
İstefanos - Stefan
istekli - gorliwy, zapalony
istemek - chcieć
istenmeyen - niechciany, niemile widziany, niepożądany
istisna - wyjątek
İsveç - Szwecja
İsviçre - Szwajcaria
it - pies
İtalya - Włochy
İtalyanca - język włoski
iterbiyum - iterb
itfaiyeci - strażak
itriyum - itr
it ürür, kervan yürür - psy szczekają, karawana idzie dalej
iyi - dobry
iyi geceler - dobranoc
iyi günler - dzień dobry (po południu), miłego dnia
izdiham - tłok, ścisk, tłum
İzlanda - Islandia
jaguar - jaguar
Jamaika - Jamajka
Japon balığı - złota rybka
Japonya - Japonia
jargon - żargon
jeoloji - geologia
jilet - brzytwa
jonglör - żongler
judo - judo, dżudo
Jüpiter - Jowisz
kabak - dynia, cukinia, kabaczek, trukwa, tykwa, kolczoch
kabarık - puszysty
kaba sofu - bigot
Kâbil - Kabul
kabile - plemię
kabiliyet - umiejętność, zdolność, dar, talent
kabine - gabinet
kabir - grób
kabristan - cmentarz
kabuki - kabuki
kabul - akceptacja
kabza - uchwyt (broni), garść haszyszu
kaçırmak - pozwolić uciec lub pomóc w ucieczce, sprawić by coś odeszło lub ustało, porywać, spóźnić się, nie skorzystać z okazji, nie zdążyć
kaçmak - uciekać (skąd - ), uciekać, chować się (przed czym/kogo - ), unikać (czego/kogo - )
kader - przeznaczenie
kadın - kobieta
kadınlık - kobiecość
Kadir - tureckie imię męskie
kadmiyum - kadm
kafa - głowa
kafatası - czaszka
kafein - kofeina
kâğıt - papier
kahraman - bohater
kahve - kawa
kahverengi - brązowy, brąz
kaide - baza
kâkül - grzywka
kalay - cyna
kaldırım - chodnik
kaldırmak - podnieść, unieść, unosić, podnosić, wspierać, odłożyć, przenieść (poza czyjś zasięg), znieść, anulować, uchylać
kalem - ołówek
kalkan - tarcza
kalmak - zostać, pozostać
kalp - serce
kalsiyum - wapń
Kamerun - Kamerun
kan - krew
kanaat - opinia, przekonanie, wiara
Kanada - Kanada
kanamak - krwawić
kanarya - kanarek
Kanarya Adaları - Wypsy Kanaryjskie
kanat - skrzydło
kanıtlamak - pokazywać
kanser - nowotwór, rak
kansız - anemiczny
kansızlık - niedokrwistość, anemia
kanun - akt prawny, przepis, ustawa
kanuni - legalny, zgodny z prawem
kanyak - brandy, koniak
kanyon - kanion
kaos - chaos
kapamak - zamykać
kapı - drzwi, brama, wrota
kapital - kapitał
kapitalizm - kapitalizm
kaplan - tygrys
kaplumbağa - żółw
kapris - kaprys, fantazja, zachcianka
kaprisli - kapryśny, zmienny
kapsamak - zawierać
kapsül - kapsułka
kaptan - dowódca, kapitan
kar - śnieg
kara - ląd, ziemia, czarny, zły, niepomyślny
karabiber - pieprz
karaborsa - czarny rynek
karaciğer - wątroba
Karadağ - Czarnogóra
Karadağca - język czarnogórski
kara delik - czarna dziura
Karadeniz - Morze Czarne
karakol - komenda, posterunek policji
karakter - charakter
karakteristik - charakterystyczny
kara liste - czarna lista
karamel - karmel
karanlık - czarny, ponury, ciemność
karantina - kwarantanna
karar - decyzja
karar almak - podjąć decyzję
kararlaştırmak - decydować, zdecydować
kararma - nalot, warstwa
karar vermek - zdecydować (co - )
kara tahta - tablica
Karayipler - Karaiby
karbon - węgiel
kardan adam - bałwan śniegowy
kardelen - śnieżyczka
kardeş - rodzeństwo (brat albo siostra)
kardeşlik - braterstwo, bractwo
kardinal - kardynał
karga - wrona
kargı - włócznia
karı - żona
karides - krewetka
karikatür - karykatura
karınca - mrówka
karıncayiyen - mrówkojad
karışıklık - plątanina, bałagan
karışım - mieszanina
kariyer - kariera
karizma - charyzma
karmaşık - złożony
karmaşık sayı - liczba zespolona
karnabahar - kalafior
karnaval - karnawał
Karolina - Karolina
karpuz - arbuz
karşılaştırılabilir - porównywalny
kartal - orzeł
kartpostal - pocztówka
kas - mięsień
kaş - brew
kasa - bezpieczny
kasaba - miasto
kasap - rzeźnik
kaşık - łyżka
kaşıkçıkuşu - pelikan
kasım - listopad
kasımpatı - chryzantema
Katalanca - język kataloński
Katalonya - Katalonia
Katar - Katar
katedral - katedra
kategori - kategoria
kati - definitywny, ostateczny, pewny, kategoryczny
katil - zabójca, morderca
katır - muł
katlamak - zgiąć, złożyć
katliam - masakra
katmak - dodać, dołączyć
Katmandu - Katmandu
katran - smoła
kavak - topola
kavanoz - słój, słoik
kavun - melon
kaya - skała
kayak - narta
kaybetmek - stracić
kaygana - omlet
kayık - łódź, łódka
kayısı - morela
kaymak - ześlizgnąć się, poślizgnąć się, zjechać
kaz - gęś
kaza - wypadek
Kazakça - język kazachski
Kazakistan - Kazachstan
kazanç - zysk, korzyść, profit
kebze - łopatka
keçi - koza
keder - żal, smutek
kedi - kot
kefalet - poręczenie
kefir - kefir
kehanet - przepowiednia
kehribar - bursztyn
keklik - kuropatwa
kel - łysy
kelebek - motyl
kelime - słowo
keman - skrzypce
kemik - kość
kent - miasto
Kenya - Kenia
kepek - otręby, łupież
kereviz - seler
kermen - zamek
kertenkele - jaszczurka
kervan - karawana
kese - portfel
keşfetmek - odkrywać
kesin - definitywny, pewny, decydujący
kesinlikle - zdecydowanie, definitywnie, całkowicie, na pewno
ketçap - keczup
ki - że
kibar - uprzejmy
kibir - arogancja, próżność
kibirli - arogancki, zarozumiały
kibirsiz - skromny
Kıbrıs - Cypr
kıkırdak - chrząstka
kılıç - miecz
Kilimanjaro - Kilimandżaro
kilise - kościół
kılsız - bezwłosy
kimya - chemia
kimyon - kmin, kminek
kinetik - kinetyka, kinetyczny
kir - brud
kiralama - najem
kiraz - czereśnia
Kırgızistan - Kirgistan
kırk - czterdzieści
kırkınci - czterdziesty
kırlangıç - jaskółka
kirli - brudny
kırmak - złamać
kırmızı - czerwony, czerwień
kırmızılık - zaczerwienienie, czerwoność
kirpi - jeż
kirpik - rzęsa
kış - zima
kısa - krótki
kısaltma - skrót, abrewiatura
kişi - osoba, persona
kısım - część
kişisel - osobisty
kıskanç - zazdrosny
kışkırtma - prowokacja
kısrak - szkapa
kıstas - kryterium
kıt - krótki
kitabevi - księgarnia
kitap - książka
kitapçı - księgarz
kitaplık - regał na książki, biblioteczka
kıtlık - głód, brak, niedożywienie
kıyamet - apokalista, koniec świata
kıyı - plaża
kıyın - trudny
kız - dziewczyna, córka, dziewczę, dziewica, w kartach: królowa
kızamıkçık - różyczka
kızgın - zły, rozgniewany
kızgınlık - gniew
kızıl - czerwony, komunistyczny, czerwień, komunista
Kızıldeniz - Morze Czerwone
klarnet - klarnet
klasik - klasyczny
klasisizm - klasycyzm
klavye - klawiatura
klinik - klinika, przychodnia, lecznica
klitoris - łechtaczka
klor - chlor
klorofil - chlorofil
kloroplast - chloroplast
koala - koala
koalisyon - koalicja
koç - baran
Koç - Baran
koca - mąż
kod - kod
kokarca - skunks
kokmak - pachnieć, mieć zapach, śmierdzieć
kokoroz - kukurydza
koku - zapach, aromat
kokusuz - bezzapachowy
kol - ręka
kolay - łatwy, prosty
kolaylaştırmak - ułatwiać, czynić prostszym, łatwiejszym
köle - niewolnik
kolektif - zbiorowy
kölelik - niewolnictwo
Kolomb - Kolumb (odkrywca)
Kolombiya - Kolumbia
kolonoskopi - kolonoskopia
koltuk - fotel, pacha, zakątek, podpora, podpórka
kolye - naszyjnik
komedi - komedia
komik - śmieszny
komisyon - komisja
komite - komitet
Komorlar - Komory
komşu - sąsiad
komünist - komunista, komunistyczny
komünizm - komunizm
kömür - węgiel
kondom - prezerwatywa
konfederasyon - konfederacja
konferans - konferencja
konfor - komfort, luksus
kongre - kongres, konferencja
konser - koncert
konsey - rada
kontak lens - soczewka kontaktowa
kontakt lens - soczewka kontaktowa
kontes - hrabina
kontrat - umowa, kontrakt
konuk - gość
konuşmak - rozmawiać, mówić
konveksiyon - konwekcja
köpek - pies
köpek balığı - rekin
köprü - most
körce - ślepo
Kore - Korea
Korece - język koreański
Koreli - Koreańczyk
körfez - zatoka
Korhan - tureckie imię męskie
korkmak - bać się (czego - )
korku - strach, obawa, lęk, fobia
korku filmi - horror
korkulmak - być przerażonym, bać się
korkulu - przerażający, straszny
korkuluk - strach, strach na wróble
korkunç - przerażający, straszliwy, straszny
korkutmak - wystraszyć, odstraszyć
körlük - ślepota
korsan - pirat
korsanlık - piractwo
korse - gorset
Korsika - Korsyka
körük - miech
köşe - kąt (róg)
koşmak - biec, biegnąć
Kosova - Kosowo
Kostas - Kostas
köstebek - kret
kostüm - kostium, garnitur
koşucu - biegacz
koşullu - warunkowy
kötü - zły, podły, kiepski, kiepskiej jakości, bardzo, naprawdę, strasznie, wściekle, gniewnie
kötülük - zło, krzywda
kova - wiadro
kovalamak - ścigać
kovboy - kowboj
köy - wieś
köylü - chłop
koymak - położyć, umieścić
koyu - gruby, mocny, gęsty, twardy
koyun - owca, prostak
koza - kokon
kozmik - kosmiczny
kral - król, monarcha (głowa państwa)
kralcı - rojalista
kraliçe - królowa
kraliçe arı - królowa pszczół
krallık - królestwo
kravat - krawat
kripton - krypton
kristal - krzyształ, kryształowy
kriter - kryterium
kriyojenik - kriogenika
kriz - kryzys
krizantem - chryzantema
kromozom - chromosom
kronoloji - chronologia
ksilofon - ksylofon
Küba - Kuba
küçük - mały, młody, drobny, dziecko, malec
Küçük Antiller - Małe Antyle
küçük karga - kawka
Kudüs - Jerozolima
küf - pleśń
kuğu - łabędź
kukla - marionetka
kül - popiół
kulak - ucho
kullanıcı - użytkownik
kullanmak - używać, prowadzić
küllük - popielniczka
kült - kult
kültür - kultura
kültürel - kulturowy
kulübe - chata
kum - piasek
kumanda - komenda, rozkaz
kumaş - materiał, tkanina
kumpir - kumpir, ziemniak
kumsal - plaża
kumul - wydma
küp - sześcian, kostka
küpe - kolczyk
kurabiye - ciastko
kural - reguła
kuram - teoria
Kur'an - Koran
kurbağa - żaba
Kürdistan - Kurdystan
kurkumin - kurkumina
kurt - wilk
Kürt - Kurd, kurdyjski
kürtaj - aborcja
kurtarmak - ratować, uratować
Kürtçe - język kurdyjski
kuru - suchy
kurul - komitet, organ
kuruluş - fundacja, organizacja, założenie
kurumak - schnąć, wyschnąć, wysuszyć się
kurutmak - suszyć, wysuszyć
kuş - ptak, ptaszek, penis
kuskus - kuskus
kusmak - wymiotować
kusmuk - to, co zostało wymiotowane
küstah - arogancki
kusur - defekt, błąd, niedociągnięcie
kutsal - święty
kutup ayısı - niedźwiedź polarny
kütüphane - biblioteka
küvet - wanna
Kuveyt - Kuwejt
kuvvet - siła, potęga
kuvvetli - potężny, silny
kuvvetsiz - słaby
kuyruk - kolejka, ogonek, ogon
kuyu - studnia
kuzey - północ
Kuzey Kıbrıs - Cypr Północny
Kuzey Kore - Korea Północna
kuzgun - kruk
kuzu - baranek
labirent - labirynt
laboratuvar - laboratorium
lahana - kapusta
lahza - moment, chwila
lakaytlık - obojętność
lale - tulipan
lantan - lantan
latif - uroczy, słodki, ładny, sympatyczny, miły, przyjemny, przyjazny, delikatny
latife - dowcipna uwaga, dowcip, żart, bon mot
Latince - język łaciński, łacina
lav - lawa
lavabo - umywalka
layemut - nieśmiertelny
lazer - laser
Lefkoşa - Nikozja
lehçe - dialekt
Lehçe - język polski
Lehistan - Polska
lejyon - legion, legia
leksikografi - leksykografia
lens - soczewka kontaktowa
leopar - lampart
Letonya - Łotwa
levye - łom
leylek - bocian
lezzetli - smakowity, apetyczny
liberal - liberalny
liberalizm - liberalizm
Libya - Libia
lif - włókno
Lihtenştayn - Liechtenstein
likopen - likopen
likör - likier
liman - port
limon - cytryna
limonata - lemionada
limonlu - cytrynowy
limuzin - limuzyna
linolyum - linoleum
lisan - język
lise - liceum
liseli - licealista
liste - lista
litre - litr
Litvanya - Litwa
lityum - lit
logaritma - logarytm
lokanta - restauracja
Londra - Londyn
lösemi - białaczka
lostracı - pucybut
lotarya - loteria
Lübnan - Liban
Lübnanlı - Libańczyk, Libanka, libański
lügat - słownik
lügatçe - glosariusz
Lüksemburg - Luksemburg
ma - i
maalesef - niestety
maaş - pensja, płaca, wynagrodzenie, uposażenie
mabet - świątynia
Macaristan - Węgry
madalya - medal
madam - pani
madde - materia, substancja
maddeci - materialista
maddecilik - materializm
madenci - górnik
mağara - jaskinia
magnezyum - magnez
mahalle - dzielnica
Mahir - imię męskie
makale - artykuł
makam - miejsce, siedziba
makarna - makaron
makas - nożyczki
Makedonca - język macedoński
Makedonya - Macedonia
maksimum - maksymalny
Malavi - Malawi
Malezya - Malezja
malt - słód
Malta - Malta
Maltaca - język maltański
malumat - wiedza
manas - bohater
manastır - monastyr, klasztor, opactwo
Mançukuo - Mandżukuo
Mançurya - Mandżuria
mâni - przeszkoda
manivela - korba, dźwignia
mantalite - mentalność
mantar - grzyb
mantık - logika
mantıkçı - logik
mantıkdışı - nielogiczny
mantıki - logiczny
mantıklı - logiczny
mantıksal - logiczny
mantıksız - nielogiczny
manyetik - magnetyczny
manyetizma - magnetyzm
marangoz - stolarz
mart - marzec
masa - stół
masa örtüsü - obrus
mastürbasyon yapmak - masturbować się
masum - niewinny
matbaacılık - druk
matematik - matematyka
materyalist - materialista
materyalizm - materializm
mavi - niebieski, błękitny, błękit
maydanoz - pietruszka
mayıs - maj
maymun - małpa
mayo - kostium kąpielowy
mayonez - majonez
mazoşizm - masochizm
mecaz - przenośnia, metafora
medeniyetsiz - niecywilizowany, prymitywny, barbarzyński
mehtap - światło księżyca
mekân - miejsce
Mekke - Mekka
Meksika - Meksyk
Meksika Körfezi - Zatoka Meksykańska
mektup - list
melankoli - melancholia
melatonin - melatonina
melek - anioł
mellah - żeglarz
melodi - melodia
meme - pierś
memleket - kraj, ojczyzna
mendil - chusteczka do nosa
meni - sperma
menteşe - zawias
merci - autorytet
mercimek - soczewica
merdiven - drabina
merhaba - cześć
meritokrasi - merytokracja
merkezî - centralny
Merkür - Merkury
mesafe - odległość
mesaj - wiadomość
mesele - problem, kwestia, sprawa
meşgul - zajęty
meşhur - słynny
meslek - kariera, zawód, profesja
meslektaş - kolega (z pracy)
meşrubat - napój
mesuliyet - odpowiedzialność
mesuliyetli - odpowiedzialny
mesuliyetsiz - nieodpowiedzialny
Mesut - tureckie imię męskie
metabolizma - metabolizm
metal - metal
metodoloji - metodologia
metot - metoda
metreküp - metr sześcienny
mevsim - pora roku, sezon
meydan - plac
meyve - owoc
meyve vermek - przynosić, dawać owoce
mezar - grób
mezarcı - grabarz
mezarlık - cmentarz
mıknatıs - magnes
mikrofon - mikrofon
mikroorganizma - mikroorganizm
miktar - ilość
milenyum - tysiąclecie, millenium
milimetre - milimetr
militarizm - militaryzm
millet - naród, nacja
milliyetçi - nacjonalistyczny
milliyetçilik - nacjonalizm, szowinizm
milyon - milion
milyoner - milioner
mimar - architekt
mimarlık - architektura
mineraloji - mineralogia
misafir - gość
misafirperver - gościnny
mısır - kukurydza
Mısır - Egipt
misyon - misja
mitoloji - mitologia
mızrak - włócznia
modernizm - modernizm
Moğolistan - Mongolia
Moldovca - język mołdawski
molekül - cząsteczka
molibden - molibden
monarşi - monarchia
monofizit - monofizytyzm
monoteizm - monoteizm
monoton - monotonny
monotonluk - monotonia
montaj - montaż, montowanie
mönü - menu
mor - fioletowy
morartı - siniak
morfin - morfina
morfoloji - morfologia
morötesi - nadfiolet, ultrafiolet
mors - mors
motivasyon - motywacja
mozaik - mozaika
muallim - nauczyciel
mücadele - walka, trud
mucize - cud
müezzin - muezin
müfettiş - inspektor
muğlak - niejasny
muhafazakar - konserwatywny
muhakkak - na pewno, pewnie, z pewnością, bez wątpienia
Muhammed - Mohamet
muharebe - bitwa, walka
mühendis - inżynier
mühendislik - inżynieria
muhtelif - wielokrotny
muhtemel - prawdopodobny
muhtemelen - prawdopodobnie
mülkiyet - własność
mülteci - uchodźca
mum - świeca, wosk
mümkün - możliwy
mumluk - świecznik
mumya - mumia
münakaşa - dyskusja
münasip - odpowiedni, pasujący, wygodny, dogodny
müneccimlik - astrologia, bycie astrologiem
münekkit - recenzent, krytyk
Murat - tureckie imię męskie
murdar - brudny, nieczysty
murdarlık - brud, nieczystość
mürekkep - atrament
müsaade - pozwolenie, zezwolenie
müsade - pozwolenie
müsait - właściwy
Musevilik - judaizm
müşfik - uroczy, miły, współczujący, łagodny
Müslüman - muzułmanin, muzułmański
Müslümanlık - islam, mahometanizm
müsrif - rozrzutny, marnotrawny
Mustafa - Mustafa
müstahsil - producent
müşteri - klient
mütedeyyin - religijny
mutfak - kuchnia (pomieszczenie), kuchnia, kulinaria
mutlak - absolutny, absolut
mutlu - szczęśliwy
mutluluk - szczęście
mutsuz - nieszczęśliwy
mutsuzluk - nieszczęście, nieszczęśliwość
muttasıl - ciągły, ustawiczny
müttefik - sojusznik, aliant, sojuszniczy
muz - banan
müze - muzeum
müzik - muzyka
müzisyen - muzyk
Myanmar - Myanmar
nadir - rzadki
Nairobi - Nairobi
nakış - haft
nakit - gotówka
nal - podkowa
namaz - modlitwa, namaz
Namibya - Namibia
nane - mięta
nanoteknoloji - nanotechnologia
nar - granat
narkotik - narkotyk
nasıl - jak
nasılsınız - co słychać, jak się macie? (formalne, grzecznościowe lub w liczbie mnogiej)
nasyonalizm - nacjonalizm
nazik - uprzejmy
nazizm - nazizm
nefes - oddech
nefret - nienawiść
nehir - rzeka
nekrofili - nekrofilia
neoliberalizm - neoliberalizm
Neptün - Neptun
nerede - gdzie
nesil - pokolenie, generacja
Neslişah - tureckie imię żeńskie
neşriyat - publikacja
niçin - dlaczego
Nihat - tureckie imię męskie
nihilizm - nihilizm
Nijer - Niger
Nijerya - Nigeria
nikotin - nikotyna
Nil - Nil
nilüfer - lotos
nine - babcia
ninni - kołysanka
Ninova - Niniwa
nisan - kwiecień
nişasta - skrobia
niyobyum - niob
noel - Boże Narodzenie
Noel Baba - święty mikołaj
nohut - groch
noktalı virgül - średnik
Norveç - Norwegia
Norveççe - język norweski
nozoloji - nozologia
nükleer - jądrowy, nuklearny
o - on, ona
ocak - styczeń
oda - pokój
odun - drewno
ofis - biuro
oğlan - chłopiec, katamita, bierny homoseksualista
öğle - południe
öğrenmek - uczyć się (czego, jak)
öğretmek - uczyć
öğretmen - nauczyciel
oğul - syn
ok - strzała
okçu - łucznik
okçuluk - łucznictwo
ökseotu - jemioła
oksijen - tlen
Oksitanca - język oksytański
öksürmek - kaszleć
öksürük - kaszel
okul - szkoła
okuldaş - kolega (ze szkoły)
okumak - czytać
okunaklı - czytelny
okunaksız - nieczytelny
okyanus - ocean
Okyanusya - Oceania
olanaksız - niemożliwy
olası - możliwy, potencjalny
olay - zdarzenie, wydarzenie, okoliczność, nietypowe zdarzenie, wypadek, zjawisko
ölçmek - mierzyć
ölçüşmek - rywalizować
ölçüt - kryterium
oldukça - dość, dosyć, wystarczająco
öldürmek - zabijać
oligarşi - oligarchia
olmak - być, stawać się
ölmek - umierać
ölü - martwy, nieżywy
oluk - rynna
ölüm - śmierć
olumlu - pozytywny
ölümlü - śmiertelny
ölümlülük - śmiertelność
ölümsüz - nieśmiertelny
ölümsüzlük - nieśmiertelność
oluşturmak - stanowić, składać się na co
omlet - omlet
omuz - ramię
on - dziesięć
önad - przymiotnik
onay - akceptacja
on beşinci - piętnasty
on birinci - jedenasty
önce düşün, sonra söyle - pomyśl, zanim coś powiesz
öncelik - priorytet
önder - przywódca, lider
on dördüncü - czternasty
önem - waga, powaga, ważność, ważkość
önemli - duży, poważny, ważny, istotny, znaczący
önermek - proponować, sugerować
on ikinci - dwunasty
onkoloji - onkologia
onlar - oni
onu - jej
on üçüncü - trzynasty
onuncu - dziesiąty
onur - honor, godność, duma, honory, odznaczenie
öpmek - całować, pocałować
öpücük - pocałunek
öpüş - całowanie
orak - sierp
orangutan - orangutan
ördek - kaczka
ordu - armia, wojsko
organizasyon - organizacja
organizma - organizm
orgazm - orgazm
örgüt - organizacja
origami - origami
orman - las
orospu çocuğu - sukinsyn
ortak - partner
örtmece - eufemizm
örtmek - ukryć, zakryć, przykryć, okryć, pokryć, zamknąć, zamykać (np. okno)
örümcek - pająk
Osmanlıca - język osmańsko-turecki
ot - trawa, zioło
otağ - namiot
otel - hotel
otistik - autystyczny
otobüs - autobus
otomatik - automatyczny
otomobil - samochód
otonomi - autonomia
otorite - autorytet
oturmak - siedzieć, przebywać, usiąść
oturma odası - pokój gościnny, duży pokój
otuz - trzydzieści
otuzuncu - trzydziesty
oynamak - tańczyć, bawić się, zabawiać
oyuncak - zabawka
ozan - poeta
Özbekçe - język uzbecki
Özbekistan - Uzbekistan
özdekçi - materialista
özdekçilik - materializm
özdeş - identyczny
özdeşlik - identyczność
özerk - autonomiczny
özerklik - autonomia
özgül - specyficzny
özgür - wolny, swobodny
özgürlük - wolność
özlem - tęsknota
özlük muhafızı - ochroniarz
özür - usprawiedliwianie się, tłumaczenie, wymówka
özür dilemek - przepraszać
pabuç - but, kapeć
pahalı - drogi, kosztowny
pak - czysty
Pakistan - Pakistan
Palermo - Palermo
palindrom - palindrom
palto - palto, płaszcz
palyaço - pajac
pamuk - bawełna, bawełniany
Panama - Panama
panda - panda
Pandora'nın kutusu - puszka Pandory
panseksüellik - panseksualizm
pansiyon - renta
papa - papież
papağan - papuga
papatya - stokrotka
para - pieniądze, gotówka, pieniądz
paradoks - paradoks
parafili - parafilia
Paraguay - Paragwaj
parfüm - perfumy
Paris - Paryż
parlamak - błyszczeć
parlamento - parlament
parmak - palec
pars kedisi - kot bengalski
parti - partia
pasaport - paszport
paskalya - Wielkanoc
patates - ziemniak
pati - łapa
patlama - wybuch, eksplozja
patlıcan - oberżyna, bakłażan
patron - szef
pay - część, udział, przydział
paylaşmak - dzielić się
pazar - niedziela
pazarlama - marketing
pazartesi - poniedziałek
pazı - burak liściowy, boćwina, burak szpinakowy
pedagoji - pedagogika
pedofili - pedofilia
pelenk - lampart
pelikan - pelikan
pembe - różowy
pembe dizi - opera mydlana
pencere - okno
penguen - pingwin
penis - penis
penisilin - penicylina
perde - zasłona
perhiz - abstynencja, dieta, post
perşembe - czwartek
perspektif - perspektywa
petrol - ropa naftowa
peynir - ser
pezevenk - sutener, alfons
piç - bękart
pigment - pigment
piksel - piksel
pil - bateria
piliç - kurczak, laska
pilot - pilot, lotnik
piramit - piramida
pire - pchła
pireyi deve yapmak - robić z igły widły
pirinç - ryż
pirit - piryt
piromani - piromania
pis - brudny
Pittsburgh - Pittsburgh (stolica Allegheny)
piyano - pianino
plaj - plaża
plaster - plaster
platin - platyna
plütokrasi - plutokracja
Plüton - Pluton
polat - stal
polen - pyłek
polis - policja
politeizm - politeizm
politika - polityka
Polonya - Polska
polyester - poliester
pompa - pompa
ponton - ponton
popülizm - populizm
pornografi - pornografia
pornografik - pornograficzny
portakal - pomarańcza
Portekiz - Portugalia
Portekizce - język portugalski
postmodernizm - postmodernizm
potansiyel - potencjalny, potencjał
potasyum - potas
pozisyon - edukacja
poz vermek - pozować (artyście lub do zdjęcia)
prenses - księżniczka
prezervatif - prezerwatywa
profesör - profesor
profesyonel - profesjonalny
profesyonellik - profesjonalizm, profesjonalność
profilaksi - profilaktyka
profilaktik - profilaktyczny
progesteron - progesteron
program - program
programcı - programista
proje - projekt
projeksiyon - projekcja
projektör - projektor, rzutnik
propaganda - propaganda
prostat - prostata
protein - proteina, białko
protesto - protest
provokasyon - prowokacja
psikolog - psycholog
psikoloji - psychologia
psikoterapi - psychoterapia
Ptah - Ptah
puro - cygaro
pusu - zasadzka
pusula - kompas, busola
radyo - radio
raf - półka
ragbi - rugby
rahat - pokojowy, spokojny, łagodny, spokój, cisza, komfort, wypoczynek, wygoda
rahim - macica
rahip - mnich
rakam - cyfra
rakip - konkurent, przeciwnik, rywal
randevu - spotkanie, randka
rasyonel - racjonalny
rasyonel sayı - liczba wymierna
ravent - rabarbar (roślina), rabarbar (warzywo)
Recep - tureckie imię męskie
reçete - recepta
red - odmowa
reenkarnasyon - reinkarnacja
refah - dobrobyt, pomyślność
refleks - refleks
reform - reforma
rehber - poradnik
rehine - zakładnik
reklam - reklama
renk - kolor
resepsiyon - przyjęcie
resesyon - recesja
resim - malarstwo
resmî - oficjalny
ressam - malarz
ringa - śledź
ritim - rytm
ritm - rytm
Riyad - Rijad
robot - robot
rodeo - rodeo
rodyum - rod
rögar - studzienka kanalizacyjna
roket - rakieta
rom - rum
romantizm - romantyzm
Romanya - Rumunia
rönesans - renesans
ruba - ubiór, ubranie
rubidyum - rubid
ruh - duch, dusza
ruj - szminka
Rumence - język rumuński
Rusça - język rosyjski
rüşvet - łapówka
Rusya - Rosja
rutenyum - ruten
rutherfordiyum - rutherford
rüzgâr - wiatr
saat - godzina, zegar, zegarek, czas, pora
sabah - poranek
sabır - cierpliwość
sabır acıdır, meyvesi tatlıdır - cierpliwość bywa gorzka, ale jej owoce są słodkie
sabırlı - cierpliwy
şablon - szablon
sabretmek - być cierpliwym, okazywać cierpliwość
sabun - mydło
sabunlanmak - mydlić, namydlać, namydlić, spłukać się, stracić wszystkie pieniądze (najczęściej w grach hazardowych)
sabunlaşma - zmydlanie
sabunlu - mydlany
saç - włos
saçma - absurdalny, bełkotliwy
saçmalık - nonsens
sadece - tylko, jedynie
sadist - sadysta
sadistlik - sadyzm
sadomazoşizm - sadomasochizm
safa - beztroska, wolność od zmartwień, niepokojów, przyjemność, zabawa
şafak - świt
safha - faza, poziom, etap
safi - czysty, netto
safir - szafir
sağlıklı - zdrowy
sağlıksız - niezdrowy
sağ olun - dziękuję
şah - szach, władca, król
saha - pole
şaheser - arcydzieło
sahil - wybrzeże
sahipsiz - bezpański, niczyj
şahmerdan - taran
sahne - scena
şahsi - osobisty
şahsî - osobisty
sahte - fałszywy, sztuczny
şair - poeta
şaka - żart, dowcip
şakak - skroń
sakal - broda (owłosienie)
sakallı - brodaty
sakalsız - niebrodaty
sakarin - sacharyna
sakız - guma do żucia
saksafon - saksofon
saksağan - sroka
şal - szal
salak - głupi, idiotyczny, głupek, idiota
salata - sałatka
saldırgan - agresywny
saldırı - atak, napaść, agresja
saldırmak - atakować, napadać
şalgam - rzepa
salgın - epidemiczny
salı - wtorek
salmak - uwolnić, wysłać, posłać
salname - rocznik
salon - pokój gościnny, duży pokój, sklep
saloz - głupi
salyangoz - ślimak
Şam - Damaszek
saman - siano
şaman - szaman
şamandıra - boja, pława
şamdan - świecznik
şampanya - szampan
şampiyon - mistrz, czempion
şampiyonluk - mistrzostwa, mistrzostwo
şampuan - szampon
sanat - sztuka, twórczość
sanatçı - artysta
sanatoryum - sanatorium
sanatsal - artystyczny
sanayi - przemysł
sanayileşme - industrializacja
sancak - sztandar
sandalet - sandał
sandalye - krzesło
sandık - skrzynka, kufer
sandviç - kanapka
sansar - kuna
şanslı - szczęśliwy
şanssız - nieszczęśliwy, pechowy
şantaj - szantaż
santralizasyon - centralizacja
São Tomé ve Príncipe - Wyspy Świętego Tomasza i Książęca
sapaklık - anormalność, nieprawidłowość, anormalia
sapasağlam - silny, zdrowy, w świetnej kondycji
sapık - zboczony, perwersyjny, zboczeniec
sapıklık - perwersja, zboczenie
sapına kadar - całkowicie, w pełni, do samego końca
sapıtmak - wariować, zwariować, gadać bzdury
şapka - czapka
şarap - wino
Saraybosna - Sarajewo
sarhoş - pijany, nietrzeźwy, osoba pijana, nietrzeźwa, oszołomiona używkami
sarhoşluk - pijaństwo
sarı - żółty
sarımsak - czosnek
sarışın - blond
şarkı - piosenka
şarkıcı - śpiewak
sarmak - owijać, nawijać coś w coś, okrywać, pokrywać, otulać, opatrywać, obandażować
sarmaşık - bluszcz
şartlı - warunkowy
satın almak - kupić, zakupić
satış - sprzedaż
satmak - sprzedawać
satranç - szachy
Satürn - Saturn
savan - sawanna
savaş - wojna, walka, bitwa
savaş arabası - rydwan
savaşçı - wojownik
savunmak - bronić, chronić
saydam - przeźroczysty
sayfa - strona
sayı - liczba
sayısal - językowy
saymak - liczyć
Scylla - Scylla
sebebiyle - z powodu
şebek - pawian
sebze - warzywo
seçenek - opcja
seçim - wybory
seçme - wybór, selekcja
seçmek - wybrać
şef - szef
sefalet - bieda, nędza
şeffaf - przeźroczysty
şeftali - brzoskwinia
şehir - miasto
şehir efsanesi - miejska legenda
şeker - cukier
sekiz - osiem, 8
sekizinci - ósmy
seks - seks
seksen - osiemdziesiąt
sekseninci - osiemdziesiąty
seksoloji - seksuologia
sektör - sektor
sekülarizm - sekularyzm
sel - powódź
şelale - wodospad
selenyum - selen
selüloz - celuloza
semantik - semantyka
sembol - symbol
şempanze - szympans
şemsiye - parasol
sen - ty
sene - rok
sepet - kosz
serçe - wróbel
şeref - honor, godność
şerefli - honorowy, godny, dumny
şerefsiz - niehonorowy, hańbiący, niegodziwy, niecny, nieszlachetny
sermaye - kapitał
sertifika - certyfikat
sertleşme - sztywnienie
serüven - przygoda
sesli - samogłoska
sesli harf - samogłoska
sessiz harf - spółgłoska
sessizlik - cisza
sevda - miłość
sevgi - miłość (silne uczucie)
sevimli - słodki, uroczy, kochany, drogi
sevinç - radość
seviye - poziom
sevmek - kochać, lubić
sevmemek - nie lubić
şey - rzecz
şeyh - szejk
şeytan - szatan, diabeł
Sezen - tureckie imię żeńskie
sezyum - cez
sıcak - gorący, ciepły
sıcaklık - temperatura, ciepło
sıçan - szczur
sıçramak - skoczyć
sıfat - przymiotnik
sıfır - zero
sigara - papieros
sığınak - schronienie
sığır - krowa, bydło, rogacizna
sigortacı - agent ubezpieczeniowy
sihir - magia, urok, czar, zaklęcie
sihirbaz - czarodziej, magik
sihirli - magiczny
sihizm - sikhizm
sık - często
sıkıcı - nudny
siklon - cyklon
sık sık - często
silah - broń
Şili - Chile
silisyum - krzem
silvikültür - leśnictwo, gospodarka leśna
şimdi - teraz
şimdiki zaman - czas teraźniejszy
şimşek - błyskawica
simya - alchemia
simyacı - alchemik
sinagog - synagoga
sınav - egzamin, test
sincap - wiewiórka
sindirim - trawienie
sinek - mucha
sinema - kino
Singapur - Singapur
sınırdaş - przyległy
sinyal - sygnał
sipahi - rycerz (jazdy tureckiej za czasów imperium osmańskiego)
sipariş - zamówienie
sıradan - zwykły, zwyczajny
Sırbistan - Serbia
şırınga - strzykawka
sirk - cyrk
şirket - firma, koncern
Sırpça - język serbski
sırt - plecy, barki, tył
şişe - butelka
sistem - system
sistematik - systematyka
sitoloji - cytologia
sitoplazma - cytoplazma
şive - dialekt
sıvı - ciecz, płyn, płynny
sivil - cywilny
sivilce - krosta
sivrisinek - komar
siyah - czarny
siyaset - polityka
şizofreni - schizofrenia
Slovakya - Słowacja
Slovenya - Słowenia
soba - piec
sodyum - sód
sofizm - sofizm
Sofya - Sofia
soğan - cebula
soğuk - zimny
söğüt - wierzba
sohbet - rozmowa, konwersacja
şok - szok, wstrząs
sokağa çıkma yasağı - godzina policyjna
sokak - ulica
sokmak - wsadzić, włożyć, wetknąć
solgun - blady, bezbarwny, niewyraźny
Solon - Solon
solucan - robak
solumak - oddychać
som - łosoś
Somali - Somalia
sömürme - eksploatacja
sömürmek - eksploatować, wykorzystywać
sonbahar - jesień
sonra - po, później
sonsuz - wieczny, nieskończony
sonsuzluk - wieczność, nieskończoność
sonuç - wynik, rezultat
sonunda - w końcu
sormak - pytać
soru - pytanie
sorumlu - odpowiedzialny
sorumluluk - odpowiedzialność
sorumsuz - nieodpowiedzialny
sos - sos
sosis - kiełbasa
sosyalist - socjalistyczny
sosyalizm - socjalizm
sosyolog - socjolog
sosyoloji - socjologia
şövalye - rycerz
şovenizm - szowinizm
soykırım - ludobójstwo
söylence - legenda
söylencebilim - mitologia
soylu - szlachetny, szlachcic
soyut - abstrakcyjny, abstrakt
sözcük - słowo
sözlük - słownik
sözlükçülük - leksykografia
söz vermek - obiecać, dać słowo
sperm - sperma
spirulina - spirulina
Sri Lanka - Sri Lanka
Stokholm - Sztokholm
strateji - strategia
stronsiyum - stront
su - woda
şu - tamten, tamta
şu anda - teraz, w tym momencie, obecnie
şubat - luty
suçlu - karygodny
Sudan - Sudan
suikast - zamach
şükran - dziękczynienie, podzięka, wdzięczność
sultan - sułtan
sulu - soczysty, wodnisty, wodny, nawodniony, mówiący nieprzyzwoite żarty
sülük - pijawka
sululuk - soczystość
sülün - bażant
sümbül - hiacynt
Sümerce - język sumeryjski
sunak - ołtarz
sünger - gąbka
sünnet - sunna, obrzezanie mężczyzn
sünnet derisi - napletek
şüphe - wątpliwość
süpürge - miotła
sure - sura
süre - czas trwania
Suriye - Syria
sürü - stado, sterta
sürüngen - gad
şurup - syrop
susam - sezam
susamış - spragniony
suslamak - milczeć, zamilknąć
süslemek - dekorować
susturmak - uciszyć, prosić o lub zmusić do zamilknięcia
susuz - bezwodny, suchy, bez wody, nie mający wody
süt - mleko
sütlü - mleczny
Suudi Arabistan - Arabia Saudyjska
süveter - sweter
Süveyş - Suez
tabak - danie, talerz
tabaka - warstwa
tabiat - natura, charakter, smak (dobry), gust
tabiiyet - narodowość, obywatelstwo
tabur - batalion
tabure - taboret
tabut - trumna
taç - korona
Tacikistan - Tadżykistan
taciz - molestowanie
taç yaprak - płatek
tahammül - tolerancja, wytrzymałość
tahlil - analiza
tahmin - przypuszczenie
taht - tron
tahta - drewno, drzewo
Taipei - Tajpej
takım - grupa, drużyna, rząd
taklit etmek - imitować, naśladować
takmak - przymocowywać, przytwierdzać, przyczepiać, zawieszać, wkładać
taksi - taksówka
takvim - kalendarz
tam - pełny, całkowity, właściwy, akuratny, akurat
tamam - kompletny
tamamlamak - ukończyć, skończyć, wypełnić, uzupełnić
tamlayan durumu - dopełniacz
tamlayan hâli - dopełniacz
tamu - piekło
tanımak - znać, poznać, rozpoznać
tanımlamak - określać, definiować, charakteryzować
tanınmak - być znanym (z czego - )
tanışmak - poznać się (rozpocząć znajomość), znać się
tanıştırmak - przedstawiać, prezentować (kogo komu - )
tankı - pogoda
Tanrı - Bóg
Tanzanya - Tanzania
tarafsız - bezstronny, neutralny, obiektywny
taramak - czesać
tarçın - cynamon
tarif - definicja, opis
tarih - dzieje, historia
tarihçi - historyk
tarihî - historyczny
tarım - rolnictwo
tartıştay - forum
taş - kamień
taşikardi - częstoskurcz, tachykardia
tatil - wakacje, ferie, urlop, wolne, wypoczynek, wczasy, wakacyjny, feriowy, urlopowy, wolny, wypoczynkowy, wczasowy
tatmak - smakować
tava - patelnia
tavan - sufit
tavanarası - strych
tavşan - królik
tavuk - kura
tayfa - załoga
tayfun - tajfun
Tayland - Tajlandia
Tayvan - Tajwan
tayyare - samolot
taze - świeży
tazı - chart
tebessüm etmek - uśmiechnąć się
tecessüm - personifikacja
tecrübe - doświadczenie
tedricî - stopniowo
tehdit etmek - grozić, straszyć
tehlike - niebezpieczeństwo
tehlikeli - niebezpieczny, ryzykowny
tehlikesiz - bezpieczny
tek boynuzlu at - jednorożec
teke - kozioł
tekerklik - monarchia
tekeşli - monogamiczny
tekeşlilik - monogamia
teknetyum - technet
teknokrasi - technokracja
teknoloji - technologia
teknolojik - technologiczny
tekrar etmek - powtórzyć
tekrarlamak - powtarzać, robić coś ponownie
Teksas - Teksas
telaffuz - wymowa
Tel Aviv - Tel Awiw
telefon - telefon
telekomünikasyon - telekomunikacja
telepati - telepatia
telepatik - telepatyczny
teleskop - teleskop
televizyon - telewizja
telgraf - telegraf
telgrafçılık - telegrafia
telif hakkı - prawo autorskie
temas - kontakt, dotyk
tembel - leniwy, powolny, gnuśny
teminat - zabezpieczenie, gwarancja, asekuracja
temiz - czysty
temizlemek - czyścić
temmuz - lipiec
tenhalık - odizolowanie, izolacja (miejsca)
tenis - tenis
tentürdiyot - jodyna
teokrasi - teokracja
teokratik - teokratyczny
teoloji - teologia
teolojik - teologiczny
teori - teoria
teorik - teoretyczny
tepe - pagórek
tepke - odruch, refleks
ter - pot
terbiyum - terb
tercih - preferencja
tercüman - tłumacz
tercüme - tłumaczenie, przekład
tereddüt - wahanie, brak decyzji
tereyağı - masło
terk edilmiş - opuszczony
terlemek - pocić się
terlik - kapeć
termometre - termometr
terörist - terrorysta
terörizm - terroryzm
terzi - krawiec
tesadüf - zbieg okoliczności
teşekkür - dziękowanie, podziękowanie, dzięki
teşhis - diagnoza
tespih - tasbih
testis - jądro
testosteron - testosteron
tetrapylon - tetrapylon
Thermopylae - Termopile
ticaret - handel
ticari - handlowy
tiftik - angora, moher
tifüs - tyfus
tilki - lis
timsah - krokodyl
tipik - typowy
Tiran - Tirana
tirbuşon - korkociąg
tırnak - paznokieć
Tirol - Tyrol
tırtıl - gąsienica
titanyum - tytan
titreşim - wibracja
tiyatro - teatr
ton - tona
top arabası - laweta (podstawa działa na kołach), jaja (o jądrach męskich)
toplama - dodawanie, akumulacja
toplamak - zbierać, gromadzić, akumulować, dodawać
toplum - społeczeństwo
topoloji - topologia
toprak - ziemia, kraj, teren
tören - ceremonia, rytuał, ryt
törenli - ceremionalny
tornavida - śrubokręt
tortu - osad
tosbağa - żółw
totalitarizm - totalitaryzm
töz - substancja
Trabzon hurması - persymona
trafik - ruch drogowy, komunikacja
trajedi - tragedia
trajik - tragiczny
trajikomedi - tragikomedia
tramvay - tramwaj
tren - pociąg
trigonometri - trygonometria
trikotillomani - trichotillomania
troposfer - troposfera
trotuar - chodnik
trup - trupa
Truva - Troja
tufan - potop, powódź
tüfek - karabin
tuğla - cegła, zrobiony z cegieł
tuğra - tugra, podpis sułtana
tükenmez kalem - długopis
tüketim - konsumpcja
tükürük - ślina, plwocina, splunięcie
tulyum - tul
tunç - brąz
Tunus - Tunezja
tür - rodzaj, typ, gatunek
türban - turban
Turgut - tureckie imię męskie
turist - turysta
turistik - turystyczny
turizm - turystyka
Türk - Turek
Türkçe - język turecki
Türkiye - Turcja
Türkiye Cumhuriyeti - Republika Turcji
Türk kahvesi - kawa po turecku
Türkmenistan - Turkmenia
turna - żuraw
turuncu - pomarańczowy
tutkulu - namiętny, pełen pasji
tutmak - trzymać
tütsü - kadzidło
tutuklama - aresztowanie
tutuklamak - aresztować
tutukluluk - aresztowanie
tutulma - zaćmienie
tütün - tytoń
tüy - pióro
tuz - sól
tuzak - pułapka
üç - trzy
uçak - samolot
üçgen - trójkąt
üçüncü - trzeci
uçurum - klif
ucuz - tani
ufuk - horyzont
Ugarit - Ugarit
uğratmak - powodować
Ukrayna - Ukraina
ulaşım - transport
ülke - kraj, państwo
ülkü - ideał
uluslararası - międzynarodowy
ümit - nadzieja
ummak - mieć nadzieję na, oczekiwać
umman - ocean
Umman - Oman
Umman Körfezi - Zatoka Omańska
umum - publiczny
umut - nadzieja
umut etmek - mieć nadzieję, oczekiwać
un - mąka
üniversite - uniwersytet
üniversiteli - student uniwersytetu
ünlü harf - spółgłoska
ünsüz harf - spółgłoska
unutmak - zapomnieć, zapominać
unutulmaz - niezapomniany
Uranüs - Uran
Ürdün - Jordania
Uruguay - Urugwaj
usanç - znudzenie, nuda, znużenie
usta - ekspert
usul - system
utanç - wstyd
utangaç - bojaźliwy
ütopya - utopia
ütü - żelazko
üvey kız - pasierbica
üvey oğul - pasierb
uyandırmak - obudzić, przebudzić, rozbudzić, spowodować pojawienie się czegoś (o uczuciu lub myśli), uświadomić komuś, co się dzieje
uyanmak - obudzić się, zbudzić się, pojawić się (o uczuciu lub myśli), uświadomić sobie, co się dzieje
uyarmak - ostrzegać
uydurmak - dopasowywać, czynić pasującym
üye - członek (np. stowarzyszenia), członek, organ
uygun - dobry, odpowiedni, właściwy, pomyślny
uyku - sen, spanie
uyluk - udo
uyluk kemiği - kość udowa
uymak - pasować, odpowiadać
uyrukluk - obywatelstwo
uyumak - spać
uyuşturucu - narkotyk, substancja narkotyczna, znieczulająca lub nasenna
uzagörüm - telewizja
uzaklık - odległość
üzgün - smutny
üzgünlük - smutek
uzman - biegły, ekspert, specjalista
üzmek - zasmucić, zmartwić, zafrasować
üzülmek - zasmucić się, zmartwić się (czym - )
üzüm - wino, winorośl, winogrono
uzun - długi
uzunluk - długość
üzüntü - smutek
vaftiz - chrzest
vahşi - dziki, barbarzyński, prymitywny, brutalny, dziewiczy, dziki (np. las)
vajina - pochwa, wagina
vampir - wampir
vapur - parowiec, statek
varış - przybycie
varlıklı - bogaty
varmak - przybyć, dotrzeć, dojść, dojechać
varoluşçu - egzystencjalista
varoluşçuluk - egzystencjalizm
varoş - przedmieście
Varşova - Warszawa
vaşak - ryś
vasektomi - wazektomia
vasi - szeroki
vatandaşlık - obywatelstwo
Vatikan - Watykan
vazo - wazon
ve - i
vefat - śmierć
veganizm - weganizm
veganlık - weganizm
vejetaryenlik - wegetarianizm
vektör - wektor
velev - choć
Venezuela - Wenezuela
Venüs - Wenus
verem - gruźlica
vermek - dawać
veteriner - weterynarz
veya - lub
veyahut - lub
Vezüv - Wezuwiusz
vida - śruba
video - wideo
Vietnam - Wietnam
Vikipedi - Wikipedia
Viracocha - Wirakocza
virgül - przecinek
viski - whisky
vişne - wiśnia
Vistül - Wisła
vitamin - witamina
Viyana - Wiedeń
viyolonsel - wiolonczela
voleybol - siatkówka
von Willebrant hastalığı - choroba von Willebranda
votka - wódka
vurgu - akcent
vurgulamak - podkreślać, zaznaczać, akcentować
vurmak - uderzyć
ya - lub
yaban - dzicz, dzikość
yaban arısı - osa
Yabancı Lejyon - Legia Cudzoziemska
ya da - lub
yağ - olej, tłuszcz
yağday - sytuacja
yağlamak - naoliwić, nasmarować, smarować, oliwić
yağmur - deszcz
yağmurlu - deszczowy
yahut - lub, albo
yakalamak - złapać
yakamoz - odbicie światła księżyca w tafli wody
yakışıklı - przystojny
yakmak - palić
yakşı - dobry
yakut - rubin
yalan - kłamstwo
yalancı - kłamliwy, oszukańczy, fałszywy, sztuczny, kłamca
yalın durum - mianownik
yalın hâl - mianownik
yalnızlık - samotność
yalvarmak - błagać
yamyam - kanibal
yanardağ - wulkan
yanık - oparzenie
yanıtlamak - odpowiedzieć
yanıt vermek - odpowiedzieć
yankı - echo
yanlış - błąd, pomyłka, błędny, błędnie
yanmak - palić się
yanmaz - odporny na ogień, ognioodporny, ogniotrwały
yapan - wykonawca, autor
yapay - sztuczny
yapımcı - producent
yapmak - robić, wykonywać
yaprak - liść
yar - klif
yaralamak - ranić, zranić
yararlı - przydatny, pomocny, praktyczny, użyteczny
yarasa - nietoperz
yaratıcılık - kreatywność
yaratık - stworzenie
yaratmak - tworzyć
yardım - pomoc
yardımcı - pomocnik
yardımsever - pomocny
yarı - pół, połowicznie, częściowo
yarımada - półwysep
yarın - jutro
yaşam - życie
yaşamak - żyć, mieszkać, zamieszkiwać, doświadczać, przeżywać
yasemin - jaśmin
yasmık - soczewica
yastık - poduszka
yatak - łóżko
yatay - poziomy
yatırımcı - inwestor
yatmak - iść do łóżka, iść spać, położyć się, pójść z kimś do łóżka, przespać się z kimś
yavaş - wolny, powolny, wolno, powoli
yavaşça - powoli
yavaş yavaş - stopniowo, powoli
yaygın - przeważający, powszechny, rozpowszechniony
yaz - lato
yazar - autor
yazıhane - biuro
yazmak - pisać
yedi - siedem, 7
yedinci - siódmy
yel - wiatr
yel değirmeni - wiatrak
yelpaze - wachlarz
yem - pasza
yemek - jedzenie, pokarm, jeść
yemek borusu - przełyk
yemek odası - jadalnia
Yemen - Jemen
Yemenli - Jemeńczyk, Jemenka
yemin - przysięga
yemiş - melon
yemlik - żłób
yemyeşil - intensywnie zielony
yenge - szwagierka, żona brata, żona wuja, o czyjejś żonie
Yengeç - Rak
yeni - nowy, świeży
Yeni Delhi - Nowe Delhi
Yeni Zelanda - Nowa Zelandia
yenmek - pokonać, pokonywać
yer - miejsce
yer fıstığı - orzech ziemny
yer sarsıntısı - trzęsienie ziemi
yeryüzü - ziemia, powierzchnia Ziemi
yeşil - zielony, świeży, nowy, niedojrzały
yetmiş - siedemdziesiąt
yetmişinci - siedemdziesiąty
yiğit - dzielny, śmiały
yıl - rok
yılan - wąż
yılan balığı - węgorz
yıldız - gwiazda
yirmi - dwadzieścia
yirminci - dwudziesty
yiyecek - jedzenie, coś do jedzenia, żywność
yoğalmak - zniknąć
yoğurt - jogurt
yok - nie istnieje, nie ma
yoksul - biedny
yol - droga, ścieżka, przejście, przejazd, trasa, sposób, sposób zachowywania się, metoda, system, środki, sposoby, cel
yolcu - pasażer
yolculuk - podróż, wyprawa
yoldaş - towarzysz, kompan
yön - adres, kierunek
yönelme durumu - celownik
yönelme hâli - celownik
yönetim - administracja, administrowanie
yöntem - metoda, procedura
yöntembilim - metodologia
yörekent - przedmieście
yorgun - zmęczony
yormak - zmęczyć
yorulmak - zmęczyć się
yorum - komentarz
yosun - mech
Yucatán - Jukatan
Yugoslavya - Jugosławia
yüksek - duży, wysoki
yüksek fırın - piec
yüksük - naparstek
yumurta - jajko
yumurta akı - białko jajka
yumurta sarısı - żółtko
Yunanca - język grecki
Yunanistan - Grecja
yunus - delfin
yürek - serce
yürümek - iść, maszerować, posuwać się naprzód
yuvarlak - okrągły
yüz - sto, twarz
yüzbaşı - porucznik
yüzey - powierzchnia
yüzgeç - płetwa
yüzme - pływanie, pływactwo
yüzme havuzu - basen pływacki
yüzmek - pływać
yüzsüz - bezwstydny
yüzücü - pływak
yüzük - pierścionek, pierścień
yüzük parmağı - palec serdeczny
yüzüncü - setny
yüzyıl - wiek, stulecie
zaaf - słabość, skłonność, osłabienie
zafer - zwycięstwo
zakkum - oleander
zaman - czas
Zambiya - Zambia
zamir - zaimek
zarar - strata, uszczerbek
zararlı - szkodliwy
zarf - przysłówek, koperta
zarif - piękny, elegancki, pełen wdzięku
zaruri - nieodzowny
zavallı - biedny, nieszczęśliwy, nędzny
zebra - zebra
zehir - trucizna
zehirli - trujący
zelzele - trzęsienie ziemi
zencefil - imbir
zengin - bogaty
zenofobi - ksenofobia
zevk - przyjemność
zevkli - przyjemny, miły
zeytin - oliwa, oliwka, dzewo oliwne
zeytinyağı - oliwa, oliwa z oliwek
zihin - umysł, intelekt, duch
ziraat - rolnictwo
zirkonyum - cyrkon
ziyafet - bankiet, kolacja
ziyaretçi - gość
Zodyak - zodiak
zombi - zombi
zor - trudny, trudność, kłopot, problem, trud, przymus, nacisk, z trudem, trudno
zorla - siłą, przemocą
zorlama - przymus, życie
zulüm - niesprawiedliwość, krzywda, okrucieństwo, tyrania
zum - zoom
zürafa - żyrafa
