kozak - Kozak
а - a | ale
Аахен - Akwizgran
абажур - abażur | żyrandol | klosz
абажурний - abażurowy
абажурчик - abażurek
абазія - abazja
абак - abakus | liczydło
Абакум - ukraińskie imię męskie
абандон - porzucenie
абат - opat
абатство - klasztor | monastyr
абдукція - abdukcja
аберація - aberracja
абетка - abecadło | alfabet
абзац - akapit | paragraf | ustęp
аби - aby | żeby
абихто - ktokolwiek | obojętnie kto
абищиця - głupstwo | drobnostka | błahostka
абищо - cokolwiek | co bądź | co popadnie
абиякий - jakikolwiek
абіогенез - abiogeneza
Абісинія - Abisynia
абіссінський - abisyński
абітурієнт - abiturient
абітурієнтка - abiturientka
або - lub | albo | czyli
або-або - albo-albo
або-вже - już
аболіціонізм - abolicjonizm
аболіціоніст - abolicjonista
аболіція - abolicja
абонемент - abonament
абонент - abonent | prenumerator | subskrybent
абориген - aborygen
аборигенка - aborygenka
аборигенний - aborygeński
аборт - aborcja | poronienie
абракадабра - abrakadabra
Абрам - Abram
абревіатура - skrót
абрикос - morela
абрикосівка - morelówka
абрикосовий - morelowy
аброгація - abrogacja
абсолют - absolut
абсолютистка - absolutystka
абсолютна більшість - większość absolutna | większość bezwzględna
абсолютна істина - prawda absolutna
абсолютний - absolutny | bezwzględny
абсолютний нуль - zero absolutne
абсолютний слух - słuch absolutny
абсолютність - absolutność
абсолютно - absolutnie
абсорбент - absorbent
абсорбер - absorber
абсорбувати - absorbować | pochłaniać
абсорбція - absorpcja
абстракт - abstrakt
абстрактний - abstrakcyjny
абстрактність - abstrakcyjność
абстракціонізм - abstrakcjonizm
абстракція - abstrakcja
абсурд - absurd | bujda | głupota | głupstwo
абсурдний - absurdalny
абсцес - absces | ropień
Абу-Дабі - Abu Zabi | Abu Dhabi | Abu Dabi
абхаз - Abchaz
Абхазія - Abchazja
абхазка - Abchazka
абхазький - abchaski
аваліст - zwolennik
авангард - awangarda
авангардизм - awangardyzm
авангардистський - awangardowy
авангардний - awangardowy
аванпост - wysunięta placówka | posterunek wysunięty | awanpost
аванс - awans | kredyt | zadatek | zaliczka
авансцена - proscenium
авантюра - przypadek | przygoda | wypadek
авантюрист - awanturnik
авантюристичний - ryzykowny | przygodny
авантюрний - awanturniczy
аварійний - awaryjny
аварійність - awaryjność
аварія - awaria | usterka | uszkodzenie | wypadek
Август - August
Августа - Augusta
Августин - Augustyn
авдит - audyt | аудит
авеню - aleja | prospekt
авжеж - oczywiście
авіабаза - baza lotnicza
авіакатастрофа - katastrofa lotnicza
авіаконструктор - projektant/konstruktor samolotów
авіалінія - linia lotnicza | linie lotnicze (przedsiębiorstwo)
авіаносець - lotniskowiec | baza pływająca dla hydroplanów
авіатор - awiator | lotnik
авіатранспорт - transport lotniczy
авіаційний - lotniczy | samolotowy
авіація - awiacja | lotnictwo
авізо - awizo
авіста - awista | a vista
авокадо - awokado
авран - konitrut
Аврелія - Aurelia
Аврора - Aurora | Aurora (imię)
австралієць - Australijczyk
австралійка - Australijka
австралійський - australijski
Австралія - Australia
австрієць - Austriak
австрійка - Austriaczka
австрійський - austriacki
Австрія - Austria
автаркія - autarchia
автентичний - autentyczny
автобіографічний - autobiograficzny
автобіографія - autobiografia
автобус - autobus
автобусний - autobusowy
автограф - autograf
автозаправна станція - stacja benzynowa
автокар - autokar | autobus turystyczny
автокаталіз - autokataliza
автоклав - autoklaw
автократичний - dyktatorski | autokratyczny
автомат - automat | robot
автоматизація - automatyzacja
автоматизм - automatyzm
автоматизувати - automatyzować
автоматичний - automatyczny
автомобіліст - automobilista
автомобіль - samochód
автомобільний - samochodowy
автономічний - autonomiczny
автономія - autonomia
автономний - autonomiczny
автономність - autonomiczność
автопортрет - autoportret
автор - autor | pisarz | inicjator | twórca | wynalazca | sprawca | winowajca
авторадіограма - autoradiogram
авторитарний - autorytarny
авторитет - autorytet | władza | wpływ
авторитетний - autorytatywny | pewny | sądowy
авторка - autorka
авторство - autorstwo
автострада - autostrada
агава - agawa
агат - agat
Агата - Agata
агатовий - agatowy
агент - agent | przedstawiciel | pośrednik
агентство - agencja
агентський - pośredniczący
агентура - agentura
агенція - agencja
агіографія - hagiografia
агітатор - agitator
агітаційний - agitacyjny
агітація - agitacja
агітувати - agitować
агломерація - aglomeracja aglomeratu | skupisko mikroorganizmów | aglomeracja miast i osiedli
Агнеса - Agnieszka
агностик - agnostyk
агностицизм - agnostycyzm
агностичний - agnostyczny
агонія - agonia | męczarnia | męka
агорафобія - agorafobia
аграрний - agrarny
агрегат - agregat
агресивний - agresywny | napastliwy | energiczny | natarczywy
агресія - agresja | napad | napaść
агресор - agresor
Агрипина - Agrypina
агробіологічний - agrobiologiczny
агроном - agronom
агрономічний - agronomiczny
агрономія - agronomia
агрономка - agronomka
агротехнічний - agrotechniczny
аґрус - agrest
аґрусівка - agrestówka
аґрусовий - agrestowy
Ада - Ada
Адам - Adam
адамів - adamowy
адамове яблуко - jabłko Adama
адаптація - adaptacja | przystosowanie
адаптер - adapter
адаптуйтеся - dostosowywać się
адвокат - adwokat | obrońca
адвокатство - bycie adwokatem | adwokatowanie | adwokatura | adwokactwo
адвокатура - adwokatura
Аддис-Абеба - Addis Abeba
адекватний - adekwatny | odpowiedni
адекватність - odpowiedniość | adekwatność | zgodność
Аделаїда - Adelajda | imię Adelajda
адепт - zwolennik
адипоцит - adipocyt
адіябата - adiabata
адміністратор - administrator | zarządca
адміністраторський - administratorski
адміністрація - administracja | ministerstwo | zarząd
адміністрування - administrowanie
адмірал - admirał
адміральський - admiralski
Адольф - Adolf
Адоніс - Adonis
адреналін - adrenalina
адрес - adres
адреса - adres
адресат - adresat
адресувати - adresować
Адріан - Adrian
Адріана - Adriana
Адріатика - Adriatyk
Адріатичне море - Morze Adriatyckie
адріатичний - adriatycki
адюльтер - cudzołóstwo
ад'юнкт - adiunkt
ад'ютант - adiutant
аератор - aerator
аерація - aeracja
аеробіка - aerobik
аеродинамічний - aerodynamiczny
аеродром - lotnisko
аерозоль - aerozol
аероклуб - aeroklub
аерометр - aerometr
аероплан - samolot
аеропорт - lotnisko
аеростат - aerostat | balon
аж - aż
ажіо - ażio
ажіотаж - ażiotaż
ажур - ażur
ажурний - ażurowy
азалія - azalia
азарт - hazard | ferwor
азбест - azbest
азбестовий - azbestowy
азбука - abecadło
Азербайджан - Azerbejdżan
азербайджанець - Azerbejdżanin
азербайджанка - Azerbejdżanka
азербайджанський - azerbejdżański
азимут - azymut
азимутний - azymutalny
азіат - Azjata
азіатка - Azjatka
азіатський - azjatycki
азієць - Azjata
азійка - Azjatka
азійський - azjatycki
Азія - Azja
Азов - Azow
Азорські острови - Azory
азот - azot
азотистий - azotowy
азотний - azotowy
АЗС - stacja benzynowa
айва - pigwa
айвівка - pigwówka
айвовий - pigwowy
Айдахо - Idaho
Айова - Iowa
айсберг - góra lodowa
айстра - aster
академізм - akademizm
академік - akademik
академічний - akademicki
академія - akademia
акалькулія - akalkulia
акація - akacja
аквамарин - akwamaryn
аквамариновий - akwamarynowy
аквареліст - akwarelista
акварелістка - akwarelistka
акваріум - akwarium
акведук - akwedukt
Акерман - Białogród nad Dniestrem
Аккра - Akra
акліматизація - aklimatyzacja
акліматизувати - aklimatyzować
акомодація - akomodacja
акомпанемент - akompaniament
акомпаніатор - akompaniator
акомпаніаторка - akompaniatorka
аконіт - akonit | tojad
акорд - akord
акордеон - akordeon
акордеоніст - akordeonista
акордеоністка - akordeonistka
акордний - zgodny
акордовий - akordowy
акр - akr
акредитувати - akredytować | upełnomocniać | upoważniać
акрил - akryl
акробат - akrobata
акробатика - akrobatyka
акробатка - akrobatka
акрополь - akropol
аксіома - aksjomat
аксіоматика - aksjomatyka
аксіоматичний - aksjomatyczny
аксон - akson
акт - akt | czyn | działanie | dokument | protokół | ara
актив - aktyw
активація - aktywacja
активізація - aktywizacja
активіст - aktywista
активістка - aktywistka
активний - aktywny | czynny
активність - aktywność | działalność
активно - aktywnie
активувати - aktywować | uaktywnić
актиній - aktyn
актовий - aktowy
актор - aktor
актриса - aktorka
актуалізація - aktualizacja
актуальний - aktualny
актуальність - aktualność
акула - rekin | wielki spryciarz | cwaniak
акумулювати - akumulować
акумулюватися - akumulować się
акумулятор - akumulator
акумуляція - akumulacja
акупунктура - akupunktura
акурат - akurat | dokładnie
акуратний - dokładny | precyzyjny | szczegółowy | ułożony | porządny | staranny
акуратність - precyzja | ścisłość | dokładność
акуратно - ostrożnie
акустика - akustyka
акустичний - akustyczny
акушер - położnik | akuszer
акушерка - akuszerka | położna
акушерство - położnictwo | akuszerstwo
акушерський - położniczy | akuszerski
акцент - akcent | nacisk
акцентувати - akcentować | podkreślać | uwydatniać
акцептант - akceptant
акцептний - przyjęty | zaakceptowany
акцептор - akceptor
акцептування - akceptacja | przyjęcie | akceptowanie
акцептувати - przyjmować | akceptować
акциз - akcyza
акцизний - akcyzowy
акціонер - akcjonariusz
акціонерне товариство - spółka akcyjna
акціонерний - udziałowy
акція - akcja | czyn | uczynek
Алабама - Alabama
албанець - Albańczyk
Албанія - Albania
албанка - Albanka
албанський - albański
алгебра - algebra
алгебраїчний - algebraiczny
алгол - Algol
алгоритм - algorytm
алгоритмізація - algorytmizacja
алгоритмічний - algorytmiczny
але - ale | lecz
алебарда - halabarda
алебардний - halabardowy
алебастр - alabaster
алебастровий - alabastrowy
алегоричний - alegoryczny
алеґрето - allegretto
алеґро - allegro
алексія - aleksja
алерген - alergen
алергічний - alergiczny
алергія - alergia | uczulenie
алерголог - alergolog
алергологічний - alergologiczny
алергологія - alergologia
алея - aleja
Алжир - Algieria | Algier – stolica Algierii
алжирський - algierski
алжірець - Algierczyk | algierczyk
алжірка - Algierka | algierka
алібі - alibi
алігатор - aligator
алігаторова груша - awokado
алілуя - alleluja
аліменти - alimenty
Аліна - Alina
алітераційний - aliteracyjny
алітерація - aliteracja
алкоголізм - alkoholizm
алкоголь - alkohol
алкогольний - alkoholowy
алло - cześć | halo
алмаз - diament
алмазик - diamencik
алмазний - diamentowy
алое - aloes
алоевий - aloesowy
алонж - alonż
Алтай - Ałtaj
алтайський - ałtajski
алфавіт - alfabet | abecadło
алфавітний - alfabetyczny
алхімік - alchemik
алхімія - alchemia
альбатрос - albatros
Альберт - Albert
Альберта - Alberta
альбінізм - albinizm
альбінос - albinos
альбом - album
альв - elf
альков - alkowa | nisza
альманах - almanach
альманаховий - almanachowy
Альпи - Alpy
альпініада - alpiniada
альпінізм - alpinizm
альпініст - alpinista
альпіністка - alpinistka
альпіністський - alpinistyczny
альт - alt | altówka
альтанка - altana
альтернатива - wybór | alternatywa
альтернативний - alternatywny
альтовий - altowy
альтруїзм - altruizm
альтруїстка - altruistka
альфа - alfa
Альфонс - Alfons
Альфред - Alfred
альянс - sojusz | zrzeszenie
алюмінієвий - aluminiowy
алюміній - glin | aluminium
Аляска - Alaska
амазоніт - amazonit
Амазонія - Amazonia
Амазонка - Amazonka
амальгама - amalgamat | mieszanina | mieszanka
амарант - amarant
амариліс - amarylis
амарилісовий - amarylisowy
аматор - adorator | amator | wielbiciel | zwolennik
аматорство - amatorstwo
аматорський - amatorski
амбасада - ambasada
амбасадор - ambasador
амбівалентний - ambiwalentny
амбіційний - ambitny
амбіція - ambicja | cel
амбра - ambra
амбразура - ambrazura
амбровий - ambrowy
амброзія - ambrozja
амбулаторія - ambulatorium
амвон - ambona
амеба - ameba
Америка - Ameryka
американець - Amerykanin
американізація - amerykanizacja
американізм - amerykanizm
американізувати - amerykanizować
американіст - amerykanista
американістика - amerykanistyka
американка - Amerykanka
американський - amerykański
америцій - ameryk
аметист - ametyst
аметистовий - ametystowy
аміачний - amoniakowy
амікошонство - amikoszoneria
амілопласт - amyloplast
амінокислота - aminokwas
амінокислотний - aminokwasowy
Амман - Amman
амнезія - amnezja
амністія - amnestia
амоніак - amoniak
аморальний - amoralny | niemoralny
аморальність - amoralność | niemoralność
амортизація - amortyzacja
аморфний - amorficzny | bezkształtny
Амос - Amos
ампер - amper
амплітуда - amplituda
ампліфікація - amplifikacja
ампула - ampułka
ампутаційний - amputacyjny
ампутація - amputacja
Амстердам - Amsterdam
амстердамський - amsterdamski
амулет - amulet | maskotka
Амур - Amur
амфібія - amfibia | płaz
амфітеатр - amfiteatr
амфора - amfora
анаболізм - anabolizm
анаконда - anakonda
аналіз - analiza
аналізатор - analizator
аналітик - analityk
аналітичний - analityczny
аналогійний - analogiczny
аналогічний - analogiczny
аналогічно - analogicznie
аналогія - analogia | podobieństwo
аналоговий - analogowy
анальний - analny
анаморфоз - anamorfoza
ананас - ananas
ананасик - ananasik
ананасовий - ananasowy
анархізм - anarchizm
анархіст - anarchista
анархістка - anarchistka
анархічний - anarchiczny
анархія - anarchia
Анастасія - Anastazja
Анатоль - Anatol
анатом - anatom
анатомічний - anatomiczny
анатомія - anatomia
анафема - przekleństwo | anatema
анафора - anafora
анахронізм - anachronizm
анахронічний - anachroniczny
ангажувати - angażować
ангар - garaż | hangar | magazyn | skład | składnica | zajezdnia
ангел - anioł
ангел-охоронець - Anioł Stróż
ангелочок - aniołek | anioł
ангельський - anielski
ангелятко - aniołek | anioł
ангіна - angina
ангіографія - angiografia
ангіологія - angiologia
англієць - Anglik
англійка - Angielka
англійський - angielski
англіканець - anglikanin
англіканство - anglikanizm
англіканський - anglikański
англіцизм - anglicyzm
Англія - Anglia
англо-американський - angloamerykański
англоман - angloman
англоманія - anglomania
англоманка - anglomanka
англоманський - dotyczący anglomana lub anglomanii
англомовний - anglojęzyczny
англосакс - Anglosas
англофіл - anglofil
англофільство - anglofilstwo | anglofilizm
англофільський - anglofilski
англофоб - anglofob
англофобство - anglofobia
англофобський - dotyczący anglofoba lub anglofobii
Ангола - Angola
анголець - Angolczyk | Angolijczyk
анголка - Angolka | Angolijka
ангольський - angolski
ангора - moher
ангорський - angorski
ангстрем - angstrem
Андалузія - Andaluzja
Андалусія - Andaluzja
анданте - andante
Анди - Andy
андійський - andyjski
Андора - Andora (miasto)
Андорра - Andora
Андрій - Andrzej
Андромеда - Andromeda
анекдот - anegdota
анекдотичний - anegdotyczny
анексія - aneksja
анексувати - anektować
анемічний - anemiczny
анемія - anemia
анестезіолог - anestezjolog
анестезіологічний - anestezjologiczny
анестезіологія - anestezjologia
анестезувати - znieczulić
Анжеліка - Angelika
ані - ni | ani | nie
анігіляція - zniszczenie | anihilacja
аніж - aniżeli
анізокорія - anizokoria
анізотропія - anizotropia
анілін - anilina
аніліновий - anilinowy
анімація - animacja | animowanie | pobudzanie do działań
аніме - anime
анімізм - animizm
аніон - anion
аніоніт - anionit
аніс - anyż
анісовий - anyżowy
Аніта - Anita
Анкара - Ankara
анкарський - ankarski
анкер - śruba kotwowa | śruba kotwicząca
анкета - ankieta | kwestionariusz
Анна - Anna
аннали - annały
анод - anoda
аномалія - anomalia
аномальний - anomalny
анонім - anonim | osoba występująca anonimowo | list bez podpisu
анонімний - anonimowy
анонімність - anonimowość
анонс - anons
анормальний - anormalny
анортит - anortyt
анотація - adnotacja
ансамбль - grupa wykonawców występujących wspólnie | zespół | grupa muzyczna | zespół obiektów stanowiących całość
антагонізм - antagonizm | wrogość | przeciwieństwo | sprzeczność interesów | antagonizm organizmów
антагоніст - antagonista
антагоністичний - antagonistyczny
антагоністка - antagonistka
Антананаріву - Antananarywa
Антарес - Antares
Антарктида - Antarktyda
антарктичний - antarktyczny
Антверпен - Antwerpia
антена - antena
антибіотик - antybiotyk
антиген - antygen
антигромадський - aspołeczny
Антигуа і Барбуда - Antigua i Barbuda
антиісторизм - ahistoryzm
антик - antyk
антикваріат - antykwariat
антилопа - antylopa
антильський - antylski
Антильські острови - Antyle Holenderskie
антиномічний - antynomiczny | antynomijny
антиномія - antynomia
антиоксидант - przeciwutleniacz | antyoksydant
антипатія - antypatia
антисанітарний - antysanitarny
антисеміт - antysemita
антисемітизм - antysemityzm
антисемітка - antysemitka
антисемітський - antysemicki
антисептика - antyseptyka
антисоціальний - aspołeczny
антитеза - antyteza
антитоксин - antytoksyna
антифашист - antyfaszysta
антихлор - antychlor
антихрист - antychryst
античний - antyczny
античність - antyczność | starożytność
антологія - antologia
антонім - antonim
Антоніна - Antonina
антракт - antrakt | przerwa
антрепренер - antreprener
антрепренерство - zawód wykonywany przez antreprenera
антрепренерський - dotyczący antreprenera
антрополог - antropolog
антропологізм - antropologizm
антропологія - antropologia
антропометр - antropometr
антропометрія - antropometria
антропоморфізм - antropomorfizm
антураж - orszak | otoczenie | świta
анулювання - umorzenie
анулювати - anulować | znosić | kasować | skasować | unieważniać | unieważnić | odwoływać | odwołać | umarzać | umorzyć
анус - odbyt
анчоус - sardela | anchois
аорта - aorta
аортальний - aortalny
апарат - aparat
апатичний - apatyczny
апатично - apatycznie
апатія - apatia
апаш - apasz
апельсин - pomarańcza
апельсиновий - pomarańczowy (mający związek z pomarańczą)
апелювання - apelowanie
апелянт - apelant
апеляційний - apelacyjny
апеляція - apelacja | odwołanie | odwoływanie się
Апенніни - Apeniny
апеннінський - apeniński
Апеннінський півострів - Półwysep Apeniński
апетит - apetyt | ochota
апетитик - apetycik
апетитний - apetyczny
аплодисменти - oklaski
аплодувати - oklaskiwać | bić brawo
апогей - apogeum | maksimum
апокаліпсичний - apokaliptyczny
апокрифічний - apokryficzny
аполітичний - apolityczny
Аполлінарій - Apolinary
Аполлон - Apollo
Аполлонія - Apolonia
апоплексія - apopleksja
апоплектик - apoplektyk
апорія - aporia
апостол - apostoł | propagator
Апостол - księga zawierająca Dzieje Apostolskie
апостольство - apostolstwo
апостольський - apostolski
апостроф - apostrof
апострофа - apostrofa
апофема - apotema
Аппалачі - Appalachy
апробація - aprobata
апроксимація - aproksymacja
апсида - apsyda
аптека - apteka
аптекар - aptekarz
аптекарка - aptekarka
аптекарський - aptekarski
аптечка - apteczka
аптечний - apteczny
ар - ar
ара - ara
араб - Arab
арабізм - arabizm
арабіст - arabista
арабістика - arabistyka
арабка - Arabka
арабський - arabski
Аравія - Arabia
арак - arak
араковий - arakowy
арамейка - Aramejka
арамейський - aramejski
Арарат - Ararat (masyw)
арахіс - orzech ziemny
арбалет - arbalet
арбітр - sędzia polubowny | arbiter | rozjemca | sędzia
арбітраж - arbitraż | rozjemstwo
арбітражний - arbitrażowy | pojednawczy | rozjemczy
Аргентина - Argentyna
аргентинець - Argentyńczyk
аргентинка - Argentynka
аргентинський - argentyński
аргон - argon
аргоновий - argonowy
аргумент - argument
аргументація - argumentacja
аргументування - argumentowanie
аргументувати - argumentować | uzasadniać | udowadniać
ареал - areał
арена - arena
ареопаг - areopag
арешт - areszt | aresztowanie
арештант - aresztant
арештантка - aresztantka
арештовувати - aresztować
аристократ - arystokrata
аристократизм - arystokratyzm
аристократичний - arystokratyczny
аристократично - arystokratycznie
аристократія - arystokracja
аристократка - arystokratka
аритмічний - arytmiczny
аритмія - arytmia
арифметика - arytmetyka
Аріадна - Ariadna
арієць - Aryjczyk
арійка - Aryjka
арійський - aryjski
арія - aria
арка - łuk
аркада - arkada
аркан - arkan | huculski taniec wykonywany przez mężczyzn
арковий - łukowy
Арктика - Arktyka
арктичний - arktyczny
аркуш - arkusz | karta | arkusz drukarski
арлекін - arlekin | pajac | błazen
арлекінада - arlekinada
армада - armada
арматура - armatura | przyrządy | przybory | zbrojenie | uzbrojenie
армієць - wojskowy
армія - armia | wojsko | masa | mnóstwo | mnogość
арніка - arnika
арніковий - arnikowy
Арнольд - Arnold
аромат - aromat | zapach
ароматичний - aromatyczny
ароматний - aromatyczny | pachnący
ароматотерапія - aromaterapia | aromatoterapia
арсен - arsen
арсенал - arsenał
артезіанський - artezyjski
артеріальний - arterialny | arteryjny
артерія - arteria | tętnica | magistrala
артефакт - artefakt
артилерист - artylerzysta
артилеристка - artylerzystka
артилерійський - artyleryjski
артилерія - artyleria
артист - artysta publicznie wykonujący sztukę | artysta | mistrz w jakiejś dziedzinie
артистизм - artyzm (piękno czegoś) | artyzm (mistrzowskie wykonanie, umiejętność pięknego tworzenia)
артистичний - artystyczny
артистка - artystka publicznie wykonująca sztukę | artystka | mistrzyni w jakiejś dziedzinie
артишок - karczoch
артіль - artel
артрит - artretyzm
Артур - Artur
Аруба - Aruba
арум - aron
арфа - harfa
арфіст - harfista | harfiarz
арфістка - harfistka | harfiarka
арф'яр - harfista | harfiarz
арф'ярка - harfistka | harfiarka
архаїзм - archaizm
архаїчний - archaiczny
архаїчність - archaiczność
архангел - archanioł
Архангельськ - Archangielsk
архангельський - archanielski | archangielski
археологічний - archeologiczny
археологія - archeologia
архів - archiwum
архіваріус - archiwariusz
архівний - archiwalny
архієпископ - arcybiskup
архієрей - archijerej | archirej
архієрейський - biskupi | episkopalny
архімандрит - archimandryta
архіпелаг - archipelag
архітект - architekt
архітектоніка - architektonika
архітектонічний - architektoniczny
архітектор - architekt | twórca czegokolwiek
архітектура - architektura
архітектурний - architektoniczny
архітрав - architraw
архонт - archont
ас - as
асамблея - zgromadzenie
асемблер - asembler
асептичний - aseptyczny
асертивність - asertywność
асигнація - asygnacja | asygnata | przekaz | dyspozycja
асигнування - asygnacja | asygnowanie | wyasygnowanie | świadczenia | dotacje | dofinansowanie
асигнувати - asygnować | wyasygnować
асиметричний - asymetryczny
асиметричність - asymetryczność
асиметрія - asymetria
асимілювати - asymilować
асимілюватися - asymilować się
асиміляція - asymilacja | przyswojenie
асимптота - asymptota
асистент - asystent
асистентка - asystentka
аскет - asceta
аскетизм - ascetyzm | asceza
аскетичний - ascetyczny
аскетично - ascetycznie
аскетка - ascetka
аскорбінова кислота - kwas askorbinowy
аскорбіновий - askorbinowy
Асмара - Asmara
асонанс - asonans
асортимент - asortyment
асорті - mieszanka jednorodnych elementów | przedmiotów w różnych odmianach | czekoladki | czekoladowe cukierki
асоціативний - asocjatywny
асоціація - asocjacja | kojarzenie | skojarzenie | towarzystwo | spółka | stowarzyszenie
аспект - aspekt | ujęcie | postać | przejaw
аспірант - aspirant
аспірантура - aspirantura
аспіратор - aspirator
аспірин - aspiryna
ассирійський - asyryjski
Астана - Astana
астенік - astenik
астенія - astenia
астероїд - asteroida
астигматизм - astygmatyzm
астма - astma | dychawica
астматик - astmatyk
астматичка - astmatyczka
астматичний - astmatyczny
астрагал - traganek | astragal
астральний - astralny
астрограф - astrograf
астролог - astrolog
астрологічний - astrologiczny
астрологія - astrologia
астролябія - astrolabium
астрометрія - astrometria
астронавт - astronauta
астронавтика - astronautyka
астронавтський - astronautyczny
астроном - astronom
астрономічний - astronomiczny
астрономія - astronomia
астрофізик - astrofizyk
астрофізика - astrofizyka
астрофізичний - astrofizyczny
асфальт - asfalt
асфальтівка - asfaltówka
асфальтний - asfaltowy
асфальтник - asfalciarz
асфальтобетон - asfaltobeton
асфальтобетонний - asfaltobetonowy
асфальтобітумний - asfaltobitumiczny
асфальтовий - asfaltowy
асфальтозмішувач - mieszarka asfaltu
асфальтоподібний - asfaltopodobny
асфальтоукладач - maszyna do układania asfaltu
асфальтувальник - asfalciarz
асфальтування - asfaltowanie
асфальтувати - asfaltować
АТ - spółka akcyjna
атавізм - atawizm
атавістичний - atawistyczny
атака - atak | napaść | napad | natarcie | szturm | ofensywa
атакування - atakowanie
атакувати - atakować (wroga) | atakować (oddziaływać z dużym nasileniem)
атакуючий - atakujący
аташе - attache | attaché
атеїзм - ateizm
атеїст - ateista
атеїстичний - ateistyczny
атеїстка - ateistka
ательє - atelier | pracownia
атестат - atestat | zaświadczenie | świadectwo | metryka
атестат зрілості - świadectwo dojrzałości | matura
атестація - atestacja
атестувати - zaświadczać | atestować
Атлантида - Atlantyda
атлантичний - atlantycki
Атлантичний океан - Ocean Atlantycki
атлас - atlas | atłas
атласний - atłasowy | atlasowy
атласовий - atłasowy
атлет - atleta | atleta cyrkowy | człowiek z rozwiniętą muskulaturą
атлетика - atletyka
атлетичний - atletyczny
атлетка - atletka | kobieta postawna | silna | z rozwiniętą muskulaturą
атмосфера - atmosfera otaczająca ciało niebieskie | atmosfera - jednostka ciśnienia | atmosfera | nastrój
атмосферний - atmosferyczny
атол - atol
атом - atom | energia atomowa | atom (najmniejsza odrobina czegokolwiek)
атомізм - atomizm
атомістика - atomistyka
атомістичний - atomistyczny
атомна енергія - energia atomowa | energia jądrowa
атомна зброя - broń atomowa
атомний - atomowy
атональний - atonalny
атонія - atonia
атракціон - wesołe miasteczko | popis | numer estradowy lub cyrkowy
атрибут - atrybut
атрибутивний - atrybutywny
атріум - atrium
атропін - atropina
атрофія - atrofia | zanik cech | wrażliwości
аттик - attyka
ату - okrzyk zachęty do zrywu dla psów podczas polowania
аудит - audyt
аудитор - audytor
аудиторія - audytorium (pomieszczenie) | audytorium (słuchacze)
аудієнція - audiencja
аудіовізуальний - audiowizualny
аукціон - aukcja | licytacja | przetarg
аукціоніст - osoba prowadząca sprzedaż dóbr na targu | licytację | licytant
аукціонний - aukcyjny
аура - aura
аускультація - osłuchiwanie
аут - aut
аутентичний - autentyczny
аутопсія - sekcja zwłok | autopsja
аутсайдер - outsider | autsajder
афазія - afazja
афганець - Afgańczyk
афгані - afgani
Афганістан - Afganistan
афганка - Afganka
афганський - afgański
афект - afekt
афектація - afektacja
афективний - afektywny
афера - afera | oszustwo
аферист - aferzysta
аферистка - aferzystka
афікс - zrostek
Афіна - Atena
Афіни - Ateny
афінський - ateński
афінянин - ateńczyk
афінянка - atenka
афіша - afisz | plakat
афішувати - afiszować
афішуватися - afiszować się
афонія - bezgłos | afonia
афоризм - aforyzm
афористичний - aforystyczny
афористично - aforystycznie
Африка - Afryka
африканер - Afrykaner
африканець - Afrykanin
африканіст - afrykanista
африканістика - afrykanistyka
африканка - Afrykanka
африканський - afrykański
африканьский - afrykański
африката - afrykata
афроамериканець - Afroamerykanin
Афродіта - Afrodyta
афронт - afront
ах - ach
Ахілл - Achilles
ахнути - jęknąć
ахромат - achromat
ахроматизм - achromatyzm
ахроматичний - achromatyczny
ацетилен - acetylen
ацетиленовий - acetylenowy
ацетиловий - acetylowy
ацетилсаліциловий - acetylosalicylowy
ацетилцелюлоза - acetyloceluloza
ацетон - aceton
ацетоновий - acetonowy
ацидоз - acydoza
ациклічний - acykliczny
ациклічність - acykliczność
ацтек - Aztek
ацтекський - aztecki
аякже - a jakże | oczywiście | naturalnie
аятола - ajatollah
баба - babcia | staruszka | bałwan | baba | kobieta
баба з воза, коням легше - baba z wozu, koniom lżej
бабуся - babcia
бавовна - bawełna
багаж - bagaż
багажний - bagażowy
багажник - bagażnik
Багамські Острови - Bahamy
багатий - bogaty
багато - dużo | wiele
багаторазовий - wielokrotny | wielorazowy
багатство - bogactwo
Багдад - Bagdad
багнистий - bagnisty
багно - bagno | trzęsawisko | grzęzawisko | błoto
бажання - życzenie | pragnienie | chęć | pożądanie | namiętność
бажати - pragnąć
базальт - bazalt
базальтовий - bazaltowy
базар - bazar
базарний - bazarowy | targowy
базиліка - bazylika
Баїрикі - Bairiki
Байкал - Bajkał
байкальський - bajkalski
баклажан - bakłażan
бактерія - bakteria
Баку - Baku
балет - balet
балетний - związany z baletem
балістичний - balistyczny
Балканський півострів - Półwysep Bałkański
балкон - balkon
Балтійське море - Morze Bałtyckie
балтійський - bałtycki
бальзам - balsam
бальзамічний - balsamiczny
бальзамувати - balsamować
Бамако - Bamako
банан - banan
банановий - bananowy
Бангкок - Bangkok
Бангладеш - Bangladesz
Бандар-Сері-Бегаван - Bandar Seri Begawan
Банджул - Bandżul
банк - bank
баптизм - baptyzm
баптист - baptysta
баптистський - baptystyczny
барабан - bęben | faska
баран - baran (samiec owcy) | baran (o głupim człowieku)
баранина - baranina
Барбадос - Barbados
барбадоський - barbadoski
бардак - bardak | burdel | bajzel | bałagan | dom publiczny
барикада - barykada
барій - bar
барліг - legowisko
баскетбол - koszykówka
батрахологія - batrachologia
батьківщина - ojczyzna
батько - ojciec | rodzice
Бахрейн - Bahrajn
бачити - widzieć | patrzeć | dostrzegać
бджілка - pszczoła
бджільництво - pszczelarstwo
бджола - pszczoła
бедро - biodro
бежевий - beżowy
без - bez
бездітний - bezdzietny
бездітність - bezdzietność
беззубий - bezzębny | bezzębny (słaby, bezsilny i niegroźny)
безлюддя - bezludzie | odludzie
безлюдний - bezludny | wyludniony | bezosobowy
безлюдніти - wyludniać się
безлюдько - odludek
безпека - bezpieczeństwo
безриб'я - bezrybie | brak lub znikoma ilość ryb
безрозмірний параметр - liczba bezwymiarowa
Бейрут - Bejrut
бейрутський - bejrucki
бейсбол - baseball | bejsbol
Беліз - Belize
белізійський - belizeński
бельгієць - Belg
бельгійка - Belgijka
бельгійський - belgijski
Бельгія - Belgia
Бельмопан - Belmopan
бензин - benzyna
Бенін - Benin
берегти як зіницю ока - strzec jak źrenicy oka
береза - brzoza
березень - marzec
берилій - beryl
берклій - berkel
беркут - orzeł przedni | zys
Беркут - nazwa zlikwidowanych w lutym 2014 specjalnych oddziałów ukraińskiej milicji | zajmujących się m.in. przestępczością zorganizowaną i ochroną manifestacji
Берлін - Berlin
берлінець - berlińczyk
берлінка - berlinianka | berlinka
берлінський - berliński
Бермудські острови - Bermudy
Бескиди - Beskidy
бетонний - betonowy
бик - byk
бир - birr
бити - bić
бити тривогу - bić w dzwony na trwogę | dzwonić na trwogę
бібліоманія - bibliomania | książkomania
бібліотека - biblioteka
бібліотекар - bibliotekarz
Біблія - Biblia
біг - bieg
бігати - biegać
біда - bieda | nieszczęście
біда ніколи сама не ходить - nieszczęścia chodzą parami
бідний - biedny
бізнес - biznes
бізнесмен - biznesmen
біла гарячка - biała gorączka
білий - biały
білий як хустка - biały jak chusta | blady jak chusta
білка - wiewiórka
білок - białko | białko jaja | biała część oka
білорус - Białorusin
білоруска - Białorusinka
Білорусь - Białoruś
білоруський - białoruski
біль - ból
більйон - bilion
більйонний - bilionowy
біографічний - biograficzny
біографія - biografia
біолог - biolog
біологія - biologia
біржа - giełda
бірюзовий - turkusowy | koloru turkusowego | wykonany z turkusu
Бісау - Bissau
Бішкек - Biszkek
блакитний - niebieski | błękitny
блакить - błękit
Близнята - Bliźnięta
близький - bliski | zbliżony
блискавка - piorun
блідий - blady (pozbawiony rumieńca, opalenizny, mający jasną karnację) | blady (o mało intensywnej barwie) | blady (mało wyraźny)
блідий як смерть - blady jak śmierć
блоха - pchła
блудний син - syn marnotrawny
бо - dlatego | że | bo | ponieważ
бобер - bóbr | futro z bobra
бог - bóg | bóstwo
Бог - Bóg
Богдан - Bogdan
богиня - bogini
Богота - Bogota
болгарин - Bułgar
Болгарія - Bułgaria
болгарка - Bułgarka
болгарський - bułgarski
болівіано - boliviano
болівієць - Boliwijczyk
болівійка - Boliwijka
болівійський - boliwijski
Болівія - Boliwia
боліти - boleć | ubolewać | przejmować się
болотистий - bagnisty | bagienny | błotnisty
болото - bagno | grzęzawisko | torfowisko | błoto
бор - bor
бордель - burdel
борода - broda | owłosienie na brodzie (1.1)
бородатий - brodaty
борона - brona
боротьба - walka | zapasy
борошно - mąka
борсук - borsuk
борщ - barszcz
боснійський - bośniacki
Боснія - Bośnia
Боснія і Герцеговина - Bośnia i Hercegowina
босняк - Bośniak
боснячка - Bośniaczka
ботаніка - botanika
Ботсвана - Botswana
бочка - beczka | beczka (figura akrobatyczna w pilotażu)
боятися - bać się
боятися за свою шкуру - bać się o swoją skórę
боятися як вогню - bać się jak ognia
боятися як чорт ладану - bać się jak diabeł święconej wody | bać się jak czart kadzidła
боятися як чорт свяченої води - bać się jak diabeł święconej wody
Браззавіль - Brazzaville
бразилець - Brazylijczyk
бразилійка - Brazylijka
Бразилія - Brazylia | Brasília
бразильський - brazylijski
брат - brat | zakonnik
брати - brać
Братислава - Bratysława
братиславський - bratysławski
Бриджтаун - Bridgetown
брова - brew
бром - brom
брудний - brudny
Бруней - Brunei
брюнет - brunet
Брюссель - Bruksela
брюссельська капуста - brukselka
Буг - Bug
Будапешт - Budapeszt
буддистка - buddystka
будинок - budynek
будинок розпусти - dom rozpusty
будувати - budować
будяк - oset
Буенос-Айрес - Buenos Aires
Бужумбура - Bużumbura
буква - litera | duch | myśl tekstu
букмекер - bukmacher
булгур - bulgur
булімія - bulimia
бульба - bulwa
Буркіна-Фасо - Burkina Faso
Бурунді - Burundi
бурундійський - burundyjski
буря - burza
буряк - burak
бур'ян - chwast
Бурятія - Buriacja
Бутан - Bhutan
бути - być
бути на сьомому небі - być w siódmym niebie
бути сіллю в оці - być solą w oku
Бухарест - Bukareszt
бухгалтер - księgowy
бухгалтерія - księgowość | księgowość  (komórka organizacyjna zajmująca się księgowaniem)
бухгалтерка - księgowa
бухгалтерський - księgowy
бюрократ - biurokrata | biurokrata (wysoki urzędnik)
бюрократизація - biurokratyzacja
бюрократизм - biurokratyzm | biurokracja | formalizm | biurokracja (system zarządzania, w którym decydującą rolę odgrywa administracyjny aparat urzędniczy)
бюрократизувати - biurokratyzować
бюрократизуватися - biurokratyzować się
бюрократичний - biurokratyczny | formalistyczny | biurokratyczny (związany z systemem biurokracji)
бюрократичність - biurokratyczność
бюрократично - biurokratycznie
бюрократія - biurokracja (hierarchiczny system zarządzania, w którym decydującą rolę odgrywa administracyjny aparat urzędniczy) | biurokracja (zbiorowość osób zarządzających)
бюрократка - biurokratka
бюстгальтер - biustonosz
в - w
Вавилон - Babilon
Вагадугу - Wagadugu
вагітна - ciężarna | kobieta w ciąży
вагітність - ciąża
вагон - wagon
Вадуц - Vaduz
важка атлетика - ciężka atletyka
важкий - ciężki
важкий метал - heavy metal
важливий - ważny | doniosły
важний - ważny
вазектомія - wazektomia
вазелін - wazelina
Валетта - Valletta
вампука - wampuka
ванадій - wanad
ванна - wanna | łazienka
вантажівка - ciężarówka
Вануату - Vanuatu
вареник - pieróg | pierożek
Варта - Warta
Варшава - Warszawa
вата - wata
Ватикан - Watykan
ваш - wasz
вгору ногами - do góry nogami (w odwrotnym położeniu) | do góry nogami (na odwrót, nieprawidłowo, nie tak jak zwykle)
вдвічі - dwukrotnie
вдова - wdowa
вдовець - wdowiec
вдячний - wdzięczny
вегетаріанець - wegetarianin
вегетаріанка - wegetarianka
вегетаріанство - wegetarianizm
вегетаріанський - wegetariański
ведмідь - niedźwiedź
вежа - wieża
вексилологія - weksylologia
Велика Британія - Wielka Brytania
Великдень - Wielkanoc
великий - duży | wielki | dorosły | wybitny
Великобританія - Wielka Brytania
великодержавний - wielkomocarstwowy
великодержавник - szowinista wielkomocarstwowy
великодержавництво - wielkomocarstwowość | wielkomocarstwowy szowinizm
великодержавницький - wielkomocarstwowy
великодержавність - wielkomocarstwowość
великодній - wielkanocny
великоруський - wielkoruski
велосипед - rower
Венера - Wenus
венеричний - weneryczny
Венесуела - Wenezuela
венеціанець - wenecjanin
венеціанка - wenecjanka
венеціанський - wenecki | język/dialekt wenecki
Венеція - Wenecja
верба - wierzba
верблюд - wielbłąd
верес - wrzos
вересень - wrzesień
веретено - wrzeciono
вертоліт - śmigłowiec
веселий - wesoły | radosny | zabawny
веселка - tęcza
весілля - wesele
весна - wiosna
весь - cały | wszystek
вечір - wieczór
вечірній - wieczorny | wieczorowy
В'єнтьян - Wientian
В'єтнам - Wietnam
вже - już
взагалі - w ogóle
взаємодія - interakcja
взяти - wziąć
ви - wy | pan | pani
вибух - ukraiński
виверження - erupcja
вивчення - badanie | studium
вигук - głośny zwrot | wykrzyknienie | okrzyk | wykrzyknik
виделка - widelec
видра - wydra
виклад - prezentacja | przedstawienie | wypowiedź
вилазити із шкіри - wyłazić ze skóry
вимова - wymowa | umowa
вимовити - wymówić | wypowiedzieć
вино - wino
виноград - winorośl
виноградник - winnica
вирок - wyrok | werdykt
вислухувати - słyszeć | słuchać
високий - wysoki
високосний рік - rok przestępny
виставка - wystawa
вихід - wyjście
вишня - wiśnia
вівторок - wtorek
вівця - owca
від - od
від а до я - od a do zet
відгомін - odgłos | echo
Відень - Wiedeń
відео - wideo
відлюдник - odludek | pustelnik | eremita | anachoreta
відлюдок - odludek | samotnik
відмінок - przypadek | forma deklinacji
відповідальний - odpowiedzialny
відповідальність - odpowiedzialność
відповідь - odpowiedź
відро - wiadro
віз - wóz
візит - wizyta
війна - wojna
військовий - wojskowy
вік - wiek | życie | okres | epoka
Вікіпедія - Wikipedia
Вікісловник - Wikisłownik
вікно - okno | okienko
віл - wół
Віллемстад - Willemstad
вільний - wolny
вільний удар - rzut wolny
Вільнюс - Wilno
він - on
Віндгук - Windhuk
віолончеліст - wiolonczelista
віолончелістка - wiolonczelistka
віолончель - wiolonczela
віолончельний - wiolonczelowy
віра - wiara
вірити - wierzyć
вірмен - Ormianin
вірменин - Ormianin
Вірменія - Armenia
вірменка - Ormianka
вірменський - ormiański
вірус - wirus
вірусологія - wirusologia
вісім - osiem
вісімдесят - osiemdziesiąt | 80
вісімдесятий - osiemdziesiąty
вісімка - ósemka | 8
вісімнадцятий - osiemnasty
вісімнадцять - osiemnaście | 18
вісімсот - osiemset | 800
віск - wosk
віскі - whisky
Вісла - Wisła
віслюк - osioł
вісмут - bizmut
вітання - powitanie
вітер - wiatr
Віченца - Vicenza (miasto)
Вішну - Wisznu
вія - rzęsa
властивість - właściwość
вмерти - umrzeć
внаслідок - wskutek
вовк - wilk
вовк в овечій шкурі - wilk w owczej skórze
вовна - wełna
вогонь - ogień
вода - woda
водень - wodór
водити за ніс - wodzić za nos
водій - kierowca
водка - wódka
водний - wodny
Водолій - Wodnik
воловина - wołowina
волос - włos
волосся - włosy
вольфрам - wolfram
вона - ona | won
вони - oni | one
воно - ono
ворог - wróg
ворожий - wrogi
ворожість - wrogość
ворон - kruk | zabawa polegająca na udawaniu łapania kurczątek przez kruka | rodzaj podpory w dawnym budownictwie rosyjskim | kruczy
ворона - wrona
воротар - stróż przy bramie | bramkarz
восьмеро - ośmioro
восьмий - ósmy
восьмикратний - ośmiokrotny
восьмисотий - osiemsetny
воша - wsza
вродливий - ładny | nadobny
Вроцлав - Wrocław
всесвітній - ogólnoświatowy
вступний - wstępny (dziejący się na wstępie) | wstępny | rekrutacyjny (dający prawo wstępu lub przejścia pewnego etapu)
вступний екзамен - egzamin wstępny
втрачати - stracić
вуглець - węgiel
вугор - węgorz
вузький - wąski
вул. - ulica | ul.
вулиця - ulica
вулкан - wulkan
вухо - ucho | uchwyt naczynia
вчора - wczoraj
в'язень - więzień
га - ha | hektar
Габон - Gabon
Габороне - Gaborone
Гавана - Hawana
гад - gad
газ - gaz
газета - gazeta
Гаїті - Haiti
гаїтянин - Haitańczyk
гаїтянка - Haitanka
гаїтянський - haitański
галактика - galaktyka
галій - gal
Галілея - Galilea (kraina) | Galilea (miasto w Hiszpanii)
галка - kawka | kawka zwyczajna
галузь - gałąź
гамбійський - gambijski
Гамбія - Gambia
Гамільтон - Hamilton
Гана - Ghana
гандбол - piłka ręczna
гарантія - gwarancja | rękojmia
гарбуз - dynia
Гаргантюа - Gargantua
гармонія - harmonia
гарний - ładny | piękny
гарячий - gorący | gwałtowny | zapalczywy | porywczy
Гаяна - Gujana
Гватемала - Gwatemala (państwo) | Gwatemala (miasto)
гватемалець - Gwatemalczyk | gwatemalczyk
гватемалка - Gwatemalka | gwatemalka
гватемальський - gwatemalski
гвинтівка - karabin
гвінеєць - Gwinejczyk
гвінейка - Gwinejka
гвінейський - gwinejski
Гвінея - Gwinea
Гвінея-Бісау - Gwinea Bissau
Гданськ - Gdańsk
Ґданськ - Gdańsk
Гдиня - Gdynia
ґедзь - giez
гедонізм - hedonizm
гектар - hektar
гектолітр - hektolitr
гелієвий - helowy
гелій - hel
гелікоптер - helikopter | вертоліт
Гельсінкі - Helsinki
гематологія - hematologia
гематурія - krwiomocz | hematuria
географія - geografia
геологія - geologia
геометричний - geometryczny
геометрія - geometria
германізація - germanizacja
германій - german
германський - niemiecki
героїзм - heroizm | bohaterstwo
Гібралтар - Gibraltar
гібралтарський - gibraltarski
гівно - gówno
гілка - gałąź
гімн - hymn
гімно - kał | wydalina
гіпопотам - hipopotam
гість - gość
гітара - gitara
гітарист - gitarzysta
гітаристка - gitarzystka
гітлерівець - hitlerowiec
глибокий - głęboki
глобалізація - globalizacja
глобальне потепління - globalne ocieplenie
глухар - głuszec | głuchy | duża śruba z kwadratową lub sześciokątną główką
глухий - głuchy
гляціологія - glacjologia
гніздо - gniazdo
гном - gnom | krasnal
говорити - mówić | rozmawiać
год. - godz. (= година)
Ґодзілла - Godzilla
година - godzina | pora | czas | ładna pogoda
годинник - zegar | zegarek
голем - golem
голий - nagi
голкіпер - bramkarz
голова - głowa | przewodniczący | prezes
голод - głód
голодний - głodny
голос - głos
голуб - gołąb | ozdoba mająca kształt gołębia (1.1) wykonana z papieru | wosku lub innego materiału
голубий - niebieski | błękitny | homoseksualista
гольф - golf
гомеопатія - homeopatia
гомосексуалізм - homoseksualizm
Гондурас - Honduras
гора - góra | szczyt | stos | sterta
горілка - wódka | palnik
горіти - palić się | płonąć
горло - gardło | szyja | szyjka (butelki)
горобець - wróbel
город - ogród | miasto
горох - groch | groszek
гостина - gościna
гостинець - gościniec (podarunek od gościa lub powracającego z podróży) | gościniec (droga, trakt)
гостинний - gościnny (cecha) | gościnny (przeznaczony dla gości)
гостинність - gościnność
гостинно - gościnnie
гострий - ostry
готель - hotel
готовий - gotowy
гра - gra
град - grad
грам - gram
граматика - gramatyka
граната - granat
грати - grać (na instrumencie muzycznym) | grać (w jakąś grę) | grać (rolę w filmie lub teatrze)
грати з відкритими картами - grać w otwarte karty
грати на нервах - grać na nerwach
грати першу скрипку - grać pierwsze skrzypce
гратися в кота й мишку - bawić się w kotka i myszkę
графік - grafik
графіка - grafika
грек - Grek
грекомовний - greckojęzyczny
Гренада - Grenada (państwo)
Греція - Grecja
грецький - grecki
гречанка - Greczynka
гречка - gryka | hreczka
гриб - grzyb
грива - grzywa
гривня - hrywna | nazwa ukraińskiej waluty
григоріанський - gregoriański
гріб - grób | trumna
грім - grom | grzmot
гріх - grzech
грішити - grzeszyć
грішник - grzesznik
грішниця - grzesznica
гроза - burza | nawałnica | groza | postrach
громадянська війна - wojna domowa
гроші - pieniądz
грудень - grudzień
грузин - Gruzin
грузинка - Gruzinka
грузинський - gruziński
Грузія - Gruzja
група - grupa | ekipa
груша - grusza | gruszka
гуакамоле - guacamole
губа - warga | końcówka kleszczy | obcęg i innych narzędzi służąca do przytrzymywania przedmiotów | zatoka głęboko wdzierająca się w obszar wysuszony lub pozbawiony zbiorników wodnych
ґудзик - guzik
гульден - gulden
гурд - gourde
гуска - gęś | gąska
давальний відмінок - celownik
давати - dawać
Дакка - Dhaka
даласі - dalasi
далекий - daleki | odległy | obcy
далі буде - ciąg dalszy nastąpi | cdn.
Далмація - Dalmacja
Даніель - Daniel
Данія - Dania
дарованому коневі в зуби не дивляться - darowanemu koniowi w zęby się nie zagląda
дати - dać
датський - duński
датчанин - Duńczyk
датчанка - Dunka
дах - dach | pokrycie budynku | mieszkanie
два - dwa | 2
двадцятий - dwudziesty
двадцятка - dwudziestka
двадцять - dwadzieścia | 20
дванадцятий - dwunasty
дванадцять - dwanaście | 12
двері - drzwi
двійка - dwójka
двісті - dwieście | 200
двоє - dwoje
двоєдушність - dwulicowość
дволичний - dwulicowy | obłudny
дволичність - dwulicowość
двохсотий - dwusetny
де - gdzie? | gdzie
дебіл - debil
дев'яностий - dziewięćdziesiąty
дев'яносто - dziewięćdziesiąt | 90
дев'ятеро - dziewięcioro
дев'ятий - dziewiąty
дев'ятикратний - dziewięciokrotny
дев'ятисотий - dziewięćsetny
дев'ятка - dziewiątka
дев'ятнадцятий - dziewiętnasty
дев'ятнадцять - dziewiętnaście | 19
дев'ятсот - dziewięćset | 900
дев'ять - dziewięć
декаграм - dekagram
декламувати - deklamować
декларація - deklaracja
деколонізація - dekolonizacja
деконструктивізм - dekonstruktywizm
демографія - demografia
демократ - demokrata
демократизація - demokratyzacja
демократизувати - demokratyzować
Демократична Республіка Конго - Demokratyczna Republika Konga
демократичний - demokratyczny
демократія - demokracja
демократка - demokratka
демонстрація - demonstracja
денар - denar
дендролог - dendrolog
дендрологічний - dendrologiczny
дендрологія - dendrologia
день - dzień
депортація - deportacja
дерево - drzewo | drewno
держава - państwo | kraj
державний - państwowy
десятеро - dziesięcioro
десятий - dziesiąty
десятикратний - dziesięciokrotny
десятиліття - dziesięciolecie
десятка - dziesiątka
десять - dziesięć | 10
де чорт не зможе, туди бабу пошле - gdzie diabeł nie może, tam babę pośle
дешевий - tani
Джакарта - Dżakarta
джерело - źródło
Джибуті - Dżibuti (kraj) | Dżibuti (miasto)
джибутійський - dżibutyjski
джинси - dżinsy
джміль - trzmiel
Джорджтаун - Georgetown
джу́нглі - dżungla
дзвінко - dźwięcznie | donośnie
дзеркало - lustro | zwierciadło
дзьоб - dziób
див. - zob. (= дивись)
дивитися - patrzeć | spoglądać | oglądać | pilnować | doglądać
дивитися крізь рожеві окуляри - patrzeć przez różowe okulary
дизентерія - dyzenteria | czerwonka
диктатор - dyktator
диктатура - dyktatura
дим - dym
динаміка - dynamika
динар - dinar
диня - melon
дискусія - dyskusja
дитина - dziecko
дитячий садок - przedszkole
дифалія - difalia
діагенез - diageneza
діамант - diament
діатриба - diatryba
Діва - Panna
дівка - dziewczyna
дівчина - dziewczyna
дід - dziadek | dziadzio
дідусь - dziadek | dziadzio | dziadunio
дідько знає - licho wie | diabeł wie
дієслово - czasownik
дієтологія - dietetyka
ділити шкуру вбитого ведмедя - dzielić skórę na niedźwiedziu
дім - dom
дім розпусти - dom rozpusty
дірхам - dirham
дітвора - dzieciarnia | dziatwa
для - dla
до - do
доба - doba | epoka
добраніч - dobranoc
добре - dobrze
добридень - dzień dobry
добрий - dobry
добрий вечір - dobry wieczór
добрий день - dzień dobry
доброго дня - dzień dobry
доброго ранку - dzień dobry
добросовісний - sumienny | rzetelny
добросовісність - sumienność | rzetelność
довгий - długi
довго - długo
довірливий - ufny | łatwowierny
довірливість - ufność | łatwowierność
довір'я - zaufanie
догори ногами - do góry nogami (w odwrotnym położeniu) | do góry nogami (na odwrót, nieprawidłowo, nie tak jak zwykle)
додаток - dodatek
до зустрічі - do zobaczenia
доктринер - doktryner
доктринерка - doktrynerka
доктринерство - doktrynerstwo
доктринерський - doktrynerski
документ - dokument
документація - dokumentacja
долар - dolar
доларизація - dolaryzacja
доларовий - dolarowy
долина - dolina
долоня - dłoń
долото - dłuto
домашній - domowy
Домініка - Dominika | imię Dominika
Домінікана - Dominikana
домініканець - Dominikanin
домініканка - Dominikanka
Домініканська Республіка - Dominikana
домініканський - dominikański
домосід - domator
Донецьк - Donieck
до побачення - do widzenia
дорога - droga | kierunek | sposób dojścia do celu | podróż
дорогий - drogi
дорослий - dorosły
Доха - Ad-Dauha
дочка - córka
дощ - deszcz
дощовий - deszczowy
д-р - dr (= доктор) | doktor
драм - dram
драматург - dramaturg | dramatopisarz
дриблінг - drybling
дрижати за свою шкуру - drżeć o swoją skórę | bać się o swoją skórę
дрізд - drozd
друг - przyjaciel | kolega
друга світова війна - druga wojna światowa
другий - drugi | następny
дружина - żona
дуб - dąb
Дублін - Dublin
дублінський - dubliński
дуже - bardzo | strasznie
думати - myśleć | sądzić | zamierzać | mieć zamiar
дурень - dureń
дурень у квадраті - dureń do kwadratu
дурний - głupi | nierozumny
дурня клеїти - kleić durnia | rżnąć głupa | udawać Greka | wydurniać się
душ - prysznic | natrysk
душа - dusza
дюжина - tuzin
дядько - wuj | wujek
дякувати - dziękować
дякую - dziękuję
дятел - dzięcioł
еволюція - ewolucja
евфемізм - eufemizm
егоїзм - egoizm
егоїст - egoista
егоїстичний - egoistyczny
Езоп - Ezop
ейнштейній - einstein
Еквадор - Ekwador
еквадорець - Ekwadorczyk
еквадорка - Ekwadorka
еквадорський - ekwadorski
Екваторіальна Гвінея - Gwinea Równikowa
екзамен - egzamin | sprawdzian | próba | test
екзаменатор - egzaminator
екзаменаторський - egzaminatorski (dotyczący egzaminatora)
екзаменаційний - egzaminacyjny
екзаменувати - egzaminować
екзотичний - egzotyczny
екологічний - ekologiczny
екологія - ekologia
екскурсія - wycieczka
електричний - elektryczny
електроніка - elektronika
елемент - element
Ельзас - Alzacja
Ель-Кувейт - Kuwejt
Емілія - Emilia
емірат - emirat
Еней - Eneasz
енологія - enologia
ентомологія - entomologia
енциклопедія - encyklopedia
епідеміолог - epidemiolog
епідеміологія - epidemiologia
епідемія - epidemia
епоха - epoka | okres | czas
ера - era
ерекція - erekcja
Еритрея - Erytrea
еротика - erotyka
Ер-Ріяд - Rijad
ескалація - eskalacja
естетика - estetyka
естонець - Estończyk
Естонія - Estonia
естонка - Estonka
естонський - estoński
етап - etap
етика - etyka
етимологія - etymologia
ефіоп - Etiopczyk
Ефіопія - Etiopia
ефіопка - Etiopka
ефіопський - etiopski
ехокардіографія - echokardiografia
Євразія - Eurazja
євро - euro
Європа - Europa
європеєць - Europejczyk
європейка - Europejka
Європейська комісія - Komisja Europejska
європейський - europejski
Європейський Союз - Unia Europejska
Єгипет - Egipt
єгипетський - egipski
єгиптянин - Egipcjanin
єгиптянка - Egipcjanka
єдність - jedność
єзуїт - jezuita | jezuita (obłudnik)
єзуїтство - jezuityzm
єзуїтський - jezuicki | jezuicki (przebiegły, obłudny, przewrotny)
Ємен - Jemen
єна - jen
єпископ - biskup
Єреван - Erywań
Єрусалим - Jerozolima
єрусалимський - jerozolimski
ЄС - Unia Europejska | UE
жаба - żaba
жарт - żart
жедрит - gedryt
Женева - Genewa
женевець - genewczyk
женевка - genewka
женевський - genewski
живий - żywy
живопис - malarstwo | malowidło | obraz
жираф - żyrafa | жирафа
жирова тканина - tkanka tłuszczowa
жити - żyć | mieszkać
жити на широку ногу - żyć na wysokiej stopie
жити як кіт з собакою - żyć jak pies z kotem
життя - życie
жінка - kobieta | żona
жіночий - żeński | kobiecy
жіночий рід - rodzaj żeński
жовта картка - żółta kartka
жовтень - październik
жовтий - żółty
жовток - żółtko
жолудь - żołądź
жук - żuk
журавель - żuraw
журналіст - dziennikarz
журналістика - dziennikarstwo
з - z - dziesiąta litera ukraińskiego alfabetu | z | od | około
за - za | na | w ciągu | przez | od | o | po | podczas | przy
завжди - zawsze
завтра - jutro
Загреб - Zagrzeb
задирати носа - zadzierać nosa
заєць - zając
займати - zajmować
займатися - zajmować się
займенник - zaimek
закон - prawo
закоханий - zakochany
залізо - żelazo | produkty z żelaza (1.1)
Замбія - Zambia
замок - zamek | pałac | kłódka
Замостя - Zamość
зануда - nudziarz
зараз - zaraz | natychmiast | naraz
затока - zatoka
захист - obrona
захід - zachód (chwila zniknięcia ciała niebieskiego, w domyśle: Słońca, za horyzontem) | zachód (kierunek geograficzny) | środek
збити з пантелику - zbić z pantałyku
зброя - broń | oręż
звичайний - zwyczajny | zwykły
з вогню та в полум'я - z deszczu pod rynnę
звук - dźwięk
зв'язок - związek | połączenie
згадувати - przypominać | wspominać | nadmieniać
згода - zgoda
зграя - zgraja | grupa
здоров - cześć!
здоровий - zdrowy
здоров'я - zdrowie
зебра - zebra
зелена людинка - zielony ludzik (ufoludek) | zielony ludzik (żołnierz rosyjski)
зелений - zielony | dolar | polityk związany z ekologią
земельний - rolny | rolniczy | agrarny
землетрус - trzęsienie ziemi
земля - ziemia
Земля - Ziemia
зима - zima
зимовий - zimowy
зимородок - zimorodek
Зімбабве - Zimbabwe
зіниця - źrenica
зірка - gwiazda | gwiazdor
з'їзд - kongres | konferencja
злий - zły | gniewny | bolesny
злопам'ятливий - pamiętliwy
злопам'ятний - pamiętliwy
злопам'ятність - pamiętliwość
злопам'ятство - pamiętliwość
зміна - zmiana
змія - żmija | wąż
знак - znak
знаменитий - znamienity
знання - wiedza | wiadomości | znajomość czegoś
знати - znać | wiedzieć
знахідний відмінок - biernik
знаходитися - znajdować się
значний - znaczny | znaczący
знімок - zdjęcie | kopia
зозуля - kukułka
золота рука - złota rączka
золота середина - złoty środek
золота справа - złoty interes
золоте діло - złoty interes
золотий - złoty
золоті руки - złota rączka
золото - złoto
зоо- - zoo-
зоологія - zoologia
зоопарк - zoo
зоопланктон - zooplankton
зоря - gwiazda | zorza
зошит - zeszyt
З Різдвом Христовим - Wesołych Świąt (Bożego Narodzenia)
зрозуміти - zrozumieć
зуб - ząb
зубний - zębowy | do zębów
зупинка - przystanek | zatrzymanie się | przerwa
зустріч - spotkanie | powitanie | przyjęcie
зустрічатися - spotykać się
і - i (oraz) | dwunasta litera ukraińskiego alfabetu
Іван - Iwan | Jan
Ігор - Igor | ukraińskie imię męskie
ідеалізм - idealizm
ідеологічний - ideologiczny
ідеологія - ideologia
ідіот - idiota
ідіотизм - idiotyzm | głupota | idiotyzm (upośledzenie umysłowe)
ідіотичний - idiotyczny
ідіотія - idiotyzm (upośledzenie umysłowe)
ідіотка - idiotka
ідіотство - idiotyzm | głupota
ідіотський - idiotyczny
-ізм - -izm
Ізраїль - Izrael
ізраїльський - izraelski
ізраїльтянин - Izraelczyk
ізраїльтянка - Izraelka
Іісус Христос - Jezus Chrystus
імбир - imbir
іменник - rzeczownik
імунологія - immunologia
ім'я - imię
інвестувати - inwestować
індик - indyk
індиферентизм - indyferentyzm
індиферентний - indyferentny
індиферентність - indyferentność
індійський - indyjski
Індійський океан - Ocean Indyjski
Індія - Indie
індонезієць - Indonezyjczyk
індонезійка - Indonezyjka
індонезійський - indonezyjski
Індонезія - Indonezja
інж. - inż. (= інженер) | inżynier
інженер - inżynier
іновірець - innowierca | różnowierca
іновірка - innowierka | różnowierka
іновірний - innowierczy | różnowierczy
іновірство - innowierstwo | różnowierstwo
інструмент - instrument
інтелект - intelekt
інтелігентний - inteligentny
інтелігенція - inteligencja
інфекційний - infekcyjny
інфекція - zakażenie | infekcja
інформація - informacja
інший - inny
Ірак - Irak
іракець - Irakijczyk
іракійка - Irakijka
іракський - iracki
Іран - Iran
іраністика - iranistyka
іранський - irański | perski
ірландець - Irlandczyk
Ірландія - Irlandia
ірландка - Irlandka
ірландський - irlandzki
іронізувати - ironizować
іронічний - ironiczny
іронія - ironia
ісландець - Islandczyk
Ісландія - Islandia
ісландка - Islandka
ісландський - islandzki
існувати - istnieć
іспанець - Hiszpan
Іспанія - Hiszpania
іспанка - Hiszpanka | hiszpanka
іспаномовний - hiszpańskojęzyczny
іспанський - hiszpański
істина - prawda
історизм - historyzm
історик - historyk
історичний - historyczny
історіографія - historiografia
історія - historia | dzieje | opowieść
істота - istota
Ісус - Jezus
італієць - Włoch
італійка - Włoszka
італійський - włoski
Італія - Włochy
і там і тут - tu i ówdzie
і т. д. - itd. (= і так далі)
іти - iść
і т. п. - itp. (= і тому подібне)
ітрій - itr
іхтіологія - ichtiologia
їдальня - jadalnia
їжа - jedzenie
їжак - jeż
її - jej
їсти - jeść
Йоан - Jan
Йов - Hiob
йога - joga
Йоганнесбург - Johannesburg
його - jego
Йоккаїті - Yokkaichi
йолоп - dureń | głupiec | jełop
Йорданія - Jordania
кабачок - kabaczek
каблучка - pierścionek
Кабо-Верде - Zielony Przylądek
Кабул - Kabul
кава - kawa | ziarno kawowca | napój z ziaren (1.1) | namiastka kawy (1.2) naturalnej przygotowana z ziaren zbóż
Кавказ - Kaukaz
кавове дерево - kawowiec
кавун - arbuz
каганат - kaganat
кадмій - kadm
кажан - nietoperz
казати - mówić | kazać | rozkazywać | polecać
казах - Kazach
Казахстан - Kazachstan
казахстанський - kazaski | kazachski | kazachstański
казахський - kazaski | kazachski | kazachstański
казашка - Kazaszka
казка - bajka | baśń | bujda
Каїр - Kair
календар - kalendarz
календарний - kalendarzowy
калій - potas
каліфорній - kaliforn
кальвінізм - kalwinizm
кальвініст - kalwinista | kalwin
кальвіністка - kalwinistka
кальвіністський - kalwiński | kalwinistyczny
калькулятор - kalkulator
кальцит - kalcyt
кальцій - wapń
калюжа - kałuża
Камбоджа - Kambodża
камбоджійський - kambodżański
Камерун - Kamerun (państwo)
камінь - kamień
Канада - Kanada
канадійський - kanadyjski
канадський - kanadyjski
канал - kanał
Канберра - Canberra
канікули - wakacje
канікуловий - wakacyjny
канонізація - kanonizacja
Капернаум - Kafarnaum
капітан - kapitan
капуста - kapusta
карась - karaś
карат - karat
карбованець - karbowaniec
кардіологія - kardiologia
карма - karma
Карпати - Karpaty
картопля - ziemniaki | kartofle
Кастилія - Kastylia
каталог - katalog
Катар - Katar
католик - katolik
католицизм - katolicyzm
католицтво - katolicyzm
католицький - katolicki
католичка - katoliczka
кацап - kacap
кацапка - kacapka (Rosjanka)
кацапський - kacapski (rosyjski)
качатися зо сміху - tarzać się ze śmiechu | pokładać się ze śmiechu
качка - kaczka
качкодзьоб - dziobak
каштан - kasztan
кванза - kwanza
квартал - kwartał | dzielnica
квартира - mieszkanie
квас - kwas chlebowy
квасоля - fasola
квача - kwacha
квінтал - kwintal
квітень - kwiecień
квітка - kwiat
квітнути - kwitnąć
кебаб - kebab
кемпінг - kemping
кенійський - kenijski
Кенія - Kenia
кетсаль - quetzal
кетчуп - keczup
кефір - kefir
кидати - rzucać | ciskać
кидати слова на вітер - rzucać słowa na wiatr (zapowiadać, obiecywać coś, czego się nie zrealizuje) | rzucać słowa na wiatr (używać czczych, próżnych słów)
кидок - rzut | zryw | skok | przerzut
Київ - Kijów
Киргизія - Kirgistan
Киргизстан - Kirgistan
кисень - tlen
кислий - kwaśny
кит - wieloryb
китаєзнавство - chinoznawstwo | sinologia
китаєць - Chińczyk
китаїстика - sinoistyka | filologia chińska | chinoznawstwo | sinologia
Китай - Chiny
китайський - chiński
китаянка - Chinka
кишеня - kieszeń
Кишинів - Kiszyniów
ківі - kiwi
кікс - kiks w grze w piłkę | kiks w bilardzie | kiks
кілограм - kilogram
кілометр - kilometr
кілька - kilka
кількадесят - kilkadziesiąt
кільканадцять - kilkanaście
кількісний - ilościowy
кімната - pokój
кімнатна температура - temperatura pokojowa
кімнатний - pokojowy
Кінгстон - Kingston
кінець - koniec | kraniec | śmierć
кінці з кінцями зводити - wiązać koniec z końcem
Кіншаса - Kinszasa
кінь - koń
кіп - kip
Кіпр - Cypr
кіпріот - Cypryjczyk
кіпріотка - Cypryjka
кіпріотський - cypryjski
кіпрський - cypryjski
Кірибаті - Kiribati
кістка - kość | ość
кіт - kot
Кіто - Quito
кіш - kosz
кішка - kotka
кларнет - klarnet
кларнетист - klarnecista
кларнетистка - klarnecistka
класифікатор - klasyfikator
класифікація - klasyfikacja
класифікувати - klasyfikować
класицизм - klasycyzm
класичнний - klasyczny
клептоманія - kleptomania
клерикалізм - klerykalizm
кличний відмінок - wołacz
клімат - klimat
кліматичний - klimatyczny
кліматолог - klimatolog
кліматологічний - klimatologiczny
кліматологія - klimatologia
клінічний - kliniczny
клітина - komórka
ключ - klucz (do zamka) | klucz | klucz (ptaków) | klucz (na pięciolinii)
книга - księga | książka
книжка - książka
коаліція - koalicja
кобальт - kobalt | ciemnoniebieska farba | w której składzie znajduje się kobalt (1.1)
коваль - kowal
ковбаса - kiełbasa
код - kod
кодеїн - kodeina
кожен - każdy | co
кожний - każdy | co
коза - koza
козел - kozioł
Козеріг - Koziorożec
койот - kojot
колектив - kolektyw
колективізація - kolektywizacja
колективізм - kolektywizm
колективізувати - kolektywizować
колективіст - kolektywista
колективістичний - kolektywistyczny (związany z kolektywizmem, charakterystyczny dla kolektywizmu)
колективістка - kolektywistka
колективістський - kolektywistyczny (charakterystyczny dla kolektywisty lub kolektywistki)
колективний - kolektywny | zespołowy | zbiorowy | wspólny
колективність - kolektywność
колективно - kolektywnie | zespołowo | zbiorowo | grupowo
колесо - koło
коли - kiedy? | kiedy | gdy | gdyby | jakby
колись - kiedyś | niegdyś
коліно - kolano | kolanko | pokolenie
колір - kolor | barwa
коло - koło | krąg
колон - kolon | colon
колоноскопія - kolonoskopia
Колумб - Kolumb (odkrywca)
Колумбія - Kolumbia
кольоровий - kolorowy
кома - przecinek | śpiączka | koma
комар - komar
комаха - owad
коментатор - komentator
комета - kometa
комісія - komisja | komis | prowizja
комітет - komitet
Коморські острови - Komory
Коморські Острови - Komory
комп'ютер - komputer
комунізм - komunizm
комунікація - komunikacja
Конакрі - Konakry
конвалія - konwalia
Конго - Kongo
коновал - konował (człowiek bez przygotowania weterynaryjnego zajmujący się kastrowaniem lub leczeniem koni) | konował (kiepski lekarz)
консервативний - konserwatywny
консерватизм - konserwatyzm
контрабас - kontrabas
контрабасист - kontrabasista
контратака - kontratak
конфлікт - konflikt
конформізм - konformizm
конформіст - konformista
конформістка - konformistka
конформістський - konformistyczny
Конфуцій - Konfucjusz
концентраційний табір - obóz koncentracyjny
концерт - koncert
концтабір - obóz koncentracyjny
Копенгаген - Kopenhaga
кора - kora
корабель - statek | okręt
Коран - Koran
кордон - granica
корейський - koreański
Корея - Korea Południowa | Korea Północna
корзина - kosz
корисний - korzystny | pożyteczny | użyteczny | przydatny | pomocny | wygodny | użytkowy
корисний ідіот - użyteczny idiota
коричневий - brązowy
корінь - korzeń
корова - krowa
королева - królowa
королевич - królewicz
королівство - królestwo
король - król
коромисло - koromysło
корона - korona
корона з голови не впаде - korona z głowy nie spadnie
короткий - krótki
коротко - krótko
короткозорість - krótkowzroczność
космічний - kosmiczny
космос - kosmos
Коста-Рика - Kostaryka
Коста-Ріка - Kostaryka
Костюшко - Kościuszko (nazwisko polskie i białoruskie)
Косцян - Kościan
Кот-д'Івуар - Wybrzeże Kości Słoniowej
котел - kocioł
коханка - kochanka
кохання - miłość | kochanie
кохати - kochać
краватка - krawat
країна - kraj
край - krawędź | kraniec
крамниця - sklep
крапка - kropka
крапка з комою - średnik
красивий - piękny
крейда - kreda
крематорій - krematorium
кремінь - krzemień
кремній - krzem
крижень - krzyżówka | kaczka krzyżówka
крик - krzyk | wrzask
крило - skrzydło
кримінальний - kryminalny
кримський - krymski
Кримський півострів - Krym | Półwysep Krymski
криптон - krypton
криця - stal
кричати - krzyczeć | wołać
кріль - królik
кріп - koper | koperek
Кріспін - Kryspin (imię męskie)
кріт - kret
кров - krew
кровоносна система - układ krwionośny
кровоносний - krwionośny
крокодил - krokodyl
кролик - królik
крона - korona
круглий - krągły | kulisty
крук - kruk
крюк - hak
ксенофобія - ksenofobia
Куала-Лумпур - Kuala Lumpur
Куба - Kuba
кубізм - kubizm
кубло розпусти - jaskinia rozpusty | gniazdo rozpusty
Кувейт - Kuwejt
кукурудза - kukurydza
куленепробивний - kuloodporny
кулінарія - kuchnia
культ - kult
культура - kultura
куна - kuna
куниця - kuna
купити - kupić
купувати - kupować
купувати кота в мішку - kupować kota w worku
курдупель - kurdupel
курець - palacz (tytoniu)
курити - palić (tytoń)
курка - kura
курорт - kurort | uzdrowisko
кутовий удар - rzut rożny
кухня - kuchnia
к'ят - kiat
лабіринт - labirynt
лабораторія - laboratorium
лавка - ławka | ława
ламаїзм - lamaizm
лампа - lampa
лампада - lampka
лампочка - żarówka | lampka choinkowa
Лаос - Laos
Ла-Пас - La Paz
ларі - lari
ластівка - jaskółka
лат - łat
латвієць - Łotysz
латвійка - Łotyszka
латвійський - łotewski
Латвія - Łotwa
латинізація - latynizacja
латинник - łacinnik
латиноамериканець - Latynoamerykanin
латиноамериканка - Latynoamerykanka
латиноамериканський - latynoamerykański
Латинська Америка - Ameryka Łacińska
латинський - łaciński
лебідь - łabędź
лев - lew
Лев - Lew | ♌
левиця - lwica
легеня - płuco
легінь - młodzieniec
легка атлетика - lekkoatletyka | lekka atletyka
легкий - lekki
лежати - leżeć
лей - lej
лек - lek
лелека - bocian
лемпіра - lempira
Лесото - Lesotho
лимон - cytryna
липа - lipa
липень - lipiec
лис - lis | chytry człowiek
лисиця - lisica | samica lisa
лист - liść
листок - listek
листоноша - listonosz
листопад - listopad | opadanie liści
лит - lit
Литва - Litwa
литвин - Litwin
литвинка - Litwinka
литка - łydka
литовець - Litwin
литовка - Litwinka
литовський - litewski
лице - twarz
лицемір - obłudnik
лицемірка - obłudnica
лицемірний - obłudny
лицемірство - obłuda
лише - tylko
лібералізація - liberalizacja
лібералізм - liberalizm
Ліберія - Liberia
Лібревіль - Libreville
Ліван - Liban
лівий - lewy | lewicowy
Лівія - Libia
лід - lód
ліжко - łóżko
лік - lek | lekarstwo | liczba
лікар - lekarz
лікарка - lekarka
лікарня - szpital
лікер - likier
лікопен - likopen
лікувати - leczyć
Лілонгве - Lilongwe
лінгвіст - lingwista
лінгвістичний - lingwistyczny
лінгвістка - lingwistka
лінія - linia
ліра - starogrecka lira | dawny instrument strunowy popularny w Rosji | na Ukrainie i Białorusi | lira
ліс - las
лісистий - lesisty
лісистість - lesistość
лісництво - leśnictwo
лісовий - leśny
лісопилка - tartak
лісопильний - tartaczny
лісопильня - tartak
лісопосадка - sadzenie lasu
лісоруб - drwal
лісорубний - drwalski (dotyczący drwalnictwa)
лісорубський - drwalski (dotyczący drwala)
лісостеп - lasostep
лісостеповий - lasostepowy
літак - samolot
літати - latać
літера - litera
література - literatura
літературний - literacki
літій - lit
літній - letni
літо - lato
літопис - latopis (staroruski rocznik kronikarski) | kronika
літр - litr
ліхтар - latarnia
Ліхтенштейн - Liechtenstein
ліцензія - licencja
ліцитація - licytacja
лоб - czoło
логарифм - logarytm
логіка - logika
ложка - łyżka | łyżki | ложки
локшина - makaron
Лондон - Londyn
лопата - łopata
лосось - łosoś
лотерея - loteria
лоті - loti
Луанда - Luanda
луг - łąka | ług
лука - łąka
лупанар - lupanar
лупанарій - lupanar
лучник - łucznik
Львів - Lwów
льоха - maciora | locha
любити - lubić | kochać
любов - miłość
людина - człowiek
людство - ludzkość
Люксембург - Luksemburg
люксембуржець - Luksemburczyk | luksemburczyk
люксембуржка - Luksemburka | luksemburka
люксембурзький - luksemburski
лютеранин - luteranin
лютеранка - luteranka
лютеранство - luteranizm
лютеранський - luterański
лютий - luty | zły | okrutny | srogi
лялька - lalka
мавпа - małpa
Маврикій - Mauritius
Мавританія - Mauretania
магазин - sklep
магній - magnez
магніт - magnes
Мадагаскар - Madagaskar
Мадрид - Madryt
майбутній час - czas przyszły
майдан - plac
майже - niemal | prawie
майстер - mistrz
македонець - Macedończyk
Македонія - Macedonia
македонка - Macedonka
македонський - macedoński
македонянин - Macedończyk
макіавеллівський - makiaweliczny | machiaweliczny | makiawelski
макіавеллізм - makiawelizm (polityka zgodna z zasadą, że „cel uświęca środki”) | makiawelizm (postępowanie przewrotne i perfidne)
макіавелліст - makiawelista
максимум - maksimum
Мала Азія - Azja Mniejsza
Малабо - Malabo
Малаві - Malawi
малавійський - malawijski
Малайзія - Malezja
Маланка - Małanka | zabawa w wieczór poprzedzający Nowy Rok według kalendarza juliańskiego (13 stycznia według kalendarza gregoriańskiego)
Мале - Male
маленький - mały
малина - malina
Малі - Mali
мало - mało
малодушність - małoduszność | bojaźliwość | lękliwość
Мальдіви - Malediwy
Мальта - Malta
мальтійський - maltański
мама - mama
Манама - Manama
манат - manat
манган - mangan
Мапуту - Maputo
марка - marka
марокканець - Marokańczyk
марокканка - Marokanka
марокканський - marokański
Марокко - Maroko
Масеру - Maseru
масло - masło
маслюк - maślak
маслюк звичайний - maślak zwyczajny
маслюк зернистий - maślak ziarnisty
маслюк модриновий - maślak żółty | maślak modrzewiowy
математика - matematyka
материк - kontynent | ląd
матеріал - materiał
матеріалізм - materializm
мати - matka | mieć | posiadać
мати голову на плечах - mieć głowę na karku
мати ніж на горлі - mieć nóż na gardle
Мауглі - Mowgli
мед - miód
медицина - medycyna
медичний - medyczny
Медуза - Meduza
межувати - graniczyć | rozgraniczać
Мексика - Meksyk
мексиканський - meksykański
мелодія - melodia
ментальність - mentalność
мер - burmistrz
Меркурій - Merkury
Мертве море - Morze Martwe
мертвий - martwy
Месопотамія - Mezopotamia
метал - metal
металевий - metalowy
метелик - motyl
метемпсихоз - metempsychoza
метеорит - meteoryt
метеоритика - meteorytyka
метеорна астрономія - meteorytyka
метикал - metical
метилморфін - metylomorfina
метод - metoda
метр - metr
метро - metro
механік - mechanik
Мехіко - Meksyk
меч - miecz
ми - my
мигдаль - migdał
мило - mydło | miło | mile
мимовільний - mimowolny
минулий час - czas przeszły
мир - pokój
мистецтво - sztuka | twórczość artystyczna
мити - myć
мить - moment | mgnienie | chwila
миша - mysz
міастенія - miastenia
мігматит - migmatyt
мідь - miedź
міжнародний - międzynarodowy
мій - mój
мікологія - mykologia | mikologia
мікроавтобус - mikrobus
мікроб - mikrob
мікробіологія - mikrobiologia
Мікронезія - Mikronezja
мікроскоп - mikroskop
міліграм - miligram
міліметр - milimetr
міліційний - milicyjny (dotyczący milicji)
міліціонер - milicjant
міліціонерка - milicjantka
міліціонерський - milicyjny (dotyczący milicjanta lub milicjantki)
міліція - milicja (nazwa policji w niektórych krajach) | milicja (formacja wojskowa tworzona z cywilów mających własną broń, zwykle na czas wojny)
мільйон - milion | 1 000 000
мільйонер - milioner
мільйонерка - milionerka
мільйонний - milionowy
мільярд - miliard | 1 000 000 000
мільярдний - miliardowy
мінералогія - mineralogia
Мінськ - Mińsk
мінський - miński
мірмекологія - myrmekologia
міряти - mierzyć
міст - most
містечко - miasteczko
містити - mieścić | zawierać
місто - miasto
місце - miejsce
місцевий - lokalny
місцевий відмінок - miejscownik
міський - miejski
місяць - miesiąc | księżyc | naturalny satelita Ziemi lub innych planet
міф - mit
міфічний - mityczny
міфологізація - mitologizacja
міфологізувати - mitologizować
міфологія - mitologia | zbiór mitów | nauka o mitach
міцний - mocny | silny
мішок - worek
млин - młyn
множина - liczba mnoga | zbiór
мова - język | mowa
мовознавець - językoznawca
мовознавство - językoznawstwo
мовчати - milczeć | cisza!
могила - mogiła | grób
могти - móc
модриновий - modrzewiowy
Мозамбік - Mozambik (państwo)
мозок - mózg
мокра робота - mokra robota
мокрий - mokry (pokryty lub nasiąknięty wodą, albo inną cieczą) | mokry (obfity w deszcze)
молдаванин - Mołdawianin
молдаванка - Mołdawianka
Молдавія - Mołdawia | Mołdowa
молдавський - mołdawski
Молдова - Mołdawia
молитва - modlitwa
молодий - młody | pan młody
молодь - młodzież
молоко - mleko
молочна кислота - kwas mlekowy
Монако - Monako
монарх - monarcha
монархія - monarchia
Монголія - Mongolia
монотеїстка - monoteistka
Монровія - Monrovia
Монтсеррат - Montserrat
море - morze
мореплавець - żeglarz | marynarz
морква - marchew
мороз - mróz
морозиво - lody
Мороні - Moroni
морський - morski
морський вовк - wilk morski
морфін - morfina
морфологія - morfologia
Москва - Moskwa
мотика - motyka
мрія - marzenie
мріяти - marzyć | śnić
мстивий - mściwy
мстивість - mściwość
мужність - odwaga
музей - muzeum
музейний - muzealny
музика - muzyka | muzykant | grajek
музикальний - muzykalny
музикант - muzykant | muzyk
музикантка - muzykantka | muzyczka
музичний - muzyczny
мука - męka | mąka
муніципальний - municypalny
мураха - mrówka
мурашка - mrówka
мурашник - mrowisko
мускул - mięsień | muskuł
мусульманин - muzułmanin
мусульманський - muzułmański
муха - mucha
мухомор - muchomor
мухомор білий смердючий - muchomor jadowity
мухомор зелений - muchomor sromotnikowy | muchomor zielonawy
мухомор пантерний - muchomor plamisty
мухомор червоний - muchomor czerwony
мухомор червоніючий - muchomor czerwieniejący | muchomor czerwonawy
м'яз - mięsień
М'янма - Myanmar | Birma
м'ясо - mięso
м'ята - mięta
м'яч - piłka
на - na
на безриб'ї і рак риба - na bezrybiu i rak ryba
набирати - nabierać
на вагу золота - na wagę złota
навігація - nawigacja
навіть - nawet
надвоє баба ворожила - na dwoje babka wróżyła
надія - nadzieja
на добраніч - dobranoc
надобраніч - dobranoc
назва - nazwa | tytuł
називний відмінок - mianownik
наївний - naiwny
наївність - naiwność
Найробі - Nairobi
наказовий спосіб - tryb rozkazujący
накфа - nakfa
намет - namiot
Намібія - Namibia
напій - napój
напр. - np. (= наприклад) | na przykład
наприкінці - pod koniec
наприклад - na przykład
наркоманія - narkomania
народ - naród
народжувати - rodzić
народитися - urodzić się
народний - ludowy
населення - ludność | zaludnienie
наслідник - spadkobierca | następca
Нассау - Nassau
натовп - tłum | ciżba
натрій - sód
наука - nauka
науковий - naukowy
Наум - Nahum
Науру - Nauru
націоналізація - nacjonalizacja
націоналізм - nacjonalizm
націоналіст - nacjonalista
націоналістичний - nacjonalistyczny (odnoszący się do nacjonalizmu) | nacjonalistyczny (związany z nacjonalistami)
націоналістка - nacjonalistka
націоналістський - nacjonalistyczny (związany z nacjonalistami)
національний - narodowy
наш - nasz
нгултрум - ngultrum
Нджамена - Ndżamena
не - nie
небо - niebo | część kosmosu widziana z Ziemi | miejsce | gdzie jest Bóg (bogowie)
не вірити своїм очам - nie wierzyć własnym oczom
невірник - niewierzący (w boga)
негр - Murzyn
негритянка - Murzynka
неділя - niedziela
незабаром - wkrótce
незалежність - niepodległość
незгода - niezgoda
неінвазивний - nieinwazyjny
нейробіологія - neurobiologia
нема диму без вогню - nie ma dymu bez ognia
немає - nie ma
неня - matka
необхідний - konieczny | niezbędny
неодим - neodym
неолібералізм - neoliberalizm
неон - neon
Непал - Nepal
неплатоспроможний - niewypłacalny
неплатоспроможність - niewypłacalność
нептуній - neptun
несправедливий - niesprawiedliwy
несправедливість - niesprawiedliwość (brak sprawiedliwości) | niesprawiedliwość (niesprawiedliwy postępek)
низький - niski
низько - nisko
ні - nie | ni | ani
Нігер - Niger
Нігерія - Nigeria
ніготь - paznokieć
нідерландець - Holender
Нідерланди - Holandia
нідерландка - Holenderka
нідерландський - holenderski
ніж - nóż | niż | aniżeli
нікель - nikiel
ніколи - nigdy
Нікосія - Nikozja
німець - Niemiec
німецький - niemiecki
Німеччина - Niemcy
німка - Niemka
нірвана - nirwana
ніс - nos | dziób
ніхто - nikt
Ніцца - Nicea
ніч - noc
ніша - nisza
ніщо - nic
новий - nowy | nowożytny | nowoczesny
нога - noga
ножиці - nożyczki
нозологія - nozologia
Ноїв ковчег - arka Noego
номер - numer
нонконформізм - nonkonformizm
нонконформіст - nonkonformista
нонконформістка - nonkonformistka
нонконформістський - nonkonformistyczny
Норвегія - Norwegia
норвежець - Norweg
норвежка - Norweżka
норвезький - norweski
носок - nosek | czubek | skarpetka
носоріг - nosorożec
Нуакшот - Nawakszut
нуль - zero | 0
нульовий - zerowy
няв - miau!
обеліск - obelisk
Об'єднані Арабські Емірати - Zjednoczone Emiraty Arabskie
обід - obiad | obwód | obręcz
обіцяти - obiecać
обіцяти золоті гори - obiecywać złote góry
обличчя - twarz | oblicze | charakter | wygląd
оборона - obrona
Овен - Baran | ♈
овечий - owczy
овоч - warzywo
овуляція - owulacja | jajeczkowanie
огірок - ogórek
Одер - Odra
Одеса - Odessa
один - jeden | pewien | sam | sam jeden
одинадцятий - jedenasty
одинадцять - jedenaście | 11
одна ластівка не робить весни - jedna jaskółka wiosny nie czyni
однина - liczba pojedyncza
ожеледь - gołoledź
ожина - jeżyna
озеро - jezioro
ознака - oznaka
океан - ocean
океанічний - oceaniczny
око - oko
око циклону - oko cyklonu (obszar ciszy w centrum cyklonu)
Оксана - Ksenia
окультизм - okultyzm
окуляри - okulary | окуляр
олень - jeleń
оливка - oliwka
олівець - ołówek
олігарх - oligarcha
олігархія - oligarchia
олія - olej
олово - cyna
Оман - Oman
онкологічний - onkologiczny
онкологія - onkologia
онук - wnuk
онука - wnuczka
ООН - ONZ (= Організація Об'єднаних Націй) | Organizacja Narodów Zjednoczonych
опал - opal
оплаток - opłatek
опозиція - opozycja
опортунізм - oportunizm
опортуніст - oportunista
опортуністка - oportunistka
опортуністський - oportunistyczny
оранжевий - pomarańczowy
оргазм - orgazm
орган - narząd | organ
Організація Об'єднаних Націй - Organizacja Narodów Zjednoczonych
організм - organizm (żywa istota) | organizm (ciało człowieka) | organizm (złożona struktura lub organizacja)
органіст - organista
органогенез - organogeneza
орел - orzeł
орудний відмінок - narzędnik
оса - osa
освіта - oświata | edukacja
осел - osioł
оселедець - śledź | osełedec
осінній - jesienny
осінь - jesień
осінь життя - jesień życia
осмій - osm
особа - osoba
особливість - osobliwość | cecha szczególna/wyróżniająca
особовий - osobisty
останній - ostatni
остракізм - ostracyzm (bojkot jakiejś osoby lub grupy osób) | ostracyzm (sąd skorupkowy)
острів - wyspa | ostrów
острівець - wyspiarz
острівок - wysepka | ostrówek
отець - ojciec
отримати - dostać | otrzymać
отрута - trucizna
Оттава - Ottawa
оцет - ocet
очне яблуко - gałka oczna
ошуканка - oszustka
ошуканство - oszustwo
ошукування - oszukiwanie
павук - pająk
падати - padać
падати з ніг - padać z nóg
Пакистан - Pakistan
палац - pałac
палеоботаніка - paleobotanika
палеозоологія - paleozoologia
палеонтологія - paleontologia
палеофітологія - paleofitologia | paleobotanika
палець - palec
Палікір - Palikir
Панама - Panama
пантеїзм - panteizm
панчоха - pończocha
панщина - pańszczyzna
папір - papier (materiał) | papier (dokument)
папір усе зносить - papier jest cierpliwy
папір усе терпить - papier jest cierpliwy
папороть - paproć
паприка - papryka
папуга - papuga
Парагвай - Paragwaj
парадокс - paradoks
парашут - spadochron
Париж - Paryż
парк - park
парниковий ефект - efekt cieplarniany
партія - partia
парубок - chłopak
пасивний - bierny
паспорт - paszport | dowód osobisty
патологія - patologia
патріот - patriota
патріотизм - patriotyzm
патріотичний - patriotyczny
патріотка - patriotka
пацифізм - pacyfizm
пацифіст - pacyfista
пацюк - szczur | prosię
педант - pedant
педантизм - pedantyzm | pedanteria
педантичний - pedantyczny
педантичність - pedantyczność
педантка - pedantka
педофіл - pedofil
педофілія - pedofilia
Пекін - Pekin
пелікан - pelikan
пенальті - rzut karny
пеніцилін - penicylina
перевтомлюватися - przemęczać się
перегонка - destylacja
переклад - przekład
перемагати - pokonywać | zwyciężać | przezwyciężać
перемир'я - zawieszenie broni
перемога - zwycięstwo
перепливати - przepływać
перо - pióro ptasie | pióro | pióro wieczne
персик - brzoskwinia
персона - osoba
Перу - Peru
перукар - fryzjer
перукарня - zakład fryzjerski
перший - pierwszy
пес - pies
песо - peso
петрушка - pietruszka
печера - jaskinia
печінка - wątroba
п'єса - sztuka teatralna | utwór muzyczny
пивний - piwny
пиво - piwo
пилосос - odkurzacz
писанка - pisanka
писати - pisać
письменник - pisarz
питання - pytanie
питати - pytać
пити - pić
пів - pół
Південна Америка - Ameryka Południowa
Південна Корея - Korea Południowa
південний - południowy
південноамериканський - południowoamerykański
Південно-Африканська Республіка - Republika Południowej Afryki
південь - południe | godzina 12 | południe (kierunek geograficzny)
півень - kogut
півкуля - półkula | półkula kuli ziemskiej
півмісяць - półksiężyc
північ - północ | godzina 24 | północ (kierunek geograficzny)
Північна Америка - Ameryka Północna
Північна Ірландія - Irlandia Północna
Північна Корея - Korea Północna
північний - północny
північноамериканський - północnoamerykański
півострів - półwysep
півтора - półtora
півтори - półtorej
півфінал - półfinał
півфіналіст - półfinalista
півфінальний - półfinałowy
пігмент - pigment | barwnik
під - pod
підборіддя - podbródek
під відкритим небом - pod gołym niebem
підземний - podziemny
підкласти свиню - podłożyć świnię
підлога - podłoga
підмет - podmiot
підосиковик - koźlarz czerwony | podosiniak
підпільний - podziemny | konspiracyjny
підставити свиню - podłożyć świnię
пізній - późny
пізно - późno
пінгвін - pingwin
піонер - pionier (osadnik, który jako pierwszy zasiedla dany teren) | pionier (osoba przecierająca szlaki w jakiejś dziedzinie) | pionier (harcerz zrzeszony w komunistycznej organizacji) | pionier (żołnierz wojsk inżynieryjnych)
піонерка - pionierka (osadniczka, który jako pierwsza zasiedla dany teren) | pionierka (kobieta przecierająca szlaki w jakiejś dziedzinie) | pionierka (harcerka zrzeszona w komunistycznej organizacji)
піонерський - pionierski | harcerski
піп - pop (duchowny prawosławny)
піп своє, а чорт своє - pop swoje | czort swoje
піроманія - piromania
пісня - pieśń | piosenka
пісок - piasek
пісочниця - piaskownica
Піттсбург - Pittsburgh (stolica Allegheny)
піхва - pochwa
ПК - komputer osobisty (= персональний комп'ютер)
планета - planeta
планетарний - planetarny
платина - platyna
платоспроможний - wypłacalny
платоспроможність - wypłacalność
плебісцит - plebiscyt
плече - ramię | bark
плід - owoc | płód | zarodek ludzki lub zwierzęcy | rezultat działań | ród | rodzina | rasa
пліт - płot | tratwa
плітка - plotka | płoć | płotka
пляшка - butelka | flaszka
Пномпень - Phnom Penh
повезти - powieźć | odwieźć | poszczęścić się | udać się | powieść się
поверх - piętro | z wierzchu | ponad | na
поверхня - powierzchnia
повіка - powieka
повільний - wolny | powolny
повісити ніс на квінту - zwiesić nos na kwintę
повітря - powietrze
повний - pełny
повстанець - powstaniec
повстання - powstanie
повстанський - powstańczy
поганий - zły
погода - pogoda
подарунок - prezent | podarunek
подвійний - podwójny
подушка - poduszka
поезія - poezja
поема - wiersz
поет - poeta
позбавляти - pozbawiać
Познань - Poznań
поїзд - pociąg
поле - pole | dziedzina | tło
полечка - Polka | poleczka
політик - polityk
політика - polityka
політичний - polityczny
політкоректність - poprawność polityczna
поліція - policja
полонізація - polonizacja
полоній - polon
полуниця - truskawka
полька - Polka | polka
польський - polski
Польща - Polska
поляк - Polak
помаранчевий - pomarańczowy
помешкання - mieszkanie | zamieszkanie
помилка - pomyłka
помирати - umierać
помідор - pomidor
понад - ponad
понеділок - poniedziałek
попадя - popadia | żona popa
пора року - pora roku
порнографічний - pornograficzny
порнографія - pornografia
порожня дижка гучить, а повна мовчить - pusta beczka huczy | a pełna milczy
Порт-Луї - Port Louis
Порто-Ново - Porto-Novo
Порт-о-Пренс - Port-au-Prince
португалець - Portugalczyk
Португалія - Portugalia
португалка - Portugalka
португальський - portugalski
посилка - przesyłka
послідовник - zwolennik
посмішка - uśmiech
поставити - wystawić
потворний - potworny | straszny
потреба - potrzeba
потрійний - potrójny
поцілувати замок - pocałować klamkę
поцілувати колодку - pocałować klamkę
початок - początek
починати - zaczynać | rozpoczynać
пошта - poczta
поштовий - pocztowy (związany z pocztą)
права тварин - prawa zwierząt
правда - prawda | dokładność | precyzja
правий - prawy | prawicowy | niewinny | mający rację
право - prawo
Прага - Praga
празеодим - prazeodym
практика - praktyka
прапор - flaga
праска - żelazko
працювати - pracować
праця - praca
предок - przodek
президент - prezydent
привабливий - pociągający | atrakcyjny
приватизаційний - prywatyzacyjny
приватизація - prywatyzacja
приватизувати - prywatyzować
приватний - prywatny (niebędący własnością państwa) | prywatny (osobisty) | prywatny (nieoficjalny)
приватник - prywaciarz
приватність - prywatność
приватно - prywatnie
привіт - cześć! | pozdrowienie | przywitanie
придатний - przydatny
приємність - przyjemność
приїжджати - przyjechać
приїхати - przyjechać
прийменник - przyimek
приклад - przykład
прикметник - przymiotnik
прикметниковий - przymiotnikowy
природа - natura
прислівник - przysłówek
присудок - orzeczenie
приходити - przychodzić
прізвище - nazwisko
про - o
проблема - problem
про вовка помовка - o wilku mowa
прогестерон - progesteron
програма - program
прогрес - progres | postęp
продавати - sprzedawać
простий - prosty
проститутка - prostytutka | prostytutka (człowiek sprzedajny)
проституція - prostytucja
простодушний - prostoduszny
простодушність - prostoduszność
протекціонізм - protekcjonizm
протест - protest
протестант - protestant | osoba protestująca
протестантизм - protestantyzm
протестантка - protestantka | kobieta protestująca
протестантство - protestantyzm
протестантський - protestancki
протипожежний - przeciwpożarowy
професія - profesja | zawód
процес - proces
прочитати - przeczytać
психіатр - psychiatra
психіатричний - psychiatryczny
психіатрія - psychiatria
психіка - psychika
психічний - psychiczny
психолог - psycholog
психологічний - psychologiczny
психологія - psychologia
птах - ptak
пташка - ptak
птиця - ptak | persona | figura | szycha
публічний - publiczny
публічний будинок - dom publiczny
публічний дім - dom publiczny
пуголовок - kijanka
пула - pula
пульмонологія - pulmonologia
пурпурний - purpurowy
пустеля - pustynia
Пхеньян - Pjongjang
пшениця - pszenica
п'ятдесят - pięćdziesiąt | 50
п'ятдесятий - pięćdziesiąty
п'ятеро - pięcioro
п'ятий - piąty
п'ятикратний - pięciokrotny
п'ятисотий - pięćsetny
п'ятірка - piątka | 5
п'ятнадцятий - piętnasty
п'ятнадцятка - piętnastka
п'ятнадцять - piętnaście | 15
п'ятниця - piątek
п'ятсот - pięćset | 500
п'ять - pięć
Рабат - Rabat
равлик - ślimak (z muszlą) | znak @ | małpa
рада - rada
радіо - radio
радіоактивний - radioaktywny
радість - radość
радник - doradca
Радянський Союз - Związek Radziecki
раз - raz
разом - razem | wspólnie
рай - raj
рак - rak (zwierzę) | rak (choroba)
Рак - Rak | ♋
рана - rana
ранок - ranek | poranek | rano
раптом - nagle
рахувати - liczyć | rachować
реальгар - realgar
реальний - realny
ребро - żebro | krawędź | kant
ревматичний - reumatyczny | reumatoidalny
революція - rewolucja
регент - regent
регіональний - regionalny
редиска - rzodkiewka
реєстрація - rejestracja | rejestrowanie
реєструвати - rejestrować
реінкарнація - reinkarnacja
Рейк'явік - Reykjavík
релігійний - religijny
релігійність - religijność
релігія - religia
рентабельний - rentowny | opłacalny | zyskowny
рентабельність - rentowność | opłacalność
рентабельно - rentownie | opłacalnie | zyskownie
республіка - republika
Республіка Конго - Republika Konga | Kongo
Республіка Польща - Rzeczpospolita Polska
ресторан - restauracja
референдум - referendum
речення - zdanie
речовина - substancja | materia
риба - ryba
Риби - Ryby
Рига - Ryga
Рим - Rzym
римський - rzymski
ринггіт - ringgit
ринок - rynek
рись - ryś
рицар - rycerz
ріал - rial | real
ріг - róg
рід - rodzina | ród | plemię | pochodzenie | rodzaj | typ | odmiana
рідина - ciecz
рідкий - rzadki
рідко - rzadko
рієль - riel
Різдво - Boże Narodzenie
різний - inny | różny
рік - rok
ріка - rzeka
річка - rzeczka
РНК - RNA
робити - robić | wykonywać | tworzyć | produkować | działać | pracować | czynić | uczyniać
робити з мухи слона - robić z muchy słonia | robić z igły widły | wyolbrzymiać coś
робити, як віл - harować jak wół
робітник - pracownik
робітниця - robotnica
робот - robot
робота - robota | praca
робота горить в руках - robota pali się w rękach
робота горить під руками - robota pali się w rękach
робота не вовк, в ліс не втіче - robota nie zając, nie ucieknie | robota nie wilk | do lasu nie ucieknie
родій - rod
родовий - rodowy
родовий відмінок - dopełniacz
рожевий - różowy | radosny | pogodny
розмірність - wymiar | rozmiar
розмовляти - rozmawiać
Розо - Roseau
розпусний - rozpustny
розпусний дім - dom rozpusty
розпусник - rozpustnik
розпуста - rozpusta
розпутник - rozpustnik
розпутниця - rozpustnica
розстабілізація - destabilizacja
розум - rozum
розуміти - rozumieć | pojmować
розумний - rozsądny | rozumny
рококо - rokoko
ром - rum
роман - powieść | romans
романтизм - romantyzm
романтичний - romantyczny
ропуха - ropucha
російська мова - język rosyjski
Російська Федерація - Federacja Rosyjska
російський - rosyjski
Росія - Rosja
росіянин - Rosjanin
росіянка - Rosjanka
рослина - roślina
рослинний - roślinny
рости - rosnąć
рот - usta | buzia | otwór gębowy | jama gębowa
РП - RP (= Республіка Польща) | Rzeczpospolita Polska
ртуть - rtęć
Руанда - Rwanda
рубідій - rubid
руйнувати - rujnować
рука - ręka
румун - Rumun
Румунія - Rumunia
румунка - Rumunka
румунський - rumuński
рупія - rupia
руський - rosyjski | російський
руфія - rupia
рух - ruch
Ряшів - Rzeszów
ряшівський - rzeszowski
сад - ogród | sad
саксофоніст - saksofonista
саксофоністка - saksofonistka
саксофонний - saksofonowy
Сальвадор - Salwador
Самара - Samara
самаритянин - Samarytanin
самаритянка - Samarytanka
самаритянський - samarytański
самарій - samar
Самарканд - Samarkanda
самбар - sambar
самовар - samowar
самовбивець - samobójca
самовбивство - samobójstwo
самовбивця - samobójca | samobójczyni
самовбивчий - samobójczy
самогон - bimber | samogon
самогонка - bimber | samogon
самогонний - bimbrowniczy | samogonowy
самогонник - bimbrownik
самогубець - samobójca
самогубний - samobójczy
самогубство - samobójstwo
самогубця - samobójca | samobójczyni
Сана - Sana
Сан-Марино - San Marino
сантиметр - centymetr
Санто-Домінго - Santo Domingo
Сан-Томе і Принсіпі - Wyspy Świętego Tomasza i Książęca
Сантьяго - Santiago
Сан-Хосе - San José
сапфір - szafir
Сараєво - Sarajewo
сарана - szarańcza | dokuczliwy | uciążliwy tłum
сардинка - sardynka
Саудівська Аравія - Arabia Saudyjska
сауна - sauna
Сахара - Sahara
свинець - ołów
свинина - wieprzowina
свиня - świnia
свідомий - świadomy
свіжий - świeży
свій - swój
Свіноуйсцє - Świnoujście
світ - świat
світанок - świt | brzask
Світлана - Świetlana | Swietłana
світлий - jasny
світло - światło
світовий - światowy
свічка - świeca | świeczka
свобода - wolność | swoboda
свобода слова - wolność słowa
святвечір - Wigilia Bożego Narodzenia
себе - się | siebie
седі - cedi
сейсмічний - sejsmiczny
сейсмологія - sejsmologia
секта - sekta
секунда - sekunda
секція - sekcja
селекціонер - selekcjoner | specjalista w zakresie selekcji
селекція - selekcja
селен - selen
селера - seler
село - wieś | wioska
семеро - siedmioro
семестр - semestr
семикратний - siedmiokrotny
семисотий - siedemsetny
семінар - seminarium
Сенегал - Senegal
Сент-Вінсент і Гренадини - Saint Vincent i Grenadyny
Сент-Джонс - Saint John's
Сент-Джорджес - Saint George's
Сент-Люсія - Saint Lucia
сепулька - sepulka
серб - Serb
Сербія - Serbia
сербка - Serbka
сербський - serbski
серед - wśród | pośród
середа - środa
Середземне море - Morze Śródziemne
середній рід - rodzaj nijaki
серйозний - poważny
серотонін - serotonina
серпень - sierpień
сертифікат - certyfikat
серце - serce | źródło uczuć | główna | najważniejsza lub centralna część czegoś | serce dzwonu | kształt | przedmiot symbolizujący serce (1.1-2)
серцевий - sercowy
сесія - sesja
сестра - siostra | pielęgniarka | zakonnica
Сеул - Seul
сеульський - seulski
сигарета - papieros
сигналізація - sygnalizacja
сидіти - siedzieć
сидіти як на голках - siedzieć jak na szpilkach
сидіти як на шпичках - siedzieć jak na szpilkach
сикхізм - sikhizm
сила - siła | siły | grupa ludzi mająca na coś wpływ | potęga | moc | moc prawna | sedno | istota
сильний - silny | intensywny
симптом - symptom
син - syn
синдром - syndrom
синій - granatowy | niebieski | siny
синонім - synonim
синтагма - syntagma
сир - ser
Сирія - Syria
сирний - serowy
система - system | układ
сіль - sól
сільське господарство - rolnictwo
сім - siedem
сімдесят - siedemdziesiąt | 70
сімдесятий - siedemdziesiąty
сімка - siódemka
сімнадцятий - siedemnasty
сімнадцять - siedemnaście | 17
сімсот - siedemset | 700
сім'я - rodzina
Сінгапур - Singapur
сіно - siano
сірий - szary | niepozorny
сірка - siarka | tłusta i żółta wydzielina na ściankach kanału usznego | wydzielina gruczołów u owiec
сірник - zapałka
січень - styczeń
сказати - powiedzieć
скандій - skand
скеля - skała
скептицизм - sceptycyzm
скільки - ile?
складовий - sylabiczny
скло - szkło
Скоп'є - Skopje
скорпіон - skorpion
Скорпіон - Skorpion
скринька - skrzynka
скрипаль - skrzypek
скрипач - skrzypek
скрипачка - skrzypaczka
скрипка - skrzypce
скрипковий - skrzypcowy | wiolinowy
скрупульозний - skrupulatny
скрупульозність - skrupulatność
скрупульозно - skrupulatnie
скумбрія - makrela
славістика - slawistyka
слива - śliwa | śliwka
сливовий - śliwkowy
слимак - ślimak (bez muszli)
сліпий - ślepy
словак - Słowak
словацький - słowacki
словачка - Słowaczka
Словаччина - Słowacja
словенець - Słoweniec
Словенія - Słowenia
словенка - Słowenka
словенський - słoweński
словник - słownik
словниковий - słownikowy
словничок - słowniczek
слово - słowo | wyraz | mowa | słowo (obietnica) | wystąpienie | głos (prawo przemawiania)
слов'янський - słowiański
слон - słoń | goniec
слухати - słuchać
смак - smak
смачного - smacznego
смерть - śmierć | koniec życia | personifikacja śmierci (1.1)
сметана - śmietana
сміливість - śmiałość | odwaga
сміх - śmiech
Смоленськ - Smoleńsk
смоленський - smoleński
сніг - śnieg
сніговий - śniegowy | śnieżny
сніговик - bałwan | figura ze śniegu
сніговиця - śnieżyca | zawieja śnieżna | zamieć
снігопад - opady śniegu
снігур - gil
снігуронька - śnieżka | kula śnieżna
сніданок - śniadanie
сніжинка - śnieżynka | płatek śniegu
сніжка - śnieżka | kula śnieżna
сніжний - śnieżny
сніжно-білий - śnieżnobiały
собака - pies
собака на сіні - pies ogrodnika | pies na kopie siana
сова - sowa | nocny marek (osoba, która zwykle późno kładzie się spać, aktywna głównie wieczorem)
совєтолог - sowietolog
совєтологічний - sowietologiczny
совєтологія - sowietologia
совість - sumienie
сойка - sójka
сокіл - sokół
солдат - żołnierz
солідарний - solidarny
солідарність - solidarność | solidarność (współodpowiedzialność za działania lub ich zaniechanie)
солодкий - słodki | błogi
солодко - słodko
Солон - Solon
солоний - słony
сом - sum | som
Сомалі - Somalia
сон - sen
сонет - sonet
сонечко - słoneczko | słonko | biedronka
сонце - słońce (widoczne z Ziemi na niebie)
Сонце - Słońce (gwiazda)
сонячний - słoneczny
соняшник - słonecznik
Сопот - Sopot
сорок - czterdzieści | 40
сорока - sroka
сороковий - czterdziesty
сосна - sosna
сотий - setny
сотка - setka
Софія - Sofia
соціалізм - socjalizm
Союз Радянських Соціалістичних Республік - Związek Socjalistycznych Republik Radzieckich
спальний - sypialny | do spania
спальний мішок - śpiwór
спасибі - dziękuję
спати - spać
сперма - sperma
спеціалізація - specjalizacja
спеціаліст - specjalista
спеціалістичний - specjalistyczny
спеціалістка - specjalistka
спеціальний - specjalny
спеціальність - specjalność
спина - plecy | grzbiet
співак - piosenkarz | śpiewak
співати - śpiewać | piać
спокій - spokój
спокійний - spokojny
Сполучені Штати Америки - Stany Zjednoczone Ameryki
сполучник - spójnik
спонсор - sponsor
спорт - sport
спосіб - sposób
справедливий - sprawiedliwy | słuszny
справедливість - sprawiedliwość | słuszność
справедливо - sprawiedliwie | słusznie
справжній - prawdziwy | rzeczywisty
спрага - pragnienie
спустити ніс на квінту - spuścić nos na kwintę
спустити носа на квінту - spuścić nos na kwintę | opuścić nos na kwintę
срібло - srebro | srebro (surowiec) | srebro (srebrny medal)
срібний - srebrny | wykonany ze srebra | koloru srebra
СРСР - ZSRR (= Союз Радянських Соціалістичних Республік)
ссавець - ssak
стабілізація - stabilizacja
стабільний - stabilny
стабільність - stabilność
стабільно - stabilnie
стадіон - stadion
сталініст - stalinista | stalinowiec
сталь - stal
станція станція - stacja
старий - stary
старість - starość
стародавній - starodawny | stary
стати поперек горла - stanąć kością w gardle
стаття - artykuł
стегно - udo
стеля - sufit
степ - step
степовий - stepowy
стіл - stół
стілець - krzesło
стіна - ściana
сто - sto | 100
стократний - stukrotny
столиця - stolica
століття - stulecie
столяр - stolarz
стоматологія - stomatologia
стопа - stopa | ryza
сторінка - strona | stronica
стояти - stać
страва - danie
страхування - ubezpieczenie
страшний - straszny
Стрілець - Strzelec
стронцій - stront
струмінь - strumień
струмок - strumyk
субота - sobota
субтропічний - subtropikalny
Сува - Suva
Судан - Sudan
сукмана - sukmana
суниця - poziomka
сура - sura
Суринам - Surinam
сусід - sąsiad
сусідка - sąsiadka
суспільно - społecznie
суспільство - społeczeństwo | społeczność | stowarzyszenie
суфікс - przyrostek
сухий - suchy
суцвіття - kwiatostan
сучасний - współczesny
сушарка - suszarka
сфера - sfera
схід - wschód (chwila pojawienia się ciała niebieskiego (w domyśle: Słońca) nad horyzontem) | wschód (kierunek geograficzny)
Східний Тимор - Timor Wschodni
східнокарибський - wschodniokaraibski
сховати - schować | ukryć
Сьєрра-Леоне - Sierra Leone
сьогодні - dzisiaj | dziś
сьомий - siódmy
та - i | ale | lecz | a | zaś | ta
табір - obóz (miejsce biwakowania) | obóz (miejsce izolacji) | obóz (sojusz, stronnictwo) | tabor | koczowisko | obozowisko
Таджикистан - Tadżykistan
Таїланд - Tajlandia
тайванський - tajwański
так - tak | w ten sposób | więc
така - taka
так званий - tak zwany
також - także | też | również
таксидермія - taksydermia
таксометр - taksometr | taksomierz
Таллінн - Tallinn
там - tam
танець - taniec
Танзанія - Tanzania
танцювати - tańczyć
Тарас - Taras
тарган - karaluch
тарілка - talerz
тато - tata
Татри - Tatry
Тбілісі - Tbilisi
тварина - zwierzę
тваринка - zwierzątko
твердий - twardy | stały | stabilny
твій - twój
творити - tworzyć
театр - teatr
Тегеран - Teheran
тегеранський - teherański
Тегусігальпа - Tegucigalpa
текст - tekst
телебачення - telewizja
телефон - aparat telefoniczny | telefon | numer telefonu
телець - cielec
Телець - Byk
телятина - cielęcina
темний - ciemny
тенге - tenge
теніс - tenis
теологічний - teologiczny
тепер - teraz | obecnie
теперішній час - czas teraźniejszy
теплий - ciepły
Терези - Waga
територія - terytorium
термін - termin
термодинаміка - termodynamika
тероризм - terroryzm
техніка - technika
технологія - technologia
т.з. - tzw. (= так званий) | tak zwany
ти - ty
тигр - tygrys | człowiek | charakterem przypominający drapieżność tygrysa
тиждень - tydzień
тиск - ciśnienie | nacisk | presja | ucisk
тисяча - tysiąc | 1000
тисячний - tysięczny
тисячократний - tysiąckrotny
титан - tytan | silny | potężny człowiek
Тихий океан - Ocean Spokojny
тиша - cisza
тіло - ciało
тільки - tylko | jedynie | dopiero | ledwie
тінь - cień
Тірана - Tirana
тісто - ciasto
тітка - ciocia | ciotka
тітушка - uliczny chuligan opłacany przez rząd | używany do walki z opozycją
товар - towar
товариство - towarzystwo | stowarzyszenie | spółka
товариство з обмеженою відповідальністю - spółka z ograniczoną odpowiedzialnością
товариш - towarzysz
Того - Togo
той - tamten
Токіо - Tokio
толерантність - tolerancja
том - tom
томат - pomidor | pasta lub sos z pomidorów
Тоскана - Toskania
тоталітаризм - totalitaryzm
тоталітарний - totalitarny
трава - trawa
травень - maj
трагедія - tragedia | nieszczęście
трагікомедія - tragikomedia
трагікомічний - tragikomiczny
трагічний - tragiczny
традиційний - tradycyjny
традиційно - tradycyjnie
традиціоналізм - tradycjonalizm
традиціоналіст - tradycjonalista
традиціоналістка - tradycjonalistka
традиціоналістський - tradycjonalistyczny
традиція - tradycja
трамвай - tramwaj
трансфер - transfer
тренер - trener
третій - trzeci
три - trzy
тривати - trwać
тридцятий - trzydziesty
тридцять - trzydzieści | 30
трильйон - trylion
трильйонний - trylionowy
тринадцятий - trzynasty
тринадцять - trzynaście | 13
Тринідад і Тобаго - Trynidad i Tobago
триста - trzysta | 300
трійка - trójka
Тріполі - Trypolis
тріска - trzaska | drzazga | dorsz
троє - troje
тромбон - puzon
тромбоніст - puzonista
тромбоністка - puzonistka
тромбонний - puzonowy
троянда - róża
труба - trąbka
трудівник - pracownik | pracuś
трьохсотий - trzechsetny
туалет - toaleta
туалетний папір - papier toaletowy
тугрик - tugrik
туди - tam | tędy
туман - mgła
тунець - tuńczyk
Туніс - Tunezja
турецький - turecki
Туреччина - Turcja
туристичний - turystyczny
Туркменістан - Turkmenistan
турок - Turek
турчанка - Turczynka
тут - tu | tutaj
Тхімпху - Thimphu
тхір - tchórz | tchórz (człowiek strachliwy, bojaźliwy)
тюль - tiul
тюркологічний - turkologiczny
тюркомовний - tureckojęzyczny
тюркський - turecki
тютюн - tytoń
тютюнокуріння - palenie tytoniu
тютюнопаління - palenie tytoniu
у - w | we | u
убивати - zabijać
увага - uwaga
Уганда - Uganda
угія - ugija
угорець - Węgier
угорка - Węgierka
угорський - węgierski
Угорщина - Węgry
удар - cios | uderzenie | udar
удар нижче пояса - cios poniżej pasa
Узбекистан - Uzbekistan
Україна - Ukraina
українець - Ukrainiec
українізація - ukrainizacja
українізм - ukrainizm
українізувати - ukrainizować
україністика - ukrainistyka
українка - Ukrainka
українознавство - ukrainoznawstwo
україноненависництво - ukrainofobia | antyukrainizm
українофобія - ukrainofobia
українська мова - język ukraiński
український - ukraiński
УКХ - UKF (= льтраороткі вилі) | fale ultrakrótkie
Улан-Батор - Ułan Bator
Улан-Уде - Ułan Ude
ультразвук - ultradźwięk
умовний - warunkowy
університет - uniwersytet
УПА - UPA | Ukraińska Powstańcza Armia
уподібнення - asymilacja
у поті чола - w pocie czoła
уран - uran
Уран - Uranos | Uran
урок - lekcja
Уругвай - Urugwaj
у страха великі очі - strach ma wielkie oczy
утерти носа - utrzeć nosa
учень - uczeń
учитель - nauczyciel | instruktor
фагот - fagot
фанатизм - fanatyzm
фанатик - fanatyk
фанатичний - fanatyczny
фанатично - fanatycznie
фараон - faraon
Фарерські острови - Wyspy Owcze
фахівець - specjalista | znawca | fachowiec
фашизм - faszyzm
фашистський - faszystowski
Федеративна Республіка Німеччини - Republika Federalna Niemiec | Niemcy
фемінізм - feminizm
фенілаланін - fenyloalanina
фенілкетонурія - fenyloketonuria | oligofrenia fenylopirogronowa
феодалізм - feudalizm
Фермопіли - Termopile
Фіджі - Fidżi
фіджійський - fidżyjski
фізика - fizyka
фізіолог - fizjolog
фізіологія - fizjologia
філантропія - filantropia
філіппінець - Filipińczyk
Філіппіни - Filipiny
філіппінка - Filipinka
філіппінський - filipiński
філологія - filologia
філософія - filozofia
фін - Fin
фінал - finał
фіналіст - finalista
фінальний - finałowy
фінікієць - Fenicjanin
фінікійка - Fenicjanka
фінікійський - fenicki
Фінікія - Fenicja
фінікіянин - Fenicjanin
фінікіянка - Fenicjanka
фінка - Finka | koń fiński | finka | nóż fiński | rodzaj zimowej czapki fińskiej | lekka łódka z wąskim dziobem
фінляндизація - finlandyzacja
Фінляндія - Finlandia
фінський - fiński
фіолетовий - fioletowy
флейтист - flecista
флейтистка - flecistka
фол - faul
фонологічний - fonologiczny
фонологія - fonologia
форель - pstrąg
форма - forma
фортепіано - fortepian
фортеця - forteca | twierdza
фосфор - fosfor
фотографія - fotografia
фразеологізм - frazeologizm
фразеологічний - frazeologiczny
фразеологія - frazeologia (zasób wyrażeń w danym języku) | frazeologia (nauka o frazeologizmach) | frazeologia (frazesy)
франк - frank
Франція - Francja
француженка - Francuzka
француз - Francuz
французький - francuski
ФРН - RFN (= Федеративна Республіка Німеччини) | Republika Federalna Niemiec
фрукт - owoc | typek | nieprzyjemny lub podejrzany człowiek
фруктаріанство - frutarianizm
фруктоза - fruktoza
фтор - fluor
функція - funkcja
фунт - funt
футбол - futbol | piłka nożna
футболіст - piłkarz
футбольний - piłkarski
футурологія - futurologia
халіфат - kalifat
Харків - Charków
хвилина - minuta | chwila
хвиля - fala | długość fali
хвіст - ogon
хворий - chory
хвороба - choroba
хіджаб - hidżab
хімік - chemik
хімічний - chemiczny
хімічний елемент - pierwiastek chemiczny
хімія - chemia
хіроптерологія - chiropterologia
Хіросіма - Hiroszima
хліб - chleb | zboże
хлопець - chłopiec
хлопчик - chłopiec | chłopczyk
хлоп'ячий - chłopięcy
хлор - chlor
хмара - chmura
хмарочос - wieżowiec | drapacz chmur
хміль - chmiel
ходити - chodzić
холодильник - lodówka
холодний - zimny | chłodny
хор - chór
хорват - Chorwat
Хорватія - Chorwacja
хорватка - Chorwatka
хорватський - chorwacki
хоробрий - odważny
хотіти - chcieć
хоч ми собі брати, але наші кишені не сестри - kochajmy się jak bracia, rachujmy się jak Żydzi | chociaż jesteśmy sobie braćmi | to nasze kieszenie nie są siostrami
хребет - grzbiet | kręgosłup
хрест - krzyż
християнин - chrześcijanin
християнка - chrześcijanka
християнство - chrześcijaństwo | chrześcijaństwo (ogół chrześcijan)
християнський - chrześcijański
христологія - chrystologia
Христос - Chrystus
хром - chrom
хронічний - chroniczny
хрущ - żuk
хто - kto? | kto
худий - chudy (o człowieku)
худоба - bydło
хуй - chuj (penis)
цап - koza
цар - król | cesarz
цвинтар - cmentarz | podwórko koło cerkwi wraz z cmentarzem
цвіклі - ćwikła
цвіркун - świerszcz
цвіт - kwiat
цвітна капуста - kalafior
цвях - gwóźdź
це - to | цей
цегла - cegła
цегляний - ceglany
цезій - cez
цей - ten
Центральна Америка - Ameryka Środkowa
центральний - centralny | środkowy
церемонія - ceremonia
церій - cer
церква - kościół
цибуля - cebula
циган - Cygan
циганка - Cyganka
циганський - cygański
цигарка - papieros
циклон - cyklon
цинк - cynk
цитрина - cytryna
цікавий - interesujący
цілісність - integralność
цілувати - całować
ціна - cena
цінність - wartość
цукерка - cukierek
цукор - cukier
цунамі - tsunami
цуценя - szczeniak
Чад - Czad
чай - herbata | napar z ziół
чайка - mewa
чапля - czapla
час - czas | pora | moment
часник - czosnek
частина - część
частка - część | cząstka | partykuła
часто - często
чверть - ćwierć
чвертьфінал - ćwierćfinał
чвертьфіналіст - ćwierćfinalista
чвертьфінальний - ćwierćfinałowy
червень - czerwiec
червона картка - czerwona kartka
червоний - czerwony
черемша - czosnek niedźwiedzi ( L.) | czosnek siatkowaty ( L.)
черепаха - żółw
черешня - czereśnia
чеський - czeski
четвер - czwartek
четверо - czworo
четвертий - czwarty
четвірка - czwórka
чех - Czech
Чехія - Czechy
Чечня - Czeczenia
чешка - Czeszka
чи - czy
Чилі - Chile
чилієць - Chilijczyk
чилійка - Chilijka
чилійський - chilijski
числівник - liczebnik
число - liczba
чистий - czysty
читати - czytać
чобіт - but | botek
чоло - czoło
чоловік - mężczyzna | mąż | człowiek | jakaś osoba | zwykle mężczyzna
чоловічий рід - rodzaj męski
чоловічний - człowieczy | ludzki
чому - dlaczego? czemu? | dlaczego | czemu
чорна скринька - czarna skrzynka
Чорне море - Morze Czarne
чорний - czarny
чорниця - czarna jagoda
Чорнобиль - Czarnobyl
Чорногорія - Czarnogóra
чорт - czart | diabeł
чотири - cztery
чотирикратний - poczwórny
чотириста - czterysta | 400
чотирнадцятий - czternasty
чотирнадцять - czternaście | 14
чотирьохсотий - czterechsetny
чути - słyszeć | słuchać | czuć | odczuwać
шаблон - szablon | wzornik | wzorzec
шавлія - szałwia
шаманізм - szamanizm
шафа - szafa
шахрай - szachraj
шахрайка - szachrajka
шахрайство - szachrajstwo
шахрайський - szachrajski
швед - Szwed
шведка - Szwedka
шведський - szwedzki
швейцарець - Szwajcar
Швейцарія - Szwajcaria
швейцарка - Szwajcarka
швейцарський - szwajcarski
швейцарський сир - żółty ser | ser szwajcarski
Швеція - Szwecja
швидкий - szybki | prędki
швидко - szybko | prędko
шекель - szekel
шестеро - sześcioro
шестикратний - sześciokrotny
шестисотий - sześćsetny
шизофренік - schizofrenik
шизофренічка - schizofreniczka
шизофренічний - schizofreniczny
шизофренія - schizofrenia
шилінг - szyling
шинка - szynka
широко - szeroko
шити - szyć
шия - szyja | kark
шістдесят - sześćdziesiąt | 60
шістдесятий - sześćdziesiąty
шістка - szóstka
шістнадцятий - szesnasty
шістнадцять - szesnaście | 16
шістсот - sześćset | 600
шість - sześć
шкарпетка - skarpetka
шкідливий - szkodliwy
шкіра - skóra
школа - szkoła
шлунок - żołądek | potrawa z żołądka (1.1)
шлях - droga | szlak
шовінізм - szowinizm (skrajna postawa nacjonalistyczna) | szowinizm (wrogość wobec przedstawicieli innych grup społecznych)
шовініст - szowinista
шовк - jedwab
шоколад - czekolada
шостий - szósty
шпигунство - szpiegostwo
шпилька - szpilka
шпіхлір - spichlerz
Шрі-Ланка - Sri Lanka
штрафний майданчик - pole karne
штрафний удар - rzut karny
штука - sztuka | egzemplarz | kawał | żart | figiel
штурм - szturm
шукайте і знайдете - szukajcie, a znajdziecie
шухляда - szuflada
шьоґун - szogun
щасливий - szczęśliwy
щастя - szczęście
ще - jeszcze
що - co? | co | który | jak | że | co jakiś czas (odbywający się)
щока - policzek
щука - szczupak
щур - szczur
юань - juan
Юлія - Julia
юрба - tłum | tłok | masa
я - ja
яблуко - jabłko
яблуня - jabłoń
ягідка - jagódka
ягня - jagnię
ягода - jagoda
яєчко - jądro
язик - język | ozór | ozorek | jeniec złapany dla uzyskania informacji o wrogu
яйце - jajko | jajo
як - jak
як грім з ясного неба - jak grom z jasnego nieba
якість - jakość
як кіт наплакав - tyle, co kot napłakał
якщо - jeśli | jeżeli
ялиця - jodła | drewno z jodły (1.1) | las jodłowy
ялиця сибірська - jodła syberyjska
яловичина - wołowina
Ялта - Jałta
Ямайка - Jamajka (wyspa) | Jamajka (państwo)
Японія - Japonia
ясен - jesion
ясень - jesion
ясний - jasny
яструб - jastrząb
Ятвігія - Jaćwież
Яунде - Jaunde
ящірка - jaszczurka
