abad - opat
achosi - powodować
achwyn - narzekać
adain - skrzydło
addolwr - czciciel | wyznawca
adeilad - budynek
adeiladwaith - budowla | struktura
adeiladwr - budowniczy
aderyn - ptak
aderyn du - kos
aeddfedrwydd - dojrzałość
afal - jabłko
afallen - jabłoń
afanc - bóbr
aflwyddiannus - nieudany
afon - rzeka
agweddi - posag
Aifft - Egipt
ailadrodd - powtarzać
alarch - łabędź
Alban - Szkocja
Albania - Albania
albwm - album
allanfa - wyjście
alltud - obcokrajowiec
Almaen - Niemcy
amddiffyn - bronić
amheuaeth - wątpliwość
anadl - oddech | wiatr
anadlu - oddychać
Andora - Andora
anghofio - zapomnieć
angladd - pogrzeb
Angola - Angola
anifail - zwierzę
anner - jałówka
anodd - trudny
ansefydlogrwydd - niestabilność
ansoddair - przymiotnik
antimoni - antymon
anturiaeth - przygoda
araf - powolny
arbenigwr - specjalista | ekspert
arddodiad - przyimek
arfordir - wybrzeże
argyhoeddi - przekonywać
arian - srebro | pieniądze
Aristoteles - Arystoteles
Armenia - Armenia
arth - niedźwiedź
arweinydd - przywódca
asgwrn - kość
athrawes - nauczycielka
athro - nauczyciel
aur - złoto
awr - godzina
Awst - sierpień
Awstralia - Australia
Awstria - Austria
awyren - samolot
bach - mały
bachgen - chłopak
bachgennes - dziewczyna
ban - szczyt
bara - chleb
bardd - poeta | bard
barddoniaeth - poezja
barf - broda
barrug - szron
bawd - kciuk
bedd - grób
berf - czasownik
beth - co
betws - kaplica
Bhutan - Bhutan
bîr - piwo
blaidd - wilk
ble - gdzie
blinder - zmęczenie
blinedig - zmęczony
blodeuyn - kwiat
blodyn - kwiat
blwch llwch - popielniczka
blwydd - rok
blwyddyn - rok
bod - być
bodolaeth - istnienie
bore - ranek
brân - wrona
brawd - brat
broch - borsuk
broga - żaba
brown - brązowy
brwdfrydedd - entuzjazm
brwnt - brudny | nieczysty
buwch - krowa
bwced - wiadro
Bwlgaria - Bułgaria
bwrdd - stół
bwydo - karmić
bwyta - jeść
byd - świat
byr - krótki | niski | mały
cachadur - tchórz
cachu - gówno
cactws - kaktus
cadair - krzesło
cae - pole
caethwas - niewolnik
caethwasiaeth - niewolnictwo
Califfornia - Kalifornia
canfyddiad - odkrycie
canlyniad - rezultat
canolog - centralny
canu - śpiewać
capel - kaplica
carcharor - więzień | niewolnik
cariad - miłość
cariadus - ukochany
carreg - kamień
carw - jeleń
casáu - nienawidzić
casglwr - kolekcjoner
casineb - nienawiść
cath - kot
cath fach - kociak
caws - ser
ceffyl - koń
cefnfor - morze | ocean
cegin - kuchnia
ceiliog - kogut
celwydd - kłamstwo
celwyddgi - kłamca
cenedl - naród | nacja | rasa | ród
cenhinen - por
cenhinen Bedr - żonkil
cerdd - poemat | wiersz | poezja | muzyka | pieśń
cerddor - muzyk
cerddoriaeth - muzyka
chwaer - siostra
Chwefror - luty
chwip - bicz
chwys - pot
ci - pies
cigfran - kruk
cigydd - rzeźnik
cimwch - homar
cleddyf - miecz
clegyr - skała
cloc - zegar
cnocell - dzięcioł
coch - czerwony
coedwig - las
coedwigwr - leśniczy | leśnik
coffi - kawa
cofio - pamiętać
cogydd - kucharz
colomen - gołąb
côr - chór
corff - ciało
corryn - pająk
cost - koszt | wydatek
costrel - butelka
cosyn - ser
creadur - stworzenie
crefft - rzemiosło
crefydd - religia
crëwr - twórca
crëyr - czapla
Crist - Chrystus
crochenydd - garncarz
crocodeil - krokodyl
cronadur - akumulator
crwban - żółw
crychydd - czapla
cryman - sierp
cucumer - ogórek
cul - wąski
cusanu - całować
cwch - łódź
cwmwl - obłok | chmura
cwrw - piwo
cwsmer - klient
cyfansoddwr - kompozytor
cyfiawnder - sprawiedliwość
cyfieithu - tłumaczyć
cyfieithwr - tłumacz
cyfieithydd - tłumacz
cyflogai - pracownik
cyfreithiwr - prawnik
cyfreithwraig - prawniczka
cyfrifiadur - komputer
cyfrifiadureg - informatyka
cyfrinach - tajemnica
cyfriniol - tajemniczy
cyfuniad - połączenie | kombinacja
cyfystyr - synonim
cyllell - nóż
Cymraeg - język walijski
Cymru - Walia
cymyl - chmura
cynffon - ogon
cynhwysyn - składnik
cynnar - wczesny
cynnyrch - produkt
cynrychiolydd - reprezentant
cystadleuaeth - konkurencja | konkurs
cyẅres - konkubina
da - dobry
daearegwr - geolog
daearyddiaeth - geografia
daearyddwr - geograf
dannoedd - ból zęba
dant y llew - mniszek lekarski
darlithydd - wykładowca
darllen - czytać
dau - dwa
dau ddeg - dwadzieścia
dawnsio - tańczyć
defnyddioldeb - użyteczny | przydatny
defnyddiwr - użytkownik
defodol - rytualny | obrzędowy
deheubarth - południe | południowy region
deintydd - dentysta
del - ładny
delwedd - obraz
Denmarc - Dania
deusaith - czternaście
dial - zemsta
diddanu - zabawiać | dostarczać rozrywki
diddordeb - zainteresowanie | ciekawostka
diddorol - ciekawy
diflas - nudny
diflastod - nuda
dillad - odzież
dilledyn - odzież
dinas - miasto
diogelwch - bezpieczeństwo
diolch - dziękować | podziękowanie | dziękuję
dirmyg - pogarda
ditectif - detektyw
diwerth - bezużyteczny
diwinyddiaeth - teologia
diwylliant - kultura
doe - wczoraj
doeth - mądry
dolur - ból
dôr - drzwi
draenog - jeż
draig - smok
drudwen - szpak
drwg - zły
drws - drzwi
drychiolaeth - pojawienie się | zjawienie się | zjawa | duch | widziadło
du - czarny
duw - bóg
Duw - Bóg
duwes - bogini
dwfr - woda
dŵr - woda
dwrgi - wydra
dwy - dwa
dwyn - kraść
dydd - dzień
dydd Gwener - piątek
dydd Iau - czwartek
dydd Llun - poniedziałek
Dydd Llun - poniedziałek
dydd Mawrth - wtorek
dydd Mercher - środa
dydd Sadwrn - sobota
dydd Sul - niedziela
dyfrgi - wydra
dynes - kobieta
dynfarch - centaur
dysgu - uczyć się
dysgwr - uczeń
Ebrill - kwiecień
economegydd - ekonomista
edn - ptak
eira - śnieg
eirinen - śliwka
eirlithrad - lawina
eirlys - przebiśnieg
eliffant - słoń
emyn - hymn
enfys - tęcza
eog - łosoś
eryr - orzeł
esblygiad - rozwój | ewolucja
esgaladur - schody ruchome
esgid - but
estrys - struś
etholwr - wyborca
eto - znowu | znów
Ewrop - Europa
ewythr - wujek
Fatican - Watykan (państwo)
ffarm - farma
ffenest - okno
ffordd - droga | odległość
fforest - las
ffowlyn - kurczak
Ffrainc - Francja
ffrind - przyjaciel
ffrwydrad - wybuch
ffydd - wiara
ffyddlon - wierny
ffynhonnell - źródło
fory - jutro
fwltur - sęp
gaeaf - zima
gafr - koza
gair - słowo | wyraz
galw - wzywać
gardd - ogród
garddwr - ogrodnik
gefell - bliźniak
geirdarddiad - etymologia | źródłosłów
geiriadur - słownik
gellygen - gruszka
geneth - dziewczyna
glân - czysty
glaswellt - trawa
glaw - deszcz
gleisiad - łosoś
glin - kolano
glo - węgiel
glöyn byw - motyl
gobaith - nadzieja
gof - kowal
gohebydd - reporter
Gorffennaf - lipiec
gorsaf - stacja
gramadeg - gramatyka
grug - wrzos
gwaed - krew
gwag - pusty
gwahaniaeth - wyróżnienie | różnica | niezgoda
gwaith - praca
gwalch y pysgod - rybołów
gwaled - portfel
gwall - pomyłka | błąd
gwan - słaby
gwanwyn - wiosna
gwarchodwr - ochroniarz | stróż
gwawr - brzask
gwaywffon - oszczep
gweddi - modlitwa
gweddïo - modlić się
gwefus - warga
gwehydd - tkacz
gweithio - pracować
gwely - łóżko
gwên - uśmiech
gwennol - jaskółka
gwenwyn - trucizna | jad
gwenynen - pszczoła
gwenynwr - pszczelarz
gwenynwraig - pszczelarka
gwerdd - zielony
gwern - olcha
gwerslyfr - podręcznik
gwerthwr - sprzedawca
gwesty - hotel
gwin - wino
gwirionedd - prawda
gwiwer - wiewiórka
gwlad - kraj | państwo | krajobraz
Gwlad Pŵyl - Polska
Gwlad yr Iâ - Islandia
gwledd - uczta
gwleidydd - polityk
gwleidyddiaeth - polityka
gwlith - rosa
gwlyb - mokry
gwniadur - naparstek
gwraig - żona | kobieta
gwrandawr - słuchacz
gwrando - słuchać
gwreiddiol - oryginalny | pierwotny | autentyczny
gwybod - wiedzieć
gwybodaeth - informacja
gŵydd - gęś
gwyddbwyll - szachy
gwyddoniadur - encyklopedia
gwyddoniaeth - nauka
gwyddonydd - naukowiec
gwyn - biały
gwynt - wiatr
gwyr - zgięty
gwyrth - cud
hadu - siać
haf - lato
halen - sól
hanesydd - historyk
hapus - szczęśliwy
hardd - piękny
harddwch - piękno
haul - słońce
heb - bez
heddiw - dziś | dzisiaj
heddlu - policja
hedfan - latać
hefyd - także | ponadto
hendad - dziadek | przodek
hir - długi
hoffi - lubić
holiadur - kwestionariusz
huan - słońce
huddygl - sadza
hunllef - koszmar
hwch - locha | maciora
hwyaden - kaczka
hydref - jesień
Hydref - październik
hylif - ciecz
hyll - brzydki
i - w
iâ - lód
iaith - język
iâr - kura
iau - jarzmo
iechyd - zdrowie
ieithydd - językoznawca
ieithyddiaeth - językoznawstwo
Iesu - Jezus
ifanc - młody | młodzieńczy
i mewn - wewnątrz
Ionawr - styczeń
Iwerddon - Irlandia
jac-y-do - kawka
lamp - lampa
licio - lubić
lladrad - kradzież
llaeth - mleko
llawfeddyg - chirurg
llawn - pełny
lledr - skóra
lleidr - złodziej
llenyddiaeth - literatura
lleuad - księżyc
llew - lew
llo - cielę
Lloegr - Anglia
lluest - namiot
lluesty - namiot
Llundain - Londyn
llusern - lampa
llwy - łyżka
llydan - szeroki
llyffant - żaba
llyfr - księga
llyfrgell - biblioteka
llyfrgellydd - bibliotekarz
llyfu - lizać
llygoden - mysz
llygoden mawr - szczur
llyn - jezioro
llysfab - pasierb
llysfam - macocha
llysferch - pasierbica
llystad - ojczym
llythrennedd - umiejętność czytania
llywodraeth - rząd
lol - nonsens
lonawr - styczeń
lwcus - szczęśliwy
mab - syn
mad - dobry | szczęśliwy | mający szczęście | właściwy | dobroć
madfall - jaszczurka
mael - książę
maes - pole
Mai - maj
mam - matka
man - miejsce
marchog - rycerz | jeździec
marwnad - elegia
mathemateg - matematyka
Mawrth - marzec | Mars
meddwl - myśleć
meddyg - lekarz | doktor | medyk
Medi - wrzesień
Mehefin - czerwiec
melinydd - młynarz
melyn - żółty
melyster - słodycz
menyw - kobieta
merch - córka | dziewczyna
migwrn - kostka
mil - zwierzę | tysiąc
milltir - mila
milwr - żołnierz
mis - miesiąc
mochyn - świnia
mochyn daear - borsuk
modryb - ciotka
môr - morze
Mor Canoldir - Morze Śródziemne
môr-forwyn - syrena
morgrugyn - mrówka
môr-grwban - żółw
môr-ladrad - piractwo
môr-leidr - pirat
moron - marchew
moronen - marchew
morthwyl - młotek
morwr - marynarz
mudiad - organizacja
mwg - dym
mwnci - małpa
mwng - grzywa
mwyadur - mikroskop
mwyalchen - kos
mwydyn - robak
mwyhadur - wzmacniacz
mwyn - minerał
mynydd - góra
Nadolig - Boże Narodzenie
nain - babka
naw - dziewięć
nawn - południe
nef - niebo
neidio - skoczyć
neidr - wąż
nen - niebo
neu - albo | lub
newydd - nowy
newyddiadurwr - dziennikarz
newyn - głód
nid - nie
niwclews - jądro
niwl - mgła
nofio - pływać
nos - noc
noswaith - wieczór
nyth - gniazdo
ocapi - okapi
oen - jagnię
oer - zimny
ofn - strach
ogof - jaskinia
olaf - ostatni | ostateczny | pozostały | pośledni | najmniej odpowiedni
olew - olej
olwyn - koło
ond - ale
osgoi - unikać
pab - papież
pabell - namiot
paganiaeth - pogaństwo
paill - mąka | pyłek kwiatowy
paith - preria
pall - namiot
palmant - chodnik
parch - poszanowanie
parot - papuga
pechod - grzech
pedair - cztery
pedwar - cztery
peintiwr - malarz
peiriannwr - inżynier
peiriannydd - inżynier
pellter - odległość
pen-blwydd - urodziny
penglog - czaszka
pengwin - pingwin
pen-lin - kolano
pensaer - architekt
perllan - sad
personol - osobisty
peth - rzecz
pibonwyen - sopel
pidyn - penis | prącie
pilipala - motyl
pili-pala - motyl
pìn - szpilka
pioden - sroka
pladur - kosa
planed - planeta
plant - dzieci
pleser - przyjemność
p'nawn - popołudnie
pont - most
porchell - prosię
porffor - fioletowy
potasiwm - potas
potel - butelka
prifddinas - stolica
priffordd - autostrada
prifysgol - uniwersytet
proses - proces
Prydain - Brytania
prydnawn - popołudnie
pryf - owad | robak
pryfyn - owad
prynhawn - popołudnie
prynu - kupić
prynwr - nabywca
pump - pięć
putain - prostytutka
pwysig - ważny
pỳg - brudny
pysgod - ryby
pysgodyn - ryba
pysgotwr - rybak
reilffordd - kolej
reis - ryż
Rhagfyr - grudzień
rhaglen - program
rhegi - przeklinać
rheilffordd - kolej
rhi - król
rhodiwr - statysta
rhudd - czerwony | karmazynowy
rhwng - między
rhydd - wolny
rhyfel - wojna
rhyngrwyd - internet
Rwmania - Rumunia
Rwsia - Rosja
saer - stolarz | cieśla
saeth - strzała
Sais - Anglik
saith - siedem
salamandr - salamandra
São Tomé a Príncipe - Wyspy Świętego Tomasza i Książęca
Sbaen - Hiszpania
sbwng - gąbka (do mycia) | gąbka (organizm wodny)
seryddiaeth - astronomia
sgerbwd - szkielet
sicr - pewny
sies - szachy
sigarét - papieros
sinsir - imbir
siop - sklep
siwgr - cukier
soddgrwth - wiolonczela
söolegydd - zoolog
stumog - żołądek
sut - jak
sw - zoo
Sweden - Szwecja
swnllyd - hałaśliwy
sych - suchy
sylffwr - siarka
symudiad - ruch
tablen - piwo
Tachwedd - listopad
tacsi - taksówka
tad - ojciec
tafodiaith - dialekt
taid - dziadek
tair - trzy
tân - ogień
tarddiad - źródło | początek | pochodzenie
tarw - byk
tebygrwydd - podobieństwo
teigr - tygrys
teipiadur - maszyna do pisania
teulu - rodzina
Thermopylae - Termopile
trachwant - chciwość
traeth - plaża
tref - miasto | dom
trên - pociąg
triongl - trójkąt
trist - smutny
troed - stopa
trwm - ciężki
trwynol - nosowy
trychfil - owad
trydanwr - elektryk
Twfalw - Tuvalu
twr - grupa
tŵr - wieża
twymyn - gorączka
tŷ - dom
tŷ bach - toaleta
tylluan - sowa
tymeriadur - termometr
tynged - los
tywod - piasek
uchel - wysoki | głośny
un - jedyny
uncorn - jednorożec
Undeb Sofietaidd - Związek Radziecki
undeg - jedenaście
utgorn - trąbka
Wcráin - Ukraina
weldiwr - spawacz
Wicipedia - Wikipedia
wy - jajo
ŵy - jajko
wyneb - twarz
wyres - wnuczka
wyth - osiem
wythnos - tydzień
ych - wół
ychwanegu - dodać | dołączyć
yfed - pić
yfory - jutro
yma - tutaj
ymenyn - masło
ymlusgiad - gad
Ynys Manaw - Wyspa Man
yr Almaen - Niemcy
ysboncio - skoczyć
ysbyty - szpital
ysgrifen - pismo
ysgrifennu - pisać
ysgrifennwr - pisarz
ysgyfarnog - zając
ystafell - pokój
